Rank,Team,Games,W-L,FOs Won,FOs Lost,TM FOT,Pct.,Date,Academic Year
1,Bryant (NEC),18,8-10,242,119,361,0.670,05/25/2015-Final Statistics,2015.0
2,Denver (Big East),19,17-2,320,161,481,0.665,05/25/2015-Final Statistics,2015.0
3,Syracuse (ACC),16,13-3,292,149,441,0.662,05/25/2015-Final Statistics,2015.0
4,Cornell (Ivy League),16,10-6,260,136,396,0.657,05/25/2015-Final Statistics,2015.0
5,Rutgers (Big Ten),15,5-10,235,128,363,0.647,05/25/2015-Final Statistics,2015.0
6,Boston U. (Patriot),14,6-8,216,123,339,0.637,05/25/2015-Final Statistics,2015.0
7,Hofstra (CAA),14,5-9,177,115,292,0.606,05/25/2015-Final Statistics,2015.0
8,Navy (Patriot),14,9-5,183,122,305,0.600,05/25/2015-Final Statistics,2015.0
9,Brown (Ivy League),17,12-5,277,195,472,0.587,05/25/2015-Final Statistics,2015.0
10,Ohio St. (Big Ten),19,12-7,248,184,432,0.574,05/25/2015-Final Statistics,2015.0
11,Army West Point (Patriot),17,10-7,220,166,386,0.570,05/25/2015-Final Statistics,2015.0
12,Fairfield (CAA),15,9-6,173,135,308,0.562,05/25/2015-Final Statistics,2015.0
13,Duke (ACC),18,12-6,296,231,527,0.562,05/25/2015-Final Statistics,2015.0
14,Dartmouth (Ivy League),13,5-8,178,142,320,0.556,05/25/2015-Final Statistics,2015.0
15,Loyola Maryland (Patriot),15,7-8,206,167,373,0.552,05/25/2015-Final Statistics,2015.0
16,High Point (SoCon),17,10-7,222,182,404,0.550,05/25/2015-Final Statistics,2015.0
17,Drexel (CAA),15,7-8,177,151,328,0.540,05/25/2015-Final Statistics,2015.0
18,Hartford (America East),15,7-8,196,171,367,0.534,05/25/2015-Final Statistics,2015.0
19,Stony Brook (America East),18,13-5,267,236,503,0.531,05/25/2015-Final Statistics,2015.0
20,Binghamton (America East),13,4-9,169,150,319,0.530,05/25/2015-Final Statistics,2015.0
21,Marist (MAAC),18,14-4,224,200,424,0.528,05/25/2015-Final Statistics,2015.0
22,Jacksonville (SoCon),12,4-8,154,140,294,0.524,05/25/2015-Final Statistics,2015.0
23,Yale (Ivy League),16,11-5,190,173,363,0.523,05/25/2015-Final Statistics,2015.0
24,Maryland (Big Ten),19,15-4,205,187,392,0.523,05/25/2015-Final Statistics,2015.0
25,Johns Hopkins (Big Ten),18,11-7,250,229,479,0.522,05/25/2015-Final Statistics,2015.0
26,Penn St. (Big Ten),14,5-9,164,153,317,0.517,05/25/2015-Final Statistics,2015.0
27,Sacred Heart (NEC),13,6-7,158,148,306,0.516,05/25/2015-Final Statistics,2015.0
28,Mercer (SoCon),13,5-8,151,143,294,0.514,05/25/2015-Final Statistics,2015.0
29,Saint Joseph's (NEC),17,11-6,192,183,375,0.512,05/25/2015-Final Statistics,2015.0
30,Vermont (America East),16,6-10,245,234,479,0.511,05/25/2015-Final Statistics,2015.0
31,Towson (CAA),18,12-6,182,175,357,0.510,05/25/2015-Final Statistics,2015.0
32,Air Force (ECAC),15,8-7,163,160,323,0.505,05/25/2015-Final Statistics,2015.0
33,Notre Dame (ACC),15,12-3,195,195,390,0.500,05/25/2015-Final Statistics,2015.0
34,Richmond (SoCon),16,11-5,180,184,364,0.495,05/25/2015-Final Statistics,2015.0
35,North Carolina (ACC),17,13-4,234,242,476,0.492,05/25/2015-Final Statistics,2015.0
36,Siena (MAAC),14,5-9,164,174,338,0.485,05/25/2015-Final Statistics,2015.0
37,Mount St. Mary's (NEC),15,5-10,142,154,296,0.480,05/25/2015-Final Statistics,2015.0
38,Bellarmine (SoCon),12,4-8,131,143,274,0.478,05/25/2015-Final Statistics,2015.0
39,Villanova (Big East),14,6-8,155,170,325,0.477,05/25/2015-Final Statistics,2015.0
40,Penn (Ivy League),13,6-7,156,172,328,0.476,05/25/2015-Final Statistics,2015.0
41,Holy Cross (Patriot),13,6-7,147,167,314,0.468,05/25/2015-Final Statistics,2015.0
42,VMI (SoCon),15,1-14,167,191,358,0.466,05/25/2015-Final Statistics,2015.0
43,Delaware (CAA),15,5-10,160,186,346,0.462,05/25/2015-Final Statistics,2015.0
44,Virginia (ACC),15,10-5,184,214,398,0.462,05/25/2015-Final Statistics,2015.0
45,UAlbany (America East),19,16-3,265,314,579,0.458,05/25/2015-Final Statistics,2015.0
46,Lehigh (Patriot),16,7-9,170,202,372,0.457,05/25/2015-Final Statistics,2015.0
47,Robert Morris (NEC),14,3-11,155,185,340,0.456,05/25/2015-Final Statistics,2015.0
48,Canisius (MAAC),15,3-12,152,184,336,0.452,05/25/2015-Final Statistics,2015.0
49,St. John's (NY) (Big East),14,3-11,157,192,349,0.450,05/25/2015-Final Statistics,2015.0
50,Georgetown (Big East),16,10-6,186,228,414,0.449,05/25/2015-Final Statistics,2015.0
51,Detroit Mercy (MAAC),14,8-6,148,183,331,0.447,05/25/2015-Final Statistics,2015.0
52,Michigan (Big Ten),13,5-8,146,181,327,0.446,05/25/2015-Final Statistics,2015.0
53,Princeton (Ivy League),15,9-6,173,219,392,0.441,05/25/2015-Final Statistics,2015.0
54,UMBC (America East),13,5-8,124,160,284,0.437,05/25/2015-Final Statistics,2015.0
55,NJIT (Independent),12,0-12,107,140,247,0.433,05/25/2015-Final Statistics,2015.0
56,Marquette (Big East),16,10-6,168,221,389,0.432,05/25/2015-Final Statistics,2015.0
57,Bucknell (Patriot),15,9-6,149,197,346,0.431,05/25/2015-Final Statistics,2015.0
58,Massachusetts (CAA),15,5-10,153,204,357,0.429,05/25/2015-Final Statistics,2015.0
58,Wagner (NEC),13,4-9,105,140,245,0.429,05/25/2015-Final Statistics,2015.0
60,Harvard (Ivy League),14,7-7,165,223,388,0.425,05/25/2015-Final Statistics,2015.0
61,Quinnipiac (MAAC),15,7-8,160,217,377,0.424,05/25/2015-Final Statistics,2015.0
62,Furman (SoCon),13,4-9,107,148,255,0.420,05/25/2015-Final Statistics,2015.0
63,Monmouth (MAAC),14,6-8,99,147,246,0.402,05/25/2015-Final Statistics,2015.0
64,Manhattan (MAAC),15,1-14,136,203,339,0.401,05/25/2015-Final Statistics,2015.0
65,Lafayette (Patriot),14,4-10,133,208,341,0.390,05/25/2015-Final Statistics,2015.0
66,Hobart (NEC),14,7-7,115,182,297,0.387,05/25/2015-Final Statistics,2015.0
67,Providence (Big East),14,5-9,119,192,311,0.383,05/25/2015-Final Statistics,2015.0
68,Colgate (Patriot),16,10-6,142,234,376,0.378,05/25/2015-Final Statistics,2015.0
-,UMass Lowell (America East),14,1-13,75,272,347,0.216,05/25/2015-Final Statistics,2015.0
1,Denver (Big East),18,16-2,310,152,462,0.671,05/23/2015,2015.0
2,Bryant (NEC),18,8-10,242,119,361,0.670,05/23/2015,2015.0
3,Syracuse (ACC),16,13-3,292,149,441,0.662,05/23/2015,2015.0
4,Cornell (Ivy League),16,10-6,260,136,396,0.657,05/23/2015,2015.0
5,Rutgers (Big Ten),15,5-10,235,128,363,0.647,05/23/2015,2015.0
6,Boston U. (Patriot),14,6-8,216,123,339,0.637,05/23/2015,2015.0
7,Hofstra (CAA),14,5-9,177,115,292,0.606,05/23/2015,2015.0
8,Navy (Patriot),14,9-5,183,122,305,0.600,05/23/2015,2015.0
9,Brown (Ivy League),17,12-5,277,195,472,0.587,05/23/2015,2015.0
10,Ohio St. (Big Ten),19,12-7,248,184,432,0.574,05/23/2015,2015.0
11,Army West Point (Patriot),17,10-7,220,166,386,0.570,05/23/2015,2015.0
12,Fairfield (CAA),15,9-6,173,135,308,0.562,05/23/2015,2015.0
13,Duke (ACC),18,12-6,296,231,527,0.562,05/23/2015,2015.0
14,Dartmouth (Ivy League),13,5-8,178,142,320,0.556,05/23/2015,2015.0
15,Loyola Maryland (Patriot),15,7-8,206,167,373,0.552,05/23/2015,2015.0
16,High Point (SoCon),17,10-7,222,182,404,0.550,05/23/2015,2015.0
17,Drexel (CAA),15,7-8,177,151,328,0.540,05/23/2015,2015.0
18,Hartford (America East),15,7-8,196,171,367,0.534,05/23/2015,2015.0
19,Stony Brook (America East),18,13-5,267,236,503,0.531,05/23/2015,2015.0
20,Binghamton (America East),13,4-9,169,150,319,0.530,05/23/2015,2015.0
21,Marist (MAAC),18,14-4,224,200,424,0.528,05/23/2015,2015.0
22,Maryland (Big Ten),18,15-3,196,177,373,0.525,05/23/2015,2015.0
23,Jacksonville (SoCon),12,4-8,154,140,294,0.524,05/23/2015,2015.0
24,Yale (Ivy League),16,11-5,190,173,363,0.523,05/23/2015,2015.0
25,Johns Hopkins (Big Ten),18,11-7,250,229,479,0.522,05/23/2015,2015.0
26,Penn St. (Big Ten),14,5-9,164,153,317,0.517,05/23/2015,2015.0
27,Sacred Heart (NEC),13,6-7,158,148,306,0.516,05/23/2015,2015.0
28,Mercer (SoCon),13,5-8,151,143,294,0.514,05/23/2015,2015.0
29,Saint Joseph's (NEC),17,11-6,192,183,375,0.512,05/23/2015,2015.0
30,Vermont (America East),16,6-10,245,234,479,0.511,05/23/2015,2015.0
31,Towson (CAA),18,12-6,182,175,357,0.510,05/23/2015,2015.0
32,Air Force (ECAC),15,8-7,163,160,323,0.505,05/23/2015,2015.0
33,Notre Dame (ACC),15,12-3,195,195,390,0.500,05/23/2015,2015.0
34,Richmond (SoCon),16,11-5,180,184,364,0.495,05/23/2015,2015.0
35,North Carolina (ACC),17,13-4,234,242,476,0.492,05/23/2015,2015.0
36,Siena (MAAC),14,5-9,164,174,338,0.485,05/23/2015,2015.0
37,Mount St. Mary's (NEC),15,5-10,142,154,296,0.480,05/23/2015,2015.0
38,Bellarmine (SoCon),12,4-8,131,143,274,0.478,05/23/2015,2015.0
39,Villanova (Big East),14,6-8,155,170,325,0.477,05/23/2015,2015.0
40,Penn (Ivy League),13,6-7,156,172,328,0.476,05/23/2015,2015.0
41,Holy Cross (Patriot),13,6-7,147,167,314,0.468,05/23/2015,2015.0
42,VMI (SoCon),15,1-14,167,191,358,0.466,05/23/2015,2015.0
43,Delaware (CAA),15,5-10,160,186,346,0.462,05/23/2015,2015.0
44,Virginia (ACC),15,10-5,184,214,398,0.462,05/23/2015,2015.0
45,UAlbany (America East),19,16-3,265,314,579,0.458,05/23/2015,2015.0
46,Lehigh (Patriot),16,7-9,170,202,372,0.457,05/23/2015,2015.0
47,Robert Morris (NEC),14,3-11,155,185,340,0.456,05/23/2015,2015.0
48,Canisius (MAAC),15,3-12,152,184,336,0.452,05/23/2015,2015.0
49,St. John's (NY) (Big East),14,3-11,157,192,349,0.450,05/23/2015,2015.0
50,Georgetown (Big East),16,10-6,186,228,414,0.449,05/23/2015,2015.0
51,Detroit Mercy (MAAC),14,8-6,148,183,331,0.447,05/23/2015,2015.0
52,Michigan (Big Ten),13,5-8,146,181,327,0.446,05/23/2015,2015.0
53,Princeton (Ivy League),15,9-6,173,219,392,0.441,05/23/2015,2015.0
54,UMBC (America East),13,5-8,124,160,284,0.437,05/23/2015,2015.0
55,NJIT (Independent),12,0-12,107,140,247,0.433,05/23/2015,2015.0
56,Marquette (Big East),16,10-6,168,221,389,0.432,05/23/2015,2015.0
57,Bucknell (Patriot),15,9-6,149,197,346,0.431,05/23/2015,2015.0
58,Massachusetts (CAA),15,5-10,153,204,357,0.429,05/23/2015,2015.0
58,Wagner (NEC),13,4-9,105,140,245,0.429,05/23/2015,2015.0
60,Harvard (Ivy League),14,7-7,165,223,388,0.425,05/23/2015,2015.0
61,Quinnipiac (MAAC),15,7-8,160,217,377,0.424,05/23/2015,2015.0
62,Furman (SoCon),13,4-9,107,148,255,0.420,05/23/2015,2015.0
63,Monmouth (MAAC),14,6-8,99,147,246,0.402,05/23/2015,2015.0
64,Manhattan (MAAC),15,1-14,136,203,339,0.401,05/23/2015,2015.0
65,Lafayette (Patriot),14,4-10,133,208,341,0.390,05/23/2015,2015.0
66,Hobart (NEC),14,7-7,115,182,297,0.387,05/23/2015,2015.0
67,Providence (Big East),14,5-9,119,192,311,0.383,05/23/2015,2015.0
68,Colgate (Patriot),16,10-6,142,234,376,0.378,05/23/2015,2015.0
-,UMass Lowell (America East),14,1-13,75,272,347,0.216,05/23/2015,2015.0
1,Denver (Big East),17,15-2,295,143,438,0.674,05/17/2015,2015.0
2,Bryant (NEC),18,8-10,242,119,361,0.670,05/17/2015,2015.0
3,Syracuse (ACC),16,13-3,292,149,441,0.662,05/17/2015,2015.0
4,Cornell (Ivy League),16,10-6,260,136,396,0.657,05/17/2015,2015.0
5,Rutgers (Big Ten),15,5-10,235,128,363,0.647,05/17/2015,2015.0
6,Boston U. (Patriot),14,6-8,216,123,339,0.637,05/17/2015,2015.0
7,Hofstra (CAA),14,5-9,177,115,292,0.606,05/17/2015,2015.0
8,Navy (Patriot),14,9-5,183,122,305,0.600,05/17/2015,2015.0
9,Brown (Ivy League),17,12-5,277,195,472,0.587,05/17/2015,2015.0
10,Ohio St. (Big Ten),19,12-7,248,184,432,0.574,05/17/2015,2015.0
11,Army West Point (Patriot),17,10-7,220,166,386,0.570,05/17/2015,2015.0
12,Fairfield (CAA),15,9-6,173,135,308,0.562,05/17/2015,2015.0
13,Duke (ACC),18,12-6,296,231,527,0.562,05/17/2015,2015.0
14,Dartmouth (Ivy League),13,5-8,178,142,320,0.556,05/17/2015,2015.0
15,Loyola Maryland (Patriot),15,7-8,206,167,373,0.552,05/17/2015,2015.0
16,High Point (SoCon),17,10-7,222,182,404,0.550,05/17/2015,2015.0
17,Drexel (CAA),15,7-8,177,151,328,0.540,05/17/2015,2015.0
18,Hartford (America East),15,7-8,196,171,367,0.534,05/17/2015,2015.0
19,Stony Brook (America East),18,13-5,267,236,503,0.531,05/17/2015,2015.0
20,Binghamton (America East),13,4-9,169,150,319,0.530,05/17/2015,2015.0
21,Marist (MAAC),18,14-4,224,200,424,0.528,05/17/2015,2015.0
22,Johns Hopkins (Big Ten),17,11-6,238,215,453,0.525,05/17/2015,2015.0
23,Maryland (Big Ten),17,14-3,182,165,347,0.524,05/17/2015,2015.0
24,Jacksonville (SoCon),12,4-8,154,140,294,0.524,05/17/2015,2015.0
25,Yale (Ivy League),16,11-5,190,173,363,0.523,05/17/2015,2015.0
26,Penn St. (Big Ten),14,5-9,164,153,317,0.517,05/17/2015,2015.0
27,Sacred Heart (NEC),13,6-7,158,148,306,0.516,05/17/2015,2015.0
28,Mercer (SoCon),13,5-8,151,143,294,0.514,05/17/2015,2015.0
29,Saint Joseph's (NEC),17,11-6,192,183,375,0.512,05/17/2015,2015.0
30,Vermont (America East),16,6-10,245,234,479,0.511,05/17/2015,2015.0
31,Towson (CAA),18,12-6,182,175,357,0.510,05/17/2015,2015.0
32,Notre Dame (ACC),14,12-2,186,180,366,0.508,05/17/2015,2015.0
33,Air Force (ECAC),15,8-7,163,160,323,0.505,05/17/2015,2015.0
34,Richmond (SoCon),16,11-5,180,184,364,0.495,05/17/2015,2015.0
35,North Carolina (ACC),17,13-4,234,242,476,0.492,05/17/2015,2015.0
36,Siena (MAAC),14,5-9,164,174,338,0.485,05/17/2015,2015.0
37,Mount St. Mary's (NEC),15,5-10,142,154,296,0.480,05/17/2015,2015.0
38,Bellarmine (SoCon),12,4-8,131,143,274,0.478,05/17/2015,2015.0
39,Villanova (Big East),14,6-8,155,170,325,0.477,05/17/2015,2015.0
40,Penn (Ivy League),13,6-7,156,172,328,0.476,05/17/2015,2015.0
41,Holy Cross (Patriot),13,6-7,147,167,314,0.468,05/17/2015,2015.0
42,VMI (SoCon),15,1-14,167,191,358,0.466,05/17/2015,2015.0
43,Delaware (CAA),15,5-10,160,186,346,0.462,05/17/2015,2015.0
44,Virginia (ACC),15,10-5,184,214,398,0.462,05/17/2015,2015.0
45,UAlbany (America East),19,16-3,265,314,579,0.458,05/17/2015,2015.0
46,Lehigh (Patriot),16,7-9,170,202,372,0.457,05/17/2015,2015.0
47,Robert Morris (NEC),14,3-11,155,185,340,0.456,05/17/2015,2015.0
48,Canisius (MAAC),15,3-12,152,184,336,0.452,05/17/2015,2015.0
49,St. John's (NY) (Big East),14,3-11,157,192,349,0.450,05/17/2015,2015.0
50,Georgetown (Big East),16,10-6,186,228,414,0.449,05/17/2015,2015.0
51,Detroit Mercy (MAAC),14,8-6,148,183,331,0.447,05/17/2015,2015.0
52,Michigan (Big Ten),13,5-8,146,181,327,0.446,05/17/2015,2015.0
53,Princeton (Ivy League),15,9-6,173,219,392,0.441,05/17/2015,2015.0
54,UMBC (America East),13,5-8,124,160,284,0.437,05/17/2015,2015.0
55,NJIT (Independent),12,0-12,107,140,247,0.433,05/17/2015,2015.0
56,Marquette (Big East),16,10-6,168,221,389,0.432,05/17/2015,2015.0
57,Bucknell (Patriot),15,9-6,149,197,346,0.431,05/17/2015,2015.0
58,Massachusetts (CAA),15,5-10,153,204,357,0.429,05/17/2015,2015.0
58,Wagner (NEC),13,4-9,105,140,245,0.429,05/17/2015,2015.0
60,Harvard (Ivy League),14,7-7,165,223,388,0.425,05/17/2015,2015.0
61,Quinnipiac (MAAC),15,7-8,160,217,377,0.424,05/17/2015,2015.0
62,Furman (SoCon),13,4-9,107,148,255,0.420,05/17/2015,2015.0
63,Monmouth (MAAC),14,6-8,99,147,246,0.402,05/17/2015,2015.0
64,Manhattan (MAAC),15,1-14,136,203,339,0.401,05/17/2015,2015.0
65,Lafayette (Patriot),14,4-10,133,208,341,0.390,05/17/2015,2015.0
66,Hobart (NEC),14,7-7,115,182,297,0.387,05/17/2015,2015.0
67,Providence (Big East),14,5-9,119,192,311,0.383,05/17/2015,2015.0
68,Colgate (Patriot),16,10-6,142,234,376,0.378,05/17/2015,2015.0
-,UMass Lowell (America East),14,1-13,75,272,347,0.216,05/17/2015,2015.0
1,Denver (Big East),17,15-2,295,143,438,0.674,05/16/2015,2015.0
2,Bryant (NEC),18,8-10,242,119,361,0.670,05/16/2015,2015.0
3,Syracuse (ACC),15,13-2,270,137,407,0.663,05/16/2015,2015.0
4,Cornell (Ivy League),16,10-6,260,136,396,0.657,05/16/2015,2015.0
5,Rutgers (Big Ten),15,5-10,235,128,363,0.647,05/16/2015,2015.0
6,Boston U. (Patriot),14,6-8,216,123,339,0.637,05/16/2015,2015.0
7,Hofstra (CAA),14,5-9,177,115,292,0.606,05/16/2015,2015.0
8,Navy (Patriot),14,9-5,183,122,305,0.600,05/16/2015,2015.0
9,Brown (Ivy League),17,12-5,277,195,472,0.587,05/16/2015,2015.0
10,Ohio St. (Big Ten),19,12-7,248,184,432,0.574,05/16/2015,2015.0
11,Army West Point (Patriot),17,10-7,220,166,386,0.570,05/16/2015,2015.0
12,Fairfield (CAA),15,9-6,173,135,308,0.562,05/16/2015,2015.0
13,Duke (ACC),18,12-6,296,231,527,0.562,05/16/2015,2015.0
14,Dartmouth (Ivy League),13,5-8,178,142,320,0.556,05/16/2015,2015.0
15,Loyola Maryland (Patriot),15,7-8,206,167,373,0.552,05/16/2015,2015.0
16,High Point (SoCon),17,10-7,222,182,404,0.550,05/16/2015,2015.0
17,Drexel (CAA),15,7-8,177,151,328,0.540,05/16/2015,2015.0
18,Johns Hopkins (Big Ten),16,10-6,226,193,419,0.539,05/16/2015,2015.0
19,Hartford (America East),15,7-8,196,171,367,0.534,05/16/2015,2015.0
20,Stony Brook (America East),18,13-5,267,236,503,0.531,05/16/2015,2015.0
21,Binghamton (America East),13,4-9,169,150,319,0.530,05/16/2015,2015.0
22,Marist (MAAC),18,14-4,224,200,424,0.528,05/16/2015,2015.0
23,Maryland (Big Ten),16,13-3,169,153,322,0.525,05/16/2015,2015.0
24,Jacksonville (SoCon),12,4-8,154,140,294,0.524,05/16/2015,2015.0
25,Yale (Ivy League),16,11-5,190,173,363,0.523,05/16/2015,2015.0
26,Penn St. (Big Ten),14,5-9,164,153,317,0.517,05/16/2015,2015.0
27,Sacred Heart (NEC),13,6-7,158,148,306,0.516,05/16/2015,2015.0
28,Mercer (SoCon),13,5-8,151,143,294,0.514,05/16/2015,2015.0
29,Saint Joseph's (NEC),17,11-6,192,183,375,0.512,05/16/2015,2015.0
30,Vermont (America East),16,6-10,245,234,479,0.511,05/16/2015,2015.0
31,Towson (CAA),18,12-6,182,175,357,0.510,05/16/2015,2015.0
32,Notre Dame (ACC),14,12-2,186,180,366,0.508,05/16/2015,2015.0
33,Air Force (ECAC),15,8-7,163,160,323,0.505,05/16/2015,2015.0
34,Richmond (SoCon),16,11-5,180,184,364,0.495,05/16/2015,2015.0
35,North Carolina (ACC),16,13-3,222,229,451,0.492,05/16/2015,2015.0
36,Siena (MAAC),14,5-9,164,174,338,0.485,05/16/2015,2015.0
37,Mount St. Mary's (NEC),15,5-10,142,154,296,0.480,05/16/2015,2015.0
38,Bellarmine (SoCon),12,4-8,131,143,274,0.478,05/16/2015,2015.0
39,Villanova (Big East),14,6-8,155,170,325,0.477,05/16/2015,2015.0
40,Penn (Ivy League),13,6-7,156,172,328,0.476,05/16/2015,2015.0
41,Holy Cross (Patriot),13,6-7,147,167,314,0.468,05/16/2015,2015.0
42,VMI (SoCon),15,1-14,167,191,358,0.466,05/16/2015,2015.0
43,Delaware (CAA),15,5-10,160,186,346,0.462,05/16/2015,2015.0
44,Virginia (ACC),15,10-5,184,214,398,0.462,05/16/2015,2015.0
45,UAlbany (America East),19,16-3,265,314,579,0.458,05/16/2015,2015.0
46,Lehigh (Patriot),16,7-9,170,202,372,0.457,05/16/2015,2015.0
47,Robert Morris (NEC),14,3-11,155,185,340,0.456,05/16/2015,2015.0
48,Canisius (MAAC),15,3-12,152,184,336,0.452,05/16/2015,2015.0
49,St. John's (NY) (Big East),14,3-11,157,192,349,0.450,05/16/2015,2015.0
50,Georgetown (Big East),16,10-6,186,228,414,0.449,05/16/2015,2015.0
51,Detroit Mercy (MAAC),14,8-6,148,183,331,0.447,05/16/2015,2015.0
52,Michigan (Big Ten),13,5-8,146,181,327,0.446,05/16/2015,2015.0
53,Princeton (Ivy League),15,9-6,173,219,392,0.441,05/16/2015,2015.0
54,UMBC (America East),13,5-8,124,160,284,0.437,05/16/2015,2015.0
55,NJIT (Independent),12,0-12,107,140,247,0.433,05/16/2015,2015.0
56,Marquette (Big East),16,10-6,168,221,389,0.432,05/16/2015,2015.0
57,Bucknell (Patriot),15,9-6,149,197,346,0.431,05/16/2015,2015.0
58,Massachusetts (CAA),15,5-10,153,204,357,0.429,05/16/2015,2015.0
58,Wagner (NEC),13,4-9,105,140,245,0.429,05/16/2015,2015.0
60,Harvard (Ivy League),14,7-7,165,223,388,0.425,05/16/2015,2015.0
61,Quinnipiac (MAAC),15,7-8,160,217,377,0.424,05/16/2015,2015.0
62,Furman (SoCon),13,4-9,107,148,255,0.420,05/16/2015,2015.0
63,Monmouth (MAAC),14,6-8,99,147,246,0.402,05/16/2015,2015.0
64,Manhattan (MAAC),15,1-14,136,203,339,0.401,05/16/2015,2015.0
65,Lafayette (Patriot),14,4-10,133,208,341,0.390,05/16/2015,2015.0
66,Hobart (NEC),14,7-7,115,182,297,0.387,05/16/2015,2015.0
67,Providence (Big East),14,5-9,119,192,311,0.383,05/16/2015,2015.0
68,Colgate (Patriot),16,10-6,142,234,376,0.378,05/16/2015,2015.0
-,UMass Lowell (America East),14,1-13,75,272,347,0.216,05/16/2015,2015.0
1,Denver (Big East),16,14-2,280,126,406,0.690,05/10/2015,2015.0
2,Bryant (NEC),18,8-10,242,119,361,0.670,05/10/2015,2015.0
3,Syracuse (ACC),15,13-2,270,137,407,0.663,05/10/2015,2015.0
4,Cornell (Ivy League),16,10-6,260,136,396,0.657,05/10/2015,2015.0
5,Rutgers (Big Ten),15,5-10,235,128,363,0.647,05/10/2015,2015.0
6,Boston U. (Patriot),14,6-8,216,123,339,0.637,05/10/2015,2015.0
7,Hofstra (CAA),14,5-9,177,115,292,0.606,05/10/2015,2015.0
8,Navy (Patriot),14,9-5,183,122,305,0.600,05/10/2015,2015.0
9,Brown (Ivy League),17,12-5,277,195,472,0.587,05/10/2015,2015.0
10,Ohio St. (Big Ten),18,12-6,231,169,400,0.578,05/10/2015,2015.0
11,Army West Point (Patriot),17,10-7,220,166,386,0.570,05/10/2015,2015.0
12,Fairfield (CAA),15,9-6,173,135,308,0.562,05/10/2015,2015.0
13,Duke (ACC),18,12-6,296,231,527,0.562,05/10/2015,2015.0
14,Dartmouth (Ivy League),13,5-8,178,142,320,0.556,05/10/2015,2015.0
15,Loyola Maryland (Patriot),15,7-8,206,167,373,0.552,05/10/2015,2015.0
16,High Point (SoCon),17,10-7,222,182,404,0.550,05/10/2015,2015.0
17,Drexel (CAA),15,7-8,177,151,328,0.540,05/10/2015,2015.0
18,Johns Hopkins (Big Ten),16,10-6,226,193,419,0.539,05/10/2015,2015.0
19,Hartford (America East),15,7-8,196,171,367,0.534,05/10/2015,2015.0
20,Stony Brook (America East),18,13-5,267,236,503,0.531,05/10/2015,2015.0
21,Binghamton (America East),13,4-9,169,150,319,0.530,05/10/2015,2015.0
22,Marist (MAAC),18,14-4,224,200,424,0.528,05/10/2015,2015.0
23,Maryland (Big Ten),16,13-3,169,153,322,0.525,05/10/2015,2015.0
24,Jacksonville (SoCon),12,4-8,154,140,294,0.524,05/10/2015,2015.0
25,Yale (Ivy League),16,11-5,190,173,363,0.523,05/10/2015,2015.0
26,Penn St. (Big Ten),14,5-9,164,153,317,0.517,05/10/2015,2015.0
27,Sacred Heart (NEC),13,6-7,158,148,306,0.516,05/10/2015,2015.0
28,Mercer (SoCon),13,5-8,151,143,294,0.514,05/10/2015,2015.0
29,Saint Joseph's (NEC),17,11-6,192,183,375,0.512,05/10/2015,2015.0
30,Vermont (America East),16,6-10,245,234,479,0.511,05/10/2015,2015.0
31,Towson (CAA),18,12-6,182,175,357,0.510,05/10/2015,2015.0
32,Air Force (ECAC),15,8-7,163,160,323,0.505,05/10/2015,2015.0
33,Notre Dame (ACC),13,11-2,168,170,338,0.497,05/10/2015,2015.0
34,Richmond (SoCon),16,11-5,180,184,364,0.495,05/10/2015,2015.0
35,North Carolina (ACC),16,13-3,222,229,451,0.492,05/10/2015,2015.0
36,Siena (MAAC),14,5-9,164,174,338,0.485,05/10/2015,2015.0
37,Mount St. Mary's (NEC),15,5-10,142,154,296,0.480,05/10/2015,2015.0
38,Bellarmine (SoCon),12,4-8,131,143,274,0.478,05/10/2015,2015.0
39,Villanova (Big East),14,6-8,155,170,325,0.477,05/10/2015,2015.0
40,Penn (Ivy League),13,6-7,156,172,328,0.476,05/10/2015,2015.0
41,Holy Cross (Patriot),13,6-7,147,167,314,0.468,05/10/2015,2015.0
42,VMI (SoCon),15,1-14,167,191,358,0.466,05/10/2015,2015.0
43,UAlbany (America East),18,16-2,255,296,551,0.463,05/10/2015,2015.0
44,Delaware (CAA),15,5-10,160,186,346,0.462,05/10/2015,2015.0
45,Virginia (ACC),15,10-5,184,214,398,0.462,05/10/2015,2015.0
46,Lehigh (Patriot),16,7-9,170,202,372,0.457,05/10/2015,2015.0
47,Robert Morris (NEC),14,3-11,155,185,340,0.456,05/10/2015,2015.0
48,Canisius (MAAC),15,3-12,152,184,336,0.452,05/10/2015,2015.0
49,St. John's (NY) (Big East),14,3-11,157,192,349,0.450,05/10/2015,2015.0
50,Georgetown (Big East),16,10-6,186,228,414,0.449,05/10/2015,2015.0
51,Detroit Mercy (MAAC),14,8-6,148,183,331,0.447,05/10/2015,2015.0
52,Michigan (Big Ten),13,5-8,146,181,327,0.446,05/10/2015,2015.0
53,Princeton (Ivy League),15,9-6,173,219,392,0.441,05/10/2015,2015.0
54,UMBC (America East),13,5-8,124,160,284,0.437,05/10/2015,2015.0
55,NJIT (Independent),12,0-12,107,140,247,0.433,05/10/2015,2015.0
56,Marquette (Big East),16,10-6,168,221,389,0.432,05/10/2015,2015.0
57,Bucknell (Patriot),15,9-6,149,197,346,0.431,05/10/2015,2015.0
58,Massachusetts (CAA),15,5-10,153,204,357,0.429,05/10/2015,2015.0
58,Wagner (NEC),13,4-9,105,140,245,0.429,05/10/2015,2015.0
60,Harvard (Ivy League),14,7-7,165,223,388,0.425,05/10/2015,2015.0
61,Quinnipiac (MAAC),15,7-8,160,217,377,0.424,05/10/2015,2015.0
62,Furman (SoCon),13,4-9,107,148,255,0.420,05/10/2015,2015.0
63,Monmouth (MAAC),14,6-8,99,147,246,0.402,05/10/2015,2015.0
64,Manhattan (MAAC),15,1-14,136,203,339,0.401,05/10/2015,2015.0
65,Lafayette (Patriot),14,4-10,133,208,341,0.390,05/10/2015,2015.0
66,Hobart (NEC),14,7-7,115,182,297,0.387,05/10/2015,2015.0
67,Providence (Big East),14,5-9,119,192,311,0.383,05/10/2015,2015.0
68,Colgate (Patriot),16,10-6,142,234,376,0.378,05/10/2015,2015.0
-,UMass Lowell (America East),14,1-13,75,272,347,0.216,05/10/2015,2015.0
1,Denver (Big East),15,13-2,268,110,378,0.709,05/09/2015,2015.0
2,Bryant (NEC),18,8-10,242,119,361,0.670,05/09/2015,2015.0
3,Syracuse (ACC),14,12-2,249,128,377,0.660,05/09/2015,2015.0
4,Cornell (Ivy League),16,10-6,260,136,396,0.657,05/09/2015,2015.0
5,Rutgers (Big Ten),15,5-10,235,128,363,0.647,05/09/2015,2015.0
6,Boston U. (Patriot),14,6-8,216,123,339,0.637,05/09/2015,2015.0
7,Hofstra (CAA),14,5-9,177,115,292,0.606,05/09/2015,2015.0
8,Navy (Patriot),14,9-5,183,122,305,0.600,05/09/2015,2015.0
9,Brown (Ivy League),16,12-4,261,183,444,0.588,05/09/2015,2015.0
10,Ohio St. (Big Ten),18,12-6,231,169,400,0.578,05/09/2015,2015.0
11,Army West Point (Patriot),17,10-7,220,166,386,0.570,05/09/2015,2015.0
12,Fairfield (CAA),15,9-6,173,135,308,0.562,05/09/2015,2015.0
13,Duke (ACC),18,12-6,296,231,527,0.562,05/09/2015,2015.0
14,Dartmouth (Ivy League),13,5-8,178,142,320,0.556,05/09/2015,2015.0
15,Loyola Maryland (Patriot),15,7-8,206,167,373,0.552,05/09/2015,2015.0
16,High Point (SoCon),17,10-7,222,182,404,0.550,05/09/2015,2015.0
17,Marist (MAAC),17,14-3,215,179,394,0.546,05/09/2015,2015.0
18,Drexel (CAA),15,7-8,177,151,328,0.540,05/09/2015,2015.0
19,Johns Hopkins (Big Ten),15,9-6,209,181,390,0.536,05/09/2015,2015.0
20,Hartford (America East),15,7-8,196,171,367,0.534,05/09/2015,2015.0
21,Stony Brook (America East),18,13-5,267,236,503,0.531,05/09/2015,2015.0
22,Binghamton (America East),13,4-9,169,150,319,0.530,05/09/2015,2015.0
23,Maryland (Big Ten),16,13-3,169,153,322,0.525,05/09/2015,2015.0
24,Jacksonville (SoCon),12,4-8,154,140,294,0.524,05/09/2015,2015.0
25,Yale (Ivy League),16,11-5,190,173,363,0.523,05/09/2015,2015.0
26,Penn St. (Big Ten),14,5-9,164,153,317,0.517,05/09/2015,2015.0
27,Sacred Heart (NEC),13,6-7,158,148,306,0.516,05/09/2015,2015.0
28,Mercer (SoCon),13,5-8,151,143,294,0.514,05/09/2015,2015.0
29,Saint Joseph's (NEC),17,11-6,192,183,375,0.512,05/09/2015,2015.0
30,Vermont (America East),16,6-10,245,234,479,0.511,05/09/2015,2015.0
31,Towson (CAA),18,12-6,182,175,357,0.510,05/09/2015,2015.0
32,Air Force (ECAC),15,8-7,163,160,323,0.505,05/09/2015,2015.0
33,Notre Dame (ACC),13,11-2,168,170,338,0.497,05/09/2015,2015.0
34,Richmond (SoCon),16,11-5,180,184,364,0.495,05/09/2015,2015.0
35,Siena (MAAC),14,5-9,164,174,338,0.485,05/09/2015,2015.0
36,North Carolina (ACC),15,12-3,201,215,416,0.483,05/09/2015,2015.0
37,Mount St. Mary's (NEC),15,5-10,142,154,296,0.480,05/09/2015,2015.0
38,Bellarmine (SoCon),12,4-8,131,143,274,0.478,05/09/2015,2015.0
39,Villanova (Big East),14,6-8,155,170,325,0.477,05/09/2015,2015.0
40,Penn (Ivy League),13,6-7,156,172,328,0.476,05/09/2015,2015.0
41,Holy Cross (Patriot),13,6-7,147,167,314,0.468,05/09/2015,2015.0
42,VMI (SoCon),15,1-14,167,191,358,0.466,05/09/2015,2015.0
43,Virginia (ACC),14,10-4,172,197,369,0.466,05/09/2015,2015.0
44,UAlbany (America East),18,16-2,255,296,551,0.463,05/09/2015,2015.0
45,Delaware (CAA),15,5-10,160,186,346,0.462,05/09/2015,2015.0
46,Lehigh (Patriot),16,7-9,170,202,372,0.457,05/09/2015,2015.0
47,Robert Morris (NEC),14,3-11,155,185,340,0.456,05/09/2015,2015.0
48,Canisius (MAAC),15,3-12,152,184,336,0.452,05/09/2015,2015.0
49,St. John's (NY) (Big East),14,3-11,157,192,349,0.450,05/09/2015,2015.0
50,Georgetown (Big East),16,10-6,186,228,414,0.449,05/09/2015,2015.0
51,Detroit Mercy (MAAC),14,8-6,148,183,331,0.447,05/09/2015,2015.0
52,Michigan (Big Ten),13,5-8,146,181,327,0.446,05/09/2015,2015.0
53,Princeton (Ivy League),15,9-6,173,219,392,0.441,05/09/2015,2015.0
54,UMBC (America East),13,5-8,124,160,284,0.437,05/09/2015,2015.0
55,NJIT (Independent),12,0-12,107,140,247,0.433,05/09/2015,2015.0
56,Marquette (Big East),16,10-6,168,221,389,0.432,05/09/2015,2015.0
57,Bucknell (Patriot),15,9-6,149,197,346,0.431,05/09/2015,2015.0
58,Massachusetts (CAA),15,5-10,153,204,357,0.429,05/09/2015,2015.0
58,Wagner (NEC),13,4-9,105,140,245,0.429,05/09/2015,2015.0
60,Harvard (Ivy League),14,7-7,165,223,388,0.425,05/09/2015,2015.0
61,Quinnipiac (MAAC),15,7-8,160,217,377,0.424,05/09/2015,2015.0
62,Furman (SoCon),13,4-9,107,148,255,0.420,05/09/2015,2015.0
63,Monmouth (MAAC),14,6-8,99,147,246,0.402,05/09/2015,2015.0
64,Manhattan (MAAC),15,1-14,136,203,339,0.401,05/09/2015,2015.0
65,Lafayette (Patriot),14,4-10,133,208,341,0.390,05/09/2015,2015.0
66,Hobart (NEC),14,7-7,115,182,297,0.387,05/09/2015,2015.0
67,Providence (Big East),14,5-9,119,192,311,0.383,05/09/2015,2015.0
68,Colgate (Patriot),15,10-5,128,213,341,0.375,05/09/2015,2015.0
-,UMass Lowell (America East),14,1-13,75,272,347,0.216,05/09/2015,2015.0
1,Denver (Big East),15,13-2,268,110,378,0.709,05/06/2015,2015.0
2,Bryant (NEC),18,8-10,242,119,361,0.670,05/06/2015,2015.0
3,Syracuse (ACC),14,12-2,249,128,377,0.660,05/06/2015,2015.0
4,Cornell (Ivy League),15,10-5,236,128,364,0.648,05/06/2015,2015.0
5,Rutgers (Big Ten),15,5-10,235,128,363,0.647,05/06/2015,2015.0
6,Boston U. (Patriot),14,6-8,216,123,339,0.637,05/06/2015,2015.0
7,Hofstra (CAA),14,5-9,177,115,292,0.606,05/06/2015,2015.0
8,Navy (Patriot),14,9-5,183,122,305,0.600,05/06/2015,2015.0
9,Ohio St. (Big Ten),17,11-6,219,152,371,0.590,05/06/2015,2015.0
10,Brown (Ivy League),16,12-4,261,183,444,0.588,05/06/2015,2015.0
11,Army West Point (Patriot),17,10-7,220,166,386,0.570,05/06/2015,2015.0
12,Fairfield (CAA),15,9-6,173,135,308,0.562,05/06/2015,2015.0
13,Duke (ACC),17,12-5,279,219,498,0.560,05/06/2015,2015.0
14,Dartmouth (Ivy League),13,5-8,178,142,320,0.556,05/06/2015,2015.0
15,Loyola Maryland (Patriot),15,7-8,206,167,373,0.552,05/06/2015,2015.0
16,High Point (SoCon),17,10-7,222,182,404,0.550,05/06/2015,2015.0
17,Marist (MAAC),17,14-3,215,179,394,0.546,05/06/2015,2015.0
18,Drexel (CAA),15,7-8,177,151,328,0.540,05/06/2015,2015.0
19,Johns Hopkins (Big Ten),15,9-6,209,181,390,0.536,05/06/2015,2015.0
20,Hartford (America East),15,7-8,196,171,367,0.534,05/06/2015,2015.0
21,Stony Brook (America East),18,13-5,267,236,503,0.531,05/06/2015,2015.0
22,Binghamton (America East),13,4-9,169,150,319,0.530,05/06/2015,2015.0
23,Towson (CAA),17,12-5,175,156,331,0.529,05/06/2015,2015.0
24,Maryland (Big Ten),15,12-3,161,144,305,0.528,05/06/2015,2015.0
25,Jacksonville (SoCon),12,4-8,154,140,294,0.524,05/06/2015,2015.0
26,Yale (Ivy League),15,11-4,181,165,346,0.523,05/06/2015,2015.0
27,Penn St. (Big Ten),14,5-9,164,153,317,0.517,05/06/2015,2015.0
28,Sacred Heart (NEC),13,6-7,158,148,306,0.516,05/06/2015,2015.0
29,Mercer (SoCon),13,5-8,151,143,294,0.514,05/06/2015,2015.0
30,Saint Joseph's (NEC),17,11-6,192,183,375,0.512,05/06/2015,2015.0
31,Vermont (America East),16,6-10,245,234,479,0.511,05/06/2015,2015.0
32,Air Force (ECAC),15,8-7,163,160,323,0.505,05/06/2015,2015.0
33,Richmond (SoCon),16,11-5,180,184,364,0.495,05/06/2015,2015.0
34,Siena (MAAC),14,5-9,164,174,338,0.485,05/06/2015,2015.0
35,North Carolina (ACC),15,12-3,201,215,416,0.483,05/06/2015,2015.0
36,Mount St. Mary's (NEC),15,5-10,142,154,296,0.480,05/06/2015,2015.0
37,Bellarmine (SoCon),12,4-8,131,143,274,0.478,05/06/2015,2015.0
38,Notre Dame (ACC),12,10-2,149,163,312,0.478,05/06/2015,2015.0
39,Villanova (Big East),14,6-8,155,170,325,0.477,05/06/2015,2015.0
40,UAlbany (America East),17,15-2,247,272,519,0.476,05/06/2015,2015.0
41,Penn (Ivy League),13,6-7,156,172,328,0.476,05/06/2015,2015.0
42,Holy Cross (Patriot),13,6-7,147,167,314,0.468,05/06/2015,2015.0
43,VMI (SoCon),15,1-14,167,191,358,0.466,05/06/2015,2015.0
44,Virginia (ACC),14,10-4,172,197,369,0.466,05/06/2015,2015.0
45,Delaware (CAA),15,5-10,160,186,346,0.462,05/06/2015,2015.0
46,Lehigh (Patriot),16,7-9,170,202,372,0.457,05/06/2015,2015.0
47,Robert Morris (NEC),14,3-11,155,185,340,0.456,05/06/2015,2015.0
48,Canisius (MAAC),15,3-12,152,184,336,0.452,05/06/2015,2015.0
49,St. John's (NY) (Big East),14,3-11,157,192,349,0.450,05/06/2015,2015.0
50,Georgetown (Big East),16,10-6,186,228,414,0.449,05/06/2015,2015.0
51,Detroit Mercy (MAAC),14,8-6,148,183,331,0.447,05/06/2015,2015.0
52,Michigan (Big Ten),13,5-8,146,181,327,0.446,05/06/2015,2015.0
53,Princeton (Ivy League),15,9-6,173,219,392,0.441,05/06/2015,2015.0
54,UMBC (America East),13,5-8,124,160,284,0.437,05/06/2015,2015.0
55,NJIT (Independent),12,0-12,107,140,247,0.433,05/06/2015,2015.0
56,Marquette (Big East),16,10-6,168,221,389,0.432,05/06/2015,2015.0
57,Bucknell (Patriot),15,9-6,149,197,346,0.431,05/06/2015,2015.0
58,Massachusetts (CAA),15,5-10,153,204,357,0.429,05/06/2015,2015.0
58,Wagner (NEC),13,4-9,105,140,245,0.429,05/06/2015,2015.0
60,Harvard (Ivy League),14,7-7,165,223,388,0.425,05/06/2015,2015.0
61,Quinnipiac (MAAC),15,7-8,160,217,377,0.424,05/06/2015,2015.0
62,Furman (SoCon),13,4-9,107,148,255,0.420,05/06/2015,2015.0
63,Monmouth (MAAC),14,6-8,99,147,246,0.402,05/06/2015,2015.0
64,Manhattan (MAAC),15,1-14,136,203,339,0.401,05/06/2015,2015.0
65,Lafayette (Patriot),14,4-10,133,208,341,0.390,05/06/2015,2015.0
66,Hobart (NEC),14,7-7,115,182,297,0.387,05/06/2015,2015.0
67,Providence (Big East),14,5-9,119,192,311,0.383,05/06/2015,2015.0
68,Colgate (Patriot),15,10-5,128,213,341,0.375,05/06/2015,2015.0
-,UMass Lowell (America East),14,1-13,75,272,347,0.216,05/06/2015,2015.0
1,Denver (Big East),15,13-2,268,110,378,0.709,05/03/2015,2015.0
2,Bryant (NEC),17,8-9,229,112,341,0.672,05/03/2015,2015.0
3,Syracuse (ACC),14,12-2,249,128,377,0.660,05/03/2015,2015.0
4,Cornell (Ivy League),15,10-5,236,128,364,0.648,05/03/2015,2015.0
5,Rutgers (Big Ten),15,5-10,235,128,363,0.647,05/03/2015,2015.0
6,Boston U. (Patriot),14,6-8,216,123,339,0.637,05/03/2015,2015.0
7,Hofstra (CAA),14,5-9,177,115,292,0.606,05/03/2015,2015.0
8,Navy (Patriot),14,9-5,183,122,305,0.600,05/03/2015,2015.0
9,Ohio St. (Big Ten),17,11-6,219,152,371,0.590,05/03/2015,2015.0
10,Brown (Ivy League),16,12-4,261,183,444,0.588,05/03/2015,2015.0
11,Army West Point (Patriot),17,10-7,220,166,386,0.570,05/03/2015,2015.0
12,High Point (SoCon),16,10-6,215,167,382,0.563,05/03/2015,2015.0
13,Fairfield (CAA),15,9-6,173,135,308,0.562,05/03/2015,2015.0
14,Duke (ACC),17,12-5,279,219,498,0.560,05/03/2015,2015.0
15,Dartmouth (Ivy League),13,5-8,178,142,320,0.556,05/03/2015,2015.0
16,Marist (MAAC),16,13-3,208,166,374,0.556,05/03/2015,2015.0
17,Loyola Maryland (Patriot),15,7-8,206,167,373,0.552,05/03/2015,2015.0
18,Drexel (CAA),15,7-8,177,151,328,0.540,05/03/2015,2015.0
19,Johns Hopkins (Big Ten),15,9-6,209,181,390,0.536,05/03/2015,2015.0
20,Hartford (America East),15,7-8,196,171,367,0.534,05/03/2015,2015.0
21,Stony Brook (America East),18,13-5,267,236,503,0.531,05/03/2015,2015.0
22,Binghamton (America East),13,4-9,169,150,319,0.530,05/03/2015,2015.0
23,Maryland (Big Ten),15,12-3,161,144,305,0.528,05/03/2015,2015.0
24,Jacksonville (SoCon),12,4-8,154,140,294,0.524,05/03/2015,2015.0
25,Yale (Ivy League),15,11-4,181,165,346,0.523,05/03/2015,2015.0
26,Towson (CAA),16,11-5,160,149,309,0.518,05/03/2015,2015.0
27,Penn St. (Big Ten),14,5-9,164,153,317,0.517,05/03/2015,2015.0
28,Sacred Heart (NEC),13,6-7,158,148,306,0.516,05/03/2015,2015.0
29,Mercer (SoCon),13,5-8,151,143,294,0.514,05/03/2015,2015.0
30,Saint Joseph's (NEC),17,11-6,192,183,375,0.512,05/03/2015,2015.0
31,Vermont (America East),16,6-10,245,234,479,0.511,05/03/2015,2015.0
32,Air Force (ECAC),15,8-7,163,160,323,0.505,05/03/2015,2015.0
33,Richmond (SoCon),16,11-5,180,184,364,0.495,05/03/2015,2015.0
34,Siena (MAAC),14,5-9,164,174,338,0.485,05/03/2015,2015.0
35,North Carolina (ACC),15,12-3,201,215,416,0.483,05/03/2015,2015.0
36,Mount St. Mary's (NEC),15,5-10,142,154,296,0.480,05/03/2015,2015.0
37,Bellarmine (SoCon),12,4-8,131,143,274,0.478,05/03/2015,2015.0
38,Notre Dame (ACC),12,10-2,149,163,312,0.478,05/03/2015,2015.0
39,Villanova (Big East),14,6-8,155,170,325,0.477,05/03/2015,2015.0
40,UAlbany (America East),17,15-2,247,272,519,0.476,05/03/2015,2015.0
41,Penn (Ivy League),13,6-7,156,172,328,0.476,05/03/2015,2015.0
42,Holy Cross (Patriot),13,6-7,147,167,314,0.468,05/03/2015,2015.0
43,VMI (SoCon),15,1-14,167,191,358,0.466,05/03/2015,2015.0
44,Virginia (ACC),14,10-4,172,197,369,0.466,05/03/2015,2015.0
45,Delaware (CAA),15,5-10,160,186,346,0.462,05/03/2015,2015.0
46,Lehigh (Patriot),16,7-9,170,202,372,0.457,05/03/2015,2015.0
47,Robert Morris (NEC),14,3-11,155,185,340,0.456,05/03/2015,2015.0
48,Canisius (MAAC),15,3-12,152,184,336,0.452,05/03/2015,2015.0
49,St. John's (NY) (Big East),14,3-11,157,192,349,0.450,05/03/2015,2015.0
50,Georgetown (Big East),16,10-6,186,228,414,0.449,05/03/2015,2015.0
51,Detroit Mercy (MAAC),14,8-6,148,183,331,0.447,05/03/2015,2015.0
52,Michigan (Big Ten),13,5-8,146,181,327,0.446,05/03/2015,2015.0
53,Princeton (Ivy League),15,9-6,173,219,392,0.441,05/03/2015,2015.0
54,UMBC (America East),13,5-8,124,160,284,0.437,05/03/2015,2015.0
55,NJIT (Independent),12,0-12,107,140,247,0.433,05/03/2015,2015.0
56,Marquette (Big East),16,10-6,168,221,389,0.432,05/03/2015,2015.0
57,Bucknell (Patriot),15,9-6,149,197,346,0.431,05/03/2015,2015.0
58,Massachusetts (CAA),15,5-10,153,204,357,0.429,05/03/2015,2015.0
58,Wagner (NEC),13,4-9,105,140,245,0.429,05/03/2015,2015.0
60,Harvard (Ivy League),14,7-7,165,223,388,0.425,05/03/2015,2015.0
61,Quinnipiac (MAAC),15,7-8,160,217,377,0.424,05/03/2015,2015.0
62,Furman (SoCon),13,4-9,107,148,255,0.420,05/03/2015,2015.0
63,Monmouth (MAAC),14,6-8,99,147,246,0.402,05/03/2015,2015.0
64,Manhattan (MAAC),15,1-14,136,203,339,0.401,05/03/2015,2015.0
65,Lafayette (Patriot),14,4-10,133,208,341,0.390,05/03/2015,2015.0
66,Hobart (NEC),14,7-7,115,182,297,0.387,05/03/2015,2015.0
67,Providence (Big East),14,5-9,119,192,311,0.383,05/03/2015,2015.0
68,Colgate (Patriot),15,10-5,128,213,341,0.375,05/03/2015,2015.0
-,UMass Lowell (America East),14,1-13,75,272,347,0.216,05/03/2015,2015.0
1,Denver (Big East),15,13-2,268,110,378,0.709,05/02/2015,2015.0
2,Bryant (NEC),17,8-9,229,112,341,0.672,05/02/2015,2015.0
3,Syracuse (ACC),14,12-2,249,128,377,0.660,05/02/2015,2015.0
4,Cornell (Ivy League),15,10-5,236,128,364,0.648,05/02/2015,2015.0
5,Rutgers (Big Ten),15,5-10,235,128,363,0.647,05/02/2015,2015.0
6,Boston U. (Patriot),13,6-7,202,113,315,0.641,05/02/2015,2015.0
7,Hofstra (CAA),14,5-9,177,115,292,0.606,05/02/2015,2015.0
8,Navy (Patriot),14,9-5,183,122,305,0.600,05/02/2015,2015.0
9,Ohio St. (Big Ten),17,11-6,219,152,371,0.590,05/02/2015,2015.0
10,Brown (Ivy League),16,12-4,261,183,444,0.588,05/02/2015,2015.0
11,Army West Point (Patriot),17,10-7,220,166,386,0.570,05/02/2015,2015.0
12,Duke (ACC),16,11-5,269,205,474,0.568,05/02/2015,2015.0
13,High Point (SoCon),16,10-6,215,167,382,0.563,05/02/2015,2015.0
14,Fairfield (CAA),15,9-6,173,135,308,0.562,05/02/2015,2015.0
15,Dartmouth (Ivy League),13,5-8,178,142,320,0.556,05/02/2015,2015.0
16,Marist (MAAC),16,13-3,208,166,374,0.556,05/02/2015,2015.0
17,Loyola Maryland (Patriot),15,7-8,206,167,373,0.552,05/02/2015,2015.0
18,Drexel (CAA),15,7-8,177,151,328,0.540,05/02/2015,2015.0
19,Johns Hopkins (Big Ten),15,9-6,209,181,390,0.536,05/02/2015,2015.0
20,Hartford (America East),15,7-8,196,171,367,0.534,05/02/2015,2015.0
21,Stony Brook (America East),18,13-5,267,236,503,0.531,05/02/2015,2015.0
22,Binghamton (America East),13,4-9,169,150,319,0.530,05/02/2015,2015.0
23,Maryland (Big Ten),15,12-3,161,144,305,0.528,05/02/2015,2015.0
24,Jacksonville (SoCon),12,4-8,154,140,294,0.524,05/02/2015,2015.0
25,Yale (Ivy League),14,10-4,168,154,322,0.522,05/02/2015,2015.0
26,Towson (CAA),16,11-5,160,149,309,0.518,05/02/2015,2015.0
27,Penn St. (Big Ten),14,5-9,164,153,317,0.517,05/02/2015,2015.0
28,Sacred Heart (NEC),13,6-7,158,148,306,0.516,05/02/2015,2015.0
29,Mercer (SoCon),13,5-8,151,143,294,0.514,05/02/2015,2015.0
30,Saint Joseph's (NEC),17,11-6,192,183,375,0.512,05/02/2015,2015.0
31,Vermont (America East),16,6-10,245,234,479,0.511,05/02/2015,2015.0
32,Air Force (ECAC),15,8-7,163,160,323,0.505,05/02/2015,2015.0
33,Richmond (SoCon),16,11-5,180,184,364,0.495,05/02/2015,2015.0
34,Siena (MAAC),14,5-9,164,174,338,0.485,05/02/2015,2015.0
35,North Carolina (ACC),15,12-3,201,215,416,0.483,05/02/2015,2015.0
36,Mount St. Mary's (NEC),15,5-10,142,154,296,0.480,05/02/2015,2015.0
37,Bellarmine (SoCon),12,4-8,131,143,274,0.478,05/02/2015,2015.0
38,Notre Dame (ACC),12,10-2,149,163,312,0.478,05/02/2015,2015.0
39,Villanova (Big East),14,6-8,155,170,325,0.477,05/02/2015,2015.0
40,UAlbany (America East),17,15-2,247,272,519,0.476,05/02/2015,2015.0
41,Penn (Ivy League),13,6-7,156,172,328,0.476,05/02/2015,2015.0
42,Holy Cross (Patriot),13,6-7,147,167,314,0.468,05/02/2015,2015.0
43,VMI (SoCon),15,1-14,167,191,358,0.466,05/02/2015,2015.0
44,Virginia (ACC),14,10-4,172,197,369,0.466,05/02/2015,2015.0
45,Delaware (CAA),15,5-10,160,186,346,0.462,05/02/2015,2015.0
46,Lehigh (Patriot),16,7-9,170,202,372,0.457,05/02/2015,2015.0
47,Robert Morris (NEC),14,3-11,155,185,340,0.456,05/02/2015,2015.0
48,Canisius (MAAC),15,3-12,152,184,336,0.452,05/02/2015,2015.0
49,St. John's (NY) (Big East),14,3-11,157,192,349,0.450,05/02/2015,2015.0
50,Georgetown (Big East),16,10-6,186,228,414,0.449,05/02/2015,2015.0
51,Detroit Mercy (MAAC),14,8-6,148,183,331,0.447,05/02/2015,2015.0
52,Michigan (Big Ten),13,5-8,146,181,327,0.446,05/02/2015,2015.0
53,Princeton (Ivy League),14,9-5,162,206,368,0.440,05/02/2015,2015.0
54,UMBC (America East),13,5-8,124,160,284,0.437,05/02/2015,2015.0
55,NJIT (Independent),12,0-12,107,140,247,0.433,05/02/2015,2015.0
56,Marquette (Big East),16,10-6,168,221,389,0.432,05/02/2015,2015.0
57,Bucknell (Patriot),15,9-6,149,197,346,0.431,05/02/2015,2015.0
58,Massachusetts (CAA),15,5-10,153,204,357,0.429,05/02/2015,2015.0
58,Wagner (NEC),13,4-9,105,140,245,0.429,05/02/2015,2015.0
60,Harvard (Ivy League),14,7-7,165,223,388,0.425,05/02/2015,2015.0
61,Quinnipiac (MAAC),15,7-8,160,217,377,0.424,05/02/2015,2015.0
62,Furman (SoCon),13,4-9,107,148,255,0.420,05/02/2015,2015.0
63,Monmouth (MAAC),14,6-8,99,147,246,0.402,05/02/2015,2015.0
64,Manhattan (MAAC),15,1-14,136,203,339,0.401,05/02/2015,2015.0
65,Lafayette (Patriot),14,4-10,133,208,341,0.390,05/02/2015,2015.0
66,Hobart (NEC),14,7-7,115,182,297,0.387,05/02/2015,2015.0
67,Providence (Big East),14,5-9,119,192,311,0.383,05/02/2015,2015.0
68,Colgate (Patriot),15,10-5,128,213,341,0.375,05/02/2015,2015.0
-,UMass Lowell (America East),14,1-13,75,272,347,0.216,05/02/2015,2015.0
1,Denver (Big East),14,12-2,249,104,353,0.705,05/01/2015,2015.0
2,Bryant (NEC),16,7-9,212,109,321,0.660,05/01/2015,2015.0
3,Cornell (Ivy League),15,10-5,236,128,364,0.648,05/01/2015,2015.0
4,Rutgers (Big Ten),15,5-10,235,128,363,0.647,05/01/2015,2015.0
5,Syracuse (ACC),13,11-2,231,126,357,0.647,05/01/2015,2015.0
6,Boston U. (Patriot),13,6-7,202,113,315,0.641,05/01/2015,2015.0
7,Navy (Patriot),13,8-5,174,113,287,0.606,05/01/2015,2015.0
8,Hofstra (CAA),14,5-9,177,115,292,0.606,05/01/2015,2015.0
9,Ohio St. (Big Ten),16,11-5,207,141,348,0.595,05/01/2015,2015.0
10,Brown (Ivy League),16,12-4,261,183,444,0.588,05/01/2015,2015.0
11,High Point (SoCon),15,9-6,207,153,360,0.575,05/01/2015,2015.0
12,Army West Point (Patriot),16,10-6,204,154,358,0.570,05/01/2015,2015.0
13,Duke (ACC),16,11-5,269,205,474,0.568,05/01/2015,2015.0
14,Fairfield (CAA),15,9-6,173,135,308,0.562,05/01/2015,2015.0
15,Dartmouth (Ivy League),13,5-8,178,142,320,0.556,05/01/2015,2015.0
16,Marist (MAAC),15,12-3,188,152,340,0.553,05/01/2015,2015.0
17,Loyola Maryland (Patriot),15,7-8,206,167,373,0.552,05/01/2015,2015.0
18,Stony Brook (America East),17,13-4,254,216,470,0.540,05/01/2015,2015.0
19,Drexel (CAA),15,7-8,177,151,328,0.540,05/01/2015,2015.0
20,Johns Hopkins (Big Ten),14,8-6,198,169,367,0.540,05/01/2015,2015.0
21,Hartford (America East),15,7-8,196,171,367,0.534,05/01/2015,2015.0
22,Saint Joseph's (NEC),16,11-5,189,166,355,0.532,05/01/2015,2015.0
23,Binghamton (America East),13,4-9,169,150,319,0.530,05/01/2015,2015.0
24,Maryland (Big Ten),15,12-3,161,144,305,0.528,05/01/2015,2015.0
25,Jacksonville (SoCon),12,4-8,154,140,294,0.524,05/01/2015,2015.0
26,Yale (Ivy League),14,10-4,168,154,322,0.522,05/01/2015,2015.0
27,Penn St. (Big Ten),14,5-9,164,153,317,0.517,05/01/2015,2015.0
28,Sacred Heart (NEC),13,6-7,158,148,306,0.516,05/01/2015,2015.0
29,Mercer (SoCon),13,5-8,151,143,294,0.514,05/01/2015,2015.0
30,Vermont (America East),16,6-10,245,234,479,0.511,05/01/2015,2015.0
31,Towson (CAA),15,10-5,146,143,289,0.505,05/01/2015,2015.0
32,Air Force (ECAC),14,8-6,154,151,305,0.505,05/01/2015,2015.0
33,Richmond (SoCon),15,11-4,166,176,342,0.485,05/01/2015,2015.0
34,Siena (MAAC),14,5-9,164,174,338,0.485,05/01/2015,2015.0
35,North Carolina (ACC),15,12-3,201,215,416,0.483,05/01/2015,2015.0
36,Notre Dame (ACC),11,9-2,137,147,284,0.482,05/01/2015,2015.0
37,Mount St. Mary's (NEC),15,5-10,142,154,296,0.480,05/01/2015,2015.0
38,Bellarmine (SoCon),12,4-8,131,143,274,0.478,05/01/2015,2015.0
39,Villanova (Big East),14,6-8,155,170,325,0.477,05/01/2015,2015.0
40,Penn (Ivy League),13,6-7,156,172,328,0.476,05/01/2015,2015.0
41,Holy Cross (Patriot),13,6-7,147,167,314,0.468,05/01/2015,2015.0
42,UAlbany (America East),16,14-2,227,259,486,0.467,05/01/2015,2015.0
43,VMI (SoCon),15,1-14,167,191,358,0.466,05/01/2015,2015.0
44,Virginia (ACC),14,10-4,172,197,369,0.466,05/01/2015,2015.0
45,Georgetown (Big East),15,10-5,180,209,389,0.463,05/01/2015,2015.0
46,Delaware (CAA),15,5-10,160,186,346,0.462,05/01/2015,2015.0
47,Lehigh (Patriot),16,7-9,170,202,372,0.457,05/01/2015,2015.0
48,Robert Morris (NEC),14,3-11,155,185,340,0.456,05/01/2015,2015.0
49,Canisius (MAAC),15,3-12,152,184,336,0.452,05/01/2015,2015.0
50,St. John's (NY) (Big East),14,3-11,157,192,349,0.450,05/01/2015,2015.0
51,Detroit Mercy (MAAC),14,8-6,148,183,331,0.447,05/01/2015,2015.0
52,Michigan (Big Ten),13,5-8,146,181,327,0.446,05/01/2015,2015.0
53,Princeton (Ivy League),14,9-5,162,206,368,0.440,05/01/2015,2015.0
54,UMBC (America East),13,5-8,124,160,284,0.437,05/01/2015,2015.0
55,Massachusetts (CAA),14,5-9,147,190,337,0.436,05/01/2015,2015.0
56,NJIT (Independent),12,0-12,107,140,247,0.433,05/01/2015,2015.0
57,Marquette (Big East),16,10-6,168,221,389,0.432,05/01/2015,2015.0
58,Bucknell (Patriot),15,9-6,149,197,346,0.431,05/01/2015,2015.0
59,Wagner (NEC),13,4-9,105,140,245,0.429,05/01/2015,2015.0
60,Quinnipiac (MAAC),14,7-7,146,197,343,0.426,05/01/2015,2015.0
61,Harvard (Ivy League),14,7-7,165,223,388,0.425,05/01/2015,2015.0
62,Furman (SoCon),13,4-9,107,148,255,0.420,05/01/2015,2015.0
63,Monmouth (MAAC),14,6-8,99,147,246,0.402,05/01/2015,2015.0
64,Manhattan (MAAC),15,1-14,136,203,339,0.401,05/01/2015,2015.0
65,Colgate (Patriot),14,10-4,126,195,321,0.393,05/01/2015,2015.0
66,Lafayette (Patriot),14,4-10,133,208,341,0.390,05/01/2015,2015.0
67,Hobart (NEC),14,7-7,115,182,297,0.387,05/01/2015,2015.0
68,Providence (Big East),14,5-9,119,192,311,0.383,05/01/2015,2015.0
-,UMass Lowell (America East),14,1-13,75,272,347,0.216,05/01/2015,2015.0
1,Denver (Big East),14,12-2,249,104,353,0.705,04/30/2015,2015.0
2,Bryant (NEC),16,7-9,212,109,321,0.660,04/30/2015,2015.0
3,Cornell (Ivy League),14,10-4,225,120,345,0.652,04/30/2015,2015.0
4,Rutgers (Big Ten),15,5-10,235,128,363,0.647,04/30/2015,2015.0
5,Syracuse (ACC),13,11-2,231,126,357,0.647,04/30/2015,2015.0
6,Boston U. (Patriot),13,6-7,202,113,315,0.641,04/30/2015,2015.0
7,Navy (Patriot),13,8-5,174,113,287,0.606,04/30/2015,2015.0
8,Hofstra (CAA),14,5-9,177,115,292,0.606,04/30/2015,2015.0
9,Ohio St. (Big Ten),16,11-5,207,141,348,0.595,04/30/2015,2015.0
10,Brown (Ivy League),15,12-3,245,179,424,0.578,04/30/2015,2015.0
11,High Point (SoCon),15,9-6,207,153,360,0.575,04/30/2015,2015.0
12,Army West Point (Patriot),16,10-6,204,154,358,0.570,04/30/2015,2015.0
13,Duke (ACC),16,11-5,269,205,474,0.568,04/30/2015,2015.0
14,Fairfield (CAA),15,9-6,173,135,308,0.562,04/30/2015,2015.0
15,Dartmouth (Ivy League),13,5-8,178,142,320,0.556,04/30/2015,2015.0
16,Marist (MAAC),15,12-3,188,152,340,0.553,04/30/2015,2015.0
17,Loyola Maryland (Patriot),15,7-8,206,167,373,0.552,04/30/2015,2015.0
18,Yale (Ivy League),13,9-4,164,138,302,0.543,04/30/2015,2015.0
19,Stony Brook (America East),17,13-4,254,216,470,0.540,04/30/2015,2015.0
20,Drexel (CAA),15,7-8,177,151,328,0.540,04/30/2015,2015.0
21,Johns Hopkins (Big Ten),14,8-6,198,169,367,0.540,04/30/2015,2015.0
22,Hartford (America East),15,7-8,196,171,367,0.534,04/30/2015,2015.0
23,Saint Joseph's (NEC),16,11-5,189,166,355,0.532,04/30/2015,2015.0
24,Binghamton (America East),13,4-9,169,150,319,0.530,04/30/2015,2015.0
25,Maryland (Big Ten),15,12-3,161,144,305,0.528,04/30/2015,2015.0
26,Jacksonville (SoCon),12,4-8,154,140,294,0.524,04/30/2015,2015.0
27,Penn St. (Big Ten),14,5-9,164,153,317,0.517,04/30/2015,2015.0
28,Sacred Heart (NEC),13,6-7,158,148,306,0.516,04/30/2015,2015.0
29,Mercer (SoCon),13,5-8,151,143,294,0.514,04/30/2015,2015.0
30,Vermont (America East),16,6-10,245,234,479,0.511,04/30/2015,2015.0
31,Towson (CAA),15,10-5,146,143,289,0.505,04/30/2015,2015.0
32,Air Force (ECAC),14,8-6,154,151,305,0.505,04/30/2015,2015.0
33,Richmond (SoCon),15,11-4,166,176,342,0.485,04/30/2015,2015.0
34,Siena (MAAC),14,5-9,164,174,338,0.485,04/30/2015,2015.0
35,North Carolina (ACC),15,12-3,201,215,416,0.483,04/30/2015,2015.0
36,Notre Dame (ACC),11,9-2,137,147,284,0.482,04/30/2015,2015.0
37,Mount St. Mary's (NEC),15,5-10,142,154,296,0.480,04/30/2015,2015.0
38,Bellarmine (SoCon),12,4-8,131,143,274,0.478,04/30/2015,2015.0
39,Villanova (Big East),14,6-8,155,170,325,0.477,04/30/2015,2015.0
40,Penn (Ivy League),13,6-7,156,172,328,0.476,04/30/2015,2015.0
41,Holy Cross (Patriot),13,6-7,147,167,314,0.468,04/30/2015,2015.0
42,UAlbany (America East),16,14-2,227,259,486,0.467,04/30/2015,2015.0
43,VMI (SoCon),15,1-14,167,191,358,0.466,04/30/2015,2015.0
44,Virginia (ACC),14,10-4,172,197,369,0.466,04/30/2015,2015.0
45,Georgetown (Big East),15,10-5,180,209,389,0.463,04/30/2015,2015.0
46,Delaware (CAA),15,5-10,160,186,346,0.462,04/30/2015,2015.0
47,Lehigh (Patriot),16,7-9,170,202,372,0.457,04/30/2015,2015.0
48,Robert Morris (NEC),14,3-11,155,185,340,0.456,04/30/2015,2015.0
49,Canisius (MAAC),15,3-12,152,184,336,0.452,04/30/2015,2015.0
50,St. John's (NY) (Big East),14,3-11,157,192,349,0.450,04/30/2015,2015.0
51,Detroit Mercy (MAAC),14,8-6,148,183,331,0.447,04/30/2015,2015.0
52,Michigan (Big Ten),13,5-8,146,181,327,0.446,04/30/2015,2015.0
53,Princeton (Ivy League),13,8-5,154,195,349,0.441,04/30/2015,2015.0
54,UMBC (America East),13,5-8,124,160,284,0.437,04/30/2015,2015.0
55,Massachusetts (CAA),14,5-9,147,190,337,0.436,04/30/2015,2015.0
56,NJIT (Independent),12,0-12,107,140,247,0.433,04/30/2015,2015.0
57,Marquette (Big East),16,10-6,168,221,389,0.432,04/30/2015,2015.0
58,Bucknell (Patriot),15,9-6,149,197,346,0.431,04/30/2015,2015.0
59,Wagner (NEC),13,4-9,105,140,245,0.429,04/30/2015,2015.0
60,Quinnipiac (MAAC),14,7-7,146,197,343,0.426,04/30/2015,2015.0
61,Harvard (Ivy League),14,7-7,165,223,388,0.425,04/30/2015,2015.0
62,Furman (SoCon),13,4-9,107,148,255,0.420,04/30/2015,2015.0
63,Monmouth (MAAC),14,6-8,99,147,246,0.402,04/30/2015,2015.0
64,Manhattan (MAAC),15,1-14,136,203,339,0.401,04/30/2015,2015.0
65,Colgate (Patriot),14,10-4,126,195,321,0.393,04/30/2015,2015.0
66,Lafayette (Patriot),14,4-10,133,208,341,0.390,04/30/2015,2015.0
67,Hobart (NEC),14,7-7,115,182,297,0.387,04/30/2015,2015.0
68,Providence (Big East),14,5-9,119,192,311,0.383,04/30/2015,2015.0
-,UMass Lowell (America East),14,1-13,75,272,347,0.216,04/30/2015,2015.0
1,Denver (Big East),13,11-2,229,96,325,0.705,04/26/2015,2015.0
2,Cornell (Ivy League),14,10-4,225,120,345,0.652,04/26/2015,2015.0
2,Bryant (NEC),15,6-9,195,104,299,0.652,04/26/2015,2015.0
4,Rutgers (Big Ten),15,5-10,235,128,363,0.647,04/26/2015,2015.0
5,Syracuse (ACC),13,11-2,231,126,357,0.647,04/26/2015,2015.0
6,Boston U. (Patriot),13,6-7,202,113,315,0.641,04/26/2015,2015.0
7,Navy (Patriot),13,8-5,174,113,287,0.606,04/26/2015,2015.0
8,Hofstra (CAA),14,5-9,177,115,292,0.606,04/26/2015,2015.0
9,Ohio St. (Big Ten),15,10-5,196,135,331,0.592,04/26/2015,2015.0
10,High Point (SoCon),14,8-6,201,144,345,0.583,04/26/2015,2015.0
11,Brown (Ivy League),15,12-3,245,179,424,0.578,04/26/2015,2015.0
12,Army West Point (Patriot),16,10-6,204,154,358,0.570,04/26/2015,2015.0
13,Duke (ACC),16,11-5,269,205,474,0.568,04/26/2015,2015.0
14,Fairfield (CAA),14,9-5,160,127,287,0.557,04/26/2015,2015.0
15,Dartmouth (Ivy League),13,5-8,178,142,320,0.556,04/26/2015,2015.0
16,Loyola Maryland (Patriot),15,7-8,206,167,373,0.552,04/26/2015,2015.0
17,Drexel (CAA),14,7-7,169,139,308,0.549,04/26/2015,2015.0
18,Marist (MAAC),14,11-3,176,145,321,0.548,04/26/2015,2015.0
19,Johns Hopkins (Big Ten),13,7-6,186,156,342,0.544,04/26/2015,2015.0
20,Yale (Ivy League),13,9-4,164,138,302,0.543,04/26/2015,2015.0
21,Hartford (America East),14,7-7,186,157,343,0.542,04/26/2015,2015.0
22,Maryland (Big Ten),14,12-2,155,133,288,0.538,04/26/2015,2015.0
23,Saint Joseph's (NEC),15,10-5,181,156,337,0.537,04/26/2015,2015.0
24,Stony Brook (America East),16,12-4,233,204,437,0.533,04/26/2015,2015.0
25,Binghamton (America East),13,4-9,169,150,319,0.530,04/26/2015,2015.0
26,Jacksonville (SoCon),12,4-8,154,140,294,0.524,04/26/2015,2015.0
27,Vermont (America East),15,6-9,233,213,446,0.522,04/26/2015,2015.0
28,Penn St. (Big Ten),13,5-8,151,141,292,0.517,04/26/2015,2015.0
29,Sacred Heart (NEC),13,6-7,158,148,306,0.516,04/26/2015,2015.0
30,Mercer (SoCon),12,5-7,142,137,279,0.509,04/26/2015,2015.0
31,Air Force (ECAC),14,8-6,154,151,305,0.505,04/26/2015,2015.0
32,Towson (CAA),14,9-5,134,135,269,0.498,04/26/2015,2015.0
33,Villanova (Big East),13,6-7,147,150,297,0.495,04/26/2015,2015.0
34,Siena (MAAC),14,5-9,164,174,338,0.485,04/26/2015,2015.0
35,North Carolina (ACC),15,12-3,201,215,416,0.483,04/26/2015,2015.0
36,Notre Dame (ACC),11,9-2,137,147,284,0.482,04/26/2015,2015.0
37,Bellarmine (SoCon),12,4-8,131,143,274,0.478,04/26/2015,2015.0
38,Penn (Ivy League),13,6-7,156,172,328,0.476,04/26/2015,2015.0
39,Mount St. Mary's (NEC),14,5-9,132,146,278,0.475,04/26/2015,2015.0
40,Holy Cross (Patriot),13,6-7,147,167,314,0.468,04/26/2015,2015.0
41,VMI (SoCon),15,1-14,167,191,358,0.466,04/26/2015,2015.0
42,Virginia (ACC),14,10-4,172,197,369,0.466,04/26/2015,2015.0
43,Richmond (SoCon),14,10-4,150,173,323,0.464,04/26/2015,2015.0
44,Delaware (CAA),15,5-10,160,186,346,0.462,04/26/2015,2015.0
45,UAlbany (America East),15,13-2,213,249,462,0.461,04/26/2015,2015.0
46,Lehigh (Patriot),16,7-9,170,202,372,0.457,04/26/2015,2015.0
47,Detroit Mercy (MAAC),13,8-5,138,164,302,0.457,04/26/2015,2015.0
48,Robert Morris (NEC),14,3-11,155,185,340,0.456,04/26/2015,2015.0
49,Canisius (MAAC),15,3-12,152,184,336,0.452,04/26/2015,2015.0
50,St. John's (NY) (Big East),14,3-11,157,192,349,0.450,04/26/2015,2015.0
51,Georgetown (Big East),14,9-5,163,202,365,0.447,04/26/2015,2015.0
52,Michigan (Big Ten),13,5-8,146,181,327,0.446,04/26/2015,2015.0
53,Princeton (Ivy League),13,8-5,154,195,349,0.441,04/26/2015,2015.0
54,Marquette (Big East),15,10-5,161,204,365,0.441,04/26/2015,2015.0
55,Furman (SoCon),12,4-8,104,132,236,0.441,04/26/2015,2015.0
56,Massachusetts (CAA),13,4-9,139,177,316,0.440,04/26/2015,2015.0
57,UMBC (America East),13,5-8,124,160,284,0.437,04/26/2015,2015.0
58,NJIT (Independent),12,0-12,107,140,247,0.433,04/26/2015,2015.0
59,Bucknell (Patriot),15,9-6,149,197,346,0.431,04/26/2015,2015.0
60,Wagner (NEC),13,4-9,105,140,245,0.429,04/26/2015,2015.0
61,Harvard (Ivy League),14,7-7,165,223,388,0.425,04/26/2015,2015.0
62,Monmouth (MAAC),13,6-7,92,135,227,0.405,04/26/2015,2015.0
63,Quinnipiac (MAAC),13,6-7,127,187,314,0.404,04/26/2015,2015.0
64,Manhattan (MAAC),15,1-14,136,203,339,0.401,04/26/2015,2015.0
65,Hobart (NEC),13,7-6,110,165,275,0.400,04/26/2015,2015.0
66,Colgate (Patriot),14,10-4,126,195,321,0.393,04/26/2015,2015.0
67,Lafayette (Patriot),14,4-10,133,208,341,0.390,04/26/2015,2015.0
68,Providence (Big East),14,5-9,119,192,311,0.383,04/26/2015,2015.0
-,UMass Lowell (America East),14,1-13,75,272,347,0.216,04/26/2015,2015.0
1,Denver (Big East),12,10-2,209,83,292,0.716,04/25/2015,2015.0
2,Syracuse (ACC),12,10-2,220,105,325,0.677,04/25/2015,2015.0
3,Cornell (Ivy League),14,10-4,225,120,345,0.652,04/25/2015,2015.0
3,Bryant (NEC),15,6-9,195,104,299,0.652,04/25/2015,2015.0
5,Rutgers (Big Ten),15,5-10,235,128,363,0.647,04/25/2015,2015.0
6,Boston U. (Patriot),13,6-7,202,113,315,0.641,04/25/2015,2015.0
7,Navy (Patriot),13,8-5,174,113,287,0.606,04/25/2015,2015.0
8,Hofstra (CAA),14,5-9,177,115,292,0.606,04/25/2015,2015.0
9,Ohio St. (Big Ten),15,10-5,196,135,331,0.592,04/25/2015,2015.0
10,High Point (SoCon),14,8-6,201,144,345,0.583,04/25/2015,2015.0
11,Brown (Ivy League),15,12-3,245,179,424,0.578,04/25/2015,2015.0
12,Duke (ACC),15,11-4,248,194,442,0.561,04/25/2015,2015.0
13,Fairfield (CAA),14,9-5,160,127,287,0.557,04/25/2015,2015.0
14,Dartmouth (Ivy League),13,5-8,178,142,320,0.556,04/25/2015,2015.0
15,Army West Point (Patriot),15,10-5,186,149,335,0.555,04/25/2015,2015.0
16,Loyola Maryland (Patriot),15,7-8,206,167,373,0.552,04/25/2015,2015.0
17,Drexel (CAA),14,7-7,169,139,308,0.549,04/25/2015,2015.0
18,Marist (MAAC),14,11-3,176,145,321,0.548,04/25/2015,2015.0
19,Johns Hopkins (Big Ten),13,7-6,186,156,342,0.544,04/25/2015,2015.0
20,Yale (Ivy League),13,9-4,164,138,302,0.543,04/25/2015,2015.0
21,Hartford (America East),14,7-7,186,157,343,0.542,04/25/2015,2015.0
22,Maryland (Big Ten),14,12-2,155,133,288,0.538,04/25/2015,2015.0
23,Saint Joseph's (NEC),15,10-5,181,156,337,0.537,04/25/2015,2015.0
24,Stony Brook (America East),16,12-4,233,204,437,0.533,04/25/2015,2015.0
25,Binghamton (America East),13,4-9,169,150,319,0.530,04/25/2015,2015.0
26,Penn St. (Big Ten),12,4-8,142,127,269,0.528,04/25/2015,2015.0
27,Jacksonville (SoCon),12,4-8,154,140,294,0.524,04/25/2015,2015.0
28,Vermont (America East),15,6-9,233,213,446,0.522,04/25/2015,2015.0
29,Sacred Heart (NEC),13,6-7,158,148,306,0.516,04/25/2015,2015.0
30,Mercer (SoCon),12,5-7,142,137,279,0.509,04/25/2015,2015.0
31,Air Force (ECAC),14,8-6,154,151,305,0.505,04/25/2015,2015.0
32,Towson (CAA),14,9-5,134,135,269,0.498,04/25/2015,2015.0
33,Villanova (Big East),13,6-7,147,150,297,0.495,04/25/2015,2015.0
34,Siena (MAAC),14,5-9,164,174,338,0.485,04/25/2015,2015.0
35,North Carolina (ACC),15,12-3,201,215,416,0.483,04/25/2015,2015.0
36,Notre Dame (ACC),11,9-2,137,147,284,0.482,04/25/2015,2015.0
37,Bellarmine (SoCon),12,4-8,131,143,274,0.478,04/25/2015,2015.0
38,Penn (Ivy League),13,6-7,156,172,328,0.476,04/25/2015,2015.0
39,Mount St. Mary's (NEC),14,5-9,132,146,278,0.475,04/25/2015,2015.0
40,Holy Cross (Patriot),13,6-7,147,167,314,0.468,04/25/2015,2015.0
41,Virginia (ACC),14,10-4,172,197,369,0.466,04/25/2015,2015.0
42,Richmond (SoCon),14,10-4,150,173,323,0.464,04/25/2015,2015.0
43,Delaware (CAA),15,5-10,160,186,346,0.462,04/25/2015,2015.0
44,UAlbany (America East),15,13-2,213,249,462,0.461,04/25/2015,2015.0
45,Lehigh (Patriot),16,7-9,170,202,372,0.457,04/25/2015,2015.0
46,Detroit Mercy (MAAC),13,8-5,138,164,302,0.457,04/25/2015,2015.0
47,Robert Morris (NEC),14,3-11,155,185,340,0.456,04/25/2015,2015.0
48,Canisius (MAAC),15,3-12,152,184,336,0.452,04/25/2015,2015.0
49,St. John's (NY) (Big East),14,3-11,157,192,349,0.450,04/25/2015,2015.0
50,Georgetown (Big East),14,9-5,163,202,365,0.447,04/25/2015,2015.0
51,Marquette (Big East),14,10-4,148,184,332,0.446,04/25/2015,2015.0
52,Princeton (Ivy League),13,8-5,154,195,349,0.441,04/25/2015,2015.0
53,Furman (SoCon),12,4-8,104,132,236,0.441,04/25/2015,2015.0
54,Massachusetts (CAA),13,4-9,139,177,316,0.440,04/25/2015,2015.0
55,VMI (SoCon),14,0-14,146,187,333,0.438,04/25/2015,2015.0
56,UMBC (America East),13,5-8,124,160,284,0.437,04/25/2015,2015.0
57,Michigan (Big Ten),12,5-7,132,172,304,0.434,04/25/2015,2015.0
58,NJIT (Independent),12,0-12,107,140,247,0.433,04/25/2015,2015.0
59,Bucknell (Patriot),15,9-6,149,197,346,0.431,04/25/2015,2015.0
60,Wagner (NEC),13,4-9,105,140,245,0.429,04/25/2015,2015.0
61,Harvard (Ivy League),14,7-7,165,223,388,0.425,04/25/2015,2015.0
62,Colgate (Patriot),13,9-4,121,177,298,0.406,04/25/2015,2015.0
63,Monmouth (MAAC),13,6-7,92,135,227,0.405,04/25/2015,2015.0
64,Quinnipiac (MAAC),13,6-7,127,187,314,0.404,04/25/2015,2015.0
65,Manhattan (MAAC),15,1-14,136,203,339,0.401,04/25/2015,2015.0
66,Hobart (NEC),13,7-6,110,165,275,0.400,04/25/2015,2015.0
67,Lafayette (Patriot),14,4-10,133,208,341,0.390,04/25/2015,2015.0
68,Providence (Big East),14,5-9,119,192,311,0.383,04/25/2015,2015.0
-,UMass Lowell (America East),13,1-12,71,251,322,0.220,04/25/2015,2015.0
1,Denver (Big East),12,10-2,209,83,292,0.716,04/24/2015,2015.0
2,Syracuse (ACC),12,10-2,220,105,325,0.677,04/24/2015,2015.0
3,Bryant (NEC),15,6-9,195,104,299,0.652,04/24/2015,2015.0
4,Cornell (Ivy League),13,9-4,205,111,316,0.649,04/24/2015,2015.0
5,Rutgers (Big Ten),14,4-10,215,117,332,0.648,04/24/2015,2015.0
6,Boston U. (Patriot),13,6-7,202,113,315,0.641,04/24/2015,2015.0
7,Ohio St. (Big Ten),14,10-4,185,115,300,0.617,04/24/2015,2015.0
8,Navy (Patriot),13,8-5,174,113,287,0.606,04/24/2015,2015.0
9,Hofstra (CAA),14,5-9,177,115,292,0.606,04/24/2015,2015.0
10,Brown (Ivy League),14,11-3,230,165,395,0.582,04/24/2015,2015.0
11,High Point (SoCon),13,7-6,184,140,324,0.568,04/24/2015,2015.0
12,Dartmouth (Ivy League),12,5-7,164,127,291,0.564,04/24/2015,2015.0
13,Drexel (CAA),13,6-7,160,124,284,0.563,04/24/2015,2015.0
14,Duke (ACC),15,11-4,248,194,442,0.561,04/24/2015,2015.0
15,Fairfield (CAA),14,9-5,160,127,287,0.557,04/24/2015,2015.0
16,Army West Point (Patriot),15,10-5,186,149,335,0.555,04/24/2015,2015.0
17,Loyola Maryland (Patriot),15,7-8,206,167,373,0.552,04/24/2015,2015.0
18,Marist (MAAC),13,10-3,165,135,300,0.550,04/24/2015,2015.0
19,Yale (Ivy League),12,9-3,155,128,283,0.548,04/24/2015,2015.0
20,Maryland (Big Ten),13,12-1,141,117,258,0.547,04/24/2015,2015.0
21,Johns Hopkins (Big Ten),12,6-6,170,142,312,0.545,04/24/2015,2015.0
22,Hartford (America East),14,7-7,186,157,343,0.542,04/24/2015,2015.0
23,Jacksonville (SoCon),11,4-7,147,126,273,0.538,04/24/2015,2015.0
24,Stony Brook (America East),16,12-4,233,204,437,0.533,04/24/2015,2015.0
25,Saint Joseph's (NEC),14,9-5,167,147,314,0.532,04/24/2015,2015.0
26,Binghamton (America East),12,4-8,153,136,289,0.529,04/24/2015,2015.0
27,Penn St. (Big Ten),12,4-8,142,127,269,0.528,04/24/2015,2015.0
28,Sacred Heart (NEC),12,6-6,149,134,283,0.527,04/24/2015,2015.0
29,Vermont (America East),14,5-9,219,197,416,0.526,04/24/2015,2015.0
30,Mercer (SoCon),11,5-6,135,126,261,0.517,04/24/2015,2015.0
31,Air Force (ECAC),14,8-6,154,151,305,0.505,04/24/2015,2015.0
32,Bellarmine (SoCon),11,4-7,127,126,253,0.502,04/24/2015,2015.0
33,Villanova (Big East),12,6-6,140,143,283,0.495,04/24/2015,2015.0
34,Siena (MAAC),13,5-8,154,163,317,0.486,04/24/2015,2015.0
35,Towson (CAA),13,9-4,119,126,245,0.486,04/24/2015,2015.0
36,North Carolina (ACC),15,12-3,201,215,416,0.483,04/24/2015,2015.0
37,Notre Dame (ACC),11,9-2,137,147,284,0.482,04/24/2015,2015.0
38,Penn (Ivy League),12,6-6,147,159,306,0.480,04/24/2015,2015.0
39,Mount St. Mary's (NEC),13,4-9,120,136,256,0.469,04/24/2015,2015.0
40,Holy Cross (Patriot),13,6-7,147,167,314,0.468,04/24/2015,2015.0
41,Delaware (CAA),15,5-10,160,186,346,0.462,04/24/2015,2015.0
42,Virginia (ACC),13,9-4,159,188,347,0.458,04/24/2015,2015.0
43,Canisius (MAAC),14,3-11,144,171,315,0.457,04/24/2015,2015.0
44,Lehigh (Patriot),16,7-9,170,202,372,0.457,04/24/2015,2015.0
45,Richmond (SoCon),13,9-4,139,166,305,0.456,04/24/2015,2015.0
46,Princeton (Ivy League),12,8-4,145,175,320,0.453,04/24/2015,2015.0
47,St. John's (NY) (Big East),13,3-10,145,177,322,0.450,04/24/2015,2015.0
48,UAlbany (America East),14,12-2,192,237,429,0.448,04/24/2015,2015.0
49,UMBC (America East),12,5-7,112,139,251,0.446,04/24/2015,2015.0
50,Marquette (Big East),14,10-4,148,184,332,0.446,04/24/2015,2015.0
51,Detroit Mercy (MAAC),12,7-5,125,156,281,0.445,04/24/2015,2015.0
52,Wagner (NEC),12,4-8,98,124,222,0.441,04/24/2015,2015.0
53,Massachusetts (CAA),13,4-9,139,177,316,0.440,04/24/2015,2015.0
54,Robert Morris (NEC),13,2-11,139,178,317,0.438,04/24/2015,2015.0
55,VMI (SoCon),14,0-14,146,187,333,0.438,04/24/2015,2015.0
56,Georgetown (Big East),13,8-5,148,190,338,0.438,04/24/2015,2015.0
57,Michigan (Big Ten),12,5-7,132,172,304,0.434,04/24/2015,2015.0
58,NJIT (Independent),12,0-12,107,140,247,0.433,04/24/2015,2015.0
59,Bucknell (Patriot),15,9-6,149,197,346,0.431,04/24/2015,2015.0
60,Harvard (Ivy League),13,6-7,155,214,369,0.420,04/24/2015,2015.0
61,Furman (SoCon),11,3-8,90,125,215,0.419,04/24/2015,2015.0
62,Colgate (Patriot),13,9-4,121,177,298,0.406,04/24/2015,2015.0
63,Quinnipiac (MAAC),13,6-7,127,187,314,0.404,04/24/2015,2015.0
64,Manhattan (MAAC),14,1-13,127,191,318,0.399,04/24/2015,2015.0
65,Hobart (NEC),12,7-5,100,153,253,0.395,04/24/2015,2015.0
66,Lafayette (Patriot),14,4-10,133,208,341,0.390,04/24/2015,2015.0
67,Monmouth (MAAC),12,5-7,80,126,206,0.388,04/24/2015,2015.0
68,Providence (Big East),13,4-9,112,185,297,0.377,04/24/2015,2015.0
-,UMass Lowell (America East),13,1-12,71,251,322,0.220,04/24/2015,2015.0
1,Denver (Big East),12,10-2,209,83,292,0.716,04/23/2015,2015.0
2,Syracuse (ACC),11,9-2,206,98,304,0.678,04/23/2015,2015.0
3,Bryant (NEC),15,6-9,195,104,299,0.652,04/23/2015,2015.0
4,Cornell (Ivy League),13,9-4,205,111,316,0.649,04/23/2015,2015.0
5,Rutgers (Big Ten),14,4-10,215,117,332,0.648,04/23/2015,2015.0
6,Boston U. (Patriot),13,6-7,202,113,315,0.641,04/23/2015,2015.0
7,Navy (Patriot),12,8-4,164,101,265,0.619,04/23/2015,2015.0
8,Ohio St. (Big Ten),14,10-4,185,115,300,0.617,04/23/2015,2015.0
9,Hofstra (CAA),13,5-8,172,107,279,0.616,04/23/2015,2015.0
10,Brown (Ivy League),14,11-3,230,165,395,0.582,04/23/2015,2015.0
11,High Point (SoCon),13,7-6,184,140,324,0.568,04/23/2015,2015.0
12,Dartmouth (Ivy League),12,5-7,164,127,291,0.564,04/23/2015,2015.0
13,Drexel (CAA),13,6-7,160,124,284,0.563,04/23/2015,2015.0
14,Army West Point (Patriot),14,9-5,174,139,313,0.556,04/23/2015,2015.0
15,Fairfield (CAA),13,8-5,152,122,274,0.555,04/23/2015,2015.0
16,Duke (ACC),14,10-4,231,187,418,0.553,04/23/2015,2015.0
17,Loyola Maryland (Patriot),15,7-8,206,167,373,0.552,04/23/2015,2015.0
18,Marist (MAAC),13,10-3,165,135,300,0.550,04/23/2015,2015.0
19,Yale (Ivy League),12,9-3,155,128,283,0.548,04/23/2015,2015.0
20,Maryland (Big Ten),13,12-1,141,117,258,0.547,04/23/2015,2015.0
21,Johns Hopkins (Big Ten),12,6-6,170,142,312,0.545,04/23/2015,2015.0
22,Hartford (America East),13,7-6,174,148,322,0.540,04/23/2015,2015.0
23,Stony Brook (America East),15,11-4,224,192,416,0.538,04/23/2015,2015.0
23,Jacksonville (SoCon),11,4-7,147,126,273,0.538,04/23/2015,2015.0
25,Saint Joseph's (NEC),14,9-5,167,147,314,0.532,04/23/2015,2015.0
26,Binghamton (America East),12,4-8,153,136,289,0.529,04/23/2015,2015.0
27,Penn St. (Big Ten),12,4-8,142,127,269,0.528,04/23/2015,2015.0
28,Sacred Heart (NEC),12,6-6,149,134,283,0.527,04/23/2015,2015.0
29,Vermont (America East),14,5-9,219,197,416,0.526,04/23/2015,2015.0
30,Mercer (SoCon),11,5-6,135,126,261,0.517,04/23/2015,2015.0
31,Air Force (ECAC),14,8-6,154,151,305,0.505,04/23/2015,2015.0
32,Bellarmine (SoCon),11,4-7,127,126,253,0.502,04/23/2015,2015.0
33,Notre Dame (ACC),10,9-1,130,130,260,0.500,04/23/2015,2015.0
34,Villanova (Big East),12,6-6,140,143,283,0.495,04/23/2015,2015.0
35,North Carolina (ACC),14,12-2,194,201,395,0.491,04/23/2015,2015.0
36,Siena (MAAC),13,5-8,154,163,317,0.486,04/23/2015,2015.0
37,Towson (CAA),13,9-4,119,126,245,0.486,04/23/2015,2015.0
38,Penn (Ivy League),12,6-6,147,159,306,0.480,04/23/2015,2015.0
39,Mount St. Mary's (NEC),13,4-9,120,136,256,0.469,04/23/2015,2015.0
40,Holy Cross (Patriot),13,6-7,147,167,314,0.468,04/23/2015,2015.0
41,Virginia (ACC),13,9-4,159,188,347,0.458,04/23/2015,2015.0
42,Canisius (MAAC),14,3-11,144,171,315,0.457,04/23/2015,2015.0
43,Lehigh (Patriot),16,7-9,170,202,372,0.457,04/23/2015,2015.0
44,Richmond (SoCon),13,9-4,139,166,305,0.456,04/23/2015,2015.0
45,Princeton (Ivy League),12,8-4,145,175,320,0.453,04/23/2015,2015.0
46,Delaware (CAA),14,4-10,146,178,324,0.451,04/23/2015,2015.0
47,St. John's (NY) (Big East),13,3-10,145,177,322,0.450,04/23/2015,2015.0
48,UAlbany (America East),14,12-2,192,237,429,0.448,04/23/2015,2015.0
49,UMBC (America East),12,5-7,112,139,251,0.446,04/23/2015,2015.0
50,Marquette (Big East),14,10-4,148,184,332,0.446,04/23/2015,2015.0
51,Massachusetts (CAA),12,4-8,131,163,294,0.446,04/23/2015,2015.0
52,Detroit Mercy (MAAC),12,7-5,125,156,281,0.445,04/23/2015,2015.0
53,Wagner (NEC),12,4-8,98,124,222,0.441,04/23/2015,2015.0
54,Robert Morris (NEC),13,2-11,139,178,317,0.438,04/23/2015,2015.0
55,VMI (SoCon),14,0-14,146,187,333,0.438,04/23/2015,2015.0
56,Georgetown (Big East),13,8-5,148,190,338,0.438,04/23/2015,2015.0
57,Michigan (Big Ten),12,5-7,132,172,304,0.434,04/23/2015,2015.0
58,NJIT (Independent),12,0-12,107,140,247,0.433,04/23/2015,2015.0
59,Harvard (Ivy League),13,6-7,155,214,369,0.420,04/23/2015,2015.0
60,Furman (SoCon),11,3-8,90,125,215,0.419,04/23/2015,2015.0
61,Bucknell (Patriot),14,9-5,134,187,321,0.417,04/23/2015,2015.0
62,Colgate (Patriot),12,8-4,111,162,273,0.407,04/23/2015,2015.0
63,Quinnipiac (MAAC),13,6-7,127,187,314,0.404,04/23/2015,2015.0
64,Manhattan (MAAC),14,1-13,127,191,318,0.399,04/23/2015,2015.0
65,Hobart (NEC),12,7-5,100,153,253,0.395,04/23/2015,2015.0
66,Lafayette (Patriot),14,4-10,133,208,341,0.390,04/23/2015,2015.0
67,Monmouth (MAAC),12,5-7,80,126,206,0.388,04/23/2015,2015.0
68,Providence (Big East),13,4-9,112,185,297,0.377,04/23/2015,2015.0
-,UMass Lowell (America East),13,1-12,71,251,322,0.220,04/23/2015,2015.0
1,Denver (Big East),12,10-2,209,83,292,0.716,04/21/2015,2015.0
2,Syracuse (ACC),11,9-2,206,98,304,0.678,04/21/2015,2015.0
3,Bryant (NEC),15,6-9,195,104,299,0.652,04/21/2015,2015.0
4,Cornell (Ivy League),13,9-4,205,111,316,0.649,04/21/2015,2015.0
5,Rutgers (Big Ten),14,4-10,215,117,332,0.648,04/21/2015,2015.0
6,Boston U. (Patriot),13,6-7,202,113,315,0.641,04/21/2015,2015.0
7,Navy (Patriot),12,8-4,164,101,265,0.619,04/21/2015,2015.0
8,Ohio St. (Big Ten),14,10-4,185,115,300,0.617,04/21/2015,2015.0
9,Hofstra (CAA),13,5-8,172,107,279,0.616,04/21/2015,2015.0
10,Brown (Ivy League),14,11-3,230,165,395,0.582,04/21/2015,2015.0
11,High Point (SoCon),13,7-6,184,140,324,0.568,04/21/2015,2015.0
12,Dartmouth (Ivy League),12,5-7,164,127,291,0.564,04/21/2015,2015.0
13,Drexel (CAA),13,6-7,160,124,284,0.563,04/21/2015,2015.0
14,Army West Point (Patriot),14,9-5,174,139,313,0.556,04/21/2015,2015.0
15,Fairfield (CAA),13,8-5,152,122,274,0.555,04/21/2015,2015.0
16,Duke (ACC),14,10-4,231,187,418,0.553,04/21/2015,2015.0
17,Loyola Maryland (Patriot),15,7-8,206,167,373,0.552,04/21/2015,2015.0
18,Marist (MAAC),13,10-3,165,135,300,0.550,04/21/2015,2015.0
19,Yale (Ivy League),12,9-3,155,128,283,0.548,04/21/2015,2015.0
20,Maryland (Big Ten),13,12-1,141,117,258,0.547,04/21/2015,2015.0
21,Johns Hopkins (Big Ten),12,6-6,170,142,312,0.545,04/21/2015,2015.0
22,Hartford (America East),13,7-6,174,148,322,0.540,04/21/2015,2015.0
23,Stony Brook (America East),15,11-4,224,192,416,0.538,04/21/2015,2015.0
23,Jacksonville (SoCon),11,4-7,147,126,273,0.538,04/21/2015,2015.0
25,Saint Joseph's (NEC),14,9-5,167,147,314,0.532,04/21/2015,2015.0
26,Binghamton (America East),12,4-8,153,136,289,0.529,04/21/2015,2015.0
27,Penn St. (Big Ten),12,4-8,142,127,269,0.528,04/21/2015,2015.0
28,Sacred Heart (NEC),12,6-6,149,134,283,0.527,04/21/2015,2015.0
29,Vermont (America East),14,5-9,219,197,416,0.526,04/21/2015,2015.0
30,Mercer (SoCon),11,5-6,135,126,261,0.517,04/21/2015,2015.0
31,Air Force (ECAC),13,8-5,142,137,279,0.509,04/21/2015,2015.0
32,Bellarmine (SoCon),11,4-7,127,126,253,0.502,04/21/2015,2015.0
33,Notre Dame (ACC),10,9-1,130,130,260,0.500,04/21/2015,2015.0
34,Villanova (Big East),12,6-6,140,143,283,0.495,04/21/2015,2015.0
35,North Carolina (ACC),14,12-2,194,201,395,0.491,04/21/2015,2015.0
36,Siena (MAAC),13,5-8,154,163,317,0.486,04/21/2015,2015.0
37,Towson (CAA),13,9-4,119,126,245,0.486,04/21/2015,2015.0
38,Penn (Ivy League),12,6-6,147,159,306,0.480,04/21/2015,2015.0
39,Mount St. Mary's (NEC),13,4-9,120,136,256,0.469,04/21/2015,2015.0
40,Holy Cross (Patriot),13,6-7,147,167,314,0.468,04/21/2015,2015.0
41,Virginia (ACC),13,9-4,159,188,347,0.458,04/21/2015,2015.0
42,Canisius (MAAC),14,3-11,144,171,315,0.457,04/21/2015,2015.0
43,Lehigh (Patriot),16,7-9,170,202,372,0.457,04/21/2015,2015.0
44,Richmond (SoCon),13,9-4,139,166,305,0.456,04/21/2015,2015.0
45,Princeton (Ivy League),12,8-4,145,175,320,0.453,04/21/2015,2015.0
46,Delaware (CAA),14,4-10,146,178,324,0.451,04/21/2015,2015.0
47,St. John's (NY) (Big East),13,3-10,145,177,322,0.450,04/21/2015,2015.0
48,UAlbany (America East),14,12-2,192,237,429,0.448,04/21/2015,2015.0
49,UMBC (America East),12,5-7,112,139,251,0.446,04/21/2015,2015.0
50,Marquette (Big East),14,10-4,148,184,332,0.446,04/21/2015,2015.0
51,Massachusetts (CAA),12,4-8,131,163,294,0.446,04/21/2015,2015.0
52,Detroit Mercy (MAAC),12,7-5,125,156,281,0.445,04/21/2015,2015.0
53,Wagner (NEC),12,4-8,98,124,222,0.441,04/21/2015,2015.0
54,Robert Morris (NEC),13,2-11,139,178,317,0.438,04/21/2015,2015.0
55,VMI (SoCon),14,0-14,146,187,333,0.438,04/21/2015,2015.0
56,Georgetown (Big East),13,8-5,148,190,338,0.438,04/21/2015,2015.0
57,Michigan (Big Ten),12,5-7,132,172,304,0.434,04/21/2015,2015.0
58,NJIT (Independent),12,0-12,107,140,247,0.433,04/21/2015,2015.0
59,Harvard (Ivy League),13,6-7,155,214,369,0.420,04/21/2015,2015.0
60,Furman (SoCon),11,3-8,90,125,215,0.419,04/21/2015,2015.0
61,Bucknell (Patriot),14,9-5,134,187,321,0.417,04/21/2015,2015.0
62,Colgate (Patriot),12,8-4,111,162,273,0.407,04/21/2015,2015.0
63,Manhattan (MAAC),14,1-13,127,191,318,0.399,04/21/2015,2015.0
64,Hobart (NEC),12,7-5,100,153,253,0.395,04/21/2015,2015.0
65,Quinnipiac (MAAC),12,5-7,113,175,288,0.392,04/21/2015,2015.0
66,Lafayette (Patriot),14,4-10,133,208,341,0.390,04/21/2015,2015.0
67,Monmouth (MAAC),12,5-7,80,126,206,0.388,04/21/2015,2015.0
68,Providence (Big East),13,4-9,112,185,297,0.377,04/21/2015,2015.0
-,UMass Lowell (America East),13,1-12,71,251,322,0.220,04/21/2015,2015.0
1,Denver (Big East),12,10-2,209,83,292,0.716,04/19/2015,2015.0
2,Syracuse (ACC),11,9-2,206,98,304,0.678,04/19/2015,2015.0
3,Bryant (NEC),14,6-8,183,95,278,0.658,04/19/2015,2015.0
4,Cornell (Ivy League),13,9-4,205,111,316,0.649,04/19/2015,2015.0
5,Rutgers (Big Ten),14,4-10,215,117,332,0.648,04/19/2015,2015.0
6,Boston U. (Patriot),13,6-7,202,113,315,0.641,04/19/2015,2015.0
7,Navy (Patriot),12,8-4,164,101,265,0.619,04/19/2015,2015.0
8,Ohio St. (Big Ten),14,10-4,185,115,300,0.617,04/19/2015,2015.0
9,Hofstra (CAA),13,5-8,172,107,279,0.616,04/19/2015,2015.0
10,Brown (Ivy League),13,10-3,221,153,374,0.591,04/19/2015,2015.0
11,High Point (SoCon),13,7-6,184,140,324,0.568,04/19/2015,2015.0
12,Drexel (CAA),13,6-7,160,124,284,0.563,04/19/2015,2015.0
13,Army West Point (Patriot),13,8-5,161,125,286,0.563,04/19/2015,2015.0
14,Loyola Maryland (Patriot),14,7-7,192,154,346,0.555,04/19/2015,2015.0
15,Fairfield (CAA),13,8-5,152,122,274,0.555,04/19/2015,2015.0
16,Duke (ACC),14,10-4,231,187,418,0.553,04/19/2015,2015.0
17,Marist (MAAC),13,10-3,165,135,300,0.550,04/19/2015,2015.0
18,Yale (Ivy League),12,9-3,155,128,283,0.548,04/19/2015,2015.0
19,Maryland (Big Ten),13,12-1,141,117,258,0.547,04/19/2015,2015.0
20,Johns Hopkins (Big Ten),12,6-6,170,142,312,0.545,04/19/2015,2015.0
21,Hartford (America East),13,7-6,174,148,322,0.540,04/19/2015,2015.0
22,Stony Brook (America East),15,11-4,224,192,416,0.538,04/19/2015,2015.0
22,Jacksonville (SoCon),11,4-7,147,126,273,0.538,04/19/2015,2015.0
24,Saint Joseph's (NEC),14,9-5,167,147,314,0.532,04/19/2015,2015.0
25,Binghamton (America East),12,4-8,153,136,289,0.529,04/19/2015,2015.0
26,Penn St. (Big Ten),12,4-8,142,127,269,0.528,04/19/2015,2015.0
27,Dartmouth (Ivy League),11,4-7,137,123,260,0.527,04/19/2015,2015.0
28,Sacred Heart (NEC),12,6-6,149,134,283,0.527,04/19/2015,2015.0
29,Vermont (America East),14,5-9,219,197,416,0.526,04/19/2015,2015.0
30,Mercer (SoCon),11,5-6,135,126,261,0.517,04/19/2015,2015.0
31,Air Force (ECAC),13,8-5,142,137,279,0.509,04/19/2015,2015.0
32,Bellarmine (SoCon),11,4-7,127,126,253,0.502,04/19/2015,2015.0
33,Notre Dame (ACC),10,9-1,130,130,260,0.500,04/19/2015,2015.0
34,Villanova (Big East),12,6-6,140,143,283,0.495,04/19/2015,2015.0
35,North Carolina (ACC),14,12-2,194,201,395,0.491,04/19/2015,2015.0
36,Towson (CAA),13,9-4,119,126,245,0.486,04/19/2015,2015.0
37,Penn (Ivy League),12,6-6,147,159,306,0.480,04/19/2015,2015.0
38,Siena (MAAC),12,5-7,133,150,283,0.470,04/19/2015,2015.0
39,Mount St. Mary's (NEC),13,4-9,120,136,256,0.469,04/19/2015,2015.0
40,Holy Cross (Patriot),13,6-7,147,167,314,0.468,04/19/2015,2015.0
41,Virginia (ACC),13,9-4,159,188,347,0.458,04/19/2015,2015.0
42,Canisius (MAAC),14,3-11,144,171,315,0.457,04/19/2015,2015.0
43,Richmond (SoCon),13,9-4,139,166,305,0.456,04/19/2015,2015.0
44,UAlbany (America East),13,11-2,179,216,395,0.453,04/19/2015,2015.0
45,Princeton (Ivy League),12,8-4,145,175,320,0.453,04/19/2015,2015.0
46,Delaware (CAA),14,4-10,146,178,324,0.451,04/19/2015,2015.0
47,St. John's (NY) (Big East),13,3-10,145,177,322,0.450,04/19/2015,2015.0
48,Lehigh (Patriot),15,7-8,156,192,348,0.448,04/19/2015,2015.0
49,UMBC (America East),12,5-7,112,139,251,0.446,04/19/2015,2015.0
50,Marquette (Big East),14,10-4,148,184,332,0.446,04/19/2015,2015.0
51,Massachusetts (CAA),12,4-8,131,163,294,0.446,04/19/2015,2015.0
52,Detroit Mercy (MAAC),12,7-5,125,156,281,0.445,04/19/2015,2015.0
53,Wagner (NEC),12,4-8,98,124,222,0.441,04/19/2015,2015.0
54,Robert Morris (NEC),13,2-11,139,178,317,0.438,04/19/2015,2015.0
55,VMI (SoCon),14,0-14,146,187,333,0.438,04/19/2015,2015.0
56,Georgetown (Big East),13,8-5,148,190,338,0.438,04/19/2015,2015.0
57,Michigan (Big Ten),12,5-7,132,172,304,0.434,04/19/2015,2015.0
58,NJIT (Independent),12,0-12,107,140,247,0.433,04/19/2015,2015.0
59,Harvard (Ivy League),13,6-7,155,214,369,0.420,04/19/2015,2015.0
60,Furman (SoCon),11,3-8,90,125,215,0.419,04/19/2015,2015.0
61,Bucknell (Patriot),13,8-5,124,173,297,0.418,04/19/2015,2015.0
62,Colgate (Patriot),12,8-4,111,162,273,0.407,04/19/2015,2015.0
63,Manhattan (MAAC),14,1-13,127,191,318,0.399,04/19/2015,2015.0
64,Hobart (NEC),12,7-5,100,153,253,0.395,04/19/2015,2015.0
65,Quinnipiac (MAAC),12,5-7,113,175,288,0.392,04/19/2015,2015.0
66,Lafayette (Patriot),14,4-10,133,208,341,0.390,04/19/2015,2015.0
67,Monmouth (MAAC),12,5-7,80,126,206,0.388,04/19/2015,2015.0
68,Providence (Big East),13,4-9,112,185,297,0.377,04/19/2015,2015.0
69,UMass Lowell (America East),12,1-11,67,224,291,0.230,04/19/2015,2015.0
1,Denver (Big East),12,10-2,209,83,292,0.716,04/18/2015,2015.0
2,Syracuse (ACC),11,9-2,206,98,304,0.678,04/18/2015,2015.0
3,Bryant (NEC),13,5-8,171,90,261,0.655,04/18/2015,2015.0
4,Rutgers (Big Ten),13,4-9,203,109,312,0.651,04/18/2015,2015.0
5,Cornell (Ivy League),13,9-4,205,111,316,0.649,04/18/2015,2015.0
6,Boston U. (Patriot),13,6-7,202,113,315,0.641,04/18/2015,2015.0
7,Navy (Patriot),12,8-4,164,101,265,0.619,04/18/2015,2015.0
8,Ohio St. (Big Ten),14,10-4,185,115,300,0.617,04/18/2015,2015.0
9,Hofstra (CAA),13,5-8,172,107,279,0.616,04/18/2015,2015.0
10,Brown (Ivy League),13,10-3,221,153,374,0.591,04/18/2015,2015.0
11,High Point (SoCon),13,7-6,184,140,324,0.568,04/18/2015,2015.0
12,Drexel (CAA),13,6-7,160,124,284,0.563,04/18/2015,2015.0
13,Army West Point (Patriot),13,8-5,161,125,286,0.563,04/18/2015,2015.0
14,Loyola Maryland (Patriot),14,7-7,192,154,346,0.555,04/18/2015,2015.0
15,Fairfield (CAA),13,8-5,152,122,274,0.555,04/18/2015,2015.0
16,Duke (ACC),14,10-4,231,187,418,0.553,04/18/2015,2015.0
17,Marist (MAAC),13,10-3,165,135,300,0.550,04/18/2015,2015.0
18,Yale (Ivy League),12,9-3,155,128,283,0.548,04/18/2015,2015.0
19,Maryland (Big Ten),13,12-1,141,117,258,0.547,04/18/2015,2015.0
20,Stony Brook (America East),14,10-4,211,176,387,0.545,04/18/2015,2015.0
21,Johns Hopkins (Big Ten),12,6-6,170,142,312,0.545,04/18/2015,2015.0
22,Hartford (America East),13,7-6,174,148,322,0.540,04/18/2015,2015.0
23,Jacksonville (SoCon),11,4-7,147,126,273,0.538,04/18/2015,2015.0
24,Penn St. (Big Ten),11,3-8,134,115,249,0.538,04/18/2015,2015.0
25,Saint Joseph's (NEC),14,9-5,167,147,314,0.532,04/18/2015,2015.0
26,Dartmouth (Ivy League),11,4-7,137,123,260,0.527,04/18/2015,2015.0
26,Binghamton (America East),11,4-7,137,123,260,0.527,04/18/2015,2015.0
28,Sacred Heart (NEC),12,6-6,149,134,283,0.527,04/18/2015,2015.0
29,Vermont (America East),14,5-9,219,197,416,0.526,04/18/2015,2015.0
30,Mercer (SoCon),11,5-6,135,126,261,0.517,04/18/2015,2015.0
31,Bellarmine (SoCon),11,4-7,127,126,253,0.502,04/18/2015,2015.0
32,Air Force (ECAC),12,7-5,129,128,257,0.502,04/18/2015,2015.0
33,Notre Dame (ACC),10,9-1,130,130,260,0.500,04/18/2015,2015.0
34,Villanova (Big East),12,6-6,140,143,283,0.495,04/18/2015,2015.0
35,North Carolina (ACC),14,12-2,194,201,395,0.491,04/18/2015,2015.0
36,Towson (CAA),13,9-4,119,126,245,0.486,04/18/2015,2015.0
37,Mount St. Mary's (NEC),12,4-8,115,124,239,0.481,04/18/2015,2015.0
38,Penn (Ivy League),12,6-6,147,159,306,0.480,04/18/2015,2015.0
39,Siena (MAAC),11,5-6,119,135,254,0.469,04/18/2015,2015.0
40,Holy Cross (Patriot),13,6-7,147,167,314,0.468,04/18/2015,2015.0
41,Virginia (ACC),13,9-4,159,188,347,0.458,04/18/2015,2015.0
42,Richmond (SoCon),13,9-4,139,166,305,0.456,04/18/2015,2015.0
43,UAlbany (America East),13,11-2,179,216,395,0.453,04/18/2015,2015.0
44,Princeton (Ivy League),12,8-4,145,175,320,0.453,04/18/2015,2015.0
45,Canisius (MAAC),13,2-11,129,156,285,0.453,04/18/2015,2015.0
46,Delaware (CAA),14,4-10,146,178,324,0.451,04/18/2015,2015.0
47,St. John's (NY) (Big East),13,3-10,145,177,322,0.450,04/18/2015,2015.0
48,Lehigh (Patriot),15,7-8,156,192,348,0.448,04/18/2015,2015.0
49,UMBC (America East),12,5-7,112,139,251,0.446,04/18/2015,2015.0
50,Marquette (Big East),14,10-4,148,184,332,0.446,04/18/2015,2015.0
51,Massachusetts (CAA),12,4-8,131,163,294,0.446,04/18/2015,2015.0
52,Wagner (NEC),12,4-8,98,124,222,0.441,04/18/2015,2015.0
53,Robert Morris (NEC),12,2-10,130,165,295,0.441,04/18/2015,2015.0
54,Georgetown (Big East),13,8-5,148,190,338,0.438,04/18/2015,2015.0
55,Detroit Mercy (MAAC),11,6-5,110,142,252,0.437,04/18/2015,2015.0
56,Michigan (Big Ten),12,5-7,132,172,304,0.434,04/18/2015,2015.0
57,NJIT (Independent),12,0-12,107,140,247,0.433,04/18/2015,2015.0
58,VMI (SoCon),13,0-13,131,172,303,0.432,04/18/2015,2015.0
59,Harvard (Ivy League),13,6-7,155,214,369,0.420,04/18/2015,2015.0
60,Furman (SoCon),11,3-8,90,125,215,0.419,04/18/2015,2015.0
61,Bucknell (Patriot),13,8-5,124,173,297,0.418,04/18/2015,2015.0
62,Colgate (Patriot),12,8-4,111,162,273,0.407,04/18/2015,2015.0
63,Manhattan (MAAC),14,1-13,127,191,318,0.399,04/18/2015,2015.0
64,Hobart (NEC),12,7-5,100,153,253,0.395,04/18/2015,2015.0
65,Quinnipiac (MAAC),12,5-7,113,175,288,0.392,04/18/2015,2015.0
66,Lafayette (Patriot),14,4-10,133,208,341,0.390,04/18/2015,2015.0
67,Monmouth (MAAC),12,5-7,80,126,206,0.388,04/18/2015,2015.0
68,Providence (Big East),13,4-9,112,185,297,0.377,04/18/2015,2015.0
69,UMass Lowell (America East),12,1-11,67,224,291,0.230,04/18/2015,2015.0
1,Denver (Big East),11,9-2,186,81,267,0.697,04/17/2015,2015.0
2,Syracuse (ACC),11,9-2,206,98,304,0.678,04/17/2015,2015.0
3,Cornell (Ivy League),12,9-3,194,98,292,0.664,04/17/2015,2015.0
4,Bryant (NEC),13,5-8,171,90,261,0.655,04/17/2015,2015.0
5,Rutgers (Big Ten),13,4-9,203,109,312,0.651,04/17/2015,2015.0
6,Boston U. (Patriot),13,6-7,202,113,315,0.641,04/17/2015,2015.0
7,Hofstra (CAA),12,4-8,166,99,265,0.626,04/17/2015,2015.0
8,Ohio St. (Big Ten),13,10-3,172,104,276,0.623,04/17/2015,2015.0
9,Navy (Patriot),12,8-4,164,101,265,0.619,04/17/2015,2015.0
10,Brown (Ivy League),12,9-3,208,142,350,0.594,04/17/2015,2015.0
11,High Point (SoCon),13,7-6,184,140,324,0.568,04/17/2015,2015.0
12,Army West Point (Patriot),13,8-5,161,125,286,0.563,04/17/2015,2015.0
13,Drexel (CAA),12,6-6,145,115,260,0.558,04/17/2015,2015.0
14,Maryland (Big Ten),12,11-1,130,104,234,0.556,04/17/2015,2015.0
15,Loyola Maryland (Patriot),14,7-7,192,154,346,0.555,04/17/2015,2015.0
16,Duke (ACC),13,9-4,214,177,391,0.547,04/17/2015,2015.0
17,Stony Brook (America East),14,10-4,211,176,387,0.545,04/17/2015,2015.0
18,Marist (MAAC),12,9-3,151,127,278,0.543,04/17/2015,2015.0
19,Hartford (America East),12,7-5,158,135,293,0.539,04/17/2015,2015.0
20,Fairfield (CAA),12,7-5,133,114,247,0.538,04/17/2015,2015.0
21,Sacred Heart (NEC),11,5-6,141,121,262,0.538,04/17/2015,2015.0
22,Penn St. (Big Ten),11,3-8,134,115,249,0.538,04/17/2015,2015.0
23,Yale (Ivy League),11,9-2,137,120,257,0.533,04/17/2015,2015.0
24,Vermont (America East),13,4-9,206,181,387,0.532,04/17/2015,2015.0
25,Jacksonville (SoCon),10,4-6,134,118,252,0.532,04/17/2015,2015.0
26,Johns Hopkins (Big Ten),11,5-6,151,134,285,0.530,04/17/2015,2015.0
27,Mercer (SoCon),10,4-6,127,113,240,0.529,04/17/2015,2015.0
28,Binghamton (America East),11,4-7,137,123,260,0.527,04/17/2015,2015.0
29,Saint Joseph's (NEC),13,8-5,155,142,297,0.522,04/17/2015,2015.0
30,Bellarmine (SoCon),10,4-6,120,112,232,0.517,04/17/2015,2015.0
31,Notre Dame (ACC),9,8-1,115,112,227,0.507,04/17/2015,2015.0
32,Dartmouth (Ivy League),10,4-6,116,114,230,0.504,04/17/2015,2015.0
33,Air Force (ECAC),12,7-5,129,128,257,0.502,04/17/2015,2015.0
34,Penn (Ivy League),11,5-6,138,138,276,0.500,04/17/2015,2015.0
35,North Carolina (ACC),13,12-1,176,186,362,0.486,04/17/2015,2015.0
36,Mount St. Mary's (NEC),12,4-8,115,124,239,0.481,04/17/2015,2015.0
37,Towson (CAA),12,9-3,111,120,231,0.481,04/17/2015,2015.0
38,Villanova (Big East),11,5-6,117,130,247,0.474,04/17/2015,2015.0
39,Siena (MAAC),11,5-6,119,135,254,0.469,04/17/2015,2015.0
40,Holy Cross (Patriot),13,6-7,147,167,314,0.468,04/17/2015,2015.0
41,Delaware (CAA),13,4-9,138,159,297,0.465,04/17/2015,2015.0
42,UAlbany (America East),12,10-2,171,198,369,0.463,04/17/2015,2015.0
43,St. John's (NY) (Big East),12,3-9,132,154,286,0.462,04/17/2015,2015.0
44,Princeton (Ivy League),12,8-4,145,175,320,0.453,04/17/2015,2015.0
45,Canisius (MAAC),13,2-11,129,156,285,0.453,04/17/2015,2015.0
46,Marquette (Big East),13,10-3,138,167,305,0.452,04/17/2015,2015.0
47,Massachusetts (CAA),11,3-8,122,148,270,0.452,04/17/2015,2015.0
48,Lehigh (Patriot),15,7-8,156,192,348,0.448,04/17/2015,2015.0
49,Michigan (Big Ten),11,5-6,124,153,277,0.448,04/17/2015,2015.0
50,Virginia (ACC),12,8-4,144,178,322,0.447,04/17/2015,2015.0
51,Georgetown (Big East),12,8-4,138,175,313,0.441,04/17/2015,2015.0
52,Robert Morris (NEC),12,2-10,130,165,295,0.441,04/17/2015,2015.0
53,Richmond (SoCon),12,8-4,125,159,284,0.440,04/17/2015,2015.0
54,Detroit Mercy (MAAC),11,6-5,110,142,252,0.437,04/17/2015,2015.0
55,NJIT (Independent),12,0-12,107,140,247,0.433,04/17/2015,2015.0
56,VMI (SoCon),13,0-13,131,172,303,0.432,04/17/2015,2015.0
57,Wagner (NEC),11,4-7,85,116,201,0.423,04/17/2015,2015.0
58,Harvard (Ivy League),13,6-7,155,214,369,0.420,04/17/2015,2015.0
59,UMBC (America East),11,4-7,96,133,229,0.419,04/17/2015,2015.0
60,Furman (SoCon),11,3-8,90,125,215,0.419,04/17/2015,2015.0
61,Bucknell (Patriot),13,8-5,124,173,297,0.418,04/17/2015,2015.0
62,Colgate (Patriot),12,8-4,111,162,273,0.407,04/17/2015,2015.0
63,Providence (Big East),12,4-8,110,162,272,0.404,04/17/2015,2015.0
64,Hobart (NEC),11,7-4,95,141,236,0.403,04/17/2015,2015.0
65,Manhattan (MAAC),13,1-12,119,177,296,0.402,04/17/2015,2015.0
66,Lafayette (Patriot),14,4-10,133,208,341,0.390,04/17/2015,2015.0
67,Quinnipiac (MAAC),11,4-7,103,164,267,0.386,04/17/2015,2015.0
68,Monmouth (MAAC),11,5-6,69,116,185,0.373,04/17/2015,2015.0
69,UMass Lowell (America East),11,1-10,61,208,269,0.227,04/17/2015,2015.0
1,Denver (Big East),11,9-2,186,81,267,0.697,04/15/2015,2015.0
2,Syracuse (ACC),11,9-2,206,98,304,0.678,04/15/2015,2015.0
3,Cornell (Ivy League),12,9-3,194,98,292,0.664,04/15/2015,2015.0
4,Bryant (NEC),13,5-8,171,90,261,0.655,04/15/2015,2015.0
5,Rutgers (Big Ten),13,4-9,203,109,312,0.651,04/15/2015,2015.0
6,Boston U. (Patriot),12,6-6,187,104,291,0.643,04/15/2015,2015.0
7,Hofstra (CAA),12,4-8,166,99,265,0.626,04/15/2015,2015.0
8,Ohio St. (Big Ten),13,10-3,172,104,276,0.623,04/15/2015,2015.0
9,Navy (Patriot),12,8-4,164,101,265,0.619,04/15/2015,2015.0
10,Brown (Ivy League),12,9-3,208,142,350,0.594,04/15/2015,2015.0
11,High Point (SoCon),12,6-6,171,130,301,0.568,04/15/2015,2015.0
12,Loyola Maryland (Patriot),13,7-6,182,141,323,0.563,04/15/2015,2015.0
13,Drexel (CAA),12,6-6,145,115,260,0.558,04/15/2015,2015.0
14,Army West Point (Patriot),12,8-4,150,119,269,0.558,04/15/2015,2015.0
15,Maryland (Big Ten),12,11-1,130,104,234,0.556,04/15/2015,2015.0
16,Duke (ACC),13,9-4,214,177,391,0.547,04/15/2015,2015.0
17,Stony Brook (America East),14,10-4,211,176,387,0.545,04/15/2015,2015.0
18,Marist (MAAC),12,9-3,151,127,278,0.543,04/15/2015,2015.0
19,Hartford (America East),12,7-5,158,135,293,0.539,04/15/2015,2015.0
20,Fairfield (CAA),12,7-5,133,114,247,0.538,04/15/2015,2015.0
21,Sacred Heart (NEC),11,5-6,141,121,262,0.538,04/15/2015,2015.0
22,Penn St. (Big Ten),11,3-8,134,115,249,0.538,04/15/2015,2015.0
23,Yale (Ivy League),11,9-2,137,120,257,0.533,04/15/2015,2015.0
24,Vermont (America East),13,4-9,206,181,387,0.532,04/15/2015,2015.0
25,Jacksonville (SoCon),10,4-6,134,118,252,0.532,04/15/2015,2015.0
26,Johns Hopkins (Big Ten),11,5-6,151,134,285,0.530,04/15/2015,2015.0
27,Mercer (SoCon),10,4-6,127,113,240,0.529,04/15/2015,2015.0
28,Binghamton (America East),11,4-7,137,123,260,0.527,04/15/2015,2015.0
29,Saint Joseph's (NEC),13,8-5,155,142,297,0.522,04/15/2015,2015.0
30,Bellarmine (SoCon),10,4-6,120,112,232,0.517,04/15/2015,2015.0
31,Notre Dame (ACC),9,8-1,115,112,227,0.507,04/15/2015,2015.0
32,Dartmouth (Ivy League),10,4-6,116,114,230,0.504,04/15/2015,2015.0
33,Air Force (ECAC),12,7-5,129,128,257,0.502,04/15/2015,2015.0
34,Penn (Ivy League),11,5-6,138,138,276,0.500,04/15/2015,2015.0
35,North Carolina (ACC),13,12-1,176,186,362,0.486,04/15/2015,2015.0
36,Mount St. Mary's (NEC),12,4-8,115,124,239,0.481,04/15/2015,2015.0
37,Towson (CAA),12,9-3,111,120,231,0.481,04/15/2015,2015.0
38,Holy Cross (Patriot),12,5-7,138,152,290,0.476,04/15/2015,2015.0
39,Villanova (Big East),11,5-6,117,130,247,0.474,04/15/2015,2015.0
40,Siena (MAAC),11,5-6,119,135,254,0.469,04/15/2015,2015.0
41,Delaware (CAA),13,4-9,138,159,297,0.465,04/15/2015,2015.0
42,UAlbany (America East),12,10-2,171,198,369,0.463,04/15/2015,2015.0
43,St. John's (NY) (Big East),12,3-9,132,154,286,0.462,04/15/2015,2015.0
44,Princeton (Ivy League),11,7-4,135,159,294,0.459,04/15/2015,2015.0
45,Canisius (MAAC),13,2-11,129,156,285,0.453,04/15/2015,2015.0
46,Marquette (Big East),13,10-3,138,167,305,0.452,04/15/2015,2015.0
47,Massachusetts (CAA),11,3-8,122,148,270,0.452,04/15/2015,2015.0
48,Michigan (Big Ten),11,5-6,124,153,277,0.448,04/15/2015,2015.0
49,Lehigh (Patriot),14,6-8,145,179,324,0.448,04/15/2015,2015.0
50,Virginia (ACC),12,8-4,144,178,322,0.447,04/15/2015,2015.0
51,Georgetown (Big East),12,8-4,138,175,313,0.441,04/15/2015,2015.0
52,Robert Morris (NEC),12,2-10,130,165,295,0.441,04/15/2015,2015.0
53,Richmond (SoCon),12,8-4,125,159,284,0.440,04/15/2015,2015.0
54,Detroit Mercy (MAAC),11,6-5,110,142,252,0.437,04/15/2015,2015.0
55,NJIT (Independent),12,0-12,107,140,247,0.433,04/15/2015,2015.0
56,VMI (SoCon),12,0-12,121,159,280,0.432,04/15/2015,2015.0
57,Wagner (NEC),11,4-7,85,116,201,0.423,04/15/2015,2015.0
58,UMBC (America East),11,4-7,96,133,229,0.419,04/15/2015,2015.0
59,Furman (SoCon),11,3-8,90,125,215,0.419,04/15/2015,2015.0
60,Colgate (Patriot),11,7-4,105,151,256,0.410,04/15/2015,2015.0
61,Harvard (Ivy League),12,6-6,139,204,343,0.405,04/15/2015,2015.0
62,Bucknell (Patriot),12,7-5,111,163,274,0.405,04/15/2015,2015.0
63,Providence (Big East),12,4-8,110,162,272,0.404,04/15/2015,2015.0
64,Hobart (NEC),11,7-4,95,141,236,0.403,04/15/2015,2015.0
65,Manhattan (MAAC),13,1-12,119,177,296,0.402,04/15/2015,2015.0
66,Quinnipiac (MAAC),11,4-7,103,164,267,0.386,04/15/2015,2015.0
67,Lafayette (Patriot),13,4-9,120,197,317,0.379,04/15/2015,2015.0
68,Monmouth (MAAC),11,5-6,69,116,185,0.373,04/15/2015,2015.0
69,UMass Lowell (America East),11,1-10,61,208,269,0.227,04/15/2015,2015.0
1,Denver (Big East),11,9-2,186,81,267,0.697,04/14/2015,2015.0
2,Syracuse (ACC),11,9-2,206,98,304,0.678,04/14/2015,2015.0
3,Cornell (Ivy League),12,9-3,194,98,292,0.664,04/14/2015,2015.0
4,Bryant (NEC),13,5-8,171,90,261,0.655,04/14/2015,2015.0
5,Rutgers (Big Ten),13,4-9,203,109,312,0.651,04/14/2015,2015.0
6,Boston U. (Patriot),12,6-6,187,104,291,0.643,04/14/2015,2015.0
7,Hofstra (CAA),12,4-8,166,99,265,0.626,04/14/2015,2015.0
8,Ohio St. (Big Ten),13,10-3,172,104,276,0.623,04/14/2015,2015.0
9,Navy (Patriot),12,8-4,164,101,265,0.619,04/14/2015,2015.0
10,Brown (Ivy League),12,9-3,208,142,350,0.594,04/14/2015,2015.0
11,Stony Brook (America East),13,10-3,202,153,355,0.569,04/14/2015,2015.0
12,High Point (SoCon),12,6-6,171,130,301,0.568,04/14/2015,2015.0
13,Loyola Maryland (Patriot),13,7-6,182,141,323,0.563,04/14/2015,2015.0
14,Drexel (CAA),12,6-6,145,115,260,0.558,04/14/2015,2015.0
15,Army West Point (Patriot),12,8-4,150,119,269,0.558,04/14/2015,2015.0
16,Maryland (Big Ten),12,11-1,130,104,234,0.556,04/14/2015,2015.0
17,Marist (MAAC),12,9-3,151,127,278,0.543,04/14/2015,2015.0
18,Hartford (America East),12,7-5,158,135,293,0.539,04/14/2015,2015.0
19,Fairfield (CAA),12,7-5,133,114,247,0.538,04/14/2015,2015.0
20,Sacred Heart (NEC),11,5-6,141,121,262,0.538,04/14/2015,2015.0
21,Penn St. (Big Ten),11,3-8,134,115,249,0.538,04/14/2015,2015.0
22,Yale (Ivy League),11,9-2,137,120,257,0.533,04/14/2015,2015.0
23,Vermont (America East),13,4-9,206,181,387,0.532,04/14/2015,2015.0
24,Duke (ACC),12,8-4,191,168,359,0.532,04/14/2015,2015.0
25,Jacksonville (SoCon),10,4-6,134,118,252,0.532,04/14/2015,2015.0
26,Johns Hopkins (Big Ten),11,5-6,151,134,285,0.530,04/14/2015,2015.0
27,Mercer (SoCon),10,4-6,127,113,240,0.529,04/14/2015,2015.0
28,Binghamton (America East),11,4-7,137,123,260,0.527,04/14/2015,2015.0
29,Saint Joseph's (NEC),13,8-5,155,142,297,0.522,04/14/2015,2015.0
30,Bellarmine (SoCon),10,4-6,120,112,232,0.517,04/14/2015,2015.0
31,Notre Dame (ACC),9,8-1,115,112,227,0.507,04/14/2015,2015.0
32,Dartmouth (Ivy League),10,4-6,116,114,230,0.504,04/14/2015,2015.0
33,Air Force (ECAC),12,7-5,129,128,257,0.502,04/14/2015,2015.0
34,Penn (Ivy League),11,5-6,138,138,276,0.500,04/14/2015,2015.0
35,North Carolina (ACC),13,12-1,176,186,362,0.486,04/14/2015,2015.0
36,Mount St. Mary's (NEC),12,4-8,115,124,239,0.481,04/14/2015,2015.0
37,Towson (CAA),12,9-3,111,120,231,0.481,04/14/2015,2015.0
38,Holy Cross (Patriot),12,5-7,138,152,290,0.476,04/14/2015,2015.0
39,Villanova (Big East),11,5-6,117,130,247,0.474,04/14/2015,2015.0
40,Siena (MAAC),11,5-6,119,135,254,0.469,04/14/2015,2015.0
41,Delaware (CAA),13,4-9,138,159,297,0.465,04/14/2015,2015.0
42,UAlbany (America East),12,10-2,171,198,369,0.463,04/14/2015,2015.0
43,St. John's (NY) (Big East),12,3-9,132,154,286,0.462,04/14/2015,2015.0
44,Princeton (Ivy League),11,7-4,135,159,294,0.459,04/14/2015,2015.0
45,Canisius (MAAC),13,2-11,129,156,285,0.453,04/14/2015,2015.0
46,Marquette (Big East),13,10-3,138,167,305,0.452,04/14/2015,2015.0
47,Massachusetts (CAA),11,3-8,122,148,270,0.452,04/14/2015,2015.0
48,Michigan (Big Ten),11,5-6,124,153,277,0.448,04/14/2015,2015.0
49,Lehigh (Patriot),14,6-8,145,179,324,0.448,04/14/2015,2015.0
50,Virginia (ACC),12,8-4,144,178,322,0.447,04/14/2015,2015.0
51,Georgetown (Big East),12,8-4,138,175,313,0.441,04/14/2015,2015.0
52,Robert Morris (NEC),12,2-10,130,165,295,0.441,04/14/2015,2015.0
53,Richmond (SoCon),12,8-4,125,159,284,0.440,04/14/2015,2015.0
54,Detroit Mercy (MAAC),11,6-5,110,142,252,0.437,04/14/2015,2015.0
55,NJIT (Independent),12,0-12,107,140,247,0.433,04/14/2015,2015.0
56,VMI (SoCon),12,0-12,121,159,280,0.432,04/14/2015,2015.0
57,Wagner (NEC),11,4-7,85,116,201,0.423,04/14/2015,2015.0
58,UMBC (America East),11,4-7,96,133,229,0.419,04/14/2015,2015.0
59,Furman (SoCon),11,3-8,90,125,215,0.419,04/14/2015,2015.0
60,Colgate (Patriot),11,7-4,105,151,256,0.410,04/14/2015,2015.0
61,Harvard (Ivy League),12,6-6,139,204,343,0.405,04/14/2015,2015.0
62,Bucknell (Patriot),12,7-5,111,163,274,0.405,04/14/2015,2015.0
63,Providence (Big East),12,4-8,110,162,272,0.404,04/14/2015,2015.0
64,Hobart (NEC),11,7-4,95,141,236,0.403,04/14/2015,2015.0
65,Manhattan (MAAC),13,1-12,119,177,296,0.402,04/14/2015,2015.0
66,Quinnipiac (MAAC),11,4-7,103,164,267,0.386,04/14/2015,2015.0
67,Lafayette (Patriot),13,4-9,120,197,317,0.379,04/14/2015,2015.0
68,Monmouth (MAAC),11,5-6,69,116,185,0.373,04/14/2015,2015.0
69,UMass Lowell (America East),11,1-10,61,208,269,0.227,04/14/2015,2015.0
1,Denver (Big East),11,9-2,186,81,267,0.697,04/12/2015,2015.0
2,Syracuse (ACC),10,8-2,189,90,279,0.677,04/12/2015,2015.0
3,Cornell (Ivy League),12,9-3,194,98,292,0.664,04/12/2015,2015.0
4,Bryant (NEC),12,5-7,157,83,240,0.654,04/12/2015,2015.0
5,Rutgers (Big Ten),13,4-9,203,109,312,0.651,04/12/2015,2015.0
6,Boston U. (Patriot),12,6-6,187,104,291,0.643,04/12/2015,2015.0
7,Hofstra (CAA),12,4-8,166,99,265,0.626,04/12/2015,2015.0
8,Ohio St. (Big Ten),13,10-3,172,104,276,0.623,04/12/2015,2015.0
9,Navy (Patriot),12,8-4,164,101,265,0.619,04/12/2015,2015.0
10,Brown (Ivy League),11,8-3,191,130,321,0.595,04/12/2015,2015.0
11,Stony Brook (America East),13,10-3,202,153,355,0.569,04/12/2015,2015.0
12,High Point (SoCon),12,6-6,171,130,301,0.568,04/12/2015,2015.0
13,Loyola Maryland (Patriot),13,7-6,182,141,323,0.563,04/12/2015,2015.0
14,Drexel (CAA),12,6-6,145,115,260,0.558,04/12/2015,2015.0
15,Army West Point (Patriot),12,8-4,150,119,269,0.558,04/12/2015,2015.0
16,Maryland (Big Ten),12,11-1,130,104,234,0.556,04/12/2015,2015.0
17,Sacred Heart (NEC),10,4-6,130,109,239,0.544,04/12/2015,2015.0
18,Marist (MAAC),12,9-3,151,127,278,0.543,04/12/2015,2015.0
19,Hartford (America East),11,7-4,146,124,270,0.541,04/12/2015,2015.0
20,Fairfield (CAA),12,7-5,133,114,247,0.538,04/12/2015,2015.0
21,Penn St. (Big Ten),11,3-8,134,115,249,0.538,04/12/2015,2015.0
22,Yale (Ivy League),11,9-2,137,120,257,0.533,04/12/2015,2015.0
23,Vermont (America East),13,4-9,206,181,387,0.532,04/12/2015,2015.0
24,Duke (ACC),12,8-4,191,168,359,0.532,04/12/2015,2015.0
25,Jacksonville (SoCon),10,4-6,134,118,252,0.532,04/12/2015,2015.0
26,Johns Hopkins (Big Ten),11,5-6,151,134,285,0.530,04/12/2015,2015.0
27,Mercer (SoCon),10,4-6,127,113,240,0.529,04/12/2015,2015.0
28,Saint Joseph's (NEC),13,8-5,155,142,297,0.522,04/12/2015,2015.0
29,Dartmouth (Ivy League),9,3-6,111,103,214,0.519,04/12/2015,2015.0
30,Bellarmine (SoCon),10,4-6,120,112,232,0.517,04/12/2015,2015.0
31,Binghamton (America East),10,3-7,121,115,236,0.513,04/12/2015,2015.0
32,Notre Dame (ACC),9,8-1,115,112,227,0.507,04/12/2015,2015.0
33,Air Force (ECAC),12,7-5,129,128,257,0.502,04/12/2015,2015.0
34,Penn (Ivy League),11,5-6,138,138,276,0.500,04/12/2015,2015.0
35,North Carolina (ACC),13,12-1,176,186,362,0.486,04/12/2015,2015.0
36,Mount St. Mary's (NEC),12,4-8,115,124,239,0.481,04/12/2015,2015.0
37,Towson (CAA),12,9-3,111,120,231,0.481,04/12/2015,2015.0
38,Holy Cross (Patriot),12,5-7,138,152,290,0.476,04/12/2015,2015.0
39,Villanova (Big East),11,5-6,117,130,247,0.474,04/12/2015,2015.0
40,UAlbany (America East),11,9-2,164,184,348,0.471,04/12/2015,2015.0
41,Siena (MAAC),11,5-6,119,135,254,0.469,04/12/2015,2015.0
42,Delaware (CAA),13,4-9,138,159,297,0.465,04/12/2015,2015.0
43,Canisius (MAAC),12,2-10,121,140,261,0.464,04/12/2015,2015.0
44,St. John's (NY) (Big East),12,3-9,132,154,286,0.462,04/12/2015,2015.0
45,Princeton (Ivy League),11,7-4,135,159,294,0.459,04/12/2015,2015.0
46,Marquette (Big East),13,10-3,138,167,305,0.452,04/12/2015,2015.0
47,Massachusetts (CAA),11,3-8,122,148,270,0.452,04/12/2015,2015.0
48,Michigan (Big Ten),11,5-6,124,153,277,0.448,04/12/2015,2015.0
49,Lehigh (Patriot),14,6-8,145,179,324,0.448,04/12/2015,2015.0
50,Virginia (ACC),12,8-4,144,178,322,0.447,04/12/2015,2015.0
51,Georgetown (Big East),12,8-4,138,175,313,0.441,04/12/2015,2015.0
52,Robert Morris (NEC),12,2-10,130,165,295,0.441,04/12/2015,2015.0
53,Richmond (SoCon),12,8-4,125,159,284,0.440,04/12/2015,2015.0
54,Detroit Mercy (MAAC),11,6-5,110,142,252,0.437,04/12/2015,2015.0
55,VMI (SoCon),12,0-12,121,159,280,0.432,04/12/2015,2015.0
56,Wagner (NEC),11,4-7,85,116,201,0.423,04/12/2015,2015.0
57,UMBC (America East),11,4-7,96,133,229,0.419,04/12/2015,2015.0
58,Furman (SoCon),11,3-8,90,125,215,0.419,04/12/2015,2015.0
59,NJIT (Independent),11,0-11,96,135,231,0.416,04/12/2015,2015.0
60,Hobart (NEC),10,7-3,87,124,211,0.412,04/12/2015,2015.0
61,Colgate (Patriot),11,7-4,105,151,256,0.410,04/12/2015,2015.0
62,Harvard (Ivy League),12,6-6,139,204,343,0.405,04/12/2015,2015.0
63,Bucknell (Patriot),12,7-5,111,163,274,0.405,04/12/2015,2015.0
64,Providence (Big East),11,4-7,98,145,243,0.403,04/12/2015,2015.0
65,Manhattan (MAAC),13,1-12,119,177,296,0.402,04/12/2015,2015.0
66,Quinnipiac (MAAC),11,4-7,103,164,267,0.386,04/12/2015,2015.0
67,Lafayette (Patriot),13,4-9,120,197,317,0.379,04/12/2015,2015.0
68,Monmouth (MAAC),11,5-6,69,116,185,0.373,04/12/2015,2015.0
69,UMass Lowell (America East),11,1-10,61,208,269,0.227,04/12/2015,2015.0
1,Denver (Big East),10,8-2,170,71,241,0.705,04/10/2015,2015.0
2,Syracuse (ACC),9,8-1,168,76,244,0.689,04/10/2015,2015.0
3,Cornell (Ivy League),11,8-3,181,90,271,0.668,04/10/2015,2015.0
4,Rutgers (Big Ten),12,4-8,192,99,291,0.660,04/10/2015,2015.0
5,Bryant (NEC),11,4-7,142,76,218,0.651,04/10/2015,2015.0
6,Hofstra (CAA),11,4-7,158,86,244,0.648,04/10/2015,2015.0
7,Boston U. (Patriot),11,6-5,174,99,273,0.637,04/10/2015,2015.0
8,Ohio St. (Big Ten),12,9-3,156,95,251,0.622,04/10/2015,2015.0
9,Navy (Patriot),11,7-4,152,93,245,0.620,04/10/2015,2015.0
10,Brown (Ivy League),10,8-2,178,115,293,0.608,04/10/2015,2015.0
11,High Point (SoCon),11,6-5,158,111,269,0.587,04/10/2015,2015.0
12,Loyola Maryland (Patriot),12,6-6,177,128,305,0.580,04/10/2015,2015.0
13,Army West Point (Patriot),11,8-3,142,107,249,0.570,04/10/2015,2015.0
14,Drexel (CAA),11,5-6,135,104,239,0.565,04/10/2015,2015.0
15,Maryland (Big Ten),11,10-1,120,93,213,0.563,04/10/2015,2015.0
16,Stony Brook (America East),12,10-2,185,144,329,0.562,04/10/2015,2015.0
17,Fairfield (CAA),11,7-4,125,103,228,0.548,04/10/2015,2015.0
18,Jacksonville (SoCon),9,4-5,123,102,225,0.547,04/10/2015,2015.0
19,Sacred Heart (NEC),10,4-6,130,109,239,0.544,04/10/2015,2015.0
20,Penn St. (Big Ten),10,3-7,121,103,224,0.540,04/10/2015,2015.0
21,Mercer (SoCon),9,4-5,118,101,219,0.539,04/10/2015,2015.0
22,Johns Hopkins (Big Ten),10,4-6,139,121,260,0.535,04/10/2015,2015.0
23,Vermont (America East),12,3-9,194,169,363,0.534,04/10/2015,2015.0
24,Duke (ACC),11,7-4,177,155,332,0.533,04/10/2015,2015.0
25,Yale (Ivy League),10,8-2,122,107,229,0.533,04/10/2015,2015.0
26,Hartford (America East),10,6-4,129,114,243,0.531,04/10/2015,2015.0
27,Marist (MAAC),11,8-3,132,120,252,0.524,04/10/2015,2015.0
28,Dartmouth (Ivy League),8,3-5,97,92,189,0.513,04/10/2015,2015.0
29,Bellarmine (SoCon),9,3-6,104,101,205,0.507,04/10/2015,2015.0
30,Mount St. Mary's (NEC),11,4-7,109,106,215,0.507,04/10/2015,2015.0
31,Notre Dame (ACC),9,8-1,115,112,227,0.507,04/10/2015,2015.0
32,Binghamton (America East),9,3-6,104,103,207,0.502,04/10/2015,2015.0
33,Saint Joseph's (NEC),12,7-5,137,136,273,0.502,04/10/2015,2015.0
34,Penn (Ivy League),10,4-6,128,128,256,0.500,04/10/2015,2015.0
35,Air Force (ECAC),11,6-5,117,119,236,0.496,04/10/2015,2015.0
36,North Carolina (ACC),12,11-1,162,165,327,0.495,04/10/2015,2015.0
37,UAlbany (America East),10,8-2,152,167,319,0.476,04/10/2015,2015.0
38,Canisius (MAAC),11,2-9,114,127,241,0.473,04/10/2015,2015.0
39,Siena (MAAC),10,4-6,109,122,231,0.472,04/10/2015,2015.0
40,Towson (CAA),11,8-3,100,112,212,0.472,04/10/2015,2015.0
41,St. John's (NY) (Big East),11,3-8,122,138,260,0.469,04/10/2015,2015.0
42,Georgetown (Big East),11,7-4,133,152,285,0.467,04/10/2015,2015.0
43,Holy Cross (Patriot),11,5-6,121,139,260,0.465,04/10/2015,2015.0
44,Princeton (Ivy League),10,6-4,124,145,269,0.461,04/10/2015,2015.0
45,Massachusetts (CAA),10,3-7,112,131,243,0.461,04/10/2015,2015.0
46,Delaware (CAA),12,4-8,127,149,276,0.460,04/10/2015,2015.0
47,Marquette (Big East),12,9-3,127,150,277,0.458,04/10/2015,2015.0
48,Lehigh (Patriot),13,5-8,136,162,298,0.456,04/10/2015,2015.0
49,Michigan (Big Ten),10,5-5,115,137,252,0.456,04/10/2015,2015.0
50,Robert Morris (NEC),11,2-9,123,150,273,0.451,04/10/2015,2015.0
51,Virginia (ACC),11,8-3,131,164,295,0.444,04/10/2015,2015.0
52,NJIT (Independent),10,0-10,89,116,205,0.434,04/10/2015,2015.0
53,Villanova (Big East),10,5-5,94,125,219,0.429,04/10/2015,2015.0
54,Wagner (NEC),10,4-6,79,106,185,0.427,04/10/2015,2015.0
55,VMI (SoCon),11,0-11,110,149,259,0.425,04/10/2015,2015.0
56,Richmond (SoCon),11,7-4,106,146,252,0.421,04/10/2015,2015.0
57,Detroit Mercy (MAAC),10,5-5,96,135,231,0.416,04/10/2015,2015.0
58,Furman (SoCon),10,2-8,80,114,194,0.412,04/10/2015,2015.0
59,UMBC (America East),10,4-6,84,121,205,0.410,04/10/2015,2015.0
60,Colgate (Patriot),10,6-4,92,134,226,0.407,04/10/2015,2015.0
61,Harvard (Ivy League),11,6-5,129,194,323,0.399,04/10/2015,2015.0
62,Bucknell (Patriot),11,6-5,97,146,243,0.399,04/10/2015,2015.0
63,Hobart (NEC),9,6-3,77,118,195,0.395,04/10/2015,2015.0
64,Manhattan (MAAC),12,1-11,106,167,273,0.388,04/10/2015,2015.0
65,Monmouth (MAAC),10,5-5,62,102,164,0.378,04/10/2015,2015.0
66,Providence (Big East),10,4-6,81,134,215,0.377,04/10/2015,2015.0
67,Quinnipiac (MAAC),10,3-7,90,157,247,0.364,04/10/2015,2015.0
68,Lafayette (Patriot),12,4-8,103,183,286,0.360,04/10/2015,2015.0
69,UMass Lowell (America East),11,1-10,61,208,269,0.227,04/10/2015,2015.0
1,Denver (Big East),10,8-2,170,71,241,0.705,04/09/2015,2015.0
2,Syracuse (ACC),9,8-1,168,76,244,0.689,04/09/2015,2015.0
3,Cornell (Ivy League),11,8-3,181,90,271,0.668,04/09/2015,2015.0
4,Rutgers (Big Ten),12,4-8,192,99,291,0.660,04/09/2015,2015.0
5,Bryant (NEC),11,4-7,142,76,218,0.651,04/09/2015,2015.0
6,Hofstra (CAA),11,4-7,158,86,244,0.648,04/09/2015,2015.0
7,Boston U. (Patriot),11,6-5,174,99,273,0.637,04/09/2015,2015.0
8,Ohio St. (Big Ten),12,9-3,156,95,251,0.622,04/09/2015,2015.0
9,Navy (Patriot),11,7-4,152,93,245,0.620,04/09/2015,2015.0
10,Brown (Ivy League),10,8-2,178,115,293,0.608,04/09/2015,2015.0
11,High Point (SoCon),11,6-5,158,111,269,0.587,04/09/2015,2015.0
12,Loyola Maryland (Patriot),12,6-6,177,128,305,0.580,04/09/2015,2015.0
13,Army West Point (Patriot),11,8-3,142,107,249,0.570,04/09/2015,2015.0
14,Drexel (CAA),11,5-6,135,104,239,0.565,04/09/2015,2015.0
15,Maryland (Big Ten),11,10-1,120,93,213,0.563,04/09/2015,2015.0
16,Fairfield (CAA),11,7-4,125,103,228,0.548,04/09/2015,2015.0
17,Jacksonville (SoCon),9,4-5,123,102,225,0.547,04/09/2015,2015.0
18,Sacred Heart (NEC),10,4-6,130,109,239,0.544,04/09/2015,2015.0
19,Stony Brook (America East),11,9-2,161,136,297,0.542,04/09/2015,2015.0
20,Penn St. (Big Ten),10,3-7,121,103,224,0.540,04/09/2015,2015.0
21,Mercer (SoCon),9,4-5,118,101,219,0.539,04/09/2015,2015.0
22,Johns Hopkins (Big Ten),10,4-6,139,121,260,0.535,04/09/2015,2015.0
23,Vermont (America East),12,3-9,194,169,363,0.534,04/09/2015,2015.0
24,Duke (ACC),11,7-4,177,155,332,0.533,04/09/2015,2015.0
25,Yale (Ivy League),10,8-2,122,107,229,0.533,04/09/2015,2015.0
26,Hartford (America East),10,6-4,129,114,243,0.531,04/09/2015,2015.0
27,Marist (MAAC),11,8-3,132,120,252,0.524,04/09/2015,2015.0
28,Dartmouth (Ivy League),8,3-5,97,92,189,0.513,04/09/2015,2015.0
29,Bellarmine (SoCon),9,3-6,104,101,205,0.507,04/09/2015,2015.0
30,Mount St. Mary's (NEC),11,4-7,109,106,215,0.507,04/09/2015,2015.0
31,Notre Dame (ACC),9,8-1,115,112,227,0.507,04/09/2015,2015.0
32,Binghamton (America East),9,3-6,104,103,207,0.502,04/09/2015,2015.0
33,Saint Joseph's (NEC),12,7-5,137,136,273,0.502,04/09/2015,2015.0
34,Penn (Ivy League),10,4-6,128,128,256,0.500,04/09/2015,2015.0
35,Air Force (ECAC),11,6-5,117,119,236,0.496,04/09/2015,2015.0
36,North Carolina (ACC),12,11-1,162,165,327,0.495,04/09/2015,2015.0
37,UAlbany (America East),10,8-2,152,167,319,0.476,04/09/2015,2015.0
38,Canisius (MAAC),11,2-9,114,127,241,0.473,04/09/2015,2015.0
39,Siena (MAAC),10,4-6,109,122,231,0.472,04/09/2015,2015.0
40,Towson (CAA),11,8-3,100,112,212,0.472,04/09/2015,2015.0
41,St. John's (NY) (Big East),11,3-8,122,138,260,0.469,04/09/2015,2015.0
42,Georgetown (Big East),11,7-4,133,152,285,0.467,04/09/2015,2015.0
43,Holy Cross (Patriot),11,5-6,121,139,260,0.465,04/09/2015,2015.0
44,Princeton (Ivy League),10,6-4,124,145,269,0.461,04/09/2015,2015.0
45,Massachusetts (CAA),10,3-7,112,131,243,0.461,04/09/2015,2015.0
46,Delaware (CAA),12,4-8,127,149,276,0.460,04/09/2015,2015.0
47,Marquette (Big East),12,9-3,127,150,277,0.458,04/09/2015,2015.0
48,Lehigh (Patriot),13,5-8,136,162,298,0.456,04/09/2015,2015.0
49,Michigan (Big Ten),10,5-5,115,137,252,0.456,04/09/2015,2015.0
50,Robert Morris (NEC),11,2-9,123,150,273,0.451,04/09/2015,2015.0
51,Virginia (ACC),11,8-3,131,164,295,0.444,04/09/2015,2015.0
52,NJIT (Independent),10,0-10,89,116,205,0.434,04/09/2015,2015.0
53,Villanova (Big East),10,5-5,94,125,219,0.429,04/09/2015,2015.0
54,Wagner (NEC),10,4-6,79,106,185,0.427,04/09/2015,2015.0
55,VMI (SoCon),11,0-11,110,149,259,0.425,04/09/2015,2015.0
56,Richmond (SoCon),11,7-4,106,146,252,0.421,04/09/2015,2015.0
57,Detroit Mercy (MAAC),10,5-5,96,135,231,0.416,04/09/2015,2015.0
58,Furman (SoCon),10,2-8,80,114,194,0.412,04/09/2015,2015.0
59,UMBC (America East),10,4-6,84,121,205,0.410,04/09/2015,2015.0
60,Colgate (Patriot),10,6-4,92,134,226,0.407,04/09/2015,2015.0
61,Harvard (Ivy League),11,6-5,129,194,323,0.399,04/09/2015,2015.0
62,Bucknell (Patriot),11,6-5,97,146,243,0.399,04/09/2015,2015.0
63,Hobart (NEC),9,6-3,77,118,195,0.395,04/09/2015,2015.0
64,Manhattan (MAAC),12,1-11,106,167,273,0.388,04/09/2015,2015.0
65,Monmouth (MAAC),10,5-5,62,102,164,0.378,04/09/2015,2015.0
66,Providence (Big East),10,4-6,81,134,215,0.377,04/09/2015,2015.0
67,Quinnipiac (MAAC),10,3-7,90,157,247,0.364,04/09/2015,2015.0
68,Lafayette (Patriot),12,4-8,103,183,286,0.360,04/09/2015,2015.0
69,UMass Lowell (America East),10,1-9,53,184,237,0.224,04/09/2015,2015.0
1,Denver (Big East),10,8-2,170,71,241,0.705,04/08/2015,2015.0
2,Syracuse (ACC),9,8-1,168,76,244,0.689,04/08/2015,2015.0
3,Cornell (Ivy League),11,8-3,181,90,271,0.668,04/08/2015,2015.0
4,Rutgers (Big Ten),12,4-8,192,99,291,0.660,04/08/2015,2015.0
5,Bryant (NEC),11,4-7,142,76,218,0.651,04/08/2015,2015.0
6,Hofstra (CAA),11,4-7,158,86,244,0.648,04/08/2015,2015.0
7,Boston U. (Patriot),11,6-5,174,99,273,0.637,04/08/2015,2015.0
8,Ohio St. (Big Ten),12,9-3,156,95,251,0.622,04/08/2015,2015.0
9,Navy (Patriot),11,7-4,152,93,245,0.620,04/08/2015,2015.0
10,Brown (Ivy League),10,8-2,178,115,293,0.608,04/08/2015,2015.0
11,High Point (SoCon),11,6-5,158,111,269,0.587,04/08/2015,2015.0
12,Loyola Maryland (Patriot),12,6-6,177,128,305,0.580,04/08/2015,2015.0
13,Army West Point (Patriot),11,8-3,142,107,249,0.570,04/08/2015,2015.0
14,Drexel (CAA),11,5-6,135,104,239,0.565,04/08/2015,2015.0
15,Maryland (Big Ten),11,10-1,120,93,213,0.563,04/08/2015,2015.0
16,Fairfield (CAA),11,7-4,125,103,228,0.548,04/08/2015,2015.0
17,Jacksonville (SoCon),9,4-5,123,102,225,0.547,04/08/2015,2015.0
18,Sacred Heart (NEC),10,4-6,130,109,239,0.544,04/08/2015,2015.0
19,Stony Brook (America East),11,9-2,161,136,297,0.542,04/08/2015,2015.0
20,Penn St. (Big Ten),10,3-7,121,103,224,0.540,04/08/2015,2015.0
21,Mercer (SoCon),9,4-5,118,101,219,0.539,04/08/2015,2015.0
22,Johns Hopkins (Big Ten),10,4-6,139,121,260,0.535,04/08/2015,2015.0
23,Vermont (America East),12,3-9,194,169,363,0.534,04/08/2015,2015.0
24,Duke (ACC),11,7-4,177,155,332,0.533,04/08/2015,2015.0
25,Yale (Ivy League),10,8-2,122,107,229,0.533,04/08/2015,2015.0
26,Hartford (America East),10,6-4,129,114,243,0.531,04/08/2015,2015.0
27,Marist (MAAC),11,8-3,132,120,252,0.524,04/08/2015,2015.0
28,Dartmouth (Ivy League),8,3-5,97,92,189,0.513,04/08/2015,2015.0
29,Bellarmine (SoCon),9,3-6,104,101,205,0.507,04/08/2015,2015.0
30,Mount St. Mary's (NEC),11,4-7,109,106,215,0.507,04/08/2015,2015.0
31,Notre Dame (ACC),9,8-1,115,112,227,0.507,04/08/2015,2015.0
32,Binghamton (America East),9,3-6,104,103,207,0.502,04/08/2015,2015.0
33,Saint Joseph's (NEC),12,7-5,137,136,273,0.502,04/08/2015,2015.0
34,Penn (Ivy League),10,4-6,128,128,256,0.500,04/08/2015,2015.0
35,Air Force (ECAC),11,6-5,117,119,236,0.496,04/08/2015,2015.0
36,North Carolina (ACC),12,11-1,162,165,327,0.495,04/08/2015,2015.0
37,UAlbany (America East),10,8-2,152,167,319,0.476,04/08/2015,2015.0
38,Canisius (MAAC),11,2-9,114,127,241,0.473,04/08/2015,2015.0
39,Siena (MAAC),10,4-6,109,122,231,0.472,04/08/2015,2015.0
40,Towson (CAA),11,8-3,100,112,212,0.472,04/08/2015,2015.0
41,St. John's (NY) (Big East),11,3-8,122,138,260,0.469,04/08/2015,2015.0
42,Georgetown (Big East),11,7-4,133,152,285,0.467,04/08/2015,2015.0
43,Holy Cross (Patriot),11,5-6,121,139,260,0.465,04/08/2015,2015.0
44,Princeton (Ivy League),10,6-4,124,145,269,0.461,04/08/2015,2015.0
45,Massachusetts (CAA),10,3-7,112,131,243,0.461,04/08/2015,2015.0
46,Delaware (CAA),12,4-8,127,149,276,0.460,04/08/2015,2015.0
47,Marquette (Big East),12,9-3,127,150,277,0.458,04/08/2015,2015.0
48,Lehigh (Patriot),13,5-8,136,162,298,0.456,04/08/2015,2015.0
49,Michigan (Big Ten),10,5-5,115,137,252,0.456,04/08/2015,2015.0
50,Robert Morris (NEC),11,2-9,123,150,273,0.451,04/08/2015,2015.0
51,Virginia (ACC),11,8-3,131,164,295,0.444,04/08/2015,2015.0
52,NJIT (Independent),10,0-10,89,116,205,0.434,04/08/2015,2015.0
53,Villanova (Big East),10,5-5,94,125,219,0.429,04/08/2015,2015.0
54,Wagner (NEC),10,4-6,79,106,185,0.427,04/08/2015,2015.0
55,VMI (SoCon),11,0-11,110,149,259,0.425,04/08/2015,2015.0
56,Richmond (SoCon),11,7-4,106,146,252,0.421,04/08/2015,2015.0
57,Detroit Mercy (MAAC),10,5-5,96,135,231,0.416,04/08/2015,2015.0
58,Furman (SoCon),10,2-8,80,114,194,0.412,04/08/2015,2015.0
59,UMBC (America East),10,4-6,84,121,205,0.410,04/08/2015,2015.0
60,Colgate (Patriot),10,6-4,92,134,226,0.407,04/08/2015,2015.0
61,Harvard (Ivy League),11,6-5,129,194,323,0.399,04/08/2015,2015.0
62,Bucknell (Patriot),11,6-5,97,146,243,0.399,04/08/2015,2015.0
63,Hobart (NEC),9,6-3,77,118,195,0.395,04/08/2015,2015.0
64,Manhattan (MAAC),12,1-11,106,167,273,0.388,04/08/2015,2015.0
65,Monmouth (MAAC),10,5-5,62,102,164,0.378,04/08/2015,2015.0
66,Providence (Big East),10,4-6,81,134,215,0.377,04/08/2015,2015.0
67,Quinnipiac (MAAC),10,3-7,90,157,247,0.364,04/08/2015,2015.0
68,Lafayette (Patriot),12,4-8,103,183,286,0.360,04/08/2015,2015.0
69,UMass Lowell (America East),10,1-9,53,184,237,0.224,04/08/2015,2015.0
1,Denver (Big East),10,8-2,170,71,241,0.705,04/07/2015,2015.0
2,Syracuse (ACC),9,8-1,168,76,244,0.689,04/07/2015,2015.0
3,Cornell (Ivy League),11,8-3,181,90,271,0.668,04/07/2015,2015.0
4,Rutgers (Big Ten),12,4-8,192,99,291,0.660,04/07/2015,2015.0
5,Bryant (NEC),11,4-7,142,76,218,0.651,04/07/2015,2015.0
6,Hofstra (CAA),11,4-7,158,86,244,0.648,04/07/2015,2015.0
7,Boston U. (Patriot),11,6-5,174,99,273,0.637,04/07/2015,2015.0
8,Ohio St. (Big Ten),12,9-3,156,95,251,0.622,04/07/2015,2015.0
9,Navy (Patriot),11,7-4,152,93,245,0.620,04/07/2015,2015.0
10,Brown (Ivy League),10,8-2,178,115,293,0.608,04/07/2015,2015.0
11,High Point (SoCon),11,6-5,158,111,269,0.587,04/07/2015,2015.0
12,Maryland (Big Ten),10,9-1,111,78,189,0.587,04/07/2015,2015.0
13,Loyola Maryland (Patriot),11,6-5,162,119,281,0.577,04/07/2015,2015.0
14,Army West Point (Patriot),11,8-3,142,107,249,0.570,04/07/2015,2015.0
15,Drexel (CAA),11,5-6,135,104,239,0.565,04/07/2015,2015.0
16,Fairfield (CAA),11,7-4,125,103,228,0.548,04/07/2015,2015.0
17,Jacksonville (SoCon),9,4-5,123,102,225,0.547,04/07/2015,2015.0
18,Sacred Heart (NEC),10,4-6,130,109,239,0.544,04/07/2015,2015.0
19,Stony Brook (America East),11,9-2,161,136,297,0.542,04/07/2015,2015.0
20,Penn St. (Big Ten),10,3-7,121,103,224,0.540,04/07/2015,2015.0
21,Mercer (SoCon),9,4-5,118,101,219,0.539,04/07/2015,2015.0
22,Johns Hopkins (Big Ten),10,4-6,139,121,260,0.535,04/07/2015,2015.0
23,Vermont (America East),12,3-9,194,169,363,0.534,04/07/2015,2015.0
24,Duke (ACC),11,7-4,177,155,332,0.533,04/07/2015,2015.0
25,Yale (Ivy League),10,8-2,122,107,229,0.533,04/07/2015,2015.0
26,Hartford (America East),10,6-4,129,114,243,0.531,04/07/2015,2015.0
27,Marist (MAAC),11,8-3,132,120,252,0.524,04/07/2015,2015.0
28,Dartmouth (Ivy League),8,3-5,97,92,189,0.513,04/07/2015,2015.0
29,Bellarmine (SoCon),9,3-6,104,101,205,0.507,04/07/2015,2015.0
30,Notre Dame (ACC),9,8-1,115,112,227,0.507,04/07/2015,2015.0
31,Binghamton (America East),9,3-6,104,103,207,0.502,04/07/2015,2015.0
32,Saint Joseph's (NEC),12,7-5,137,136,273,0.502,04/07/2015,2015.0
33,Penn (Ivy League),10,4-6,128,128,256,0.500,04/07/2015,2015.0
34,Air Force (ECAC),11,6-5,117,119,236,0.496,04/07/2015,2015.0
35,North Carolina (ACC),12,11-1,162,165,327,0.495,04/07/2015,2015.0
36,UAlbany (America East),10,8-2,152,167,319,0.476,04/07/2015,2015.0
37,Mount St. Mary's (NEC),10,4-6,92,102,194,0.474,04/07/2015,2015.0
38,Canisius (MAAC),11,2-9,114,127,241,0.473,04/07/2015,2015.0
39,Robert Morris (NEC),10,1-9,119,133,252,0.472,04/07/2015,2015.0
40,Siena (MAAC),10,4-6,109,122,231,0.472,04/07/2015,2015.0
41,Towson (CAA),11,8-3,100,112,212,0.472,04/07/2015,2015.0
42,St. John's (NY) (Big East),11,3-8,122,138,260,0.469,04/07/2015,2015.0
43,Georgetown (Big East),11,7-4,133,152,285,0.467,04/07/2015,2015.0
44,Holy Cross (Patriot),11,5-6,121,139,260,0.465,04/07/2015,2015.0
45,Princeton (Ivy League),10,6-4,124,145,269,0.461,04/07/2015,2015.0
46,Massachusetts (CAA),10,3-7,112,131,243,0.461,04/07/2015,2015.0
47,Delaware (CAA),12,4-8,127,149,276,0.460,04/07/2015,2015.0
48,Marquette (Big East),12,9-3,127,150,277,0.458,04/07/2015,2015.0
49,Lehigh (Patriot),13,5-8,136,162,298,0.456,04/07/2015,2015.0
50,Michigan (Big Ten),10,5-5,115,137,252,0.456,04/07/2015,2015.0
51,Virginia (ACC),11,8-3,131,164,295,0.444,04/07/2015,2015.0
52,NJIT (Independent),10,0-10,89,116,205,0.434,04/07/2015,2015.0
53,Villanova (Big East),10,5-5,94,125,219,0.429,04/07/2015,2015.0
54,Wagner (NEC),10,4-6,79,106,185,0.427,04/07/2015,2015.0
55,VMI (SoCon),11,0-11,110,149,259,0.425,04/07/2015,2015.0
56,Richmond (SoCon),11,7-4,106,146,252,0.421,04/07/2015,2015.0
57,Detroit Mercy (MAAC),10,5-5,96,135,231,0.416,04/07/2015,2015.0
58,Furman (SoCon),10,2-8,80,114,194,0.412,04/07/2015,2015.0
59,UMBC (America East),10,4-6,84,121,205,0.410,04/07/2015,2015.0
60,Colgate (Patriot),10,6-4,92,134,226,0.407,04/07/2015,2015.0
61,Harvard (Ivy League),11,6-5,129,194,323,0.399,04/07/2015,2015.0
62,Bucknell (Patriot),11,6-5,97,146,243,0.399,04/07/2015,2015.0
63,Hobart (NEC),9,6-3,77,118,195,0.395,04/07/2015,2015.0
64,Manhattan (MAAC),12,1-11,106,167,273,0.388,04/07/2015,2015.0
65,Monmouth (MAAC),10,5-5,62,102,164,0.378,04/07/2015,2015.0
66,Providence (Big East),10,4-6,81,134,215,0.377,04/07/2015,2015.0
67,Quinnipiac (MAAC),10,3-7,90,157,247,0.364,04/07/2015,2015.0
68,Lafayette (Patriot),12,4-8,103,183,286,0.360,04/07/2015,2015.0
69,UMass Lowell (America East),10,1-9,53,184,237,0.224,04/07/2015,2015.0
1,Denver (Big East),10,8-2,170,71,241,0.705,04/05/2015,2015.0
2,Syracuse (ACC),9,8-1,168,76,244,0.689,04/05/2015,2015.0
3,Rutgers (Big Ten),12,4-8,192,99,291,0.660,04/05/2015,2015.0
4,Cornell (Ivy League),10,7-3,163,85,248,0.657,04/05/2015,2015.0
5,Hofstra (CAA),10,4-6,144,77,221,0.652,04/05/2015,2015.0
6,Bryant (NEC),10,3-7,125,68,193,0.648,04/05/2015,2015.0
7,Boston U. (Patriot),10,6-4,158,94,252,0.627,04/05/2015,2015.0
8,Ohio St. (Big Ten),12,9-3,156,95,251,0.622,04/05/2015,2015.0
9,Navy (Patriot),11,7-4,152,93,245,0.620,04/05/2015,2015.0
10,Brown (Ivy League),10,8-2,178,115,293,0.608,04/05/2015,2015.0
11,High Point (SoCon),11,6-5,158,111,269,0.587,04/05/2015,2015.0
12,Maryland (Big Ten),10,9-1,111,78,189,0.587,04/05/2015,2015.0
13,Loyola Maryland (Patriot),11,6-5,162,119,281,0.577,04/05/2015,2015.0
14,Army West Point (Patriot),11,8-3,142,107,249,0.570,04/05/2015,2015.0
15,Sacred Heart (NEC),9,4-5,122,92,214,0.570,04/05/2015,2015.0
16,Drexel (CAA),11,5-6,135,104,239,0.565,04/05/2015,2015.0
17,Fairfield (CAA),11,7-4,125,103,228,0.548,04/05/2015,2015.0
18,Jacksonville (SoCon),9,4-5,123,102,225,0.547,04/05/2015,2015.0
19,Stony Brook (America East),11,9-2,161,136,297,0.542,04/05/2015,2015.0
20,Penn St. (Big Ten),10,3-7,121,103,224,0.540,04/05/2015,2015.0
21,Mercer (SoCon),9,4-5,118,101,219,0.539,04/05/2015,2015.0
22,Marist (MAAC),10,7-3,123,106,229,0.537,04/05/2015,2015.0
23,Johns Hopkins (Big Ten),10,4-6,139,121,260,0.535,04/05/2015,2015.0
24,Vermont (America East),12,3-9,194,169,363,0.534,04/05/2015,2015.0
25,Duke (ACC),11,7-4,177,155,332,0.533,04/05/2015,2015.0
26,Yale (Ivy League),10,8-2,122,107,229,0.533,04/05/2015,2015.0
27,Hartford (America East),10,6-4,129,114,243,0.531,04/05/2015,2015.0
28,Dartmouth (Ivy League),8,3-5,97,92,189,0.513,04/05/2015,2015.0
29,Bellarmine (SoCon),9,3-6,104,101,205,0.507,04/05/2015,2015.0
30,Saint Joseph's (NEC),11,6-5,127,125,252,0.504,04/05/2015,2015.0
31,Binghamton (America East),9,3-6,104,103,207,0.502,04/05/2015,2015.0
32,Penn (Ivy League),10,4-6,128,128,256,0.500,04/05/2015,2015.0
32,Canisius (MAAC),10,2-8,109,109,218,0.500,04/05/2015,2015.0
34,Air Force (ECAC),11,6-5,117,119,236,0.496,04/05/2015,2015.0
35,North Carolina (ACC),12,11-1,162,165,327,0.495,04/05/2015,2015.0
36,Notre Dame (ACC),8,7-1,99,104,203,0.488,04/05/2015,2015.0
37,UAlbany (America East),10,8-2,152,167,319,0.476,04/05/2015,2015.0
38,Mount St. Mary's (NEC),10,4-6,92,102,194,0.474,04/05/2015,2015.0
39,Robert Morris (NEC),10,1-9,119,133,252,0.472,04/05/2015,2015.0
40,Siena (MAAC),10,4-6,109,122,231,0.472,04/05/2015,2015.0
41,Towson (CAA),11,8-3,100,112,212,0.472,04/05/2015,2015.0
42,Marquette (Big East),11,9-2,119,134,253,0.470,04/05/2015,2015.0
43,St. John's (NY) (Big East),11,3-8,122,138,260,0.469,04/05/2015,2015.0
44,Georgetown (Big East),11,7-4,133,152,285,0.467,04/05/2015,2015.0
45,Holy Cross (Patriot),11,5-6,121,139,260,0.465,04/05/2015,2015.0
46,Massachusetts (CAA),10,3-7,112,131,243,0.461,04/05/2015,2015.0
47,Delaware (CAA),12,4-8,127,149,276,0.460,04/05/2015,2015.0
48,Princeton (Ivy League),9,6-3,108,127,235,0.460,04/05/2015,2015.0
49,Michigan (Big Ten),10,5-5,115,137,252,0.456,04/05/2015,2015.0
50,Lehigh (Patriot),12,4-8,118,146,264,0.447,04/05/2015,2015.0
51,Virginia (ACC),11,8-3,131,164,295,0.444,04/05/2015,2015.0
52,NJIT (Independent),9,0-9,78,101,179,0.436,04/05/2015,2015.0
53,Villanova (Big East),10,5-5,94,125,219,0.429,04/05/2015,2015.0
54,VMI (SoCon),11,0-11,110,149,259,0.425,04/05/2015,2015.0
55,Richmond (SoCon),11,7-4,106,146,252,0.421,04/05/2015,2015.0
56,Detroit Mercy (MAAC),10,5-5,96,135,231,0.416,04/05/2015,2015.0
57,Wagner (NEC),9,4-5,68,96,164,0.415,04/05/2015,2015.0
58,Furman (SoCon),10,2-8,80,114,194,0.412,04/05/2015,2015.0
59,Harvard (Ivy League),10,5-5,124,178,302,0.411,04/05/2015,2015.0
60,UMBC (America East),10,4-6,84,121,205,0.410,04/05/2015,2015.0
61,Colgate (Patriot),10,6-4,92,134,226,0.407,04/05/2015,2015.0
62,Bucknell (Patriot),11,6-5,97,146,243,0.399,04/05/2015,2015.0
63,Hobart (NEC),9,6-3,77,118,195,0.395,04/05/2015,2015.0
64,Manhattan (MAAC),12,1-11,106,167,273,0.388,04/05/2015,2015.0
65,Monmouth (MAAC),10,5-5,62,102,164,0.378,04/05/2015,2015.0
66,Providence (Big East),10,4-6,81,134,215,0.377,04/05/2015,2015.0
67,Quinnipiac (MAAC),10,3-7,90,157,247,0.364,04/05/2015,2015.0
68,Lafayette (Patriot),11,3-8,88,172,260,0.338,04/05/2015,2015.0
69,UMass Lowell (America East),10,1-9,53,184,237,0.224,04/05/2015,2015.0
1,Denver (Big East),10,8-2,170,71,241,0.705,04/04/2015,2015.0
2,Syracuse (ACC),9,8-1,168,76,244,0.689,04/04/2015,2015.0
3,Cornell (Ivy League),10,7-3,163,85,248,0.657,04/04/2015,2015.0
4,Rutgers (Big Ten),11,4-7,176,93,269,0.654,04/04/2015,2015.0
5,Hofstra (CAA),10,4-6,144,77,221,0.652,04/04/2015,2015.0
6,Bryant (NEC),10,3-7,125,68,193,0.648,04/04/2015,2015.0
7,Boston U. (Patriot),10,6-4,158,94,252,0.627,04/04/2015,2015.0
8,Ohio St. (Big Ten),11,8-3,138,83,221,0.624,04/04/2015,2015.0
9,Navy (Patriot),11,7-4,152,93,245,0.620,04/04/2015,2015.0
10,Brown (Ivy League),10,8-2,178,115,293,0.608,04/04/2015,2015.0
11,High Point (SoCon),11,6-5,158,111,269,0.587,04/04/2015,2015.0
12,Maryland (Big Ten),10,9-1,111,78,189,0.587,04/04/2015,2015.0
13,Loyola Maryland (Patriot),11,6-5,162,119,281,0.577,04/04/2015,2015.0
14,Army West Point (Patriot),11,8-3,142,107,249,0.570,04/04/2015,2015.0
15,Sacred Heart (NEC),9,4-5,122,92,214,0.570,04/04/2015,2015.0
16,Drexel (CAA),11,5-6,135,104,239,0.565,04/04/2015,2015.0
17,Johns Hopkins (Big Ten),9,4-5,127,103,230,0.552,04/04/2015,2015.0
18,Fairfield (CAA),11,7-4,125,103,228,0.548,04/04/2015,2015.0
19,Jacksonville (SoCon),9,4-5,123,102,225,0.547,04/04/2015,2015.0
20,Stony Brook (America East),11,9-2,161,136,297,0.542,04/04/2015,2015.0
21,Penn St. (Big Ten),10,3-7,121,103,224,0.540,04/04/2015,2015.0
22,Mercer (SoCon),9,4-5,118,101,219,0.539,04/04/2015,2015.0
23,Marist (MAAC),10,7-3,123,106,229,0.537,04/04/2015,2015.0
24,Vermont (America East),12,3-9,194,169,363,0.534,04/04/2015,2015.0
25,Duke (ACC),11,7-4,177,155,332,0.533,04/04/2015,2015.0
26,Yale (Ivy League),10,8-2,122,107,229,0.533,04/04/2015,2015.0
27,Hartford (America East),10,6-4,129,114,243,0.531,04/04/2015,2015.0
28,Dartmouth (Ivy League),8,3-5,97,92,189,0.513,04/04/2015,2015.0
29,Bellarmine (SoCon),8,3-5,93,90,183,0.508,04/04/2015,2015.0
30,Saint Joseph's (NEC),11,6-5,127,125,252,0.504,04/04/2015,2015.0
31,Binghamton (America East),9,3-6,104,103,207,0.502,04/04/2015,2015.0
32,Penn (Ivy League),10,4-6,128,128,256,0.500,04/04/2015,2015.0
32,Canisius (MAAC),10,2-8,109,109,218,0.500,04/04/2015,2015.0
34,North Carolina (ACC),12,11-1,162,165,327,0.495,04/04/2015,2015.0
35,Air Force (ECAC),10,5-5,106,108,214,0.495,04/04/2015,2015.0
36,Notre Dame (ACC),8,7-1,99,104,203,0.488,04/04/2015,2015.0
37,UAlbany (America East),10,8-2,152,167,319,0.476,04/04/2015,2015.0
38,Mount St. Mary's (NEC),10,4-6,92,102,194,0.474,04/04/2015,2015.0
39,Michigan (Big Ten),9,4-5,109,121,230,0.474,04/04/2015,2015.0
40,Robert Morris (NEC),10,1-9,119,133,252,0.472,04/04/2015,2015.0
41,Siena (MAAC),10,4-6,109,122,231,0.472,04/04/2015,2015.0
42,Towson (CAA),11,8-3,100,112,212,0.472,04/04/2015,2015.0
43,Marquette (Big East),11,9-2,119,134,253,0.470,04/04/2015,2015.0
44,St. John's (NY) (Big East),11,3-8,122,138,260,0.469,04/04/2015,2015.0
45,Georgetown (Big East),11,7-4,133,152,285,0.467,04/04/2015,2015.0
46,Massachusetts (CAA),10,3-7,112,131,243,0.461,04/04/2015,2015.0
47,Delaware (CAA),12,4-8,127,149,276,0.460,04/04/2015,2015.0
48,Princeton (Ivy League),9,6-3,108,127,235,0.460,04/04/2015,2015.0
49,Lehigh (Patriot),12,4-8,118,146,264,0.447,04/04/2015,2015.0
50,Virginia (ACC),11,8-3,131,164,295,0.444,04/04/2015,2015.0
51,Holy Cross (Patriot),10,5-5,106,133,239,0.444,04/04/2015,2015.0
52,NJIT (Independent),9,0-9,78,101,179,0.436,04/04/2015,2015.0
53,Villanova (Big East),10,5-5,94,125,219,0.429,04/04/2015,2015.0
54,VMI (SoCon),11,0-11,110,149,259,0.425,04/04/2015,2015.0
55,Richmond (SoCon),11,7-4,106,146,252,0.421,04/04/2015,2015.0
56,Detroit Mercy (MAAC),10,5-5,96,135,231,0.416,04/04/2015,2015.0
57,Wagner (NEC),9,4-5,68,96,164,0.415,04/04/2015,2015.0
58,Furman (SoCon),10,2-8,80,114,194,0.412,04/04/2015,2015.0
59,Harvard (Ivy League),10,5-5,124,178,302,0.411,04/04/2015,2015.0
60,UMBC (America East),10,4-6,84,121,205,0.410,04/04/2015,2015.0
61,Colgate (Patriot),10,6-4,92,134,226,0.407,04/04/2015,2015.0
62,Bucknell (Patriot),11,6-5,97,146,243,0.399,04/04/2015,2015.0
63,Hobart (NEC),9,6-3,77,118,195,0.395,04/04/2015,2015.0
64,Manhattan (MAAC),12,1-11,106,167,273,0.388,04/04/2015,2015.0
65,Monmouth (MAAC),10,5-5,62,102,164,0.378,04/04/2015,2015.0
66,Providence (Big East),10,4-6,81,134,215,0.377,04/04/2015,2015.0
67,Quinnipiac (MAAC),10,3-7,90,157,247,0.364,04/04/2015,2015.0
68,Lafayette (Patriot),10,2-8,82,157,239,0.343,04/04/2015,2015.0
69,UMass Lowell (America East),10,1-9,53,184,237,0.224,04/04/2015,2015.0
1,Denver (Big East),10,8-2,170,71,241,0.705,04/03/2015,2015.0
2,Syracuse (ACC),9,8-1,168,76,244,0.689,04/03/2015,2015.0
3,Rutgers (Big Ten),11,4-7,176,93,269,0.654,04/03/2015,2015.0
4,Hofstra (CAA),9,4-5,133,71,204,0.652,04/03/2015,2015.0
5,Boston U. (Patriot),9,6-3,145,78,223,0.650,04/03/2015,2015.0
6,Cornell (Ivy League),9,7-2,146,79,225,0.649,04/03/2015,2015.0
7,Navy (Patriot),10,7-3,139,78,217,0.641,04/03/2015,2015.0
8,Bryant (NEC),9,2-7,116,66,182,0.637,04/03/2015,2015.0
9,Ohio St. (Big Ten),11,8-3,138,83,221,0.624,04/03/2015,2015.0
10,Brown (Ivy League),9,8-1,164,100,264,0.621,04/03/2015,2015.0
11,High Point (SoCon),10,5-5,147,103,250,0.588,04/03/2015,2015.0
12,Maryland (Big Ten),9,8-1,99,71,170,0.582,04/03/2015,2015.0
13,Drexel (CAA),10,4-6,129,93,222,0.581,04/03/2015,2015.0
14,Loyola Maryland (Patriot),10,5-5,147,106,253,0.581,04/03/2015,2015.0
15,Army West Point (Patriot),10,7-3,126,94,220,0.573,04/03/2015,2015.0
16,Jacksonville (SoCon),8,4-4,115,91,206,0.558,04/03/2015,2015.0
17,Penn St. (Big Ten),9,3-6,114,91,205,0.556,04/03/2015,2015.0
18,Johns Hopkins (Big Ten),9,4-5,127,103,230,0.552,04/03/2015,2015.0
19,Stony Brook (America East),10,8-2,148,122,270,0.548,04/03/2015,2015.0
20,Sacred Heart (NEC),8,4-4,105,87,192,0.547,04/03/2015,2015.0
21,Fairfield (CAA),10,6-4,112,93,205,0.546,04/03/2015,2015.0
22,Hartford (America East),9,5-4,121,101,222,0.545,04/03/2015,2015.0
23,Duke (ACC),10,7-3,164,139,303,0.541,04/03/2015,2015.0
24,Marist (MAAC),9,6-3,113,97,210,0.538,04/03/2015,2015.0
25,Yale (Ivy League),9,7-2,114,98,212,0.538,04/03/2015,2015.0
26,Mercer (SoCon),8,3-5,103,92,195,0.528,04/03/2015,2015.0
27,Vermont (America East),11,3-8,171,157,328,0.521,04/03/2015,2015.0
28,Saint Joseph's (NEC),10,5-5,114,106,220,0.518,04/03/2015,2015.0
29,Dartmouth (Ivy League),7,3-4,88,84,172,0.512,04/03/2015,2015.0
30,Bellarmine (SoCon),8,3-5,93,90,183,0.508,04/03/2015,2015.0
31,Penn (Ivy League),9,3-6,113,114,227,0.498,04/03/2015,2015.0
32,North Carolina (ACC),12,11-1,162,165,327,0.495,04/03/2015,2015.0
33,Air Force (ECAC),10,5-5,106,108,214,0.495,04/03/2015,2015.0
34,UAlbany (America East),9,7-2,140,144,284,0.493,04/03/2015,2015.0
35,Georgetown (Big East),10,6-4,127,139,266,0.477,04/03/2015,2015.0
36,Canisius (MAAC),9,2-7,94,103,197,0.477,04/03/2015,2015.0
37,Notre Dame (ACC),7,6-1,83,91,174,0.477,04/03/2015,2015.0
38,Towson (CAA),10,7-3,90,99,189,0.476,04/03/2015,2015.0
39,Michigan (Big Ten),9,4-5,109,121,230,0.474,04/03/2015,2015.0
40,Siena (MAAC),10,4-6,109,122,231,0.472,04/03/2015,2015.0
40,St. John's (NY) (Big East),10,3-7,109,122,231,0.472,04/03/2015,2015.0
42,Mount St. Mary's (NEC),9,3-6,79,89,168,0.470,04/03/2015,2015.0
43,Massachusetts (CAA),9,3-6,102,118,220,0.464,04/03/2015,2015.0
44,Binghamton (America East),8,2-6,86,100,186,0.462,04/03/2015,2015.0
45,Marquette (Big East),10,8-2,103,121,224,0.460,04/03/2015,2015.0
46,Robert Morris (NEC),9,1-8,100,120,220,0.455,04/03/2015,2015.0
47,Princeton (Ivy League),8,6-2,94,114,208,0.452,04/03/2015,2015.0
48,Delaware (CAA),11,4-7,114,139,253,0.451,04/03/2015,2015.0
49,Virginia (ACC),11,8-3,131,164,295,0.444,04/03/2015,2015.0
50,Holy Cross (Patriot),10,5-5,106,133,239,0.444,04/03/2015,2015.0
51,NJIT (Independent),9,0-9,78,101,179,0.436,04/03/2015,2015.0
52,Lehigh (Patriot),11,4-7,105,136,241,0.436,04/03/2015,2015.0
53,Wagner (NEC),8,4-4,66,87,153,0.431,04/03/2015,2015.0
54,VMI (SoCon),10,0-10,101,134,235,0.430,04/03/2015,2015.0
55,Villanova (Big East),10,5-5,94,125,219,0.429,04/03/2015,2015.0
56,Furman (SoCon),9,2-7,77,104,181,0.425,04/03/2015,2015.0
57,Harvard (Ivy League),9,4-5,118,161,279,0.423,04/03/2015,2015.0
58,Hobart (NEC),8,5-3,72,101,173,0.416,04/03/2015,2015.0
59,Detroit Mercy (MAAC),9,5-4,87,125,212,0.410,04/03/2015,2015.0
60,Colgate (Patriot),9,5-4,82,121,203,0.404,04/03/2015,2015.0
61,Richmond (SoCon),10,6-4,96,143,239,0.402,04/03/2015,2015.0
62,Monmouth (MAAC),9,4-5,56,87,143,0.392,04/03/2015,2015.0
63,Bucknell (Patriot),10,6-4,84,133,217,0.387,04/03/2015,2015.0
64,UMBC (America East),9,4-5,71,113,184,0.386,04/03/2015,2015.0
65,Manhattan (MAAC),11,1-10,98,157,255,0.384,04/03/2015,2015.0
66,Quinnipiac (MAAC),9,2-7,80,149,229,0.349,04/03/2015,2015.0
67,Providence (Big East),9,4-5,68,128,196,0.347,04/03/2015,2015.0
68,Lafayette (Patriot),10,2-8,82,157,239,0.343,04/03/2015,2015.0
69,UMass Lowell (America East),9,1-8,50,166,216,0.231,04/03/2015,2015.0
1,Denver (Big East),9,7-2,154,64,218,0.706,04/02/2015,2015.0
2,Syracuse (ACC),9,8-1,168,76,244,0.689,04/02/2015,2015.0
3,Rutgers (Big Ten),11,4-7,176,93,269,0.654,04/02/2015,2015.0
4,Hofstra (CAA),9,4-5,133,71,204,0.652,04/02/2015,2015.0
5,Boston U. (Patriot),9,6-3,145,78,223,0.650,04/02/2015,2015.0
6,Cornell (Ivy League),9,7-2,146,79,225,0.649,04/02/2015,2015.0
7,Navy (Patriot),10,7-3,139,78,217,0.641,04/02/2015,2015.0
8,Bryant (NEC),9,2-7,116,66,182,0.637,04/02/2015,2015.0
9,Ohio St. (Big Ten),11,8-3,138,83,221,0.624,04/02/2015,2015.0
10,Brown (Ivy League),9,8-1,164,100,264,0.621,04/02/2015,2015.0
11,High Point (SoCon),10,5-5,147,103,250,0.588,04/02/2015,2015.0
12,Maryland (Big Ten),9,8-1,99,71,170,0.582,04/02/2015,2015.0
13,Drexel (CAA),10,4-6,129,93,222,0.581,04/02/2015,2015.0
14,Loyola Maryland (Patriot),10,5-5,147,106,253,0.581,04/02/2015,2015.0
15,Army West Point (Patriot),10,7-3,126,94,220,0.573,04/02/2015,2015.0
16,Jacksonville (SoCon),8,4-4,115,91,206,0.558,04/02/2015,2015.0
17,Penn St. (Big Ten),9,3-6,114,91,205,0.556,04/02/2015,2015.0
18,Johns Hopkins (Big Ten),9,4-5,127,103,230,0.552,04/02/2015,2015.0
19,Stony Brook (America East),10,8-2,148,122,270,0.548,04/02/2015,2015.0
20,Sacred Heart (NEC),8,4-4,105,87,192,0.547,04/02/2015,2015.0
21,Fairfield (CAA),10,6-4,112,93,205,0.546,04/02/2015,2015.0
22,Hartford (America East),9,5-4,121,101,222,0.545,04/02/2015,2015.0
23,Duke (ACC),10,7-3,164,139,303,0.541,04/02/2015,2015.0
24,Marist (MAAC),9,6-3,113,97,210,0.538,04/02/2015,2015.0
25,Yale (Ivy League),9,7-2,114,98,212,0.538,04/02/2015,2015.0
26,Mercer (SoCon),8,3-5,103,92,195,0.528,04/02/2015,2015.0
27,Vermont (America East),11,3-8,171,157,328,0.521,04/02/2015,2015.0
28,Saint Joseph's (NEC),10,5-5,114,106,220,0.518,04/02/2015,2015.0
29,Dartmouth (Ivy League),7,3-4,88,84,172,0.512,04/02/2015,2015.0
30,Bellarmine (SoCon),8,3-5,93,90,183,0.508,04/02/2015,2015.0
31,North Carolina (ACC),11,10-1,153,154,307,0.498,04/02/2015,2015.0
32,Penn (Ivy League),9,3-6,113,114,227,0.498,04/02/2015,2015.0
33,Air Force (ECAC),10,5-5,106,108,214,0.495,04/02/2015,2015.0
34,UAlbany (America East),9,7-2,140,144,284,0.493,04/02/2015,2015.0
35,Georgetown (Big East),10,6-4,127,139,266,0.477,04/02/2015,2015.0
36,Canisius (MAAC),9,2-7,94,103,197,0.477,04/02/2015,2015.0
37,Notre Dame (ACC),7,6-1,83,91,174,0.477,04/02/2015,2015.0
38,Towson (CAA),10,7-3,90,99,189,0.476,04/02/2015,2015.0
39,Michigan (Big Ten),9,4-5,109,121,230,0.474,04/02/2015,2015.0
40,Siena (MAAC),10,4-6,109,122,231,0.472,04/02/2015,2015.0
40,St. John's (NY) (Big East),10,3-7,109,122,231,0.472,04/02/2015,2015.0
42,Mount St. Mary's (NEC),9,3-6,79,89,168,0.470,04/02/2015,2015.0
43,Massachusetts (CAA),9,3-6,102,118,220,0.464,04/02/2015,2015.0
44,Binghamton (America East),8,2-6,86,100,186,0.462,04/02/2015,2015.0
45,Marquette (Big East),10,8-2,103,121,224,0.460,04/02/2015,2015.0
46,Robert Morris (NEC),9,1-8,100,120,220,0.455,04/02/2015,2015.0
47,Princeton (Ivy League),8,6-2,94,114,208,0.452,04/02/2015,2015.0
48,Delaware (CAA),11,4-7,114,139,253,0.451,04/02/2015,2015.0
49,Villanova (Big East),9,5-4,87,109,196,0.444,04/02/2015,2015.0
50,Holy Cross (Patriot),10,5-5,106,133,239,0.444,04/02/2015,2015.0
51,Virginia (ACC),10,8-2,120,155,275,0.436,04/02/2015,2015.0
52,NJIT (Independent),9,0-9,78,101,179,0.436,04/02/2015,2015.0
53,Lehigh (Patriot),11,4-7,105,136,241,0.436,04/02/2015,2015.0
54,Wagner (NEC),8,4-4,66,87,153,0.431,04/02/2015,2015.0
55,VMI (SoCon),10,0-10,101,134,235,0.430,04/02/2015,2015.0
56,Furman (SoCon),9,2-7,77,104,181,0.425,04/02/2015,2015.0
57,Harvard (Ivy League),9,4-5,118,161,279,0.423,04/02/2015,2015.0
58,Hobart (NEC),8,5-3,72,101,173,0.416,04/02/2015,2015.0
59,Detroit Mercy (MAAC),9,5-4,87,125,212,0.410,04/02/2015,2015.0
60,Colgate (Patriot),9,5-4,82,121,203,0.404,04/02/2015,2015.0
61,Richmond (SoCon),10,6-4,96,143,239,0.402,04/02/2015,2015.0
62,Monmouth (MAAC),9,4-5,56,87,143,0.392,04/02/2015,2015.0
63,Bucknell (Patriot),10,6-4,84,133,217,0.387,04/02/2015,2015.0
64,UMBC (America East),9,4-5,71,113,184,0.386,04/02/2015,2015.0
65,Manhattan (MAAC),11,1-10,98,157,255,0.384,04/02/2015,2015.0
66,Quinnipiac (MAAC),9,2-7,80,149,229,0.349,04/02/2015,2015.0
67,Providence (Big East),9,4-5,68,128,196,0.347,04/02/2015,2015.0
68,Lafayette (Patriot),10,2-8,82,157,239,0.343,04/02/2015,2015.0
69,UMass Lowell (America East),9,1-8,50,166,216,0.231,04/02/2015,2015.0
1,Denver (Big East),9,7-2,154,64,218,0.706,03/31/2015,2015.0
2,Syracuse (ACC),8,7-1,140,71,211,0.664,03/31/2015,2015.0
3,Rutgers (Big Ten),11,4-7,176,93,269,0.654,03/31/2015,2015.0
4,Hofstra (CAA),9,4-5,133,71,204,0.652,03/31/2015,2015.0
5,Boston U. (Patriot),9,6-3,145,78,223,0.650,03/31/2015,2015.0
6,Cornell (Ivy League),9,7-2,146,79,225,0.649,03/31/2015,2015.0
7,Navy (Patriot),10,7-3,139,78,217,0.641,03/31/2015,2015.0
8,Bryant (NEC),9,2-7,116,66,182,0.637,03/31/2015,2015.0
9,Ohio St. (Big Ten),11,8-3,138,83,221,0.624,03/31/2015,2015.0
10,Brown (Ivy League),9,8-1,164,100,264,0.621,03/31/2015,2015.0
11,High Point (SoCon),10,5-5,147,103,250,0.588,03/31/2015,2015.0
12,Maryland (Big Ten),9,8-1,99,71,170,0.582,03/31/2015,2015.0
13,Drexel (CAA),10,4-6,129,93,222,0.581,03/31/2015,2015.0
14,Loyola Maryland (Patriot),10,5-5,147,106,253,0.581,03/31/2015,2015.0
15,Army West Point (Patriot),10,7-3,126,94,220,0.573,03/31/2015,2015.0
16,Jacksonville (SoCon),8,4-4,115,91,206,0.558,03/31/2015,2015.0
17,Penn St. (Big Ten),9,3-6,114,91,205,0.556,03/31/2015,2015.0
18,Johns Hopkins (Big Ten),9,4-5,127,103,230,0.552,03/31/2015,2015.0
19,Stony Brook (America East),10,8-2,148,122,270,0.548,03/31/2015,2015.0
20,Sacred Heart (NEC),8,4-4,105,87,192,0.547,03/31/2015,2015.0
21,Fairfield (CAA),10,6-4,112,93,205,0.546,03/31/2015,2015.0
22,Hartford (America East),9,5-4,121,101,222,0.545,03/31/2015,2015.0
23,Duke (ACC),10,7-3,164,139,303,0.541,03/31/2015,2015.0
24,Marist (MAAC),9,6-3,113,97,210,0.538,03/31/2015,2015.0
25,UAlbany (America East),8,7-1,135,116,251,0.538,03/31/2015,2015.0
26,Yale (Ivy League),9,7-2,114,98,212,0.538,03/31/2015,2015.0
27,Mercer (SoCon),8,3-5,103,92,195,0.528,03/31/2015,2015.0
28,Vermont (America East),11,3-8,171,157,328,0.521,03/31/2015,2015.0
29,Saint Joseph's (NEC),10,5-5,114,106,220,0.518,03/31/2015,2015.0
30,Dartmouth (Ivy League),7,3-4,88,84,172,0.512,03/31/2015,2015.0
31,Bellarmine (SoCon),8,3-5,93,90,183,0.508,03/31/2015,2015.0
32,North Carolina (ACC),11,10-1,153,154,307,0.498,03/31/2015,2015.0
33,Penn (Ivy League),9,3-6,113,114,227,0.498,03/31/2015,2015.0
34,Air Force (ECAC),10,5-5,106,108,214,0.495,03/31/2015,2015.0
35,Georgetown (Big East),10,6-4,127,139,266,0.477,03/31/2015,2015.0
36,Canisius (MAAC),9,2-7,94,103,197,0.477,03/31/2015,2015.0
37,Notre Dame (ACC),7,6-1,83,91,174,0.477,03/31/2015,2015.0
38,Towson (CAA),10,7-3,90,99,189,0.476,03/31/2015,2015.0
39,Michigan (Big Ten),9,4-5,109,121,230,0.474,03/31/2015,2015.0
40,St. John's (NY) (Big East),10,3-7,109,122,231,0.472,03/31/2015,2015.0
40,Siena (MAAC),10,4-6,109,122,231,0.472,03/31/2015,2015.0
42,Mount St. Mary's (NEC),9,3-6,79,89,168,0.470,03/31/2015,2015.0
43,Massachusetts (CAA),9,3-6,102,118,220,0.464,03/31/2015,2015.0
44,Binghamton (America East),8,2-6,86,100,186,0.462,03/31/2015,2015.0
45,Marquette (Big East),10,8-2,103,121,224,0.460,03/31/2015,2015.0
46,Robert Morris (NEC),9,1-8,100,120,220,0.455,03/31/2015,2015.0
47,Princeton (Ivy League),8,6-2,94,114,208,0.452,03/31/2015,2015.0
48,Delaware (CAA),11,4-7,114,139,253,0.451,03/31/2015,2015.0
49,Villanova (Big East),9,5-4,87,109,196,0.444,03/31/2015,2015.0
50,Holy Cross (Patriot),10,5-5,106,133,239,0.444,03/31/2015,2015.0
51,Virginia (ACC),10,8-2,120,155,275,0.436,03/31/2015,2015.0
52,NJIT (Independent),9,0-9,78,101,179,0.436,03/31/2015,2015.0
53,Lehigh (Patriot),11,4-7,105,136,241,0.436,03/31/2015,2015.0
54,Wagner (NEC),8,4-4,66,87,153,0.431,03/31/2015,2015.0
55,VMI (SoCon),10,0-10,101,134,235,0.430,03/31/2015,2015.0
56,Furman (SoCon),9,2-7,77,104,181,0.425,03/31/2015,2015.0
57,Harvard (Ivy League),9,4-5,118,161,279,0.423,03/31/2015,2015.0
58,Hobart (NEC),8,5-3,72,101,173,0.416,03/31/2015,2015.0
59,Detroit Mercy (MAAC),9,5-4,87,125,212,0.410,03/31/2015,2015.0
60,Colgate (Patriot),9,5-4,82,121,203,0.404,03/31/2015,2015.0
61,Richmond (SoCon),10,6-4,96,143,239,0.402,03/31/2015,2015.0
62,Monmouth (MAAC),9,4-5,56,87,143,0.392,03/31/2015,2015.0
63,Bucknell (Patriot),10,6-4,84,133,217,0.387,03/31/2015,2015.0
64,UMBC (America East),9,4-5,71,113,184,0.386,03/31/2015,2015.0
65,Manhattan (MAAC),11,1-10,98,157,255,0.384,03/31/2015,2015.0
66,Quinnipiac (MAAC),9,2-7,80,149,229,0.349,03/31/2015,2015.0
67,Providence (Big East),9,4-5,68,128,196,0.347,03/31/2015,2015.0
68,Lafayette (Patriot),10,2-8,82,157,239,0.343,03/31/2015,2015.0
69,UMass Lowell (America East),9,1-8,50,166,216,0.231,03/31/2015,2015.0
1,Denver (Big East),9,7-2,154,64,218,0.706,03/29/2015,2015.0
2,Syracuse (ACC),8,7-1,140,71,211,0.664,03/29/2015,2015.0
3,Rutgers (Big Ten),11,4-7,176,93,269,0.654,03/29/2015,2015.0
4,Hofstra (CAA),9,4-5,133,71,204,0.652,03/29/2015,2015.0
5,Boston U. (Patriot),9,6-3,145,78,223,0.650,03/29/2015,2015.0
6,Cornell (Ivy League),9,7-2,146,79,225,0.649,03/29/2015,2015.0
7,Navy (Patriot),10,7-3,139,78,217,0.641,03/29/2015,2015.0
8,Bryant (NEC),9,2-7,116,66,182,0.637,03/29/2015,2015.0
9,Ohio St. (Big Ten),11,8-3,138,83,221,0.624,03/29/2015,2015.0
10,Brown (Ivy League),9,8-1,164,100,264,0.621,03/29/2015,2015.0
11,High Point (SoCon),10,5-5,147,103,250,0.588,03/29/2015,2015.0
12,Maryland (Big Ten),9,8-1,99,71,170,0.582,03/29/2015,2015.0
13,Drexel (CAA),10,4-6,129,93,222,0.581,03/29/2015,2015.0
14,Loyola Maryland (Patriot),10,5-5,147,106,253,0.581,03/29/2015,2015.0
15,Army West Point (Patriot),10,7-3,126,94,220,0.573,03/29/2015,2015.0
16,Yale (Ivy League),8,6-2,108,84,192,0.563,03/29/2015,2015.0
17,Jacksonville (SoCon),8,4-4,115,91,206,0.558,03/29/2015,2015.0
18,Penn St. (Big Ten),9,3-6,114,91,205,0.556,03/29/2015,2015.0
19,Hartford (America East),8,4-4,108,87,195,0.554,03/29/2015,2015.0
20,Johns Hopkins (Big Ten),9,4-5,127,103,230,0.552,03/29/2015,2015.0
21,Fairfield (CAA),10,6-4,112,93,205,0.546,03/29/2015,2015.0
22,Duke (ACC),10,7-3,164,139,303,0.541,03/29/2015,2015.0
23,Marist (MAAC),9,6-3,113,97,210,0.538,03/29/2015,2015.0
24,UAlbany (America East),8,7-1,135,116,251,0.538,03/29/2015,2015.0
25,Sacred Heart (NEC),7,4-3,91,81,172,0.529,03/29/2015,2015.0
26,Mercer (SoCon),8,3-5,103,92,195,0.528,03/29/2015,2015.0
27,Stony Brook (America East),9,7-2,126,115,241,0.523,03/29/2015,2015.0
28,Vermont (America East),11,3-8,171,157,328,0.521,03/29/2015,2015.0
29,Saint Joseph's (NEC),10,5-5,114,106,220,0.518,03/29/2015,2015.0
30,Dartmouth (Ivy League),7,3-4,88,84,172,0.512,03/29/2015,2015.0
31,North Carolina (ACC),11,10-1,153,154,307,0.498,03/29/2015,2015.0
32,Penn (Ivy League),9,3-6,113,114,227,0.498,03/29/2015,2015.0
33,Air Force (ECAC),10,5-5,106,108,214,0.495,03/29/2015,2015.0
34,Bellarmine (SoCon),7,2-5,81,86,167,0.485,03/29/2015,2015.0
35,Georgetown (Big East),10,6-4,127,139,266,0.477,03/29/2015,2015.0
36,Canisius (MAAC),9,2-7,94,103,197,0.477,03/29/2015,2015.0
37,Notre Dame (ACC),7,6-1,83,91,174,0.477,03/29/2015,2015.0
38,Towson (CAA),10,7-3,90,99,189,0.476,03/29/2015,2015.0
39,Marquette (Big East),9,8-1,99,109,208,0.476,03/29/2015,2015.0
40,Michigan (Big Ten),9,4-5,109,121,230,0.474,03/29/2015,2015.0
41,St. John's (NY) (Big East),10,3-7,109,122,231,0.472,03/29/2015,2015.0
42,Mount St. Mary's (NEC),9,3-6,79,89,168,0.470,03/29/2015,2015.0
43,Siena (MAAC),9,4-5,95,109,204,0.466,03/29/2015,2015.0
44,Massachusetts (CAA),9,3-6,102,118,220,0.464,03/29/2015,2015.0
45,Binghamton (America East),8,2-6,86,100,186,0.462,03/29/2015,2015.0
46,Robert Morris (NEC),9,1-8,100,120,220,0.455,03/29/2015,2015.0
47,Princeton (Ivy League),8,6-2,94,114,208,0.452,03/29/2015,2015.0
48,Delaware (CAA),11,4-7,114,139,253,0.451,03/29/2015,2015.0
49,Villanova (Big East),9,5-4,87,109,196,0.444,03/29/2015,2015.0
50,Holy Cross (Patriot),10,5-5,106,133,239,0.444,03/29/2015,2015.0
51,NJIT (Independent),8,0-8,72,91,163,0.442,03/29/2015,2015.0
52,Virginia (ACC),10,8-2,120,155,275,0.436,03/29/2015,2015.0
53,Lehigh (Patriot),11,4-7,105,136,241,0.436,03/29/2015,2015.0
54,Wagner (NEC),8,4-4,66,87,153,0.431,03/29/2015,2015.0
55,VMI (SoCon),10,0-10,101,134,235,0.430,03/29/2015,2015.0
56,Furman (SoCon),9,2-7,77,104,181,0.425,03/29/2015,2015.0
57,Harvard (Ivy League),9,4-5,118,161,279,0.423,03/29/2015,2015.0
58,Hobart (NEC),8,5-3,72,101,173,0.416,03/29/2015,2015.0
59,Detroit Mercy (MAAC),9,5-4,87,125,212,0.410,03/29/2015,2015.0
60,Colgate (Patriot),9,5-4,82,121,203,0.404,03/29/2015,2015.0
61,Richmond (SoCon),10,6-4,96,143,239,0.402,03/29/2015,2015.0
62,Bucknell (Patriot),10,6-4,84,133,217,0.387,03/29/2015,2015.0
63,UMBC (America East),9,4-5,71,113,184,0.386,03/29/2015,2015.0
64,Monmouth (MAAC),8,4-4,47,78,125,0.376,03/29/2015,2015.0
65,Manhattan (MAAC),10,0-10,88,151,239,0.368,03/29/2015,2015.0
66,Quinnipiac (MAAC),8,2-6,73,127,200,0.365,03/29/2015,2015.0
67,Providence (Big East),9,4-5,68,128,196,0.347,03/29/2015,2015.0
68,Lafayette (Patriot),9,1-8,73,148,221,0.330,03/29/2015,2015.0
69,UMass Lowell (America East),9,1-8,50,166,216,0.231,03/29/2015,2015.0
1,Denver (Big East),9,7-2,154,64,218,0.706,03/28/2015,2015.0
2,Syracuse (ACC),8,7-1,140,71,211,0.664,03/28/2015,2015.0
3,Rutgers (Big Ten),11,4-7,176,93,269,0.654,03/28/2015,2015.0
4,Hofstra (CAA),9,4-5,133,71,204,0.652,03/28/2015,2015.0
5,Boston U. (Patriot),9,6-3,145,78,223,0.650,03/28/2015,2015.0
6,Cornell (Ivy League),9,7-2,146,79,225,0.649,03/28/2015,2015.0
7,Ohio St. (Big Ten),10,7-3,128,71,199,0.643,03/28/2015,2015.0
8,Navy (Patriot),10,7-3,139,78,217,0.641,03/28/2015,2015.0
9,Brown (Ivy League),8,7-1,152,91,243,0.626,03/28/2015,2015.0
10,Bryant (NEC),8,2-6,102,62,164,0.622,03/28/2015,2015.0
11,High Point (SoCon),10,5-5,147,103,250,0.588,03/28/2015,2015.0
12,Drexel (CAA),10,4-6,129,93,222,0.581,03/28/2015,2015.0
13,Loyola Maryland (Patriot),10,5-5,147,106,253,0.581,03/28/2015,2015.0
14,Army West Point (Patriot),10,7-3,126,94,220,0.573,03/28/2015,2015.0
15,Duke (ACC),9,7-2,153,117,270,0.567,03/28/2015,2015.0
16,Maryland (Big Ten),8,7-1,84,65,149,0.564,03/28/2015,2015.0
17,Yale (Ivy League),8,6-2,108,84,192,0.563,03/28/2015,2015.0
18,Jacksonville (SoCon),8,4-4,115,91,206,0.558,03/28/2015,2015.0
19,Penn St. (Big Ten),8,3-5,102,81,183,0.557,03/28/2015,2015.0
20,Hartford (America East),8,4-4,108,87,195,0.554,03/28/2015,2015.0
21,Johns Hopkins (Big Ten),9,4-5,127,103,230,0.552,03/28/2015,2015.0
22,Fairfield (CAA),10,6-4,112,93,205,0.546,03/28/2015,2015.0
23,Saint Joseph's (NEC),9,4-5,110,92,202,0.545,03/28/2015,2015.0
24,Marist (MAAC),9,6-3,113,97,210,0.538,03/28/2015,2015.0
25,UAlbany (America East),8,7-1,135,116,251,0.538,03/28/2015,2015.0
26,Sacred Heart (NEC),7,4-3,91,81,172,0.529,03/28/2015,2015.0
27,Mercer (SoCon),8,3-5,103,92,195,0.528,03/28/2015,2015.0
28,Stony Brook (America East),9,7-2,126,115,241,0.523,03/28/2015,2015.0
29,Vermont (America East),11,3-8,171,157,328,0.521,03/28/2015,2015.0
30,Dartmouth (Ivy League),7,3-4,88,84,172,0.512,03/28/2015,2015.0
31,Penn (Ivy League),9,3-6,113,114,227,0.498,03/28/2015,2015.0
32,Air Force (ECAC),10,5-5,106,108,214,0.495,03/28/2015,2015.0
33,Michigan (Big Ten),8,4-4,103,106,209,0.493,03/28/2015,2015.0
34,Bellarmine (SoCon),7,2-5,81,86,167,0.485,03/28/2015,2015.0
35,North Carolina (ACC),10,9-1,131,143,274,0.478,03/28/2015,2015.0
36,Georgetown (Big East),10,6-4,127,139,266,0.477,03/28/2015,2015.0
37,Canisius (MAAC),9,2-7,94,103,197,0.477,03/28/2015,2015.0
38,Notre Dame (ACC),7,6-1,83,91,174,0.477,03/28/2015,2015.0
39,Towson (CAA),10,7-3,90,99,189,0.476,03/28/2015,2015.0
40,Marquette (Big East),9,8-1,99,109,208,0.476,03/28/2015,2015.0
41,St. John's (NY) (Big East),10,3-7,109,122,231,0.472,03/28/2015,2015.0
42,Mount St. Mary's (NEC),9,3-6,79,89,168,0.470,03/28/2015,2015.0
43,Siena (MAAC),9,4-5,95,109,204,0.466,03/28/2015,2015.0
44,Massachusetts (CAA),9,3-6,102,118,220,0.464,03/28/2015,2015.0
45,Binghamton (America East),8,2-6,86,100,186,0.462,03/28/2015,2015.0
46,Robert Morris (NEC),9,1-8,100,120,220,0.455,03/28/2015,2015.0
46,Princeton (Ivy League),7,6-1,85,102,187,0.455,03/28/2015,2015.0
48,Delaware (CAA),11,4-7,114,139,253,0.451,03/28/2015,2015.0
49,Villanova (Big East),9,5-4,87,109,196,0.444,03/28/2015,2015.0
50,Holy Cross (Patriot),10,5-5,106,133,239,0.444,03/28/2015,2015.0
51,NJIT (Independent),8,0-8,72,91,163,0.442,03/28/2015,2015.0
52,Virginia (ACC),10,8-2,120,155,275,0.436,03/28/2015,2015.0
53,Lehigh (Patriot),11,4-7,105,136,241,0.436,03/28/2015,2015.0
54,Wagner (NEC),8,4-4,66,87,153,0.431,03/28/2015,2015.0
55,VMI (SoCon),10,0-10,101,134,235,0.430,03/28/2015,2015.0
56,Furman (SoCon),9,2-7,77,104,181,0.425,03/28/2015,2015.0
57,Harvard (Ivy League),9,4-5,118,161,279,0.423,03/28/2015,2015.0
58,Hobart (NEC),8,5-3,72,101,173,0.416,03/28/2015,2015.0
59,Detroit Mercy (MAAC),9,5-4,87,125,212,0.410,03/28/2015,2015.0
60,Colgate (Patriot),9,5-4,82,121,203,0.404,03/28/2015,2015.0
61,Richmond (SoCon),10,6-4,96,143,239,0.402,03/28/2015,2015.0
62,Bucknell (Patriot),10,6-4,84,133,217,0.387,03/28/2015,2015.0
63,UMBC (America East),9,4-5,71,113,184,0.386,03/28/2015,2015.0
64,Monmouth (MAAC),8,4-4,47,78,125,0.376,03/28/2015,2015.0
65,Manhattan (MAAC),10,0-10,88,151,239,0.368,03/28/2015,2015.0
66,Quinnipiac (MAAC),8,2-6,73,127,200,0.365,03/28/2015,2015.0
67,Providence (Big East),9,4-5,68,128,196,0.347,03/28/2015,2015.0
68,Lafayette (Patriot),9,1-8,73,148,221,0.330,03/28/2015,2015.0
69,UMass Lowell (America East),9,1-8,50,166,216,0.231,03/28/2015,2015.0
1,Boston U. (Patriot),8,6-2,134,65,199,0.673,03/27/2015,2015.0
2,Syracuse (ACC),7,7-0,122,60,182,0.670,03/27/2015,2015.0
3,Denver (Big East),8,6-2,126,62,188,0.670,03/27/2015,2015.0
4,Rutgers (Big Ten),10,4-6,166,84,250,0.664,03/27/2015,2015.0
5,Cornell (Ivy League),8,6-2,140,71,211,0.664,03/27/2015,2015.0
6,Navy (Patriot),9,6-3,126,67,193,0.653,03/27/2015,2015.0
7,Ohio St. (Big Ten),10,7-3,128,71,199,0.643,03/27/2015,2015.0
8,Hofstra (CAA),8,3-5,118,69,187,0.631,03/27/2015,2015.0
9,Brown (Ivy League),8,7-1,152,91,243,0.626,03/27/2015,2015.0
10,Bryant (NEC),8,2-6,102,62,164,0.622,03/27/2015,2015.0
11,Yale (Ivy League),7,5-2,98,68,166,0.590,03/27/2015,2015.0
12,Jacksonville (SoCon),7,4-3,104,76,180,0.578,03/27/2015,2015.0
13,High Point (SoCon),9,4-5,135,99,234,0.577,03/27/2015,2015.0
14,Drexel (CAA),9,4-5,119,88,207,0.575,03/27/2015,2015.0
15,Loyola Maryland (Patriot),9,5-4,134,100,234,0.573,03/27/2015,2015.0
16,Hartford (America East),7,3-4,95,71,166,0.572,03/27/2015,2015.0
17,Duke (ACC),9,7-2,153,117,270,0.567,03/27/2015,2015.0
18,Army West Point (Patriot),9,6-3,113,87,200,0.565,03/27/2015,2015.0
19,Maryland (Big Ten),8,7-1,84,65,149,0.564,03/27/2015,2015.0
20,Fairfield (CAA),9,5-4,107,83,190,0.563,03/27/2015,2015.0
21,Johns Hopkins (Big Ten),8,3-5,118,93,211,0.559,03/27/2015,2015.0
22,Penn St. (Big Ten),8,3-5,102,81,183,0.557,03/27/2015,2015.0
23,Sacred Heart (NEC),6,4-2,85,71,156,0.545,03/27/2015,2015.0
24,Saint Joseph's (NEC),9,4-5,110,92,202,0.545,03/27/2015,2015.0
25,Mercer (SoCon),7,2-5,94,83,177,0.531,03/27/2015,2015.0
26,Georgetown (Big East),9,6-3,125,111,236,0.530,03/27/2015,2015.0
27,Vermont (America East),10,3-7,153,137,290,0.528,03/27/2015,2015.0
28,Stony Brook (America East),8,6-2,106,97,203,0.522,03/27/2015,2015.0
29,Dartmouth (Ivy League),6,3-3,80,78,158,0.506,03/27/2015,2015.0
30,UAlbany (America East),7,6-1,112,110,222,0.505,03/27/2015,2015.0
31,Marquette (Big East),8,7-1,93,94,187,0.497,03/27/2015,2015.0
32,Notre Dame (ACC),6,5-1,72,73,145,0.497,03/27/2015,2015.0
33,Michigan (Big Ten),8,4-4,103,106,209,0.493,03/27/2015,2015.0
34,Marist (MAAC),8,5-3,88,91,179,0.492,03/27/2015,2015.0
35,Air Force (ECAC),9,4-5,91,97,188,0.484,03/27/2015,2015.0
36,Bellarmine (SoCon),6,2-4,72,77,149,0.483,03/27/2015,2015.0
37,Penn (Ivy League),8,3-5,97,104,201,0.483,03/27/2015,2015.0
38,Canisius (MAAC),8,1-7,84,91,175,0.480,03/27/2015,2015.0
39,North Carolina (ACC),10,9-1,131,143,274,0.478,03/27/2015,2015.0
40,Towson (CAA),9,6-3,84,92,176,0.477,03/27/2015,2015.0
41,Delaware (CAA),10,4-6,112,124,236,0.475,03/27/2015,2015.0
42,Holy Cross (Patriot),9,5-4,97,113,210,0.462,03/27/2015,2015.0
43,Massachusetts (CAA),8,3-5,95,112,207,0.459,03/27/2015,2015.0
44,Siena (MAAC),8,4-4,83,99,182,0.456,03/27/2015,2015.0
45,Princeton (Ivy League),7,6-1,85,102,187,0.455,03/27/2015,2015.0
46,Mount St. Mary's (NEC),8,2-6,69,83,152,0.454,03/27/2015,2015.0
47,St. John's (NY) (Big East),9,2-7,92,113,205,0.449,03/27/2015,2015.0
48,NJIT (Independent),7,0-7,68,84,152,0.447,03/27/2015,2015.0
49,Binghamton (America East),7,2-5,70,87,157,0.446,03/27/2015,2015.0
50,Furman (SoCon),8,2-6,73,92,165,0.442,03/27/2015,2015.0
51,Robert Morris (NEC),8,1-7,90,114,204,0.441,03/27/2015,2015.0
52,VMI (SoCon),10,0-10,101,134,235,0.430,03/27/2015,2015.0
53,Harvard (Ivy League),9,4-5,118,161,279,0.423,03/27/2015,2015.0
54,Hobart (NEC),7,4-3,66,91,157,0.420,03/27/2015,2015.0
55,Richmond (SoCon),9,6-3,90,125,215,0.419,03/27/2015,2015.0
56,Wagner (NEC),7,3-4,59,83,142,0.415,03/27/2015,2015.0
57,Colgate (Patriot),8,4-4,76,108,184,0.413,03/27/2015,2015.0
58,Villanova (Big East),8,5-3,72,103,175,0.411,03/27/2015,2015.0
59,Virginia (ACC),9,7-2,102,149,251,0.406,03/27/2015,2015.0
60,Lehigh (Patriot),10,3-7,85,127,212,0.401,03/27/2015,2015.0
61,Quinnipiac (MAAC),7,2-5,67,102,169,0.396,03/27/2015,2015.0
62,Detroit Mercy (MAAC),8,4-4,75,115,190,0.395,03/27/2015,2015.0
63,Bucknell (Patriot),9,6-3,77,120,197,0.391,03/27/2015,2015.0
64,UMBC (America East),9,4-5,71,113,184,0.386,03/27/2015,2015.0
65,Monmouth (MAAC),8,4-4,47,78,125,0.376,03/27/2015,2015.0
66,Manhattan (MAAC),9,0-9,78,139,217,0.359,03/27/2015,2015.0
67,Providence (Big East),8,4-4,59,111,170,0.347,03/27/2015,2015.0
68,Lafayette (Patriot),9,1-8,73,148,221,0.330,03/27/2015,2015.0
69,UMass Lowell (America East),8,1-7,44,143,187,0.235,03/27/2015,2015.0
1,Boston U. (Patriot),8,6-2,134,65,199,0.673,03/25/2015,2015.0
2,Syracuse (ACC),7,7-0,122,60,182,0.670,03/25/2015,2015.0
3,Denver (Big East),8,6-2,126,62,188,0.670,03/25/2015,2015.0
4,Rutgers (Big Ten),10,4-6,166,84,250,0.664,03/25/2015,2015.0
5,Cornell (Ivy League),8,6-2,140,71,211,0.664,03/25/2015,2015.0
6,Navy (Patriot),9,6-3,126,67,193,0.653,03/25/2015,2015.0
7,Ohio St. (Big Ten),10,7-3,128,71,199,0.643,03/25/2015,2015.0
8,Hofstra (CAA),8,3-5,118,69,187,0.631,03/25/2015,2015.0
9,Brown (Ivy League),8,7-1,152,91,243,0.626,03/25/2015,2015.0
10,Bryant (NEC),8,2-6,102,62,164,0.622,03/25/2015,2015.0
11,Yale (Ivy League),7,5-2,98,68,166,0.590,03/25/2015,2015.0
12,Jacksonville (SoCon),7,4-3,104,76,180,0.578,03/25/2015,2015.0
13,High Point (SoCon),9,4-5,135,99,234,0.577,03/25/2015,2015.0
14,Drexel (CAA),9,4-5,119,88,207,0.575,03/25/2015,2015.0
15,Loyola Maryland (Patriot),9,5-4,134,100,234,0.573,03/25/2015,2015.0
16,Hartford (America East),7,3-4,95,71,166,0.572,03/25/2015,2015.0
17,Duke (ACC),9,7-2,153,117,270,0.567,03/25/2015,2015.0
18,Army West Point (Patriot),9,6-3,113,87,200,0.565,03/25/2015,2015.0
19,Maryland (Big Ten),8,7-1,84,65,149,0.564,03/25/2015,2015.0
20,Fairfield (CAA),9,5-4,107,83,190,0.563,03/25/2015,2015.0
21,Johns Hopkins (Big Ten),8,3-5,118,93,211,0.559,03/25/2015,2015.0
22,Penn St. (Big Ten),8,3-5,102,81,183,0.557,03/25/2015,2015.0
23,Sacred Heart (NEC),6,4-2,85,71,156,0.545,03/25/2015,2015.0
24,Saint Joseph's (NEC),9,4-5,110,92,202,0.545,03/25/2015,2015.0
25,Mercer (SoCon),7,2-5,94,83,177,0.531,03/25/2015,2015.0
26,Georgetown (Big East),9,6-3,125,111,236,0.530,03/25/2015,2015.0
27,Vermont (America East),10,3-7,153,137,290,0.528,03/25/2015,2015.0
28,Stony Brook (America East),8,6-2,106,97,203,0.522,03/25/2015,2015.0
29,Dartmouth (Ivy League),6,3-3,80,78,158,0.506,03/25/2015,2015.0
30,UAlbany (America East),7,6-1,112,110,222,0.505,03/25/2015,2015.0
31,Marquette (Big East),8,7-1,93,94,187,0.497,03/25/2015,2015.0
32,Notre Dame (ACC),6,5-1,72,73,145,0.497,03/25/2015,2015.0
33,Michigan (Big Ten),8,4-4,103,106,209,0.493,03/25/2015,2015.0
34,Marist (MAAC),8,5-3,88,91,179,0.492,03/25/2015,2015.0
35,Air Force (ECAC),9,4-5,91,97,188,0.484,03/25/2015,2015.0
36,Bellarmine (SoCon),6,2-4,72,77,149,0.483,03/25/2015,2015.0
37,Penn (Ivy League),8,3-5,97,104,201,0.483,03/25/2015,2015.0
38,Canisius (MAAC),8,1-7,84,91,175,0.480,03/25/2015,2015.0
39,North Carolina (ACC),10,9-1,131,143,274,0.478,03/25/2015,2015.0
40,Towson (CAA),9,6-3,84,92,176,0.477,03/25/2015,2015.0
41,Delaware (CAA),10,4-6,112,124,236,0.475,03/25/2015,2015.0
42,Holy Cross (Patriot),9,5-4,97,113,210,0.462,03/25/2015,2015.0
43,Massachusetts (CAA),8,3-5,95,112,207,0.459,03/25/2015,2015.0
44,Siena (MAAC),8,4-4,83,99,182,0.456,03/25/2015,2015.0
45,Princeton (Ivy League),7,6-1,85,102,187,0.455,03/25/2015,2015.0
46,Mount St. Mary's (NEC),8,2-6,69,83,152,0.454,03/25/2015,2015.0
47,St. John's (NY) (Big East),9,2-7,92,113,205,0.449,03/25/2015,2015.0
48,NJIT (Independent),7,0-7,68,84,152,0.447,03/25/2015,2015.0
49,Binghamton (America East),7,2-5,70,87,157,0.446,03/25/2015,2015.0
50,Furman (SoCon),8,2-6,73,92,165,0.442,03/25/2015,2015.0
51,Robert Morris (NEC),8,1-7,90,114,204,0.441,03/25/2015,2015.0
52,VMI (SoCon),10,0-10,101,134,235,0.430,03/25/2015,2015.0
53,Harvard (Ivy League),9,4-5,118,161,279,0.423,03/25/2015,2015.0
54,Hobart (NEC),7,4-3,66,91,157,0.420,03/25/2015,2015.0
55,Richmond (SoCon),9,6-3,90,125,215,0.419,03/25/2015,2015.0
56,Wagner (NEC),7,3-4,59,83,142,0.415,03/25/2015,2015.0
57,Colgate (Patriot),8,4-4,76,108,184,0.413,03/25/2015,2015.0
58,Villanova (Big East),8,5-3,72,103,175,0.411,03/25/2015,2015.0
59,Virginia (ACC),9,7-2,102,149,251,0.406,03/25/2015,2015.0
60,Lehigh (Patriot),10,3-7,85,127,212,0.401,03/25/2015,2015.0
61,Quinnipiac (MAAC),7,2-5,67,102,169,0.396,03/25/2015,2015.0
62,Detroit Mercy (MAAC),8,4-4,75,115,190,0.395,03/25/2015,2015.0
63,Bucknell (Patriot),9,6-3,77,120,197,0.391,03/25/2015,2015.0
64,Monmouth (MAAC),8,4-4,47,78,125,0.376,03/25/2015,2015.0
65,Manhattan (MAAC),9,0-9,78,139,217,0.359,03/25/2015,2015.0
66,Providence (Big East),8,4-4,59,111,170,0.347,03/25/2015,2015.0
67,UMBC (America East),8,3-5,54,102,156,0.346,03/25/2015,2015.0
68,Lafayette (Patriot),8,1-7,62,131,193,0.321,03/25/2015,2015.0
69,UMass Lowell (America East),8,1-7,44,143,187,0.235,03/25/2015,2015.0
1,Boston U. (Patriot),8,6-2,134,65,199,0.673,03/24/2015,2015.0
2,Syracuse (ACC),7,7-0,122,60,182,0.670,03/24/2015,2015.0
3,Denver (Big East),8,6-2,126,62,188,0.670,03/24/2015,2015.0
4,Rutgers (Big Ten),10,4-6,166,84,250,0.664,03/24/2015,2015.0
5,Cornell (Ivy League),8,6-2,140,71,211,0.664,03/24/2015,2015.0
6,Navy (Patriot),9,6-3,126,67,193,0.653,03/24/2015,2015.0
7,Ohio St. (Big Ten),10,7-3,128,71,199,0.643,03/24/2015,2015.0
8,Hofstra (CAA),8,3-5,118,69,187,0.631,03/24/2015,2015.0
9,Brown (Ivy League),8,7-1,152,91,243,0.626,03/24/2015,2015.0
10,Bryant (NEC),8,2-6,102,62,164,0.622,03/24/2015,2015.0
11,Yale (Ivy League),7,5-2,98,68,166,0.590,03/24/2015,2015.0
12,Jacksonville (SoCon),7,4-3,104,76,180,0.578,03/24/2015,2015.0
13,High Point (SoCon),9,4-5,135,99,234,0.577,03/24/2015,2015.0
14,Drexel (CAA),9,4-5,119,88,207,0.575,03/24/2015,2015.0
15,Loyola Maryland (Patriot),9,5-4,134,100,234,0.573,03/24/2015,2015.0
16,Hartford (America East),7,3-4,95,71,166,0.572,03/24/2015,2015.0
17,Duke (ACC),9,7-2,153,117,270,0.567,03/24/2015,2015.0
18,Army West Point (Patriot),9,6-3,113,87,200,0.565,03/24/2015,2015.0
19,Maryland (Big Ten),8,7-1,84,65,149,0.564,03/24/2015,2015.0
20,Fairfield (CAA),9,5-4,107,83,190,0.563,03/24/2015,2015.0
21,Johns Hopkins (Big Ten),8,3-5,118,93,211,0.559,03/24/2015,2015.0
22,Penn St. (Big Ten),8,3-5,102,81,183,0.557,03/24/2015,2015.0
23,Sacred Heart (NEC),6,4-2,85,71,156,0.545,03/24/2015,2015.0
24,Saint Joseph's (NEC),9,4-5,110,92,202,0.545,03/24/2015,2015.0
25,Mercer (SoCon),7,2-5,94,83,177,0.531,03/24/2015,2015.0
26,Georgetown (Big East),9,6-3,125,111,236,0.530,03/24/2015,2015.0
27,Vermont (America East),10,3-7,153,137,290,0.528,03/24/2015,2015.0
28,Stony Brook (America East),8,6-2,106,97,203,0.522,03/24/2015,2015.0
29,Dartmouth (Ivy League),6,3-3,80,78,158,0.506,03/24/2015,2015.0
30,Marquette (Big East),8,7-1,93,94,187,0.497,03/24/2015,2015.0
31,Notre Dame (ACC),6,5-1,72,73,145,0.497,03/24/2015,2015.0
32,Michigan (Big Ten),8,4-4,103,106,209,0.493,03/24/2015,2015.0
33,Marist (MAAC),8,5-3,88,91,179,0.492,03/24/2015,2015.0
34,UAlbany (America East),6,5-1,88,92,180,0.489,03/24/2015,2015.0
35,Air Force (ECAC),9,4-5,91,97,188,0.484,03/24/2015,2015.0
36,Bellarmine (SoCon),6,2-4,72,77,149,0.483,03/24/2015,2015.0
37,Penn (Ivy League),8,3-5,97,104,201,0.483,03/24/2015,2015.0
38,Canisius (MAAC),8,1-7,84,91,175,0.480,03/24/2015,2015.0
39,North Carolina (ACC),10,9-1,131,143,274,0.478,03/24/2015,2015.0
40,Towson (CAA),9,6-3,84,92,176,0.477,03/24/2015,2015.0
41,Delaware (CAA),10,4-6,112,124,236,0.475,03/24/2015,2015.0
42,Holy Cross (Patriot),9,5-4,97,113,210,0.462,03/24/2015,2015.0
43,Massachusetts (CAA),8,3-5,95,112,207,0.459,03/24/2015,2015.0
44,Siena (MAAC),8,4-4,83,99,182,0.456,03/24/2015,2015.0
45,Princeton (Ivy League),7,6-1,85,102,187,0.455,03/24/2015,2015.0
46,Mount St. Mary's (NEC),8,2-6,69,83,152,0.454,03/24/2015,2015.0
47,St. John's (NY) (Big East),9,2-7,92,113,205,0.449,03/24/2015,2015.0
48,NJIT (Independent),7,0-7,68,84,152,0.447,03/24/2015,2015.0
49,Binghamton (America East),7,2-5,70,87,157,0.446,03/24/2015,2015.0
50,Furman (SoCon),8,2-6,73,92,165,0.442,03/24/2015,2015.0
51,Robert Morris (NEC),8,1-7,90,114,204,0.441,03/24/2015,2015.0
52,VMI (SoCon),10,0-10,101,134,235,0.430,03/24/2015,2015.0
53,Harvard (Ivy League),8,4-4,100,137,237,0.422,03/24/2015,2015.0
54,Hobart (NEC),7,4-3,66,91,157,0.420,03/24/2015,2015.0
55,Richmond (SoCon),9,6-3,90,125,215,0.419,03/24/2015,2015.0
56,Wagner (NEC),7,3-4,59,83,142,0.415,03/24/2015,2015.0
57,Colgate (Patriot),8,4-4,76,108,184,0.413,03/24/2015,2015.0
58,Villanova (Big East),8,5-3,72,103,175,0.411,03/24/2015,2015.0
59,Virginia (ACC),9,7-2,102,149,251,0.406,03/24/2015,2015.0
60,Lehigh (Patriot),10,3-7,85,127,212,0.401,03/24/2015,2015.0
61,Quinnipiac (MAAC),7,2-5,67,102,169,0.396,03/24/2015,2015.0
62,Detroit Mercy (MAAC),8,4-4,75,115,190,0.395,03/24/2015,2015.0
63,Bucknell (Patriot),9,6-3,77,120,197,0.391,03/24/2015,2015.0
64,Monmouth (MAAC),8,4-4,47,78,125,0.376,03/24/2015,2015.0
65,Manhattan (MAAC),9,0-9,78,139,217,0.359,03/24/2015,2015.0
66,Providence (Big East),8,4-4,59,111,170,0.347,03/24/2015,2015.0
67,UMBC (America East),8,3-5,54,102,156,0.346,03/24/2015,2015.0
68,Lafayette (Patriot),8,1-7,62,131,193,0.321,03/24/2015,2015.0
69,UMass Lowell (America East),8,1-7,44,143,187,0.235,03/24/2015,2015.0
1,Boston U. (Patriot),8,6-2,134,65,199,0.673,03/23/2015,2015.0
2,Syracuse (ACC),7,7-0,122,60,182,0.670,03/23/2015,2015.0
3,Denver (Big East),8,6-2,126,62,188,0.670,03/23/2015,2015.0
4,Rutgers (Big Ten),10,4-6,166,84,250,0.664,03/23/2015,2015.0
5,Cornell (Ivy League),8,6-2,140,71,211,0.664,03/23/2015,2015.0
6,Navy (Patriot),9,6-3,126,67,193,0.653,03/23/2015,2015.0
7,Ohio St. (Big Ten),10,7-3,128,71,199,0.643,03/23/2015,2015.0
8,Hofstra (CAA),8,3-5,118,69,187,0.631,03/23/2015,2015.0
9,Brown (Ivy League),7,6-1,131,77,208,0.630,03/23/2015,2015.0
10,Bryant (NEC),7,1-6,89,59,148,0.601,03/23/2015,2015.0
11,Yale (Ivy League),7,5-2,98,68,166,0.590,03/23/2015,2015.0
12,Jacksonville (SoCon),7,4-3,104,76,180,0.578,03/23/2015,2015.0
13,High Point (SoCon),9,4-5,135,99,234,0.577,03/23/2015,2015.0
14,Drexel (CAA),8,3-5,109,80,189,0.577,03/23/2015,2015.0
15,Loyola Maryland (Patriot),9,5-4,134,100,234,0.573,03/23/2015,2015.0
16,Hartford (America East),7,3-4,95,71,166,0.572,03/23/2015,2015.0
17,Duke (ACC),9,7-2,153,117,270,0.567,03/23/2015,2015.0
18,Maryland (Big Ten),7,6-1,73,56,129,0.566,03/23/2015,2015.0
19,Army West Point (Patriot),9,6-3,113,87,200,0.565,03/23/2015,2015.0
20,Fairfield (CAA),9,5-4,107,83,190,0.563,03/23/2015,2015.0
21,Johns Hopkins (Big Ten),8,3-5,118,93,211,0.559,03/23/2015,2015.0
22,Penn St. (Big Ten),8,3-5,102,81,183,0.557,03/23/2015,2015.0
23,Sacred Heart (NEC),6,4-2,85,71,156,0.545,03/23/2015,2015.0
24,Saint Joseph's (NEC),9,4-5,110,92,202,0.545,03/23/2015,2015.0
25,Vermont (America East),9,3-6,138,117,255,0.541,03/23/2015,2015.0
26,Mercer (SoCon),7,2-5,94,83,177,0.531,03/23/2015,2015.0
27,Georgetown (Big East),9,6-3,125,111,236,0.530,03/23/2015,2015.0
28,Stony Brook (America East),8,6-2,106,97,203,0.522,03/23/2015,2015.0
29,Marist (MAAC),7,5-2,74,70,144,0.514,03/23/2015,2015.0
30,Marquette (Big East),8,7-1,93,94,187,0.497,03/23/2015,2015.0
31,Notre Dame (ACC),6,5-1,72,73,145,0.497,03/23/2015,2015.0
32,Michigan (Big Ten),8,4-4,103,106,209,0.493,03/23/2015,2015.0
33,UAlbany (America East),6,5-1,88,92,180,0.489,03/23/2015,2015.0
34,Dartmouth (Ivy League),5,2-3,60,63,123,0.488,03/23/2015,2015.0
35,Air Force (ECAC),9,4-5,91,97,188,0.484,03/23/2015,2015.0
36,Bellarmine (SoCon),6,2-4,72,77,149,0.483,03/23/2015,2015.0
37,Penn (Ivy League),8,3-5,97,104,201,0.483,03/23/2015,2015.0
38,Canisius (MAAC),8,1-7,84,91,175,0.480,03/23/2015,2015.0
39,North Carolina (ACC),10,9-1,131,143,274,0.478,03/23/2015,2015.0
40,Towson (CAA),9,6-3,84,92,176,0.477,03/23/2015,2015.0
41,Delaware (CAA),10,4-6,112,124,236,0.475,03/23/2015,2015.0
42,Holy Cross (Patriot),9,5-4,97,113,210,0.462,03/23/2015,2015.0
43,Massachusetts (CAA),8,3-5,95,112,207,0.459,03/23/2015,2015.0
44,Siena (MAAC),8,4-4,83,99,182,0.456,03/23/2015,2015.0
45,Princeton (Ivy League),7,6-1,85,102,187,0.455,03/23/2015,2015.0
46,Mount St. Mary's (NEC),7,2-5,59,72,131,0.450,03/23/2015,2015.0
47,St. John's (NY) (Big East),9,2-7,92,113,205,0.449,03/23/2015,2015.0
48,NJIT (Independent),7,0-7,68,84,152,0.447,03/23/2015,2015.0
49,Binghamton (America East),6,2-4,62,77,139,0.446,03/23/2015,2015.0
50,Furman (SoCon),8,2-6,73,92,165,0.442,03/23/2015,2015.0
51,Robert Morris (NEC),7,1-6,81,103,184,0.440,03/23/2015,2015.0
52,VMI (SoCon),9,0-9,91,120,211,0.431,03/23/2015,2015.0
53,Harvard (Ivy League),8,4-4,100,137,237,0.422,03/23/2015,2015.0
54,Hobart (NEC),7,4-3,66,91,157,0.420,03/23/2015,2015.0
55,Richmond (SoCon),9,6-3,90,125,215,0.419,03/23/2015,2015.0
56,Wagner (NEC),7,3-4,59,83,142,0.415,03/23/2015,2015.0
57,Colgate (Patriot),8,4-4,76,108,184,0.413,03/23/2015,2015.0
58,Villanova (Big East),8,5-3,72,103,175,0.411,03/23/2015,2015.0
59,Quinnipiac (MAAC),7,2-5,67,102,169,0.396,03/23/2015,2015.0
60,Detroit Mercy (MAAC),8,4-4,75,115,190,0.395,03/23/2015,2015.0
61,Bucknell (Patriot),9,6-3,77,120,197,0.391,03/23/2015,2015.0
62,Virginia (ACC),8,6-2,88,139,227,0.388,03/23/2015,2015.0
63,Lehigh (Patriot),9,2-7,72,115,187,0.385,03/23/2015,2015.0
64,Providence (Big East),7,4-3,56,98,154,0.364,03/23/2015,2015.0
65,Manhattan (MAAC),9,0-9,78,139,217,0.359,03/23/2015,2015.0
66,Monmouth (MAAC),7,4-3,35,65,100,0.350,03/23/2015,2015.0
67,Lafayette (Patriot),8,1-7,62,131,193,0.321,03/23/2015,2015.0
68,UMBC (America East),7,2-5,43,92,135,0.319,03/23/2015,2015.0
69,UMass Lowell (America East),8,1-7,44,143,187,0.235,03/23/2015,2015.0
1,Boston U. (Patriot),8,6-2,134,65,199,0.673,03/22/2015,2015.0
2,Syracuse (ACC),7,7-0,122,60,182,0.670,03/22/2015,2015.0
3,Denver (Big East),8,6-2,126,62,188,0.670,03/22/2015,2015.0
4,Rutgers (Big Ten),10,4-6,166,84,250,0.664,03/22/2015,2015.0
5,Cornell (Ivy League),8,6-2,140,71,211,0.664,03/22/2015,2015.0
6,Navy (Patriot),9,6-3,126,67,193,0.653,03/22/2015,2015.0
7,Ohio St. (Big Ten),10,7-3,128,71,199,0.643,03/22/2015,2015.0
8,Hofstra (CAA),8,3-5,118,69,187,0.631,03/22/2015,2015.0
9,Brown (Ivy League),7,6-1,131,77,208,0.630,03/22/2015,2015.0
10,Bryant (NEC),7,1-6,89,59,148,0.601,03/22/2015,2015.0
11,Yale (Ivy League),7,5-2,98,68,166,0.590,03/22/2015,2015.0
12,Jacksonville (SoCon),7,4-3,104,76,180,0.578,03/22/2015,2015.0
13,High Point (SoCon),9,4-5,135,99,234,0.577,03/22/2015,2015.0
14,Drexel (CAA),8,3-5,109,80,189,0.577,03/22/2015,2015.0
15,Loyola Maryland (Patriot),9,5-4,134,100,234,0.573,03/22/2015,2015.0
16,Hartford (America East),7,3-4,95,71,166,0.572,03/22/2015,2015.0
17,Duke (ACC),9,7-2,153,117,270,0.567,03/22/2015,2015.0
18,Maryland (Big Ten),7,6-1,73,56,129,0.566,03/22/2015,2015.0
19,Army West Point (Patriot),9,6-3,113,87,200,0.565,03/22/2015,2015.0
20,Fairfield (CAA),9,5-4,107,83,190,0.563,03/22/2015,2015.0
21,Johns Hopkins (Big Ten),8,3-5,118,93,211,0.559,03/22/2015,2015.0
22,Penn St. (Big Ten),8,3-5,102,81,183,0.557,03/22/2015,2015.0
23,Sacred Heart (NEC),6,4-2,85,71,156,0.545,03/22/2015,2015.0
24,Saint Joseph's (NEC),9,4-5,110,92,202,0.545,03/22/2015,2015.0
25,Vermont (America East),9,3-6,138,117,255,0.541,03/22/2015,2015.0
26,Mercer (SoCon),7,2-5,94,83,177,0.531,03/22/2015,2015.0
27,Georgetown (Big East),9,6-3,125,111,236,0.530,03/22/2015,2015.0
28,Stony Brook (America East),8,6-2,106,97,203,0.522,03/22/2015,2015.0
29,Marist (MAAC),7,5-2,74,70,144,0.514,03/22/2015,2015.0
30,Marquette (Big East),8,7-1,93,94,187,0.497,03/22/2015,2015.0
31,Notre Dame (ACC),6,5-1,72,73,145,0.497,03/22/2015,2015.0
32,Michigan (Big Ten),8,4-4,103,106,209,0.493,03/22/2015,2015.0
33,UAlbany (America East),6,5-1,88,92,180,0.489,03/22/2015,2015.0
34,Dartmouth (Ivy League),5,2-3,60,63,123,0.488,03/22/2015,2015.0
35,Air Force (ECAC),9,4-5,91,97,188,0.484,03/22/2015,2015.0
36,Bellarmine (SoCon),6,2-4,72,77,149,0.483,03/22/2015,2015.0
37,Penn (Ivy League),8,3-5,97,104,201,0.483,03/22/2015,2015.0
38,Canisius (MAAC),8,1-7,84,91,175,0.480,03/22/2015,2015.0
39,North Carolina (ACC),10,9-1,131,143,274,0.478,03/22/2015,2015.0
40,Towson (CAA),9,6-3,84,92,176,0.477,03/22/2015,2015.0
41,Delaware (CAA),10,4-6,112,124,236,0.475,03/22/2015,2015.0
42,NJIT (Independent),6,0-6,59,67,126,0.468,03/22/2015,2015.0
43,Holy Cross (Patriot),9,5-4,97,113,210,0.462,03/22/2015,2015.0
44,Massachusetts (CAA),8,3-5,95,112,207,0.459,03/22/2015,2015.0
45,Siena (MAAC),8,4-4,83,99,182,0.456,03/22/2015,2015.0
46,Princeton (Ivy League),7,6-1,85,102,187,0.455,03/22/2015,2015.0
47,Mount St. Mary's (NEC),7,2-5,59,72,131,0.450,03/22/2015,2015.0
48,St. John's (NY) (Big East),9,2-7,92,113,205,0.449,03/22/2015,2015.0
49,Binghamton (America East),6,2-4,62,77,139,0.446,03/22/2015,2015.0
50,Furman (SoCon),8,2-6,73,92,165,0.442,03/22/2015,2015.0
51,Robert Morris (NEC),7,1-6,81,103,184,0.440,03/22/2015,2015.0
52,VMI (SoCon),9,0-9,91,120,211,0.431,03/22/2015,2015.0
53,Harvard (Ivy League),8,4-4,100,137,237,0.422,03/22/2015,2015.0
54,Hobart (NEC),7,4-3,66,91,157,0.420,03/22/2015,2015.0
55,Wagner (NEC),7,3-4,59,83,142,0.415,03/22/2015,2015.0
56,Colgate (Patriot),8,4-4,76,108,184,0.413,03/22/2015,2015.0
57,Villanova (Big East),8,5-3,72,103,175,0.411,03/22/2015,2015.0
58,Quinnipiac (MAAC),7,2-5,67,102,169,0.396,03/22/2015,2015.0
59,Detroit Mercy (MAAC),8,4-4,75,115,190,0.395,03/22/2015,2015.0
60,Bucknell (Patriot),9,6-3,77,120,197,0.391,03/22/2015,2015.0
61,Virginia (ACC),8,6-2,88,139,227,0.388,03/22/2015,2015.0
62,Richmond (SoCon),8,5-3,73,116,189,0.386,03/22/2015,2015.0
63,Lehigh (Patriot),9,2-7,72,115,187,0.385,03/22/2015,2015.0
64,Providence (Big East),7,4-3,56,98,154,0.364,03/22/2015,2015.0
65,Manhattan (MAAC),9,0-9,78,139,217,0.359,03/22/2015,2015.0
66,Monmouth (MAAC),7,4-3,35,65,100,0.350,03/22/2015,2015.0
67,Lafayette (Patriot),8,1-7,62,131,193,0.321,03/22/2015,2015.0
68,UMBC (America East),7,2-5,43,92,135,0.319,03/22/2015,2015.0
69,UMass Lowell (America East),8,1-7,44,143,187,0.235,03/22/2015,2015.0
1,Syracuse (ACC),6,6-0,105,48,153,0.686,03/21/2015,2015.0
2,Boston U. (Patriot),8,6-2,134,65,199,0.673,03/21/2015,2015.0
3,Denver (Big East),8,6-2,126,62,188,0.670,03/21/2015,2015.0
4,Rutgers (Big Ten),10,4-6,166,84,250,0.664,03/21/2015,2015.0
5,Cornell (Ivy League),8,6-2,140,71,211,0.664,03/21/2015,2015.0
6,Navy (Patriot),9,6-3,126,67,193,0.653,03/21/2015,2015.0
7,Ohio St. (Big Ten),10,7-3,128,71,199,0.643,03/21/2015,2015.0
8,Hofstra (CAA),8,3-5,118,69,187,0.631,03/21/2015,2015.0
9,Brown (Ivy League),7,6-1,131,77,208,0.630,03/21/2015,2015.0
10,Bryant (NEC),7,1-6,89,59,148,0.601,03/21/2015,2015.0
11,Yale (Ivy League),7,5-2,98,68,166,0.590,03/21/2015,2015.0
12,Duke (ACC),8,7-1,141,100,241,0.585,03/21/2015,2015.0
13,Jacksonville (SoCon),7,4-3,104,76,180,0.578,03/21/2015,2015.0
14,High Point (SoCon),9,4-5,135,99,234,0.577,03/21/2015,2015.0
15,Drexel (CAA),8,3-5,109,80,189,0.577,03/21/2015,2015.0
16,Loyola Maryland (Patriot),9,5-4,134,100,234,0.573,03/21/2015,2015.0
17,Hartford (America East),7,3-4,95,71,166,0.572,03/21/2015,2015.0
18,Maryland (Big Ten),7,6-1,73,56,129,0.566,03/21/2015,2015.0
19,Army West Point (Patriot),9,6-3,113,87,200,0.565,03/21/2015,2015.0
20,Fairfield (CAA),9,5-4,107,83,190,0.563,03/21/2015,2015.0
21,Johns Hopkins (Big Ten),8,3-5,118,93,211,0.559,03/21/2015,2015.0
22,Penn St. (Big Ten),8,3-5,102,81,183,0.557,03/21/2015,2015.0
23,Sacred Heart (NEC),6,4-2,85,71,156,0.545,03/21/2015,2015.0
24,Saint Joseph's (NEC),9,4-5,110,92,202,0.545,03/21/2015,2015.0
25,Vermont (America East),9,3-6,138,117,255,0.541,03/21/2015,2015.0
26,Mercer (SoCon),7,2-5,94,83,177,0.531,03/21/2015,2015.0
27,Georgetown (Big East),9,6-3,125,111,236,0.530,03/21/2015,2015.0
28,Marist (MAAC),7,5-2,74,70,144,0.514,03/21/2015,2015.0
29,Marquette (Big East),8,7-1,93,94,187,0.497,03/21/2015,2015.0
30,Notre Dame (ACC),6,5-1,72,73,145,0.497,03/21/2015,2015.0
31,Michigan (Big Ten),8,4-4,103,106,209,0.493,03/21/2015,2015.0
32,Stony Brook (America East),7,5-2,89,92,181,0.492,03/21/2015,2015.0
33,UAlbany (America East),6,5-1,88,92,180,0.489,03/21/2015,2015.0
34,Dartmouth (Ivy League),5,2-3,60,63,123,0.488,03/21/2015,2015.0
35,Air Force (ECAC),9,4-5,91,97,188,0.484,03/21/2015,2015.0
36,Bellarmine (SoCon),6,2-4,72,77,149,0.483,03/21/2015,2015.0
37,Penn (Ivy League),8,3-5,97,104,201,0.483,03/21/2015,2015.0
38,Canisius (MAAC),8,1-7,84,91,175,0.480,03/21/2015,2015.0
39,North Carolina (ACC),10,9-1,131,143,274,0.478,03/21/2015,2015.0
40,Towson (CAA),9,6-3,84,92,176,0.477,03/21/2015,2015.0
41,Delaware (CAA),10,4-6,112,124,236,0.475,03/21/2015,2015.0
42,NJIT (Independent),6,0-6,59,67,126,0.468,03/21/2015,2015.0
43,Holy Cross (Patriot),9,5-4,97,113,210,0.462,03/21/2015,2015.0
44,Massachusetts (CAA),8,3-5,95,112,207,0.459,03/21/2015,2015.0
45,Siena (MAAC),8,4-4,83,99,182,0.456,03/21/2015,2015.0
46,Princeton (Ivy League),7,6-1,85,102,187,0.455,03/21/2015,2015.0
47,Mount St. Mary's (NEC),7,2-5,59,72,131,0.450,03/21/2015,2015.0
48,St. John's (NY) (Big East),9,2-7,92,113,205,0.449,03/21/2015,2015.0
49,Binghamton (America East),6,2-4,62,77,139,0.446,03/21/2015,2015.0
50,Furman (SoCon),8,2-6,73,92,165,0.442,03/21/2015,2015.0
51,Robert Morris (NEC),7,1-6,81,103,184,0.440,03/21/2015,2015.0
52,VMI (SoCon),9,0-9,91,120,211,0.431,03/21/2015,2015.0
53,Harvard (Ivy League),8,4-4,100,137,237,0.422,03/21/2015,2015.0
54,Hobart (NEC),7,4-3,66,91,157,0.420,03/21/2015,2015.0
55,Wagner (NEC),7,3-4,59,83,142,0.415,03/21/2015,2015.0
56,Colgate (Patriot),8,4-4,76,108,184,0.413,03/21/2015,2015.0
57,Villanova (Big East),8,5-3,72,103,175,0.411,03/21/2015,2015.0
58,Quinnipiac (MAAC),7,2-5,67,102,169,0.396,03/21/2015,2015.0
59,Detroit Mercy (MAAC),8,4-4,75,115,190,0.395,03/21/2015,2015.0
60,Bucknell (Patriot),9,6-3,77,120,197,0.391,03/21/2015,2015.0
61,Virginia (ACC),8,6-2,88,139,227,0.388,03/21/2015,2015.0
62,Richmond (SoCon),8,5-3,73,116,189,0.386,03/21/2015,2015.0
63,Lehigh (Patriot),9,2-7,72,115,187,0.385,03/21/2015,2015.0
64,Providence (Big East),7,4-3,56,98,154,0.364,03/21/2015,2015.0
65,Manhattan (MAAC),9,0-9,78,139,217,0.359,03/21/2015,2015.0
66,Monmouth (MAAC),7,4-3,35,65,100,0.350,03/21/2015,2015.0
67,UMBC (America East),6,2-4,38,75,113,0.336,03/21/2015,2015.0
68,Lafayette (Patriot),8,1-7,62,131,193,0.321,03/21/2015,2015.0
69,UMass Lowell (America East),8,1-7,44,143,187,0.235,03/21/2015,2015.0
1,Syracuse (ACC),6,6-0,105,48,153,0.686,03/20/2015,2015.0
2,Denver (Big East),7,5-2,112,54,166,0.675,03/20/2015,2015.0
3,Cornell (Ivy League),7,5-2,126,63,189,0.667,03/20/2015,2015.0
4,Rutgers (Big Ten),10,4-6,166,84,250,0.664,03/20/2015,2015.0
5,Navy (Patriot),8,5-3,115,61,176,0.653,03/20/2015,2015.0
6,Boston U. (Patriot),7,5-2,114,62,176,0.648,03/20/2015,2015.0
7,Ohio St. (Big Ten),9,7-2,119,67,186,0.640,03/20/2015,2015.0
8,Hofstra (CAA),7,3-4,108,61,169,0.639,03/20/2015,2015.0
9,Brown (Ivy League),6,5-1,108,66,174,0.621,03/20/2015,2015.0
10,Bryant (NEC),6,1-5,80,52,132,0.606,03/20/2015,2015.0
11,Hartford (America East),6,3-3,80,53,133,0.602,03/20/2015,2015.0
12,Drexel (CAA),7,2-5,99,70,169,0.586,03/20/2015,2015.0
13,Duke (ACC),8,7-1,141,100,241,0.585,03/20/2015,2015.0
14,Penn St. (Big Ten),7,3-4,94,67,161,0.584,03/20/2015,2015.0
15,Fairfield (CAA),8,4-4,100,72,172,0.581,03/20/2015,2015.0
16,Yale (Ivy League),6,5-1,81,61,142,0.570,03/20/2015,2015.0
17,Sacred Heart (NEC),5,3-2,74,56,130,0.569,03/20/2015,2015.0
18,High Point (SoCon),8,3-5,120,91,211,0.569,03/20/2015,2015.0
19,Army West Point (Patriot),8,5-3,102,82,184,0.554,03/20/2015,2015.0
20,Jacksonville (SoCon),6,4-2,84,68,152,0.553,03/20/2015,2015.0
21,Loyola Maryland (Patriot),8,4-4,111,91,202,0.550,03/20/2015,2015.0
22,Marist (MAAC),6,4-2,68,56,124,0.548,03/20/2015,2015.0
23,Maryland (Big Ten),6,5-1,58,49,107,0.542,03/20/2015,2015.0
24,Johns Hopkins (Big Ten),7,3-4,94,84,178,0.528,03/20/2015,2015.0
25,Georgetown (Big East),8,5-3,112,101,213,0.526,03/20/2015,2015.0
26,Saint Joseph's (NEC),8,3-5,93,85,178,0.522,03/20/2015,2015.0
27,Vermont (America East),8,2-6,115,108,223,0.516,03/20/2015,2015.0
28,Notre Dame (ACC),5,4-1,68,64,132,0.515,03/20/2015,2015.0
29,Mercer (SoCon),6,1-5,77,75,152,0.507,03/20/2015,2015.0
30,Marquette (Big East),7,7-0,83,81,164,0.506,03/20/2015,2015.0
31,Air Force (ECAC),8,4-4,83,82,165,0.503,03/20/2015,2015.0
32,Penn (Ivy League),7,3-4,89,90,179,0.497,03/20/2015,2015.0
33,Delaware (CAA),9,4-5,105,107,212,0.495,03/20/2015,2015.0
34,North Carolina (ACC),9,9-0,124,128,252,0.492,03/20/2015,2015.0
34,Michigan (Big Ten),7,4-3,93,96,189,0.492,03/20/2015,2015.0
36,Stony Brook (America East),7,5-2,89,92,181,0.492,03/20/2015,2015.0
37,Princeton (Ivy League),6,5-1,78,85,163,0.479,03/20/2015,2015.0
38,UAlbany (America East),5,4-1,70,77,147,0.476,03/20/2015,2015.0
39,Holy Cross (Patriot),8,4-4,87,97,184,0.473,03/20/2015,2015.0
40,Bellarmine (SoCon),5,1-4,57,64,121,0.471,03/20/2015,2015.0
41,NJIT (Independent),6,0-6,59,67,126,0.468,03/20/2015,2015.0
42,Towson (CAA),8,5-3,72,83,155,0.465,03/20/2015,2015.0
43,Furman (SoCon),7,2-5,65,75,140,0.464,03/20/2015,2015.0
44,Massachusetts (CAA),7,2-5,87,102,189,0.460,03/20/2015,2015.0
45,Mount St. Mary's (NEC),6,2-4,53,63,116,0.457,03/20/2015,2015.0
46,Siena (MAAC),7,4-3,77,93,170,0.453,03/20/2015,2015.0
47,Harvard (Ivy League),7,4-3,95,115,210,0.452,03/20/2015,2015.0
48,Canisius (MAAC),7,1-6,70,85,155,0.452,03/20/2015,2015.0
49,Binghamton (America East),5,2-3,53,65,118,0.449,03/20/2015,2015.0
50,VMI (SoCon),8,0-8,78,105,183,0.426,03/20/2015,2015.0
51,Bucknell (Patriot),8,6-2,74,100,174,0.425,03/20/2015,2015.0
52,St. John's (NY) (Big East),8,2-6,76,103,179,0.425,03/20/2015,2015.0
53,Colgate (Patriot),7,4-3,70,97,167,0.419,03/20/2015,2015.0
54,Hobart (NEC),6,3-3,59,82,141,0.418,03/20/2015,2015.0
55,Robert Morris (NEC),6,1-5,66,92,158,0.418,03/20/2015,2015.0
56,Virginia (ACC),7,5-2,79,115,194,0.407,03/20/2015,2015.0
57,Richmond (SoCon),7,4-3,65,96,161,0.404,03/20/2015,2015.0
58,Dartmouth (Ivy League),4,1-3,38,58,96,0.396,03/20/2015,2015.0
59,Wagner (NEC),6,2-4,50,77,127,0.394,03/20/2015,2015.0
60,Lehigh (Patriot),8,2-6,67,104,171,0.392,03/20/2015,2015.0
61,Detroit Mercy (MAAC),7,4-3,63,99,162,0.389,03/20/2015,2015.0
62,Villanova (Big East),7,5-2,61,96,157,0.389,03/20/2015,2015.0
63,Manhattan (MAAC),8,0-8,67,116,183,0.366,03/20/2015,2015.0
64,Providence (Big East),7,4-3,56,98,154,0.364,03/20/2015,2015.0
65,Quinnipiac (MAAC),6,1-5,51,90,141,0.362,03/20/2015,2015.0
66,UMBC (America East),6,2-4,38,75,113,0.336,03/20/2015,2015.0
67,Monmouth (MAAC),6,3-3,29,59,88,0.330,03/20/2015,2015.0
68,Lafayette (Patriot),7,1-6,53,108,161,0.329,03/20/2015,2015.0
69,UMass Lowell (America East),7,1-6,35,120,155,0.226,03/20/2015,2015.0
1,Syracuse (ACC),6,6-0,105,48,153,0.686,03/18/2015,2015.0
2,Denver (Big East),7,5-2,112,54,166,0.675,03/18/2015,2015.0
3,Rutgers (Big Ten),9,3-6,150,74,224,0.670,03/18/2015,2015.0
4,Cornell (Ivy League),7,5-2,126,63,189,0.667,03/18/2015,2015.0
5,Navy (Patriot),8,5-3,115,61,176,0.653,03/18/2015,2015.0
6,Boston U. (Patriot),7,5-2,114,62,176,0.648,03/18/2015,2015.0
7,Ohio St. (Big Ten),9,7-2,119,67,186,0.640,03/18/2015,2015.0
8,Hofstra (CAA),7,3-4,108,61,169,0.639,03/18/2015,2015.0
9,Brown (Ivy League),6,5-1,108,66,174,0.621,03/18/2015,2015.0
10,Bryant (NEC),6,1-5,80,52,132,0.606,03/18/2015,2015.0
11,Hartford (America East),6,3-3,80,53,133,0.602,03/18/2015,2015.0
12,Drexel (CAA),7,2-5,99,70,169,0.586,03/18/2015,2015.0
13,Duke (ACC),8,7-1,141,100,241,0.585,03/18/2015,2015.0
14,Penn St. (Big Ten),7,3-4,94,67,161,0.584,03/18/2015,2015.0
15,Fairfield (CAA),8,4-4,100,72,172,0.581,03/18/2015,2015.0
16,Yale (Ivy League),6,5-1,81,61,142,0.570,03/18/2015,2015.0
17,Sacred Heart (NEC),5,3-2,74,56,130,0.569,03/18/2015,2015.0
18,High Point (SoCon),8,3-5,120,91,211,0.569,03/18/2015,2015.0
19,Army West Point (Patriot),8,5-3,102,82,184,0.554,03/18/2015,2015.0
20,Jacksonville (SoCon),6,4-2,84,68,152,0.553,03/18/2015,2015.0
21,Loyola Maryland (Patriot),8,4-4,111,91,202,0.550,03/18/2015,2015.0
22,Marist (MAAC),6,4-2,68,56,124,0.548,03/18/2015,2015.0
23,Maryland (Big Ten),6,5-1,58,49,107,0.542,03/18/2015,2015.0
24,Johns Hopkins (Big Ten),7,3-4,94,84,178,0.528,03/18/2015,2015.0
25,Georgetown (Big East),8,5-3,112,101,213,0.526,03/18/2015,2015.0
26,Saint Joseph's (NEC),8,3-5,93,85,178,0.522,03/18/2015,2015.0
27,Vermont (America East),8,2-6,115,108,223,0.516,03/18/2015,2015.0
28,Notre Dame (ACC),5,4-1,68,64,132,0.515,03/18/2015,2015.0
29,Mercer (SoCon),6,1-5,77,75,152,0.507,03/18/2015,2015.0
30,Marquette (Big East),7,7-0,83,81,164,0.506,03/18/2015,2015.0
31,Air Force (ECAC),8,4-4,83,82,165,0.503,03/18/2015,2015.0
32,Penn (Ivy League),7,3-4,89,90,179,0.497,03/18/2015,2015.0
33,Delaware (CAA),9,4-5,105,107,212,0.495,03/18/2015,2015.0
34,North Carolina (ACC),9,9-0,124,128,252,0.492,03/18/2015,2015.0
34,Michigan (Big Ten),7,4-3,93,96,189,0.492,03/18/2015,2015.0
36,Stony Brook (America East),7,5-2,89,92,181,0.492,03/18/2015,2015.0
37,NJIT (Independent),5,0-5,49,51,100,0.490,03/18/2015,2015.0
38,Princeton (Ivy League),6,5-1,78,85,163,0.479,03/18/2015,2015.0
39,UAlbany (America East),5,4-1,70,77,147,0.476,03/18/2015,2015.0
40,Holy Cross (Patriot),8,4-4,87,97,184,0.473,03/18/2015,2015.0
41,Bellarmine (SoCon),5,1-4,57,64,121,0.471,03/18/2015,2015.0
42,Towson (CAA),8,5-3,72,83,155,0.465,03/18/2015,2015.0
43,Furman (SoCon),7,2-5,65,75,140,0.464,03/18/2015,2015.0
44,Massachusetts (CAA),7,2-5,87,102,189,0.460,03/18/2015,2015.0
45,Mount St. Mary's (NEC),6,2-4,53,63,116,0.457,03/18/2015,2015.0
46,Siena (MAAC),7,4-3,77,93,170,0.453,03/18/2015,2015.0
47,Harvard (Ivy League),7,4-3,95,115,210,0.452,03/18/2015,2015.0
48,Canisius (MAAC),7,1-6,70,85,155,0.452,03/18/2015,2015.0
49,Binghamton (America East),5,2-3,53,65,118,0.449,03/18/2015,2015.0
50,VMI (SoCon),8,0-8,78,105,183,0.426,03/18/2015,2015.0
51,Bucknell (Patriot),8,6-2,74,100,174,0.425,03/18/2015,2015.0
52,St. John's (NY) (Big East),8,2-6,76,103,179,0.425,03/18/2015,2015.0
53,Colgate (Patriot),7,4-3,70,97,167,0.419,03/18/2015,2015.0
54,Hobart (NEC),6,3-3,59,82,141,0.418,03/18/2015,2015.0
55,Robert Morris (NEC),6,1-5,66,92,158,0.418,03/18/2015,2015.0
56,Virginia (ACC),7,5-2,79,115,194,0.407,03/18/2015,2015.0
57,Richmond (SoCon),7,4-3,65,96,161,0.404,03/18/2015,2015.0
58,Dartmouth (Ivy League),4,1-3,38,58,96,0.396,03/18/2015,2015.0
59,Wagner (NEC),6,2-4,50,77,127,0.394,03/18/2015,2015.0
60,Lehigh (Patriot),8,2-6,67,104,171,0.392,03/18/2015,2015.0
61,Detroit Mercy (MAAC),7,4-3,63,99,162,0.389,03/18/2015,2015.0
62,Villanova (Big East),7,5-2,61,96,157,0.389,03/18/2015,2015.0
63,Manhattan (MAAC),8,0-8,67,116,183,0.366,03/18/2015,2015.0
64,Providence (Big East),7,4-3,56,98,154,0.364,03/18/2015,2015.0
65,Quinnipiac (MAAC),6,1-5,51,90,141,0.362,03/18/2015,2015.0
66,UMBC (America East),6,2-4,38,75,113,0.336,03/18/2015,2015.0
67,Monmouth (MAAC),6,3-3,29,59,88,0.330,03/18/2015,2015.0
68,Lafayette (Patriot),7,1-6,53,108,161,0.329,03/18/2015,2015.0
69,UMass Lowell (America East),7,1-6,35,120,155,0.226,03/18/2015,2015.0
1,Syracuse (ACC),6,6-0,105,48,153,0.686,03/17/2015,2015.0
2,Denver (Big East),7,5-2,112,54,166,0.675,03/17/2015,2015.0
3,Rutgers (Big Ten),9,3-6,150,74,224,0.670,03/17/2015,2015.0
4,Cornell (Ivy League),7,5-2,126,63,189,0.667,03/17/2015,2015.0
5,Navy (Patriot),8,5-3,115,61,176,0.653,03/17/2015,2015.0
6,Boston U. (Patriot),7,5-2,114,62,176,0.648,03/17/2015,2015.0
7,Ohio St. (Big Ten),9,7-2,119,67,186,0.640,03/17/2015,2015.0
8,Hofstra (CAA),7,3-4,108,61,169,0.639,03/17/2015,2015.0
9,Brown (Ivy League),6,5-1,108,66,174,0.621,03/17/2015,2015.0
10,Bryant (NEC),6,1-5,80,52,132,0.606,03/17/2015,2015.0
11,Hartford (America East),6,3-3,80,53,133,0.602,03/17/2015,2015.0
12,Drexel (CAA),7,2-5,99,70,169,0.586,03/17/2015,2015.0
13,Duke (ACC),8,7-1,141,100,241,0.585,03/17/2015,2015.0
14,Penn St. (Big Ten),7,3-4,94,67,161,0.584,03/17/2015,2015.0
15,Fairfield (CAA),8,4-4,100,72,172,0.581,03/17/2015,2015.0
16,Yale (Ivy League),6,5-1,81,61,142,0.570,03/17/2015,2015.0
17,Sacred Heart (NEC),5,3-2,74,56,130,0.569,03/17/2015,2015.0
18,High Point (SoCon),8,3-5,120,91,211,0.569,03/17/2015,2015.0
19,Loyola Maryland (Patriot),7,4-3,98,76,174,0.563,03/17/2015,2015.0
20,Army West Point (Patriot),8,5-3,102,82,184,0.554,03/17/2015,2015.0
21,Jacksonville (SoCon),6,4-2,84,68,152,0.553,03/17/2015,2015.0
22,Marist (MAAC),6,4-2,68,56,124,0.548,03/17/2015,2015.0
23,Maryland (Big Ten),6,5-1,58,49,107,0.542,03/17/2015,2015.0
24,Johns Hopkins (Big Ten),7,3-4,94,84,178,0.528,03/17/2015,2015.0
25,Georgetown (Big East),7,4-3,97,88,185,0.524,03/17/2015,2015.0
26,Saint Joseph's (NEC),8,3-5,93,85,178,0.522,03/17/2015,2015.0
27,Vermont (America East),8,2-6,115,108,223,0.516,03/17/2015,2015.0
28,Notre Dame (ACC),5,4-1,68,64,132,0.515,03/17/2015,2015.0
29,Mercer (SoCon),6,1-5,77,75,152,0.507,03/17/2015,2015.0
30,Marquette (Big East),7,7-0,83,81,164,0.506,03/17/2015,2015.0
31,Air Force (ECAC),8,4-4,83,82,165,0.503,03/17/2015,2015.0
32,Penn (Ivy League),7,3-4,89,90,179,0.497,03/17/2015,2015.0
33,North Carolina (ACC),9,9-0,124,128,252,0.492,03/17/2015,2015.0
33,Michigan (Big Ten),7,4-3,93,96,189,0.492,03/17/2015,2015.0
35,Stony Brook (America East),7,5-2,89,92,181,0.492,03/17/2015,2015.0
36,NJIT (Independent),5,0-5,49,51,100,0.490,03/17/2015,2015.0
37,Delaware (CAA),8,3-5,93,98,191,0.487,03/17/2015,2015.0
38,Princeton (Ivy League),6,5-1,78,85,163,0.479,03/17/2015,2015.0
39,UAlbany (America East),5,4-1,70,77,147,0.476,03/17/2015,2015.0
40,Holy Cross (Patriot),8,4-4,87,97,184,0.473,03/17/2015,2015.0
41,Bellarmine (SoCon),5,1-4,57,64,121,0.471,03/17/2015,2015.0
42,Towson (CAA),8,5-3,72,83,155,0.465,03/17/2015,2015.0
43,Furman (SoCon),7,2-5,65,75,140,0.464,03/17/2015,2015.0
44,Massachusetts (CAA),7,2-5,87,102,189,0.460,03/17/2015,2015.0
45,Mount St. Mary's (NEC),6,2-4,53,63,116,0.457,03/17/2015,2015.0
46,Siena (MAAC),7,4-3,77,93,170,0.453,03/17/2015,2015.0
47,Harvard (Ivy League),7,4-3,95,115,210,0.452,03/17/2015,2015.0
48,Canisius (MAAC),7,1-6,70,85,155,0.452,03/17/2015,2015.0
49,Binghamton (America East),5,2-3,53,65,118,0.449,03/17/2015,2015.0
50,VMI (SoCon),8,0-8,78,105,183,0.426,03/17/2015,2015.0
51,Bucknell (Patriot),8,6-2,74,100,174,0.425,03/17/2015,2015.0
52,St. John's (NY) (Big East),8,2-6,76,103,179,0.425,03/17/2015,2015.0
53,Colgate (Patriot),7,4-3,70,97,167,0.419,03/17/2015,2015.0
54,Hobart (NEC),6,3-3,59,82,141,0.418,03/17/2015,2015.0
55,Robert Morris (NEC),6,1-5,66,92,158,0.418,03/17/2015,2015.0
56,Virginia (ACC),7,5-2,79,115,194,0.407,03/17/2015,2015.0
57,Richmond (SoCon),7,4-3,65,96,161,0.404,03/17/2015,2015.0
58,Dartmouth (Ivy League),4,1-3,38,58,96,0.396,03/17/2015,2015.0
59,Wagner (NEC),6,2-4,50,77,127,0.394,03/17/2015,2015.0
60,Lehigh (Patriot),8,2-6,67,104,171,0.392,03/17/2015,2015.0
61,Detroit Mercy (MAAC),7,4-3,63,99,162,0.389,03/17/2015,2015.0
62,Villanova (Big East),7,5-2,61,96,157,0.389,03/17/2015,2015.0
63,Providence (Big East),7,4-3,56,98,154,0.364,03/17/2015,2015.0
64,Quinnipiac (MAAC),6,1-5,51,90,141,0.362,03/17/2015,2015.0
65,Manhattan (MAAC),7,0-7,58,104,162,0.358,03/17/2015,2015.0
66,UMBC (America East),6,2-4,38,75,113,0.336,03/17/2015,2015.0
67,Monmouth (MAAC),6,3-3,29,59,88,0.330,03/17/2015,2015.0
68,Lafayette (Patriot),7,1-6,53,108,161,0.329,03/17/2015,2015.0
69,UMass Lowell (America East),7,1-6,35,120,155,0.226,03/17/2015,2015.0
1,Syracuse (ACC),6,6-0,105,48,153,0.686,03/14/2015,2015.0
2,Denver (Big East),6,4-2,100,49,149,0.671,03/14/2015,2015.0
3,Rutgers (Big Ten),8,3-5,131,66,197,0.665,03/14/2015,2015.0
4,Cornell (Ivy League),6,4-2,110,56,166,0.663,03/14/2015,2015.0
5,Navy (Patriot),8,5-3,115,61,176,0.653,03/14/2015,2015.0
6,Boston U. (Patriot),7,5-2,114,62,176,0.648,03/14/2015,2015.0
7,Hartford (America East),5,3-2,75,41,116,0.647,03/14/2015,2015.0
8,Ohio St. (Big Ten),8,6-2,109,61,170,0.641,03/14/2015,2015.0
9,Hofstra (CAA),6,2-4,94,54,148,0.635,03/14/2015,2015.0
10,Brown (Ivy League),5,5-0,93,58,151,0.616,03/14/2015,2015.0
11,Bryant (NEC),6,1-5,80,52,132,0.606,03/14/2015,2015.0
12,Drexel (CAA),7,2-5,99,70,169,0.586,03/14/2015,2015.0
13,Duke (ACC),8,7-1,141,100,241,0.585,03/14/2015,2015.0
14,Penn St. (Big Ten),7,3-4,94,67,161,0.584,03/14/2015,2015.0
15,Yale (Ivy League),6,5-1,81,61,142,0.570,03/14/2015,2015.0
16,High Point (SoCon),8,3-5,120,91,211,0.569,03/14/2015,2015.0
17,Loyola Maryland (Patriot),7,4-3,98,76,174,0.563,03/14/2015,2015.0
18,Fairfield (CAA),7,3-4,86,68,154,0.558,03/14/2015,2015.0
19,Army West Point (Patriot),8,5-3,102,82,184,0.554,03/14/2015,2015.0
20,Jacksonville (SoCon),6,4-2,84,68,152,0.553,03/14/2015,2015.0
21,Maryland (Big Ten),6,5-1,58,49,107,0.542,03/14/2015,2015.0
22,Johns Hopkins (Big Ten),7,3-4,94,84,178,0.528,03/14/2015,2015.0
23,Georgetown (Big East),7,4-3,97,88,185,0.524,03/14/2015,2015.0
24,Marist (MAAC),5,3-2,56,51,107,0.523,03/14/2015,2015.0
25,Saint Joseph's (NEC),8,3-5,93,85,178,0.522,03/14/2015,2015.0
26,Vermont (America East),8,2-6,115,108,223,0.516,03/14/2015,2015.0
27,Notre Dame (ACC),5,4-1,68,64,132,0.515,03/14/2015,2015.0
28,Princeton (Ivy League),5,4-1,70,66,136,0.515,03/14/2015,2015.0
29,Mercer (SoCon),6,1-5,77,75,152,0.507,03/14/2015,2015.0
30,Marquette (Big East),7,7-0,83,81,164,0.506,03/14/2015,2015.0
31,Sacred Heart (NEC),4,2-2,52,51,103,0.505,03/14/2015,2015.0
32,Air Force (ECAC),8,4-4,83,82,165,0.503,03/14/2015,2015.0
33,Penn (Ivy League),7,3-4,89,90,179,0.497,03/14/2015,2015.0
34,North Carolina (ACC),8,8-0,111,114,225,0.493,03/14/2015,2015.0
35,Michigan (Big Ten),7,4-3,93,96,189,0.492,03/14/2015,2015.0
36,Stony Brook (America East),6,5-1,71,74,145,0.490,03/14/2015,2015.0
37,Delaware (CAA),8,3-5,93,98,191,0.487,03/14/2015,2015.0
38,NJIT (Independent),4,0-4,43,47,90,0.478,03/14/2015,2015.0
39,Towson (CAA),7,5-2,66,73,139,0.475,03/14/2015,2015.0
40,Bellarmine (SoCon),5,1-4,57,64,121,0.471,03/14/2015,2015.0
41,Furman (SoCon),7,2-5,65,75,140,0.464,03/14/2015,2015.0
42,Massachusetts (CAA),7,2-5,87,102,189,0.460,03/14/2015,2015.0
43,Canisius (MAAC),6,1-5,56,66,122,0.459,03/14/2015,2015.0
44,Mount St. Mary's (NEC),6,2-4,53,63,116,0.457,03/14/2015,2015.0
45,Siena (MAAC),7,4-3,77,93,170,0.453,03/14/2015,2015.0
46,Binghamton (America East),5,2-3,53,65,118,0.449,03/14/2015,2015.0
47,Holy Cross (Patriot),7,3-4,75,92,167,0.449,03/14/2015,2015.0
48,Harvard (Ivy League),6,4-2,81,102,183,0.443,03/14/2015,2015.0
49,Colgate (Patriot),6,4-2,63,81,144,0.438,03/14/2015,2015.0
50,Bucknell (Patriot),7,5-2,66,85,151,0.437,03/14/2015,2015.0
51,St. John's (NY) (Big East),7,2-5,69,89,158,0.437,03/14/2015,2015.0
52,UAlbany (America East),3,2-1,33,45,78,0.423,03/14/2015,2015.0
53,Hobart (NEC),6,3-3,59,82,141,0.418,03/14/2015,2015.0
54,Robert Morris (NEC),6,1-5,66,92,158,0.418,03/14/2015,2015.0
55,VMI (SoCon),7,0-7,66,96,162,0.407,03/14/2015,2015.0
56,Virginia (ACC),7,5-2,79,115,194,0.407,03/14/2015,2015.0
57,Richmond (SoCon),7,4-3,65,96,161,0.404,03/14/2015,2015.0
58,Lehigh (Patriot),7,2-5,62,92,154,0.403,03/14/2015,2015.0
59,Dartmouth (Ivy League),4,1-3,38,58,96,0.396,03/14/2015,2015.0
60,Detroit Mercy (MAAC),7,4-3,63,99,162,0.389,03/14/2015,2015.0
61,Villanova (Big East),7,5-2,61,96,157,0.389,03/14/2015,2015.0
62,Wagner (NEC),5,1-4,41,65,106,0.387,03/14/2015,2015.0
63,Providence (Big East),7,4-3,56,98,154,0.364,03/14/2015,2015.0
64,Quinnipiac (MAAC),6,1-5,51,90,141,0.362,03/14/2015,2015.0
65,Lafayette (Patriot),6,1-5,48,86,134,0.358,03/14/2015,2015.0
66,Manhattan (MAAC),7,0-7,58,104,162,0.358,03/14/2015,2015.0
67,UMBC (America East),6,2-4,38,75,113,0.336,03/14/2015,2015.0
68,Monmouth (MAAC),4,2-2,20,41,61,0.328,03/14/2015,2015.0
69,UMass Lowell (America East),6,1-5,31,106,137,0.226,03/14/2015,2015.0
1,Syracuse (ACC),5,5-0,89,37,126,0.706,03/11/2015,2015.0
2,Ohio St. (Big Ten),7,5-2,100,42,142,0.704,03/11/2015,2015.0
3,Rutgers (Big Ten),7,2-5,113,53,166,0.681,03/11/2015,2015.0
4,Cornell (Ivy League),5,3-2,95,46,141,0.674,03/11/2015,2015.0
5,Denver (Big East),5,4-1,81,40,121,0.669,03/11/2015,2015.0
6,Boston U. (Patriot),6,4-2,96,52,148,0.649,03/11/2015,2015.0
7,Navy (Patriot),7,4-3,94,55,149,0.631,03/11/2015,2015.0
8,Loyola Maryland (Patriot),6,3-3,93,56,149,0.624,03/11/2015,2015.0
9,Brown (Ivy League),4,4-0,76,48,124,0.613,03/11/2015,2015.0
10,Yale (Ivy League),5,5-0,71,46,117,0.607,03/11/2015,2015.0
11,Bryant (NEC),6,1-5,80,52,132,0.606,03/11/2015,2015.0
12,Drexel (CAA),6,2-4,87,59,146,0.596,03/11/2015,2015.0
13,Hofstra (CAA),5,1-4,74,51,125,0.592,03/11/2015,2015.0
14,Hartford (America East),4,2-2,55,40,95,0.579,03/11/2015,2015.0
15,Fairfield (CAA),6,2-4,74,55,129,0.574,03/11/2015,2015.0
16,High Point (SoCon),7,3-4,106,79,185,0.573,03/11/2015,2015.0
17,Penn St. (Big Ten),6,3-3,79,59,138,0.572,03/11/2015,2015.0
18,Georgetown (Big East),6,4-2,89,67,156,0.571,03/11/2015,2015.0
19,Duke (ACC),7,6-1,120,92,212,0.566,03/11/2015,2015.0
20,Johns Hopkins (Big Ten),6,3-3,83,68,151,0.550,03/11/2015,2015.0
21,Jacksonville (SoCon),5,3-2,74,63,137,0.540,03/11/2015,2015.0
22,Saint Joseph's (NEC),7,3-4,83,71,154,0.539,03/11/2015,2015.0
23,Vermont (America East),7,2-5,99,85,184,0.538,03/11/2015,2015.0
24,Notre Dame (ACC),4,3-1,57,51,108,0.528,03/11/2015,2015.0
25,Marist (MAAC),5,3-2,56,51,107,0.523,03/11/2015,2015.0
26,Mercer (SoCon),5,0-5,65,61,126,0.516,03/11/2015,2015.0
27,Army West Point (Patriot),7,5-2,82,77,159,0.516,03/11/2015,2015.0
28,Penn (Ivy League),6,3-3,75,72,147,0.510,03/11/2015,2015.0
29,Marquette (Big East),7,7-0,83,81,164,0.506,03/11/2015,2015.0
30,Delaware (CAA),7,3-4,80,80,160,0.500,03/11/2015,2015.0
30,Air Force (ECAC),7,3-4,73,73,146,0.500,03/11/2015,2015.0
30,Princeton (Ivy League),4,3-1,52,52,104,0.500,03/11/2015,2015.0
33,Towson (CAA),6,4-2,59,61,120,0.492,03/11/2015,2015.0
34,Stony Brook (America East),6,5-1,71,74,145,0.490,03/11/2015,2015.0
35,Maryland (Big Ten),5,4-1,44,46,90,0.489,03/11/2015,2015.0
36,North Carolina (ACC),7,7-0,95,100,195,0.487,03/11/2015,2015.0
37,Michigan (Big Ten),6,3-3,79,86,165,0.479,03/11/2015,2015.0
38,NJIT (Independent),4,0-4,43,47,90,0.478,03/11/2015,2015.0
39,Massachusetts (CAA),6,1-5,79,87,166,0.476,03/11/2015,2015.0
40,Canisius (MAAC),5,0-5,50,56,106,0.472,03/11/2015,2015.0
41,Bellarmine (SoCon),4,1-3,47,54,101,0.465,03/11/2015,2015.0
42,Furman (SoCon),6,1-5,55,65,120,0.458,03/11/2015,2015.0
43,Mount St. Mary's (NEC),6,2-4,53,63,116,0.457,03/11/2015,2015.0
44,Harvard (Ivy League),5,4-1,71,85,156,0.455,03/11/2015,2015.0
45,Sacred Heart (NEC),3,1-2,29,35,64,0.453,03/11/2015,2015.0
46,Siena (MAAC),6,3-3,68,83,151,0.450,03/11/2015,2015.0
47,Holy Cross (Patriot),6,3-3,63,79,142,0.444,03/11/2015,2015.0
48,Lehigh (Patriot),6,2-4,56,71,127,0.441,03/11/2015,2015.0
49,St. John's (NY) (Big East),6,1-5,58,77,135,0.430,03/11/2015,2015.0
50,UAlbany (America East),3,2-1,33,45,78,0.423,03/11/2015,2015.0
51,Bucknell (Patriot),6,4-2,53,73,126,0.421,03/11/2015,2015.0
52,Colgate (Patriot),5,4-1,50,69,119,0.420,03/11/2015,2015.0
53,Robert Morris (NEC),6,1-5,66,92,158,0.418,03/11/2015,2015.0
54,VMI (SoCon),6,0-6,61,86,147,0.415,03/11/2015,2015.0
55,Villanova (Big East),6,5-1,58,82,140,0.414,03/11/2015,2015.0
56,Providence (Big East),6,4-2,53,78,131,0.405,03/11/2015,2015.0
57,Binghamton (America East),4,1-3,39,59,98,0.398,03/11/2015,2015.0
58,Dartmouth (Ivy League),4,1-3,38,58,96,0.396,03/11/2015,2015.0
59,Richmond (SoCon),6,4-2,51,80,131,0.389,03/11/2015,2015.0
60,Virginia (ACC),6,5-1,66,104,170,0.388,03/11/2015,2015.0
61,Wagner (NEC),5,1-4,41,65,106,0.387,03/11/2015,2015.0
62,Hobart (NEC),5,3-2,47,75,122,0.385,03/11/2015,2015.0
63,Detroit Mercy (MAAC),6,4-2,54,89,143,0.378,03/11/2015,2015.0
64,Lafayette (Patriot),5,1-4,38,68,106,0.358,03/11/2015,2015.0
65,UMBC (America East),5,2-3,32,61,93,0.344,03/11/2015,2015.0
66,Quinnipiac (MAAC),5,1-4,41,81,122,0.336,03/11/2015,2015.0
67,Manhattan (MAAC),6,0-6,48,98,146,0.329,03/11/2015,2015.0
68,Monmouth (MAAC),4,2-2,20,41,61,0.328,03/11/2015,2015.0
69,UMass Lowell (America East),5,1-4,30,86,116,0.259,03/11/2015,2015.0
1,Syracuse (ACC),5,5-0,89,37,126,0.706,03/10/2015,2015.0
2,Ohio St. (Big Ten),7,5-2,100,42,142,0.704,03/10/2015,2015.0
3,Rutgers (Big Ten),7,2-5,113,53,166,0.681,03/10/2015,2015.0
4,Cornell (Ivy League),5,3-2,95,46,141,0.674,03/10/2015,2015.0
5,Denver (Big East),5,4-1,81,40,121,0.669,03/10/2015,2015.0
6,Boston U. (Patriot),6,4-2,96,52,148,0.649,03/10/2015,2015.0
7,Navy (Patriot),7,4-3,94,55,149,0.631,03/10/2015,2015.0
8,Loyola Maryland (Patriot),6,3-3,93,56,149,0.624,03/10/2015,2015.0
9,Brown (Ivy League),4,4-0,76,48,124,0.613,03/10/2015,2015.0
10,Yale (Ivy League),5,5-0,71,46,117,0.607,03/10/2015,2015.0
11,Bryant (NEC),6,1-5,80,52,132,0.606,03/10/2015,2015.0
12,Drexel (CAA),6,2-4,87,59,146,0.596,03/10/2015,2015.0
13,Hofstra (CAA),5,1-4,74,51,125,0.592,03/10/2015,2015.0
14,Hartford (America East),4,2-2,55,40,95,0.579,03/10/2015,2015.0
15,Fairfield (CAA),6,2-4,74,55,129,0.574,03/10/2015,2015.0
16,High Point (SoCon),7,3-4,106,79,185,0.573,03/10/2015,2015.0
17,Penn St. (Big Ten),6,3-3,79,59,138,0.572,03/10/2015,2015.0
18,Georgetown (Big East),6,4-2,89,67,156,0.571,03/10/2015,2015.0
19,Duke (ACC),7,6-1,120,92,212,0.566,03/10/2015,2015.0
20,Jacksonville (SoCon),4,2-2,57,45,102,0.559,03/10/2015,2015.0
21,Johns Hopkins (Big Ten),6,3-3,83,68,151,0.550,03/10/2015,2015.0
22,Saint Joseph's (NEC),7,3-4,83,71,154,0.539,03/10/2015,2015.0
23,Vermont (America East),7,2-5,99,85,184,0.538,03/10/2015,2015.0
24,Notre Dame (ACC),4,3-1,57,51,108,0.528,03/10/2015,2015.0
25,Marist (MAAC),5,3-2,56,51,107,0.523,03/10/2015,2015.0
26,Mercer (SoCon),5,0-5,65,61,126,0.516,03/10/2015,2015.0
27,Army West Point (Patriot),7,5-2,82,77,159,0.516,03/10/2015,2015.0
28,Penn (Ivy League),6,3-3,75,72,147,0.510,03/10/2015,2015.0
29,Marquette (Big East),7,7-0,83,81,164,0.506,03/10/2015,2015.0
30,Delaware (CAA),7,3-4,80,80,160,0.500,03/10/2015,2015.0
30,Air Force (ECAC),7,3-4,73,73,146,0.500,03/10/2015,2015.0
30,Princeton (Ivy League),4,3-1,52,52,104,0.500,03/10/2015,2015.0
33,Towson (CAA),6,4-2,59,61,120,0.492,03/10/2015,2015.0
34,Stony Brook (America East),6,5-1,71,74,145,0.490,03/10/2015,2015.0
35,Maryland (Big Ten),5,4-1,44,46,90,0.489,03/10/2015,2015.0
36,North Carolina (ACC),7,7-0,95,100,195,0.487,03/10/2015,2015.0
37,Michigan (Big Ten),6,3-3,79,86,165,0.479,03/10/2015,2015.0
38,NJIT (Independent),4,0-4,43,47,90,0.478,03/10/2015,2015.0
39,Massachusetts (CAA),6,1-5,79,87,166,0.476,03/10/2015,2015.0
40,Canisius (MAAC),5,0-5,50,56,106,0.472,03/10/2015,2015.0
41,Bellarmine (SoCon),4,1-3,47,54,101,0.465,03/10/2015,2015.0
42,Furman (SoCon),6,1-5,55,65,120,0.458,03/10/2015,2015.0
43,Harvard (Ivy League),5,4-1,71,85,156,0.455,03/10/2015,2015.0
44,Sacred Heart (NEC),3,1-2,29,35,64,0.453,03/10/2015,2015.0
45,Siena (MAAC),6,3-3,68,83,151,0.450,03/10/2015,2015.0
46,Holy Cross (Patriot),6,3-3,63,79,142,0.444,03/10/2015,2015.0
47,Lehigh (Patriot),6,2-4,56,71,127,0.441,03/10/2015,2015.0
48,St. John's (NY) (Big East),6,1-5,58,77,135,0.430,03/10/2015,2015.0
49,UAlbany (America East),3,2-1,33,45,78,0.423,03/10/2015,2015.0
50,Bucknell (Patriot),6,4-2,53,73,126,0.421,03/10/2015,2015.0
51,Colgate (Patriot),5,4-1,50,69,119,0.420,03/10/2015,2015.0
52,Richmond (SoCon),5,3-2,47,65,112,0.420,03/10/2015,2015.0
53,VMI (SoCon),6,0-6,61,86,147,0.415,03/10/2015,2015.0
54,Villanova (Big East),6,5-1,58,82,140,0.414,03/10/2015,2015.0
55,Providence (Big East),6,4-2,53,78,131,0.405,03/10/2015,2015.0
56,Binghamton (America East),4,1-3,39,59,98,0.398,03/10/2015,2015.0
57,Dartmouth (Ivy League),4,1-3,38,58,96,0.396,03/10/2015,2015.0
58,Mount St. Mary's (NEC),5,2-3,38,59,97,0.392,03/10/2015,2015.0
59,Robert Morris (NEC),5,1-4,48,75,123,0.390,03/10/2015,2015.0
60,Virginia (ACC),6,5-1,66,104,170,0.388,03/10/2015,2015.0
61,Wagner (NEC),5,1-4,41,65,106,0.387,03/10/2015,2015.0
62,Hobart (NEC),5,3-2,47,75,122,0.385,03/10/2015,2015.0
63,Detroit Mercy (MAAC),6,4-2,54,89,143,0.378,03/10/2015,2015.0
64,Lafayette (Patriot),5,1-4,38,68,106,0.358,03/10/2015,2015.0
65,UMBC (America East),5,2-3,32,61,93,0.344,03/10/2015,2015.0
66,Quinnipiac (MAAC),5,1-4,41,81,122,0.336,03/10/2015,2015.0
67,Manhattan (MAAC),6,0-6,48,98,146,0.329,03/10/2015,2015.0
68,Monmouth (MAAC),4,2-2,20,41,61,0.328,03/10/2015,2015.0
69,UMass Lowell (America East),5,1-4,30,86,116,0.259,03/10/2015,2015.0
1,Syracuse (ACC),5,5-0,89,37,126,0.706,03/09/2015,2015.0
2,Ohio St. (Big Ten),7,5-2,100,42,142,0.704,03/09/2015,2015.0
3,Rutgers (Big Ten),7,2-5,113,53,166,0.681,03/09/2015,2015.0
4,Cornell (Ivy League),5,3-2,95,46,141,0.674,03/09/2015,2015.0
5,Denver (Big East),5,4-1,81,40,121,0.669,03/09/2015,2015.0
6,Boston U. (Patriot),6,4-2,96,52,148,0.649,03/09/2015,2015.0
7,Loyola Maryland (Patriot),6,3-3,93,56,149,0.624,03/09/2015,2015.0
8,Navy (Patriot),6,3-3,77,47,124,0.621,03/09/2015,2015.0
9,Brown (Ivy League),4,4-0,76,48,124,0.613,03/09/2015,2015.0
10,Yale (Ivy League),5,5-0,71,46,117,0.607,03/09/2015,2015.0
11,Bryant (NEC),5,1-4,65,44,109,0.596,03/09/2015,2015.0
12,Drexel (CAA),6,2-4,87,59,146,0.596,03/09/2015,2015.0
13,Hofstra (CAA),5,1-4,74,51,125,0.592,03/09/2015,2015.0
14,Hartford (America East),4,2-2,55,40,95,0.579,03/09/2015,2015.0
15,Vermont (America East),6,2-4,87,64,151,0.576,03/09/2015,2015.0
16,Fairfield (CAA),5,2-3,61,45,106,0.575,03/09/2015,2015.0
17,High Point (SoCon),7,3-4,106,79,185,0.573,03/09/2015,2015.0
18,Marist (MAAC),4,3-1,49,37,86,0.570,03/09/2015,2015.0
19,Duke (ACC),7,6-1,120,92,212,0.566,03/09/2015,2015.0
20,Saint Joseph's (NEC),6,3-3,69,53,122,0.566,03/09/2015,2015.0
21,Jacksonville (SoCon),4,2-2,57,45,102,0.559,03/09/2015,2015.0
22,Penn St. (Big Ten),5,2-3,65,52,117,0.556,03/09/2015,2015.0
23,Georgetown (Big East),5,3-2,68,55,123,0.553,03/09/2015,2015.0
24,Johns Hopkins (Big Ten),6,3-3,83,68,151,0.550,03/09/2015,2015.0
25,Notre Dame (ACC),4,3-1,57,51,108,0.528,03/09/2015,2015.0
26,Mercer (SoCon),5,0-5,65,61,126,0.516,03/09/2015,2015.0
27,Army West Point (Patriot),7,5-2,82,77,159,0.516,03/09/2015,2015.0
28,Penn (Ivy League),6,3-3,75,72,147,0.510,03/09/2015,2015.0
29,Marquette (Big East),7,7-0,83,81,164,0.506,03/09/2015,2015.0
30,North Carolina (ACC),6,6-0,87,85,172,0.506,03/09/2015,2015.0
31,Delaware (CAA),7,3-4,80,80,160,0.500,03/09/2015,2015.0
31,Air Force (ECAC),7,3-4,73,73,146,0.500,03/09/2015,2015.0
31,Princeton (Ivy League),4,3-1,52,52,104,0.500,03/09/2015,2015.0
34,Towson (CAA),6,4-2,59,61,120,0.492,03/09/2015,2015.0
35,Stony Brook (America East),6,5-1,71,74,145,0.490,03/09/2015,2015.0
36,Maryland (Big Ten),5,4-1,44,46,90,0.489,03/09/2015,2015.0
37,Michigan (Big Ten),6,3-3,79,86,165,0.479,03/09/2015,2015.0
38,NJIT (Independent),4,0-4,43,47,90,0.478,03/09/2015,2015.0
39,Bellarmine (SoCon),4,1-3,47,54,101,0.465,03/09/2015,2015.0
40,Furman (SoCon),6,1-5,55,65,120,0.458,03/09/2015,2015.0
41,Harvard (Ivy League),5,4-1,71,85,156,0.455,03/09/2015,2015.0
42,Canisius (MAAC),4,0-4,40,48,88,0.455,03/09/2015,2015.0
43,Sacred Heart (NEC),3,1-2,29,35,64,0.453,03/09/2015,2015.0
44,Siena (MAAC),6,3-3,68,83,151,0.450,03/09/2015,2015.0
45,Holy Cross (Patriot),6,3-3,63,79,142,0.444,03/09/2015,2015.0
46,Massachusetts (CAA),5,0-5,61,78,139,0.439,03/09/2015,2015.0
47,St. John's (NY) (Big East),6,1-5,58,77,135,0.430,03/09/2015,2015.0
48,Lehigh (Patriot),5,2-3,48,65,113,0.425,03/09/2015,2015.0
49,UAlbany (America East),3,2-1,33,45,78,0.423,03/09/2015,2015.0
50,Colgate (Patriot),5,4-1,50,69,119,0.420,03/09/2015,2015.0
51,Richmond (SoCon),5,3-2,47,65,112,0.420,03/09/2015,2015.0
52,Bucknell (Patriot),5,3-2,43,60,103,0.417,03/09/2015,2015.0
53,VMI (SoCon),6,0-6,61,86,147,0.415,03/09/2015,2015.0
54,Villanova (Big East),5,4-1,52,74,126,0.413,03/09/2015,2015.0
55,Binghamton (America East),4,1-3,39,59,98,0.398,03/09/2015,2015.0
56,Dartmouth (Ivy League),4,1-3,38,58,96,0.396,03/09/2015,2015.0
57,Mount St. Mary's (NEC),5,2-3,38,59,97,0.392,03/09/2015,2015.0
58,Robert Morris (NEC),5,1-4,48,75,123,0.390,03/09/2015,2015.0
59,Wagner (NEC),5,1-4,41,65,106,0.387,03/09/2015,2015.0
60,Detroit Mercy (MAAC),6,4-2,54,89,143,0.378,03/09/2015,2015.0
61,Hobart (NEC),4,2-2,39,65,104,0.375,03/09/2015,2015.0
62,Lafayette (Patriot),4,1-3,30,51,81,0.370,03/09/2015,2015.0
63,Virginia (ACC),5,4-1,48,90,138,0.348,03/09/2015,2015.0
64,UMBC (America East),5,2-3,32,61,93,0.344,03/09/2015,2015.0
65,Quinnipiac (MAAC),4,1-3,32,63,95,0.337,03/09/2015,2015.0
66,Providence (Big East),5,3-2,37,73,110,0.336,03/09/2015,2015.0
67,Manhattan (MAAC),6,0-6,48,98,146,0.329,03/09/2015,2015.0
68,Monmouth (MAAC),4,2-2,20,41,61,0.328,03/09/2015,2015.0
69,UMass Lowell (America East),4,1-3,25,70,95,0.263,03/09/2015,2015.0
1,Syracuse (ACC),5,5-0,89,37,126,0.706,03/08/2015,2015.0
2,Ohio St. (Big Ten),7,5-2,100,42,142,0.704,03/08/2015,2015.0
3,Rutgers (Big Ten),7,2-5,113,53,166,0.681,03/08/2015,2015.0
4,Cornell (Ivy League),5,3-2,95,46,141,0.674,03/08/2015,2015.0
5,Denver (Big East),5,4-1,81,40,121,0.669,03/08/2015,2015.0
6,Boston U. (Patriot),6,4-2,96,52,148,0.649,03/08/2015,2015.0
7,Loyola Maryland (Patriot),6,3-3,93,56,149,0.624,03/08/2015,2015.0
8,Navy (Patriot),6,3-3,77,47,124,0.621,03/08/2015,2015.0
9,Brown (Ivy League),4,4-0,76,48,124,0.613,03/08/2015,2015.0
10,Yale (Ivy League),5,5-0,71,46,117,0.607,03/08/2015,2015.0
11,Bryant (NEC),5,1-4,65,44,109,0.596,03/08/2015,2015.0
12,Drexel (CAA),6,2-4,87,59,146,0.596,03/08/2015,2015.0
13,Hofstra (CAA),5,1-4,74,51,125,0.592,03/08/2015,2015.0
14,Hartford (America East),4,2-2,55,40,95,0.579,03/08/2015,2015.0
15,Vermont (America East),6,2-4,87,64,151,0.576,03/08/2015,2015.0
16,Fairfield (CAA),5,2-3,61,45,106,0.575,03/08/2015,2015.0
17,High Point (SoCon),7,3-4,106,79,185,0.573,03/08/2015,2015.0
18,Marist (MAAC),4,3-1,49,37,86,0.570,03/08/2015,2015.0
19,Duke (ACC),7,6-1,120,92,212,0.566,03/08/2015,2015.0
20,Saint Joseph's (NEC),6,3-3,69,53,122,0.566,03/08/2015,2015.0
21,Jacksonville (SoCon),4,2-2,57,45,102,0.559,03/08/2015,2015.0
22,Penn St. (Big Ten),5,2-3,65,52,117,0.556,03/08/2015,2015.0
23,Georgetown (Big East),5,3-2,68,55,123,0.553,03/08/2015,2015.0
24,Johns Hopkins (Big Ten),6,3-3,83,68,151,0.550,03/08/2015,2015.0
25,Notre Dame (ACC),4,3-1,57,51,108,0.528,03/08/2015,2015.0
26,Mercer (SoCon),5,0-5,65,61,126,0.516,03/08/2015,2015.0
27,Army West Point (Patriot),7,5-2,82,77,159,0.516,03/08/2015,2015.0
28,Penn (Ivy League),6,3-3,75,72,147,0.510,03/08/2015,2015.0
29,Marquette (Big East),7,7-0,83,81,164,0.506,03/08/2015,2015.0
30,North Carolina (ACC),6,6-0,87,85,172,0.506,03/08/2015,2015.0
31,Delaware (CAA),7,3-4,80,80,160,0.500,03/08/2015,2015.0
31,Air Force (ECAC),7,3-4,73,73,146,0.500,03/08/2015,2015.0
31,Princeton (Ivy League),4,3-1,52,52,104,0.500,03/08/2015,2015.0
34,Towson (CAA),6,4-2,59,61,120,0.492,03/08/2015,2015.0
35,Stony Brook (America East),6,5-1,71,74,145,0.490,03/08/2015,2015.0
36,Maryland (Big Ten),5,4-1,44,46,90,0.489,03/08/2015,2015.0
37,Harvard (Ivy League),4,3-1,60,65,125,0.480,03/08/2015,2015.0
38,Michigan (Big Ten),6,3-3,79,86,165,0.479,03/08/2015,2015.0
39,NJIT (Independent),4,0-4,43,47,90,0.478,03/08/2015,2015.0
40,Bellarmine (SoCon),4,1-3,47,54,101,0.465,03/08/2015,2015.0
41,Furman (SoCon),6,1-5,55,65,120,0.458,03/08/2015,2015.0
42,Canisius (MAAC),4,0-4,40,48,88,0.455,03/08/2015,2015.0
43,Sacred Heart (NEC),3,1-2,29,35,64,0.453,03/08/2015,2015.0
44,Siena (MAAC),6,3-3,68,83,151,0.450,03/08/2015,2015.0
45,Massachusetts (CAA),5,0-5,61,78,139,0.439,03/08/2015,2015.0
46,St. John's (NY) (Big East),6,1-5,58,77,135,0.430,03/08/2015,2015.0
47,Lehigh (Patriot),5,2-3,48,65,113,0.425,03/08/2015,2015.0
48,UAlbany (America East),3,2-1,33,45,78,0.423,03/08/2015,2015.0
49,Colgate (Patriot),5,4-1,50,69,119,0.420,03/08/2015,2015.0
50,Richmond (SoCon),5,3-2,47,65,112,0.420,03/08/2015,2015.0
51,Bucknell (Patriot),5,3-2,43,60,103,0.417,03/08/2015,2015.0
52,VMI (SoCon),6,0-6,61,86,147,0.415,03/08/2015,2015.0
53,Villanova (Big East),5,4-1,52,74,126,0.413,03/08/2015,2015.0
54,Binghamton (America East),4,1-3,39,59,98,0.398,03/08/2015,2015.0
55,Dartmouth (Ivy League),4,1-3,38,58,96,0.396,03/08/2015,2015.0
56,Mount St. Mary's (NEC),5,2-3,38,59,97,0.392,03/08/2015,2015.0
57,Robert Morris (NEC),5,1-4,48,75,123,0.390,03/08/2015,2015.0
58,Holy Cross (Patriot),5,3-2,43,68,111,0.387,03/08/2015,2015.0
59,Wagner (NEC),5,1-4,41,65,106,0.387,03/08/2015,2015.0
60,Detroit Mercy (MAAC),6,4-2,54,89,143,0.378,03/08/2015,2015.0
61,Hobart (NEC),4,2-2,39,65,104,0.375,03/08/2015,2015.0
62,Lafayette (Patriot),4,1-3,30,51,81,0.370,03/08/2015,2015.0
63,Virginia (ACC),5,4-1,48,90,138,0.348,03/08/2015,2015.0
64,UMBC (America East),5,2-3,32,61,93,0.344,03/08/2015,2015.0
65,Quinnipiac (MAAC),4,1-3,32,63,95,0.337,03/08/2015,2015.0
66,Providence (Big East),5,3-2,37,73,110,0.336,03/08/2015,2015.0
67,Manhattan (MAAC),6,0-6,48,98,146,0.329,03/08/2015,2015.0
68,Monmouth (MAAC),4,2-2,20,41,61,0.328,03/08/2015,2015.0
69,UMass Lowell (America East),4,1-3,25,70,95,0.263,03/08/2015,2015.0
1,Syracuse (ACC),5,5-0,89,37,126,0.706,03/07/2015,2015.0
2,Ohio St. (Big Ten),7,5-2,100,42,142,0.704,03/07/2015,2015.0
3,Cornell (Ivy League),5,3-2,95,46,141,0.674,03/07/2015,2015.0
4,Denver (Big East),5,4-1,81,40,121,0.669,03/07/2015,2015.0
5,Rutgers (Big Ten),6,2-4,93,47,140,0.664,03/07/2015,2015.0
6,Boston U. (Patriot),6,4-2,96,52,148,0.649,03/07/2015,2015.0
7,Loyola Maryland (Patriot),6,3-3,93,56,149,0.624,03/07/2015,2015.0
8,Navy (Patriot),6,3-3,77,47,124,0.621,03/07/2015,2015.0
9,Brown (Ivy League),3,3-0,53,33,86,0.616,03/07/2015,2015.0
10,Yale (Ivy League),5,5-0,71,46,117,0.607,03/07/2015,2015.0
11,Bryant (NEC),5,1-4,65,44,109,0.596,03/07/2015,2015.0
12,Drexel (CAA),6,2-4,87,59,146,0.596,03/07/2015,2015.0
13,Hofstra (CAA),5,1-4,74,51,125,0.592,03/07/2015,2015.0
14,Hartford (America East),4,2-2,55,40,95,0.579,03/07/2015,2015.0
15,Vermont (America East),6,2-4,87,64,151,0.576,03/07/2015,2015.0
16,Fairfield (CAA),5,2-3,61,45,106,0.575,03/07/2015,2015.0
17,High Point (SoCon),7,3-4,106,79,185,0.573,03/07/2015,2015.0
18,Marist (MAAC),4,3-1,49,37,86,0.570,03/07/2015,2015.0
19,Duke (ACC),7,6-1,120,92,212,0.566,03/07/2015,2015.0
20,Saint Joseph's (NEC),6,3-3,69,53,122,0.566,03/07/2015,2015.0
21,Jacksonville (SoCon),4,2-2,57,45,102,0.559,03/07/2015,2015.0
22,Penn St. (Big Ten),5,2-3,65,52,117,0.556,03/07/2015,2015.0
23,Georgetown (Big East),5,3-2,68,55,123,0.553,03/07/2015,2015.0
24,Johns Hopkins (Big Ten),6,3-3,83,68,151,0.550,03/07/2015,2015.0
25,Stony Brook (America East),5,4-1,65,54,119,0.546,03/07/2015,2015.0
26,Notre Dame (ACC),4,3-1,57,51,108,0.528,03/07/2015,2015.0
27,Mercer (SoCon),4,0-4,54,49,103,0.524,03/07/2015,2015.0
28,Army West Point (Patriot),7,5-2,82,77,159,0.516,03/07/2015,2015.0
29,Penn (Ivy League),6,3-3,75,72,147,0.510,03/07/2015,2015.0
30,North Carolina (ACC),6,6-0,87,85,172,0.506,03/07/2015,2015.0
31,Michigan (Big Ten),5,3-2,64,63,127,0.504,03/07/2015,2015.0
32,Marquette (Big East),6,6-0,71,70,141,0.504,03/07/2015,2015.0
33,Princeton (Ivy League),4,3-1,52,52,104,0.500,03/07/2015,2015.0
34,Towson (CAA),6,4-2,59,61,120,0.492,03/07/2015,2015.0
35,Maryland (Big Ten),5,4-1,44,46,90,0.489,03/07/2015,2015.0
36,Air Force (ECAC),6,2-4,60,63,123,0.488,03/07/2015,2015.0
37,Delaware (CAA),6,3-3,67,71,138,0.486,03/07/2015,2015.0
38,Harvard (Ivy League),4,3-1,60,65,125,0.480,03/07/2015,2015.0
39,NJIT (Independent),4,0-4,43,47,90,0.478,03/07/2015,2015.0
40,Bellarmine (SoCon),4,1-3,47,54,101,0.465,03/07/2015,2015.0
41,Furman (SoCon),6,1-5,55,65,120,0.458,03/07/2015,2015.0
42,Canisius (MAAC),4,0-4,40,48,88,0.455,03/07/2015,2015.0
43,Sacred Heart (NEC),3,1-2,29,35,64,0.453,03/07/2015,2015.0
44,Siena (MAAC),6,3-3,68,83,151,0.450,03/07/2015,2015.0
45,Massachusetts (CAA),5,0-5,61,78,139,0.439,03/07/2015,2015.0
46,St. John's (NY) (Big East),6,1-5,58,77,135,0.430,03/07/2015,2015.0
47,Lehigh (Patriot),5,2-3,48,65,113,0.425,03/07/2015,2015.0
48,UAlbany (America East),3,2-1,33,45,78,0.423,03/07/2015,2015.0
49,Colgate (Patriot),5,4-1,50,69,119,0.420,03/07/2015,2015.0
50,Richmond (SoCon),5,3-2,47,65,112,0.420,03/07/2015,2015.0
51,Bucknell (Patriot),5,3-2,43,60,103,0.417,03/07/2015,2015.0
52,Villanova (Big East),5,4-1,52,74,126,0.413,03/07/2015,2015.0
53,VMI (SoCon),5,0-5,51,73,124,0.411,03/07/2015,2015.0
54,Dartmouth (Ivy League),4,1-3,38,58,96,0.396,03/07/2015,2015.0
55,Binghamton (America East),3,0-3,30,46,76,0.395,03/07/2015,2015.0
56,Mount St. Mary's (NEC),5,2-3,38,59,97,0.392,03/07/2015,2015.0
57,Robert Morris (NEC),5,1-4,48,75,123,0.390,03/07/2015,2015.0
58,Holy Cross (Patriot),5,3-2,43,68,111,0.387,03/07/2015,2015.0
59,Wagner (NEC),5,1-4,41,65,106,0.387,03/07/2015,2015.0
60,Detroit Mercy (MAAC),6,4-2,54,89,143,0.378,03/07/2015,2015.0
61,Hobart (NEC),4,2-2,39,65,104,0.375,03/07/2015,2015.0
62,Lafayette (Patriot),4,1-3,30,51,81,0.370,03/07/2015,2015.0
63,Virginia (ACC),5,4-1,48,90,138,0.348,03/07/2015,2015.0
64,UMBC (America East),5,2-3,32,61,93,0.344,03/07/2015,2015.0
65,Quinnipiac (MAAC),4,1-3,32,63,95,0.337,03/07/2015,2015.0
66,Providence (Big East),5,3-2,37,73,110,0.336,03/07/2015,2015.0
67,Manhattan (MAAC),6,0-6,48,98,146,0.329,03/07/2015,2015.0
68,Monmouth (MAAC),4,2-2,20,41,61,0.328,03/07/2015,2015.0
69,UMass Lowell (America East),4,1-3,25,70,95,0.263,03/07/2015,2015.0
1,Ohio St. (Big Ten),6,4-2,91,30,121,0.752,03/05/2015,2015.0
2,Syracuse (ACC),4,4-0,75,30,105,0.714,03/05/2015,2015.0
3,Rutgers (Big Ten),6,2-4,93,47,140,0.664,03/05/2015,2015.0
4,Denver (Big East),4,3-1,65,33,98,0.663,03/05/2015,2015.0
5,Cornell (Ivy League),4,3-1,72,37,109,0.661,03/05/2015,2015.0
6,Loyola Maryland (Patriot),5,3-2,81,43,124,0.653,03/05/2015,2015.0
7,Fairfield (CAA),4,2-2,55,30,85,0.647,03/05/2015,2015.0
8,Navy (Patriot),5,3-2,63,36,99,0.636,03/05/2015,2015.0
9,Drexel (CAA),5,1-4,76,47,123,0.618,03/05/2015,2015.0
10,Bryant (NEC),4,1-3,53,33,86,0.616,03/05/2015,2015.0
10,Brown (Ivy League),3,3-0,53,33,86,0.616,03/05/2015,2015.0
12,Jacksonville (SoCon),3,2-1,47,30,77,0.610,03/05/2015,2015.0
13,Marist (MAAC),3,2-1,39,25,64,0.609,03/05/2015,2015.0
14,Boston U. (Patriot),5,3-2,70,45,115,0.609,03/05/2015,2015.0
15,Vermont (America East),5,1-4,75,50,125,0.600,03/05/2015,2015.0
16,Hofstra (CAA),4,1-3,62,42,104,0.596,03/05/2015,2015.0
17,Notre Dame (ACC),3,3-0,50,35,85,0.588,03/05/2015,2015.0
18,Yale (Ivy League),4,4-0,56,40,96,0.583,03/05/2015,2015.0
19,High Point (SoCon),6,3-3,94,69,163,0.577,03/05/2015,2015.0
20,Penn St. (Big Ten),4,2-2,54,40,94,0.574,03/05/2015,2015.0
21,Duke (ACC),6,5-1,107,80,187,0.572,03/05/2015,2015.0
22,Johns Hopkins (Big Ten),5,2-3,72,54,126,0.571,03/05/2015,2015.0
23,Georgetown (Big East),4,2-2,52,43,95,0.547,03/05/2015,2015.0
24,Stony Brook (America East),5,4-1,65,54,119,0.546,03/05/2015,2015.0
25,Penn (Ivy League),5,3-2,63,53,116,0.543,03/05/2015,2015.0
26,Saint Joseph's (NEC),5,2-3,58,49,107,0.542,03/05/2015,2015.0
27,Hartford (America East),3,1-2,40,34,74,0.541,03/05/2015,2015.0
28,Princeton (Ivy League),3,3-0,45,39,84,0.536,03/05/2015,2015.0
29,Mercer (SoCon),4,0-4,54,49,103,0.524,03/05/2015,2015.0
30,Army West Point (Patriot),6,5-1,74,68,142,0.521,03/05/2015,2015.0
31,Michigan (Big Ten),5,3-2,64,63,127,0.504,03/05/2015,2015.0
32,Colgate (Patriot),4,4-0,43,43,86,0.500,03/05/2015,2015.0
32,Sacred Heart (NEC),2,1-1,21,21,42,0.500,03/05/2015,2015.0
34,Delaware (CAA),6,3-3,67,71,138,0.486,03/05/2015,2015.0
35,Marquette (Big East),5,5-0,56,60,116,0.483,03/05/2015,2015.0
36,Air Force (ECAC),5,2-3,46,51,97,0.474,03/05/2015,2015.0
37,UAlbany (America East),2,1-1,26,29,55,0.473,03/05/2015,2015.0
38,North Carolina (ACC),5,5-0,64,72,136,0.471,03/05/2015,2015.0
38,Harvard (Ivy League),3,2-1,48,54,102,0.471,03/05/2015,2015.0
40,Bellarmine (SoCon),4,1-3,47,54,101,0.465,03/05/2015,2015.0
41,Canisius (MAAC),4,0-4,40,48,88,0.455,03/05/2015,2015.0
42,St. John's (NY) (Big East),5,1-4,51,63,114,0.447,03/05/2015,2015.0
43,Towson (CAA),5,3-2,44,55,99,0.444,03/05/2015,2015.0
44,Maryland (Big Ten),4,3-1,31,39,70,0.443,03/05/2015,2015.0
45,Furman (SoCon),5,1-4,45,58,103,0.437,03/05/2015,2015.0
46,Siena (MAAC),5,3-2,54,71,125,0.432,03/05/2015,2015.0
47,Lehigh (Patriot),4,2-2,38,54,92,0.413,03/05/2015,2015.0
48,VMI (SoCon),4,0-4,39,59,98,0.398,03/05/2015,2015.0
49,Binghamton (America East),3,0-3,30,46,76,0.395,03/05/2015,2015.0
50,Bucknell (Patriot),4,2-2,32,50,82,0.390,03/05/2015,2015.0
51,Massachusetts (CAA),4,0-4,45,71,116,0.388,03/05/2015,2015.0
52,Mount St. Mary's (NEC),4,1-3,31,49,80,0.388,03/05/2015,2015.0
53,Richmond (SoCon),4,2-2,33,53,86,0.384,03/05/2015,2015.0
54,NJIT (Independent),3,0-3,27,44,71,0.380,03/05/2015,2015.0
55,Detroit Mercy (MAAC),6,4-2,54,89,143,0.378,03/05/2015,2015.0
56,Robert Morris (NEC),4,0-4,36,61,97,0.371,03/05/2015,2015.0
57,Wagner (NEC),4,1-3,30,51,81,0.370,03/05/2015,2015.0
57,Lafayette (Patriot),4,1-3,30,51,81,0.370,03/05/2015,2015.0
59,Virginia (ACC),4,3-1,39,67,106,0.368,03/05/2015,2015.0
60,Holy Cross (Patriot),4,2-2,34,60,94,0.362,03/05/2015,2015.0
61,UMBC (America East),4,2-2,26,46,72,0.361,03/05/2015,2015.0
62,Hobart (NEC),3,2-1,27,49,76,0.355,03/05/2015,2015.0
63,Quinnipiac (MAAC),3,1-2,26,48,74,0.351,03/05/2015,2015.0
64,Monmouth (MAAC),3,2-1,16,30,46,0.348,03/05/2015,2015.0
65,Villanova (Big East),4,3-1,33,62,95,0.347,03/05/2015,2015.0
66,Dartmouth (Ivy League),3,0-3,24,47,71,0.338,03/05/2015,2015.0
67,Manhattan (MAAC),5,0-5,35,75,110,0.318,03/05/2015,2015.0
68,UMass Lowell (America East),3,0-3,22,54,76,0.289,03/05/2015,2015.0
69,Providence (Big East),4,2-2,23,65,88,0.261,03/05/2015,2015.0
1,Ohio St. (Big Ten),6,4-2,91,30,121,0.752,03/04/2015,2015.0
2,Syracuse (ACC),4,4-0,75,30,105,0.714,03/04/2015,2015.0
3,Rutgers (Big Ten),6,2-4,93,47,140,0.664,03/04/2015,2015.0
4,Denver (Big East),4,3-1,65,33,98,0.663,03/04/2015,2015.0
5,Cornell (Ivy League),4,3-1,72,37,109,0.661,03/04/2015,2015.0
6,Loyola Maryland (Patriot),5,3-2,81,43,124,0.653,03/04/2015,2015.0
7,Fairfield (CAA),4,2-2,55,30,85,0.647,03/04/2015,2015.0
8,Navy (Patriot),5,3-2,63,36,99,0.636,03/04/2015,2015.0
9,Drexel (CAA),5,1-4,76,47,123,0.618,03/04/2015,2015.0
10,Bryant (NEC),4,1-3,53,33,86,0.616,03/04/2015,2015.0
10,Brown (Ivy League),3,3-0,53,33,86,0.616,03/04/2015,2015.0
12,Jacksonville (SoCon),3,2-1,47,30,77,0.610,03/04/2015,2015.0
13,Marist (MAAC),3,2-1,39,25,64,0.609,03/04/2015,2015.0
14,Boston U. (Patriot),5,3-2,70,45,115,0.609,03/04/2015,2015.0
15,Vermont (America East),5,1-4,75,50,125,0.600,03/04/2015,2015.0
16,Hofstra (CAA),4,1-3,62,42,104,0.596,03/04/2015,2015.0
17,Notre Dame (ACC),3,3-0,50,35,85,0.588,03/04/2015,2015.0
18,Yale (Ivy League),4,4-0,56,40,96,0.583,03/04/2015,2015.0
19,High Point (SoCon),6,3-3,94,69,163,0.577,03/04/2015,2015.0
20,Penn St. (Big Ten),4,2-2,54,40,94,0.574,03/04/2015,2015.0
21,Duke (ACC),6,5-1,107,80,187,0.572,03/04/2015,2015.0
22,Johns Hopkins (Big Ten),5,2-3,72,54,126,0.571,03/04/2015,2015.0
23,Georgetown (Big East),4,2-2,52,43,95,0.547,03/04/2015,2015.0
24,Stony Brook (America East),5,4-1,65,54,119,0.546,03/04/2015,2015.0
25,Penn (Ivy League),5,3-2,63,53,116,0.543,03/04/2015,2015.0
26,Saint Joseph's (NEC),5,2-3,58,49,107,0.542,03/04/2015,2015.0
27,Hartford (America East),3,1-2,40,34,74,0.541,03/04/2015,2015.0
28,Princeton (Ivy League),3,3-0,45,39,84,0.536,03/04/2015,2015.0
29,Mercer (SoCon),4,0-4,54,49,103,0.524,03/04/2015,2015.0
30,Army West Point (Patriot),6,5-1,74,68,142,0.521,03/04/2015,2015.0
31,Michigan (Big Ten),5,3-2,64,63,127,0.504,03/04/2015,2015.0
32,Colgate (Patriot),4,4-0,43,43,86,0.500,03/04/2015,2015.0
32,Sacred Heart (NEC),2,1-1,21,21,42,0.500,03/04/2015,2015.0
34,Delaware (CAA),6,3-3,67,71,138,0.486,03/04/2015,2015.0
35,Marquette (Big East),5,5-0,56,60,116,0.483,03/04/2015,2015.0
36,Air Force (ECAC),5,2-3,46,51,97,0.474,03/04/2015,2015.0
37,UAlbany (America East),2,1-1,26,29,55,0.473,03/04/2015,2015.0
38,North Carolina (ACC),5,5-0,64,72,136,0.471,03/04/2015,2015.0
38,Harvard (Ivy League),3,2-1,48,54,102,0.471,03/04/2015,2015.0
40,Bellarmine (SoCon),4,1-3,47,54,101,0.465,03/04/2015,2015.0
41,Canisius (MAAC),4,0-4,40,48,88,0.455,03/04/2015,2015.0
42,St. John's (NY) (Big East),5,1-4,51,63,114,0.447,03/04/2015,2015.0
43,Towson (CAA),5,3-2,44,55,99,0.444,03/04/2015,2015.0
44,Maryland (Big Ten),4,3-1,31,39,70,0.443,03/04/2015,2015.0
45,Furman (SoCon),5,1-4,45,58,103,0.437,03/04/2015,2015.0
46,Siena (MAAC),5,3-2,54,71,125,0.432,03/04/2015,2015.0
47,Lehigh (Patriot),4,2-2,38,54,92,0.413,03/04/2015,2015.0
48,VMI (SoCon),4,0-4,39,59,98,0.398,03/04/2015,2015.0
49,Binghamton (America East),3,0-3,30,46,76,0.395,03/04/2015,2015.0
50,Bucknell (Patriot),4,2-2,32,50,82,0.390,03/04/2015,2015.0
51,Massachusetts (CAA),4,0-4,45,71,116,0.388,03/04/2015,2015.0
52,Mount St. Mary's (NEC),4,1-3,31,49,80,0.388,03/04/2015,2015.0
53,Richmond (SoCon),4,2-2,33,53,86,0.384,03/04/2015,2015.0
54,NJIT (Independent),3,0-3,27,44,71,0.380,03/04/2015,2015.0
55,Detroit Mercy (MAAC),6,4-2,54,89,143,0.378,03/04/2015,2015.0
56,Robert Morris (NEC),4,0-4,36,61,97,0.371,03/04/2015,2015.0
57,Wagner (NEC),4,1-3,30,51,81,0.370,03/04/2015,2015.0
57,Lafayette (Patriot),4,1-3,30,51,81,0.370,03/04/2015,2015.0
59,Virginia (ACC),4,3-1,39,67,106,0.368,03/04/2015,2015.0
60,Holy Cross (Patriot),4,2-2,34,60,94,0.362,03/04/2015,2015.0
61,UMBC (America East),4,2-2,26,46,72,0.361,03/04/2015,2015.0
62,Hobart (NEC),3,2-1,27,49,76,0.355,03/04/2015,2015.0
63,Quinnipiac (MAAC),3,1-2,26,48,74,0.351,03/04/2015,2015.0
64,Monmouth (MAAC),3,2-1,16,30,46,0.348,03/04/2015,2015.0
65,Villanova (Big East),4,3-1,33,62,95,0.347,03/04/2015,2015.0
66,Dartmouth (Ivy League),3,0-3,24,47,71,0.338,03/04/2015,2015.0
67,Manhattan (MAAC),5,0-5,35,75,110,0.318,03/04/2015,2015.0
68,UMass Lowell (America East),3,0-3,22,54,76,0.289,03/04/2015,2015.0
69,Providence (Big East),4,2-2,23,65,88,0.261,03/04/2015,2015.0
1,Ohio St. (Big Ten),6,4-2,91,30,121,0.752,03/03/2015,2015.0
2,Syracuse (ACC),4,4-0,75,30,105,0.714,03/03/2015,2015.0
3,Brown (Ivy League),2,2-0,39,19,58,0.672,03/03/2015,2015.0
4,Rutgers (Big Ten),6,2-4,93,47,140,0.664,03/03/2015,2015.0
5,Denver (Big East),4,3-1,65,33,98,0.663,03/03/2015,2015.0
6,Cornell (Ivy League),4,3-1,72,37,109,0.661,03/03/2015,2015.0
7,Loyola Maryland (Patriot),5,3-2,81,43,124,0.653,03/03/2015,2015.0
8,Fairfield (CAA),4,2-2,55,30,85,0.647,03/03/2015,2015.0
9,Navy (Patriot),5,3-2,63,36,99,0.636,03/03/2015,2015.0
10,Marist (MAAC),2,2-0,25,15,40,0.625,03/03/2015,2015.0
11,Drexel (CAA),5,1-4,76,47,123,0.618,03/03/2015,2015.0
12,Bryant (NEC),4,1-3,53,33,86,0.616,03/03/2015,2015.0
13,Jacksonville (SoCon),3,2-1,47,30,77,0.610,03/03/2015,2015.0
14,Boston U. (Patriot),5,3-2,70,45,115,0.609,03/03/2015,2015.0
15,Vermont (America East),5,1-4,75,50,125,0.600,03/03/2015,2015.0
16,Hofstra (CAA),4,1-3,62,42,104,0.596,03/03/2015,2015.0
17,Notre Dame (ACC),3,3-0,50,35,85,0.588,03/03/2015,2015.0
18,Yale (Ivy League),4,4-0,56,40,96,0.583,03/03/2015,2015.0
19,Stony Brook (America East),4,3-1,55,40,95,0.579,03/03/2015,2015.0
20,High Point (SoCon),6,3-3,94,69,163,0.577,03/03/2015,2015.0
21,Penn St. (Big Ten),4,2-2,54,40,94,0.574,03/03/2015,2015.0
22,Duke (ACC),6,5-1,107,80,187,0.572,03/03/2015,2015.0
23,Johns Hopkins (Big Ten),5,2-3,72,54,126,0.571,03/03/2015,2015.0
24,Hartford (America East),2,1-1,26,20,46,0.565,03/03/2015,2015.0
25,Georgetown (Big East),3,1-2,41,34,75,0.547,03/03/2015,2015.0
26,Penn (Ivy League),5,3-2,63,53,116,0.543,03/03/2015,2015.0
27,Saint Joseph's (NEC),5,2-3,58,49,107,0.542,03/03/2015,2015.0
28,Princeton (Ivy League),3,3-0,45,39,84,0.536,03/03/2015,2015.0
29,Army West Point (Patriot),6,5-1,74,68,142,0.521,03/03/2015,2015.0
30,Michigan (Big Ten),5,3-2,64,63,127,0.504,03/03/2015,2015.0
31,Colgate (Patriot),4,4-0,43,43,86,0.500,03/03/2015,2015.0
31,Mercer (SoCon),3,0-3,40,40,80,0.500,03/03/2015,2015.0
33,Delaware (CAA),6,3-3,67,71,138,0.486,03/03/2015,2015.0
34,Marquette (Big East),5,5-0,56,60,116,0.483,03/03/2015,2015.0
35,Air Force (ECAC),5,2-3,46,51,97,0.474,03/03/2015,2015.0
36,UAlbany (America East),2,1-1,26,29,55,0.473,03/03/2015,2015.0
37,North Carolina (ACC),5,5-0,64,72,136,0.471,03/03/2015,2015.0
37,Harvard (Ivy League),3,2-1,48,54,102,0.471,03/03/2015,2015.0
39,Bellarmine (SoCon),4,1-3,47,54,101,0.465,03/03/2015,2015.0
40,Canisius (MAAC),4,0-4,40,48,88,0.455,03/03/2015,2015.0
41,St. John's (NY) (Big East),5,1-4,51,63,114,0.447,03/03/2015,2015.0
42,Towson (CAA),5,3-2,44,55,99,0.444,03/03/2015,2015.0
43,Maryland (Big Ten),4,3-1,31,39,70,0.443,03/03/2015,2015.0
44,Furman (SoCon),5,1-4,45,58,103,0.437,03/03/2015,2015.0
45,Siena (MAAC),5,3-2,54,71,125,0.432,03/03/2015,2015.0
46,Lehigh (Patriot),4,2-2,38,54,92,0.413,03/03/2015,2015.0
47,VMI (SoCon),4,0-4,39,59,98,0.398,03/03/2015,2015.0
48,Binghamton (America East),3,0-3,30,46,76,0.395,03/03/2015,2015.0
49,Bucknell (Patriot),4,2-2,32,50,82,0.390,03/03/2015,2015.0
50,Massachusetts (CAA),4,0-4,45,71,116,0.388,03/03/2015,2015.0
51,Richmond (SoCon),4,2-2,33,53,86,0.384,03/03/2015,2015.0
52,Sacred Heart (NEC),1,0-1,8,13,21,0.381,03/03/2015,2015.0
53,NJIT (Independent),3,0-3,27,44,71,0.380,03/03/2015,2015.0
54,Detroit Mercy (MAAC),5,3-2,45,75,120,0.375,03/03/2015,2015.0
55,Robert Morris (NEC),4,0-4,36,61,97,0.371,03/03/2015,2015.0
56,Wagner (NEC),4,1-3,30,51,81,0.370,03/03/2015,2015.0
56,Lafayette (Patriot),4,1-3,30,51,81,0.370,03/03/2015,2015.0
58,Virginia (ACC),4,3-1,39,67,106,0.368,03/03/2015,2015.0
59,Mount St. Mary's (NEC),3,1-2,22,38,60,0.367,03/03/2015,2015.0
60,Holy Cross (Patriot),4,2-2,34,60,94,0.362,03/03/2015,2015.0
61,UMBC (America East),4,2-2,26,46,72,0.361,03/03/2015,2015.0
62,Hobart (NEC),3,2-1,27,49,76,0.355,03/03/2015,2015.0
63,Quinnipiac (MAAC),3,1-2,26,48,74,0.351,03/03/2015,2015.0
64,Monmouth (MAAC),3,2-1,16,30,46,0.348,03/03/2015,2015.0
65,Villanova (Big East),4,3-1,33,62,95,0.347,03/03/2015,2015.0
66,Dartmouth (Ivy League),2,0-2,16,34,50,0.320,03/03/2015,2015.0
67,Manhattan (MAAC),5,0-5,35,75,110,0.318,03/03/2015,2015.0
68,UMass Lowell (America East),3,0-3,22,54,76,0.289,03/03/2015,2015.0
69,Providence (Big East),4,2-2,23,65,88,0.261,03/03/2015,2015.0
1,Ohio St. (Big Ten),6,4-2,91,30,121,0.752,03/01/2015,2015.0
2,Syracuse (ACC),4,4-0,75,30,105,0.714,03/01/2015,2015.0
3,Brown (Ivy League),2,2-0,39,19,58,0.672,03/01/2015,2015.0
4,Denver (Big East),4,3-1,65,33,98,0.663,03/01/2015,2015.0
5,Cornell (Ivy League),4,3-1,72,37,109,0.661,03/01/2015,2015.0
6,Rutgers (Big Ten),5,2-3,79,41,120,0.658,03/01/2015,2015.0
7,Loyola Maryland (Patriot),5,3-2,81,43,124,0.653,03/01/2015,2015.0
8,Fairfield (CAA),4,2-2,55,30,85,0.647,03/01/2015,2015.0
9,Navy (Patriot),4,2-2,50,28,78,0.641,03/01/2015,2015.0
10,Yale (Ivy League),3,3-0,45,27,72,0.625,03/01/2015,2015.0
10,Marist (MAAC),2,2-0,25,15,40,0.625,03/01/2015,2015.0
12,Bryant (NEC),4,1-3,53,33,86,0.616,03/01/2015,2015.0
13,Jacksonville (SoCon),2,1-1,32,20,52,0.615,03/01/2015,2015.0
14,Boston U. (Patriot),5,3-2,70,45,115,0.609,03/01/2015,2015.0
15,Drexel (CAA),4,0-4,61,40,101,0.604,03/01/2015,2015.0
16,Saint Joseph's (NEC),4,2-2,51,34,85,0.600,03/01/2015,2015.0
17,Hofstra (CAA),4,1-3,62,42,104,0.596,03/01/2015,2015.0
18,Vermont (America East),4,0-4,56,39,95,0.589,03/01/2015,2015.0
19,Notre Dame (ACC),3,3-0,50,35,85,0.588,03/01/2015,2015.0
20,Stony Brook (America East),4,3-1,55,40,95,0.579,03/01/2015,2015.0
21,High Point (SoCon),6,3-3,94,69,163,0.577,03/01/2015,2015.0
22,Penn St. (Big Ten),4,2-2,54,40,94,0.574,03/01/2015,2015.0
23,Duke (ACC),6,5-1,107,80,187,0.572,03/01/2015,2015.0
24,Johns Hopkins (Big Ten),5,2-3,72,54,126,0.571,03/01/2015,2015.0
25,Hartford (America East),2,1-1,26,20,46,0.565,03/01/2015,2015.0
26,Army West Point (Patriot),5,4-1,68,54,122,0.557,03/01/2015,2015.0
27,Georgetown (Big East),3,1-2,41,34,75,0.547,03/01/2015,2015.0
28,Princeton (Ivy League),3,3-0,45,39,84,0.536,03/01/2015,2015.0
29,Michigan (Big Ten),4,3-1,54,48,102,0.529,03/01/2015,2015.0
30,Penn (Ivy League),4,2-2,49,49,98,0.500,03/01/2015,2015.0
30,Colgate (Patriot),4,4-0,43,43,86,0.500,03/01/2015,2015.0
30,Mercer (SoCon),3,0-3,40,40,80,0.500,03/01/2015,2015.0
33,Marquette (Big East),5,5-0,56,60,116,0.483,03/01/2015,2015.0
34,Air Force (ECAC),5,2-3,46,51,97,0.474,03/01/2015,2015.0
35,UAlbany (America East),2,1-1,26,29,55,0.473,03/01/2015,2015.0
36,North Carolina (ACC),5,5-0,64,72,136,0.471,03/01/2015,2015.0
37,Bellarmine (SoCon),4,1-3,47,54,101,0.465,03/01/2015,2015.0
38,Towson (CAA),4,3-1,36,42,78,0.462,03/01/2015,2015.0
39,Canisius (MAAC),4,0-4,40,48,88,0.455,03/01/2015,2015.0
40,Delaware (CAA),5,2-3,50,61,111,0.450,03/01/2015,2015.0
41,Maryland (Big Ten),4,3-1,31,39,70,0.443,03/01/2015,2015.0
42,Furman (SoCon),5,1-4,45,58,103,0.437,03/01/2015,2015.0
43,Siena (MAAC),5,3-2,54,71,125,0.432,03/01/2015,2015.0
44,St. John's (NY) (Big East),4,1-3,38,52,90,0.422,03/01/2015,2015.0
45,Lehigh (Patriot),4,2-2,38,54,92,0.413,03/01/2015,2015.0
46,Lafayette (Patriot),3,1-2,26,37,63,0.413,03/01/2015,2015.0
47,Harvard (Ivy League),2,1-1,28,41,69,0.406,03/01/2015,2015.0
48,VMI (SoCon),4,0-4,39,59,98,0.398,03/01/2015,2015.0
49,Binghamton (America East),3,0-3,30,46,76,0.395,03/01/2015,2015.0
50,Bucknell (Patriot),4,2-2,32,50,82,0.390,03/01/2015,2015.0
50,NJIT (Independent),2,0-2,16,25,41,0.390,03/01/2015,2015.0
52,Massachusetts (CAA),4,0-4,45,71,116,0.388,03/01/2015,2015.0
53,Richmond (SoCon),4,2-2,33,53,86,0.384,03/01/2015,2015.0
54,Wagner (NEC),3,1-2,26,42,68,0.382,03/01/2015,2015.0
55,Sacred Heart (NEC),1,0-1,8,13,21,0.381,03/01/2015,2015.0
56,Detroit Mercy (MAAC),5,3-2,45,75,120,0.375,03/01/2015,2015.0
57,Robert Morris (NEC),4,0-4,36,61,97,0.371,03/01/2015,2015.0
58,Virginia (ACC),4,3-1,39,67,106,0.368,03/01/2015,2015.0
59,Mount St. Mary's (NEC),3,1-2,22,38,60,0.367,03/01/2015,2015.0
60,UMBC (America East),4,2-2,26,46,72,0.361,03/01/2015,2015.0
61,Holy Cross (Patriot),3,2-1,24,43,67,0.358,03/01/2015,2015.0
62,Hobart (NEC),3,2-1,27,49,76,0.355,03/01/2015,2015.0
63,Villanova (Big East),4,3-1,33,62,95,0.347,03/01/2015,2015.0
64,Dartmouth (Ivy League),2,0-2,16,34,50,0.320,03/01/2015,2015.0
65,Manhattan (MAAC),5,0-5,35,75,110,0.318,03/01/2015,2015.0
66,Quinnipiac (MAAC),2,1-1,13,28,41,0.317,03/01/2015,2015.0
67,UMass Lowell (America East),3,0-3,22,54,76,0.289,03/01/2015,2015.0
68,Providence (Big East),4,2-2,23,65,88,0.261,03/01/2015,2015.0
69,Monmouth (MAAC),2,1-1,7,26,33,0.212,03/01/2015,2015.0
1,Ohio St. (Big Ten),5,4-1,72,26,98,0.735,02/28/2015,2015.0
2,Syracuse (ACC),3,3-0,55,23,78,0.705,02/28/2015,2015.0
3,Brown (Ivy League),2,2-0,39,19,58,0.672,02/28/2015,2015.0
4,Denver (Big East),4,3-1,65,33,98,0.663,02/28/2015,2015.0
5,Cornell (Ivy League),4,3-1,72,37,109,0.661,02/28/2015,2015.0
6,Rutgers (Big Ten),5,2-3,79,41,120,0.658,02/28/2015,2015.0
7,Loyola Maryland (Patriot),5,3-2,81,43,124,0.653,02/28/2015,2015.0
8,Fairfield (CAA),4,2-2,55,30,85,0.647,02/28/2015,2015.0
9,Navy (Patriot),4,2-2,50,28,78,0.641,02/28/2015,2015.0
10,Yale (Ivy League),3,3-0,45,27,72,0.625,02/28/2015,2015.0
10,Marist (MAAC),2,2-0,25,15,40,0.625,02/28/2015,2015.0
12,Bryant (NEC),4,1-3,53,33,86,0.616,02/28/2015,2015.0
13,Jacksonville (SoCon),2,1-1,32,20,52,0.615,02/28/2015,2015.0
14,Boston U. (Patriot),5,3-2,70,45,115,0.609,02/28/2015,2015.0
15,Drexel (CAA),4,0-4,61,40,101,0.604,02/28/2015,2015.0
16,Saint Joseph's (NEC),4,2-2,51,34,85,0.600,02/28/2015,2015.0
17,Hofstra (CAA),4,1-3,62,42,104,0.596,02/28/2015,2015.0
18,Vermont (America East),4,0-4,56,39,95,0.589,02/28/2015,2015.0
19,Notre Dame (ACC),3,3-0,50,35,85,0.588,02/28/2015,2015.0
20,Stony Brook (America East),4,3-1,55,40,95,0.579,02/28/2015,2015.0
21,High Point (SoCon),6,3-3,94,69,163,0.577,02/28/2015,2015.0
22,Penn St. (Big Ten),4,2-2,54,40,94,0.574,02/28/2015,2015.0
23,Johns Hopkins (Big Ten),5,2-3,72,54,126,0.571,02/28/2015,2015.0
24,Hartford (America East),2,1-1,26,20,46,0.565,02/28/2015,2015.0
25,Marquette (Big East),4,4-0,52,41,93,0.559,02/28/2015,2015.0
26,Army West Point (Patriot),5,4-1,68,54,122,0.557,02/28/2015,2015.0
27,Georgetown (Big East),3,1-2,41,34,75,0.547,02/28/2015,2015.0
28,Princeton (Ivy League),3,3-0,45,39,84,0.536,02/28/2015,2015.0
29,Duke (ACC),5,4-1,83,73,156,0.532,02/28/2015,2015.0
30,Michigan (Big Ten),4,3-1,54,48,102,0.529,02/28/2015,2015.0
31,Penn (Ivy League),4,2-2,49,49,98,0.500,02/28/2015,2015.0
31,Colgate (Patriot),4,4-0,43,43,86,0.500,02/28/2015,2015.0
31,Mercer (SoCon),3,0-3,40,40,80,0.500,02/28/2015,2015.0
34,Air Force (ECAC),5,2-3,46,51,97,0.474,02/28/2015,2015.0
35,UAlbany (America East),2,1-1,26,29,55,0.473,02/28/2015,2015.0
36,North Carolina (ACC),5,5-0,64,72,136,0.471,02/28/2015,2015.0
37,Towson (CAA),4,3-1,36,42,78,0.462,02/28/2015,2015.0
38,Canisius (MAAC),4,0-4,40,48,88,0.455,02/28/2015,2015.0
39,Delaware (CAA),5,2-3,50,61,111,0.450,02/28/2015,2015.0
40,Bellarmine (SoCon),3,1-2,32,40,72,0.444,02/28/2015,2015.0
41,Maryland (Big Ten),4,3-1,31,39,70,0.443,02/28/2015,2015.0
42,Furman (SoCon),5,1-4,45,58,103,0.437,02/28/2015,2015.0
43,Siena (MAAC),5,3-2,54,71,125,0.432,02/28/2015,2015.0
44,St. John's (NY) (Big East),4,1-3,38,52,90,0.422,02/28/2015,2015.0
45,Lehigh (Patriot),4,2-2,38,54,92,0.413,02/28/2015,2015.0
46,Lafayette (Patriot),3,1-2,26,37,63,0.413,02/28/2015,2015.0
47,Harvard (Ivy League),2,1-1,28,41,69,0.406,02/28/2015,2015.0
48,Virginia (ACC),3,3-0,32,47,79,0.405,02/28/2015,2015.0
49,VMI (SoCon),4,0-4,39,59,98,0.398,02/28/2015,2015.0
50,Binghamton (America East),3,0-3,30,46,76,0.395,02/28/2015,2015.0
51,Bucknell (Patriot),4,2-2,32,50,82,0.390,02/28/2015,2015.0
51,NJIT (Independent),2,0-2,16,25,41,0.390,02/28/2015,2015.0
53,Massachusetts (CAA),4,0-4,45,71,116,0.388,02/28/2015,2015.0
54,Richmond (SoCon),4,2-2,33,53,86,0.384,02/28/2015,2015.0
55,Wagner (NEC),3,1-2,26,42,68,0.382,02/28/2015,2015.0
56,Sacred Heart (NEC),1,0-1,8,13,21,0.381,02/28/2015,2015.0
57,Robert Morris (NEC),4,0-4,36,61,97,0.371,02/28/2015,2015.0
58,Mount St. Mary's (NEC),3,1-2,22,38,60,0.367,02/28/2015,2015.0
59,UMBC (America East),4,2-2,26,46,72,0.361,02/28/2015,2015.0
60,Holy Cross (Patriot),3,2-1,24,43,67,0.358,02/28/2015,2015.0
61,Hobart (NEC),3,2-1,27,49,76,0.355,02/28/2015,2015.0
62,Villanova (Big East),4,3-1,33,62,95,0.347,02/28/2015,2015.0
63,Detroit Mercy (MAAC),4,2-2,31,60,91,0.341,02/28/2015,2015.0
64,Dartmouth (Ivy League),2,0-2,16,34,50,0.320,02/28/2015,2015.0
65,Manhattan (MAAC),5,0-5,35,75,110,0.318,02/28/2015,2015.0
66,Quinnipiac (MAAC),2,1-1,13,28,41,0.317,02/28/2015,2015.0
67,UMass Lowell (America East),3,0-3,22,54,76,0.289,02/28/2015,2015.0
68,Providence (Big East),3,2-1,16,41,57,0.281,02/28/2015,2015.0
69,Monmouth (MAAC),2,1-1,7,26,33,0.212,02/28/2015,2015.0
1,Yale (Ivy League),2,2-0,35,9,44,0.795,02/27/2015,2015.0
2,Ohio St. (Big Ten),5,4-1,72,26,98,0.735,02/27/2015,2015.0
3,Brown (Ivy League),1,1-0,19,7,26,0.731,02/27/2015,2015.0
4,Syracuse (ACC),3,3-0,55,23,78,0.705,02/27/2015,2015.0
5,Cornell (Ivy League),3,2-1,55,25,80,0.688,02/27/2015,2015.0
6,Denver (Big East),4,3-1,65,33,98,0.663,02/27/2015,2015.0
7,Fairfield (CAA),3,2-1,41,22,63,0.651,02/27/2015,2015.0
8,Boston U. (Patriot),4,2-2,59,32,91,0.648,02/27/2015,2015.0
9,Navy (Patriot),3,1-2,40,22,62,0.645,02/27/2015,2015.0
10,Stony Brook (America East),3,2-1,47,26,73,0.644,02/27/2015,2015.0
11,Hofstra (CAA),3,1-2,48,28,76,0.632,02/27/2015,2015.0
12,Loyola Maryland (Patriot),4,2-2,65,38,103,0.631,02/27/2015,2015.0
13,Marist (MAAC),2,2-0,25,15,40,0.625,02/27/2015,2015.0
14,Johns Hopkins (Big Ten),4,2-2,57,35,92,0.620,02/27/2015,2015.0
15,Jacksonville (SoCon),2,1-1,32,20,52,0.615,02/27/2015,2015.0
16,Drexel (CAA),3,0-3,50,32,82,0.610,02/27/2015,2015.0
17,Rutgers (Big Ten),4,2-2,59,38,97,0.608,02/27/2015,2015.0
18,Vermont (America East),3,0-3,43,28,71,0.606,02/27/2015,2015.0
19,Bryant (NEC),3,1-2,35,23,58,0.603,02/27/2015,2015.0
20,Saint Joseph's (NEC),4,2-2,51,34,85,0.600,02/27/2015,2015.0
21,Hartford (America East),1,0-1,14,10,24,0.583,02/27/2015,2015.0
22,Georgetown (Big East),2,0-2,27,20,47,0.574,02/27/2015,2015.0
23,Penn St. (Big Ten),3,1-2,37,28,65,0.569,02/27/2015,2015.0
24,Marquette (Big East),4,4-0,52,41,93,0.559,02/27/2015,2015.0
25,High Point (SoCon),5,2-3,75,61,136,0.551,02/27/2015,2015.0
26,UAlbany (America East),1,1-0,14,12,26,0.538,02/27/2015,2015.0
27,Michigan (Big Ten),3,2-1,44,38,82,0.537,02/27/2015,2015.0
28,Penn (Ivy League),3,2-1,37,32,69,0.536,02/27/2015,2015.0
29,Notre Dame (ACC),2,2-0,31,27,58,0.534,02/27/2015,2015.0
30,Harvard (Ivy League),1,1-0,16,14,30,0.533,02/27/2015,2015.0
31,Army West Point (Patriot),4,3-1,54,48,102,0.529,02/27/2015,2015.0
32,Princeton (Ivy League),2,2-0,26,24,50,0.520,02/27/2015,2015.0
33,Mercer (SoCon),3,0-3,40,40,80,0.500,02/27/2015,2015.0
34,Duke (ACC),4,3-1,56,61,117,0.479,02/27/2015,2015.0
35,Furman (SoCon),4,1-3,43,47,90,0.478,02/27/2015,2015.0
36,North Carolina (ACC),5,5-0,64,72,136,0.471,02/27/2015,2015.0
37,Lafayette (Patriot),2,1-1,20,23,43,0.465,02/27/2015,2015.0
38,Lehigh (Patriot),3,2-1,33,38,71,0.465,02/27/2015,2015.0
39,Delaware (CAA),4,2-2,43,50,93,0.462,02/27/2015,2015.0
40,Towson (CAA),4,3-1,36,42,78,0.462,02/27/2015,2015.0
41,Maryland (Big Ten),3,2-1,23,28,51,0.451,02/27/2015,2015.0
42,Bellarmine (SoCon),3,1-2,32,40,72,0.444,02/27/2015,2015.0
43,Siena (MAAC),4,2-2,47,59,106,0.443,02/27/2015,2015.0
44,Canisius (MAAC),3,0-3,30,38,68,0.441,02/27/2015,2015.0
45,Colgate (Patriot),3,3-0,28,36,64,0.438,02/27/2015,2015.0
46,Air Force (ECAC),4,1-3,35,49,84,0.417,02/27/2015,2015.0
46,Bucknell (Patriot),3,2-1,25,35,60,0.417,02/27/2015,2015.0
48,Virginia (ACC),3,3-0,32,47,79,0.405,02/27/2015,2015.0
49,Robert Morris (NEC),3,0-3,28,42,70,0.400,02/27/2015,2015.0
49,Monmouth (MAAC),1,0-1,4,6,10,0.400,02/27/2015,2015.0
51,VMI (SoCon),4,0-4,39,59,98,0.398,02/27/2015,2015.0
52,Massachusetts (CAA),3,0-3,33,51,84,0.393,02/27/2015,2015.0
53,Sacred Heart (NEC),1,0-1,8,13,21,0.381,02/27/2015,2015.0
54,Mount St. Mary's (NEC),3,1-2,22,38,60,0.367,02/27/2015,2015.0
55,St. John's (NY) (Big East),3,1-2,26,45,71,0.366,02/27/2015,2015.0
56,Richmond (SoCon),3,2-1,24,44,68,0.353,02/27/2015,2015.0
56,Holy Cross (Patriot),2,2-0,18,33,51,0.353,02/27/2015,2015.0
58,Dartmouth (Ivy League),1,0-1,8,15,23,0.348,02/27/2015,2015.0
59,Detroit Mercy (MAAC),4,2-2,31,60,91,0.341,02/27/2015,2015.0
60,Binghamton (America East),2,0-2,17,35,52,0.327,02/27/2015,2015.0
61,UMBC (America East),3,1-2,17,37,54,0.315,02/27/2015,2015.0
62,Hobart (NEC),2,1-1,16,36,52,0.308,02/27/2015,2015.0
63,Wagner (NEC),2,0-2,13,31,44,0.295,02/27/2015,2015.0
64,Villanova (Big East),3,2-1,22,55,77,0.286,02/27/2015,2015.0
65,Manhattan (MAAC),4,0-4,25,63,88,0.284,02/27/2015,2015.0
66,Providence (Big East),3,2-1,16,41,57,0.281,02/27/2015,2015.0
67,Quinnipiac (MAAC),1,0-1,7,19,26,0.269,02/27/2015,2015.0
67,NJIT (Independent),1,0-1,7,19,26,0.269,02/27/2015,2015.0
69,UMass Lowell (America East),2,0-2,11,41,52,0.212,02/27/2015,2015.0
1,Yale (Ivy League),2,2-0,35,9,44,0.795,02/25/2015,2015.0
2,Brown (Ivy League),1,1-0,19,7,26,0.731,02/25/2015,2015.0
3,Ohio St. (Big Ten),4,3-1,58,22,80,0.725,02/25/2015,2015.0
4,Denver (Big East),3,3-0,53,21,74,0.716,02/25/2015,2015.0
5,Syracuse (ACC),3,3-0,55,23,78,0.705,02/25/2015,2015.0
6,Cornell (Ivy League),3,2-1,55,25,80,0.688,02/25/2015,2015.0
7,Fairfield (CAA),3,2-1,41,22,63,0.651,02/25/2015,2015.0
8,Boston U. (Patriot),4,2-2,59,32,91,0.648,02/25/2015,2015.0
9,Navy (Patriot),3,1-2,40,22,62,0.645,02/25/2015,2015.0
10,Stony Brook (America East),3,2-1,47,26,73,0.644,02/25/2015,2015.0
11,Hofstra (CAA),3,1-2,48,28,76,0.632,02/25/2015,2015.0
12,Loyola Maryland (Patriot),4,2-2,65,38,103,0.631,02/25/2015,2015.0
13,Marist (MAAC),2,2-0,25,15,40,0.625,02/25/2015,2015.0
14,Johns Hopkins (Big Ten),4,2-2,57,35,92,0.620,02/25/2015,2015.0
15,Jacksonville (SoCon),2,1-1,32,20,52,0.615,02/25/2015,2015.0
16,Drexel (CAA),3,0-3,50,32,82,0.610,02/25/2015,2015.0
17,Rutgers (Big Ten),4,2-2,59,38,97,0.608,02/25/2015,2015.0
18,Vermont (America East),3,0-3,43,28,71,0.606,02/25/2015,2015.0
19,Bryant (NEC),3,1-2,35,23,58,0.603,02/25/2015,2015.0
20,Saint Joseph's (NEC),4,2-2,51,34,85,0.600,02/25/2015,2015.0
21,Hartford (America East),1,0-1,14,10,24,0.583,02/25/2015,2015.0
22,Georgetown (Big East),2,0-2,27,20,47,0.574,02/25/2015,2015.0
23,Penn St. (Big Ten),3,1-2,37,28,65,0.569,02/25/2015,2015.0
24,High Point (SoCon),5,2-3,75,61,136,0.551,02/25/2015,2015.0
25,UAlbany (America East),1,1-0,14,12,26,0.538,02/25/2015,2015.0
26,Michigan (Big Ten),3,2-1,44,38,82,0.537,02/25/2015,2015.0
27,Penn (Ivy League),3,2-1,37,32,69,0.536,02/25/2015,2015.0
28,Notre Dame (ACC),2,2-0,31,27,58,0.534,02/25/2015,2015.0
29,Harvard (Ivy League),1,1-0,16,14,30,0.533,02/25/2015,2015.0
30,Army West Point (Patriot),4,3-1,54,48,102,0.529,02/25/2015,2015.0
31,Marquette (Big East),3,3-0,38,34,72,0.528,02/25/2015,2015.0
32,Princeton (Ivy League),2,2-0,26,24,50,0.520,02/25/2015,2015.0
33,Bellarmine (SoCon),2,1-1,28,26,54,0.519,02/25/2015,2015.0
34,Mercer (SoCon),3,0-3,40,40,80,0.500,02/25/2015,2015.0
35,Duke (ACC),4,3-1,56,61,117,0.479,02/25/2015,2015.0
36,Furman (SoCon),4,1-3,43,47,90,0.478,02/25/2015,2015.0
37,Lafayette (Patriot),2,1-1,20,23,43,0.465,02/25/2015,2015.0
38,Lehigh (Patriot),3,2-1,33,38,71,0.465,02/25/2015,2015.0
39,North Carolina (ACC),4,4-0,52,60,112,0.464,02/25/2015,2015.0
40,Delaware (CAA),4,2-2,43,50,93,0.462,02/25/2015,2015.0
41,Maryland (Big Ten),3,2-1,23,28,51,0.451,02/25/2015,2015.0
42,Siena (MAAC),4,2-2,47,59,106,0.443,02/25/2015,2015.0
43,Canisius (MAAC),3,0-3,30,38,68,0.441,02/25/2015,2015.0
44,Colgate (Patriot),3,3-0,28,36,64,0.438,02/25/2015,2015.0
45,Air Force (ECAC),4,1-3,35,49,84,0.417,02/25/2015,2015.0
45,Bucknell (Patriot),3,2-1,25,35,60,0.417,02/25/2015,2015.0
47,Towson (CAA),3,2-1,26,37,63,0.413,02/25/2015,2015.0
48,Virginia (ACC),3,3-0,32,47,79,0.405,02/25/2015,2015.0
49,Robert Morris (NEC),3,0-3,28,42,70,0.400,02/25/2015,2015.0
49,Monmouth (MAAC),1,0-1,4,6,10,0.400,02/25/2015,2015.0
51,VMI (SoCon),4,0-4,39,59,98,0.398,02/25/2015,2015.0
52,Massachusetts (CAA),3,0-3,33,51,84,0.393,02/25/2015,2015.0
53,Sacred Heart (NEC),1,0-1,8,13,21,0.381,02/25/2015,2015.0
54,Mount St. Mary's (NEC),2,1-1,17,28,45,0.378,02/25/2015,2015.0
55,St. John's (NY) (Big East),3,1-2,26,45,71,0.366,02/25/2015,2015.0
56,Richmond (SoCon),3,2-1,24,44,68,0.353,02/25/2015,2015.0
56,Holy Cross (Patriot),2,2-0,18,33,51,0.353,02/25/2015,2015.0
58,Dartmouth (Ivy League),1,0-1,8,15,23,0.348,02/25/2015,2015.0
59,Detroit Mercy (MAAC),3,2-1,24,46,70,0.343,02/25/2015,2015.0
60,Binghamton (America East),2,0-2,17,35,52,0.327,02/25/2015,2015.0
61,UMBC (America East),3,1-2,17,37,54,0.315,02/25/2015,2015.0
62,Hobart (NEC),2,1-1,16,36,52,0.308,02/25/2015,2015.0
63,Wagner (NEC),2,0-2,13,31,44,0.295,02/25/2015,2015.0
64,Villanova (Big East),3,2-1,22,55,77,0.286,02/25/2015,2015.0
65,Manhattan (MAAC),4,0-4,25,63,88,0.284,02/25/2015,2015.0
66,Providence (Big East),3,2-1,16,41,57,0.281,02/25/2015,2015.0
67,Quinnipiac (MAAC),1,0-1,7,19,26,0.269,02/25/2015,2015.0
67,NJIT (Independent),1,0-1,7,19,26,0.269,02/25/2015,2015.0
69,UMass Lowell (America East),2,0-2,11,41,52,0.212,02/25/2015,2015.0
1,Yale (Ivy League),2,2-0,35,9,44,0.795,02/24/2015,2015.0
2,Brown (Ivy League),1,1-0,19,7,26,0.731,02/24/2015,2015.0
3,Ohio St. (Big Ten),4,3-1,58,22,80,0.725,02/24/2015,2015.0
4,Denver (Big East),3,3-0,53,21,74,0.716,02/24/2015,2015.0
5,Syracuse (ACC),3,3-0,55,23,78,0.705,02/24/2015,2015.0
6,Cornell (Ivy League),3,2-1,55,25,80,0.688,02/24/2015,2015.0
7,Fairfield (CAA),3,2-1,41,22,63,0.651,02/24/2015,2015.0
8,Navy (Patriot),3,1-2,40,22,62,0.645,02/24/2015,2015.0
9,Stony Brook (America East),3,2-1,47,26,73,0.644,02/24/2015,2015.0
10,Hofstra (CAA),3,1-2,48,28,76,0.632,02/24/2015,2015.0
11,Loyola Maryland (Patriot),4,2-2,65,38,103,0.631,02/24/2015,2015.0
12,Marist (MAAC),2,2-0,25,15,40,0.625,02/24/2015,2015.0
13,Saint Joseph's (NEC),3,1-2,43,26,69,0.623,02/24/2015,2015.0
14,Johns Hopkins (Big Ten),4,2-2,57,35,92,0.620,02/24/2015,2015.0
15,Jacksonville (SoCon),2,1-1,32,20,52,0.615,02/24/2015,2015.0
16,Drexel (CAA),3,0-3,50,32,82,0.610,02/24/2015,2015.0
17,Rutgers (Big Ten),4,2-2,59,38,97,0.608,02/24/2015,2015.0
18,Vermont (America East),3,0-3,43,28,71,0.606,02/24/2015,2015.0
19,Boston U. (Patriot),3,2-1,46,30,76,0.605,02/24/2015,2015.0
20,Bryant (NEC),3,1-2,35,23,58,0.603,02/24/2015,2015.0
21,Hartford (America East),1,0-1,14,10,24,0.583,02/24/2015,2015.0
22,Georgetown (Big East),2,0-2,27,20,47,0.574,02/24/2015,2015.0
23,Penn St. (Big Ten),3,1-2,37,28,65,0.569,02/24/2015,2015.0
24,High Point (SoCon),5,2-3,75,61,136,0.551,02/24/2015,2015.0
25,UAlbany (America East),1,1-0,14,12,26,0.538,02/24/2015,2015.0
26,Michigan (Big Ten),3,2-1,44,38,82,0.537,02/24/2015,2015.0
27,Penn (Ivy League),3,2-1,37,32,69,0.536,02/24/2015,2015.0
28,Notre Dame (ACC),2,2-0,31,27,58,0.534,02/24/2015,2015.0
29,Harvard (Ivy League),1,1-0,16,14,30,0.533,02/24/2015,2015.0
30,Army West Point (Patriot),4,3-1,54,48,102,0.529,02/24/2015,2015.0
31,Marquette (Big East),3,3-0,38,34,72,0.528,02/24/2015,2015.0
32,Princeton (Ivy League),2,2-0,26,24,50,0.520,02/24/2015,2015.0
33,Bellarmine (SoCon),2,1-1,28,26,54,0.519,02/24/2015,2015.0
34,Mercer (SoCon),3,0-3,40,40,80,0.500,02/24/2015,2015.0
35,Duke (ACC),4,3-1,56,61,117,0.479,02/24/2015,2015.0
36,Furman (SoCon),4,1-3,43,47,90,0.478,02/24/2015,2015.0
37,Lafayette (Patriot),2,1-1,20,23,43,0.465,02/24/2015,2015.0
38,Lehigh (Patriot),3,2-1,33,38,71,0.465,02/24/2015,2015.0
39,North Carolina (ACC),4,4-0,52,60,112,0.464,02/24/2015,2015.0
40,Delaware (CAA),4,2-2,43,50,93,0.462,02/24/2015,2015.0
41,Maryland (Big Ten),3,2-1,23,28,51,0.451,02/24/2015,2015.0
42,Siena (MAAC),4,2-2,47,59,106,0.443,02/24/2015,2015.0
43,Canisius (MAAC),3,0-3,30,38,68,0.441,02/24/2015,2015.0
44,Colgate (Patriot),3,3-0,28,36,64,0.438,02/24/2015,2015.0
45,Air Force (ECAC),4,1-3,35,49,84,0.417,02/24/2015,2015.0
45,Bucknell (Patriot),3,2-1,25,35,60,0.417,02/24/2015,2015.0
47,Towson (CAA),3,2-1,26,37,63,0.413,02/24/2015,2015.0
48,Virginia (ACC),3,3-0,32,47,79,0.405,02/24/2015,2015.0
49,Robert Morris (NEC),3,0-3,28,42,70,0.400,02/24/2015,2015.0
49,Monmouth (MAAC),1,0-1,4,6,10,0.400,02/24/2015,2015.0
51,Massachusetts (CAA),3,0-3,33,51,84,0.393,02/24/2015,2015.0
52,Sacred Heart (NEC),1,0-1,8,13,21,0.381,02/24/2015,2015.0
53,VMI (SoCon),3,0-3,31,51,82,0.378,02/24/2015,2015.0
54,Mount St. Mary's (NEC),2,1-1,17,28,45,0.378,02/24/2015,2015.0
55,St. John's (NY) (Big East),3,1-2,26,45,71,0.366,02/24/2015,2015.0
56,Richmond (SoCon),3,2-1,24,44,68,0.353,02/24/2015,2015.0
56,Holy Cross (Patriot),2,2-0,18,33,51,0.353,02/24/2015,2015.0
58,Dartmouth (Ivy League),1,0-1,8,15,23,0.348,02/24/2015,2015.0
59,Detroit Mercy (MAAC),3,2-1,24,46,70,0.343,02/24/2015,2015.0
60,Providence (Big East),2,1-1,14,28,42,0.333,02/24/2015,2015.0
61,Binghamton (America East),2,0-2,17,35,52,0.327,02/24/2015,2015.0
62,UMBC (America East),3,1-2,17,37,54,0.315,02/24/2015,2015.0
63,Hobart (NEC),2,1-1,16,36,52,0.308,02/24/2015,2015.0
64,Wagner (NEC),2,0-2,13,31,44,0.295,02/24/2015,2015.0
65,Villanova (Big East),3,2-1,22,55,77,0.286,02/24/2015,2015.0
66,Manhattan (MAAC),4,0-4,25,63,88,0.284,02/24/2015,2015.0
67,NJIT (Independent),1,0-1,7,19,26,0.269,02/24/2015,2015.0
67,Quinnipiac (MAAC),1,0-1,7,19,26,0.269,02/24/2015,2015.0
69,UMass Lowell (America East),2,0-2,11,41,52,0.212,02/24/2015,2015.0
1,Yale (Ivy League),2,2-0,35,9,44,0.795,02/23/2015,2015.0
2,Brown (Ivy League),1,1-0,19,7,26,0.731,02/23/2015,2015.0
3,Ohio St. (Big Ten),4,3-1,58,22,80,0.725,02/23/2015,2015.0
4,Denver (Big East),3,3-0,53,21,74,0.716,02/23/2015,2015.0
5,Syracuse (ACC),3,3-0,55,23,78,0.705,02/23/2015,2015.0
6,Cornell (Ivy League),2,1-1,35,16,51,0.686,02/23/2015,2015.0
7,Fairfield (CAA),3,2-1,41,22,63,0.651,02/23/2015,2015.0
8,Navy (Patriot),3,1-2,40,22,62,0.645,02/23/2015,2015.0
9,Stony Brook (America East),3,2-1,47,26,73,0.644,02/23/2015,2015.0
10,Loyola Maryland (Patriot),4,2-2,65,38,103,0.631,02/23/2015,2015.0
11,Marist (MAAC),2,2-0,25,15,40,0.625,02/23/2015,2015.0
12,Saint Joseph's (NEC),3,1-2,43,26,69,0.623,02/23/2015,2015.0
13,Johns Hopkins (Big Ten),4,2-2,57,35,92,0.620,02/23/2015,2015.0
14,Penn (Ivy League),2,2-0,29,18,47,0.617,02/23/2015,2015.0
15,Jacksonville (SoCon),2,1-1,32,20,52,0.615,02/23/2015,2015.0
16,Vermont (America East),3,0-3,43,28,71,0.606,02/23/2015,2015.0
17,Boston U. (Patriot),3,2-1,46,30,76,0.605,02/23/2015,2015.0
18,Bryant (NEC),3,1-2,35,23,58,0.603,02/23/2015,2015.0
19,Hartford (America East),1,0-1,14,10,24,0.583,02/23/2015,2015.0
20,Georgetown (Big East),2,0-2,27,20,47,0.574,02/23/2015,2015.0
21,Penn St. (Big Ten),3,1-2,37,28,65,0.569,02/23/2015,2015.0
22,Rutgers (Big Ten),3,1-2,40,31,71,0.563,02/23/2015,2015.0
23,High Point (SoCon),5,2-3,75,61,136,0.551,02/23/2015,2015.0
24,UAlbany (America East),1,1-0,14,12,26,0.538,02/23/2015,2015.0
25,Drexel (CAA),2,0-2,29,25,54,0.537,02/23/2015,2015.0
26,Michigan (Big Ten),3,2-1,44,38,82,0.537,02/23/2015,2015.0
27,Notre Dame (ACC),2,2-0,31,27,58,0.534,02/23/2015,2015.0
28,Harvard (Ivy League),1,1-0,16,14,30,0.533,02/23/2015,2015.0
29,Army West Point (Patriot),4,3-1,54,48,102,0.529,02/23/2015,2015.0
30,Marquette (Big East),3,3-0,38,34,72,0.528,02/23/2015,2015.0
31,Princeton (Ivy League),2,2-0,26,24,50,0.520,02/23/2015,2015.0
32,Hofstra (CAA),2,0-2,28,26,54,0.519,02/23/2015,2015.0
32,Bellarmine (SoCon),2,1-1,28,26,54,0.519,02/23/2015,2015.0
34,Siena (MAAC),3,1-2,39,41,80,0.488,02/23/2015,2015.0
35,Duke (ACC),4,3-1,56,61,117,0.479,02/23/2015,2015.0
36,Furman (SoCon),4,1-3,43,47,90,0.478,02/23/2015,2015.0
37,Lafayette (Patriot),2,1-1,20,23,43,0.465,02/23/2015,2015.0
38,Lehigh (Patriot),3,2-1,33,38,71,0.465,02/23/2015,2015.0
39,North Carolina (ACC),4,4-0,52,60,112,0.464,02/23/2015,2015.0
40,Canisius (MAAC),3,0-3,30,38,68,0.441,02/23/2015,2015.0
41,Colgate (Patriot),3,3-0,28,36,64,0.438,02/23/2015,2015.0
42,Air Force (ECAC),4,1-3,35,49,84,0.417,02/23/2015,2015.0
42,Bucknell (Patriot),3,2-1,25,35,60,0.417,02/23/2015,2015.0
44,Towson (CAA),3,2-1,26,37,63,0.413,02/23/2015,2015.0
45,Mercer (SoCon),2,0-2,22,32,54,0.407,02/23/2015,2015.0
46,Delaware (CAA),3,1-2,28,41,69,0.406,02/23/2015,2015.0
47,Virginia (ACC),3,3-0,32,47,79,0.405,02/23/2015,2015.0
48,Robert Morris (NEC),3,0-3,28,42,70,0.400,02/23/2015,2015.0
48,Monmouth (MAAC),1,0-1,4,6,10,0.400,02/23/2015,2015.0
50,Massachusetts (CAA),3,0-3,33,51,84,0.393,02/23/2015,2015.0
51,Mount St. Mary's (NEC),1,1-0,8,13,21,0.381,02/23/2015,2015.0
51,Sacred Heart (NEC),1,0-1,8,13,21,0.381,02/23/2015,2015.0
53,VMI (SoCon),3,0-3,31,51,82,0.378,02/23/2015,2015.0
54,St. John's (NY) (Big East),3,1-2,26,45,71,0.366,02/23/2015,2015.0
55,Richmond (SoCon),3,2-1,24,44,68,0.353,02/23/2015,2015.0
55,Holy Cross (Patriot),2,2-0,18,33,51,0.353,02/23/2015,2015.0
57,Manhattan (MAAC),3,0-3,23,43,66,0.348,02/23/2015,2015.0
58,Binghamton (America East),1,0-1,8,15,23,0.348,02/23/2015,2015.0
58,Dartmouth (Ivy League),1,0-1,8,15,23,0.348,02/23/2015,2015.0
60,Detroit Mercy (MAAC),3,2-1,24,46,70,0.343,02/23/2015,2015.0
61,Providence (Big East),2,1-1,14,28,42,0.333,02/23/2015,2015.0
61,Wagner (NEC),1,0-1,6,12,18,0.333,02/23/2015,2015.0
63,UMBC (America East),3,1-2,17,37,54,0.315,02/23/2015,2015.0
64,Maryland (Big Ten),2,1-1,9,20,29,0.310,02/23/2015,2015.0
65,Hobart (NEC),2,1-1,16,36,52,0.308,02/23/2015,2015.0
66,Villanova (Big East),2,1-1,15,34,49,0.306,02/23/2015,2015.0
67,Quinnipiac (MAAC),1,0-1,7,19,26,0.269,02/23/2015,2015.0
67,NJIT (Independent),1,0-1,7,19,26,0.269,02/23/2015,2015.0
69,UMass Lowell (America East),2,0-2,11,41,52,0.212,02/23/2015,2015.0
1,Yale (Ivy League),2,2-0,35,9,44,0.795,02/22/2015,2015.0
2,Brown (Ivy League),1,1-0,19,7,26,0.731,02/22/2015,2015.0
3,Ohio St. (Big Ten),4,3-1,58,22,80,0.725,02/22/2015,2015.0
4,Denver (Big East),3,3-0,53,21,74,0.716,02/22/2015,2015.0
5,Syracuse (ACC),3,3-0,55,23,78,0.705,02/22/2015,2015.0
6,Cornell (Ivy League),2,1-1,35,16,51,0.686,02/22/2015,2015.0
7,Fairfield (CAA),3,2-1,41,22,63,0.651,02/22/2015,2015.0
8,Navy (Patriot),3,1-2,40,22,62,0.645,02/22/2015,2015.0
9,Stony Brook (America East),3,2-1,47,26,73,0.644,02/22/2015,2015.0
10,Loyola Maryland (Patriot),4,2-2,65,38,103,0.631,02/22/2015,2015.0
11,Marist (MAAC),2,2-0,25,15,40,0.625,02/22/2015,2015.0
12,Saint Joseph's (NEC),3,1-2,43,26,69,0.623,02/22/2015,2015.0
13,Johns Hopkins (Big Ten),4,2-2,57,35,92,0.620,02/22/2015,2015.0
14,Penn (Ivy League),2,2-0,29,18,47,0.617,02/22/2015,2015.0
15,Jacksonville (SoCon),2,1-1,32,20,52,0.615,02/22/2015,2015.0
16,Vermont (America East),3,0-3,43,28,71,0.606,02/22/2015,2015.0
17,Boston U. (Patriot),3,2-1,46,30,76,0.605,02/22/2015,2015.0
18,Bryant (NEC),3,1-2,35,23,58,0.603,02/22/2015,2015.0
19,Hartford (America East),1,0-1,14,10,24,0.583,02/22/2015,2015.0
20,Georgetown (Big East),2,0-2,27,20,47,0.574,02/22/2015,2015.0
21,Penn St. (Big Ten),3,1-2,37,28,65,0.569,02/22/2015,2015.0
22,Rutgers (Big Ten),3,1-2,40,31,71,0.563,02/22/2015,2015.0
23,High Point (SoCon),5,2-3,75,61,136,0.551,02/22/2015,2015.0
24,UAlbany (America East),1,1-0,14,12,26,0.538,02/22/2015,2015.0
25,Drexel (CAA),2,0-2,29,25,54,0.537,02/22/2015,2015.0
26,Michigan (Big Ten),3,2-1,44,38,82,0.537,02/22/2015,2015.0
27,Notre Dame (ACC),2,2-0,31,27,58,0.534,02/22/2015,2015.0
28,Harvard (Ivy League),1,1-0,16,14,30,0.533,02/22/2015,2015.0
29,Army West Point (Patriot),4,3-1,54,48,102,0.529,02/22/2015,2015.0
30,Marquette (Big East),3,3-0,38,34,72,0.528,02/22/2015,2015.0
31,Princeton (Ivy League),2,2-0,26,24,50,0.520,02/22/2015,2015.0
32,Hofstra (CAA),2,0-2,28,26,54,0.519,02/22/2015,2015.0
32,Bellarmine (SoCon),2,1-1,28,26,54,0.519,02/22/2015,2015.0
34,Siena (MAAC),3,1-2,39,41,80,0.488,02/22/2015,2015.0
35,Duke (ACC),4,3-1,56,61,117,0.479,02/22/2015,2015.0
36,Furman (SoCon),4,1-3,43,47,90,0.478,02/22/2015,2015.0
37,Lafayette (Patriot),2,1-1,20,23,43,0.465,02/22/2015,2015.0
38,Lehigh (Patriot),3,2-1,33,38,71,0.465,02/22/2015,2015.0
39,North Carolina (ACC),4,4-0,52,60,112,0.464,02/22/2015,2015.0
40,Monmouth (MAAC),1,0-1,5,6,11,0.455,02/22/2015,2015.0
41,Canisius (MAAC),3,0-3,30,38,68,0.441,02/22/2015,2015.0
42,Colgate (Patriot),3,3-0,28,36,64,0.438,02/22/2015,2015.0
43,Air Force (ECAC),4,1-3,35,49,84,0.417,02/22/2015,2015.0
43,Bucknell (Patriot),3,2-1,25,35,60,0.417,02/22/2015,2015.0
45,Towson (CAA),3,2-1,26,37,63,0.413,02/22/2015,2015.0
46,Mercer (SoCon),2,0-2,22,32,54,0.407,02/22/2015,2015.0
47,Delaware (CAA),3,1-2,28,41,69,0.406,02/22/2015,2015.0
48,Virginia (ACC),3,3-0,32,47,79,0.405,02/22/2015,2015.0
49,Robert Morris (NEC),3,0-3,28,42,70,0.400,02/22/2015,2015.0
50,Massachusetts (CAA),3,0-3,33,51,84,0.393,02/22/2015,2015.0
51,Mount St. Mary's (NEC),1,1-0,8,13,21,0.381,02/22/2015,2015.0
51,Sacred Heart (NEC),1,0-1,8,13,21,0.381,02/22/2015,2015.0
53,VMI (SoCon),3,0-3,31,51,82,0.378,02/22/2015,2015.0
54,St. John's (NY) (Big East),3,1-2,26,45,71,0.366,02/22/2015,2015.0
55,Richmond (SoCon),3,2-1,24,44,68,0.353,02/22/2015,2015.0
55,Holy Cross (Patriot),2,2-0,18,33,51,0.353,02/22/2015,2015.0
57,Manhattan (MAAC),3,0-3,23,43,66,0.348,02/22/2015,2015.0
58,Binghamton (America East),1,0-1,8,15,23,0.348,02/22/2015,2015.0
58,Dartmouth (Ivy League),1,0-1,8,15,23,0.348,02/22/2015,2015.0
60,Detroit Mercy (MAAC),3,2-1,24,46,70,0.343,02/22/2015,2015.0
61,Providence (Big East),2,1-1,14,28,42,0.333,02/22/2015,2015.0
61,Wagner (NEC),1,0-1,6,12,18,0.333,02/22/2015,2015.0
63,Maryland (Big Ten),2,1-1,9,20,29,0.310,02/22/2015,2015.0
64,UMBC (America East),3,1-2,17,38,55,0.309,02/22/2015,2015.0
65,Hobart (NEC),2,1-1,16,36,52,0.308,02/22/2015,2015.0
66,Villanova (Big East),2,1-1,15,34,49,0.306,02/22/2015,2015.0
67,Quinnipiac (MAAC),1,0-1,7,19,26,0.269,02/22/2015,2015.0
67,NJIT (Independent),1,0-1,7,19,26,0.269,02/22/2015,2015.0
69,UMass Lowell (America East),2,0-2,11,41,52,0.212,02/22/2015,2015.0
1,Yale (Ivy League),2,2-0,35,9,44,0.795,02/21/2015,2015.0
2,Denver (Big East),2,2-0,42,14,56,0.750,02/21/2015,2015.0
3,Bryant (NEC),2,0-2,25,9,34,0.735,02/21/2015,2015.0
4,Brown (Ivy League),1,1-0,19,7,26,0.731,02/21/2015,2015.0
5,Ohio St. (Big Ten),4,3-1,58,22,80,0.725,02/21/2015,2015.0
6,Cornell (Ivy League),2,1-1,35,16,51,0.686,02/21/2015,2015.0
7,Fairfield (CAA),3,2-1,41,22,63,0.651,02/21/2015,2015.0
8,Army West Point (Patriot),3,3-0,50,27,77,0.649,02/21/2015,2015.0
9,Navy (Patriot),3,1-2,40,22,62,0.645,02/21/2015,2015.0
10,Stony Brook (America East),3,2-1,47,26,73,0.644,02/21/2015,2015.0
11,Syracuse (ACC),2,2-0,34,19,53,0.642,02/21/2015,2015.0
12,Loyola Maryland (Patriot),4,2-2,65,38,103,0.631,02/21/2015,2015.0
13,Saint Joseph's (NEC),3,1-2,43,26,69,0.623,02/21/2015,2015.0
14,Johns Hopkins (Big Ten),4,2-2,57,35,92,0.620,02/21/2015,2015.0
15,Penn (Ivy League),2,2-0,29,18,47,0.617,02/21/2015,2015.0
16,Jacksonville (SoCon),2,1-1,32,20,52,0.615,02/21/2015,2015.0
17,Vermont (America East),3,0-3,43,28,71,0.606,02/21/2015,2015.0
18,Boston U. (Patriot),3,2-1,46,30,76,0.605,02/21/2015,2015.0
19,Marist (MAAC),1,1-0,10,7,17,0.588,02/21/2015,2015.0
20,Penn St. (Big Ten),3,1-2,37,28,65,0.569,02/21/2015,2015.0
21,Rutgers (Big Ten),3,1-2,40,31,71,0.563,02/21/2015,2015.0
22,High Point (SoCon),5,2-3,75,61,136,0.551,02/21/2015,2015.0
23,UAlbany (America East),1,1-0,14,12,26,0.538,02/21/2015,2015.0
24,Drexel (CAA),2,0-2,29,25,54,0.537,02/21/2015,2015.0
25,Michigan (Big Ten),3,2-1,44,38,82,0.537,02/21/2015,2015.0
26,Notre Dame (ACC),2,2-0,31,27,58,0.534,02/21/2015,2015.0
27,Harvard (Ivy League),1,1-0,16,14,30,0.533,02/21/2015,2015.0
28,Marquette (Big East),2,2-0,25,23,48,0.521,02/21/2015,2015.0
29,Princeton (Ivy League),2,2-0,26,24,50,0.520,02/21/2015,2015.0
30,Bellarmine (SoCon),2,1-1,28,26,54,0.519,02/21/2015,2015.0
30,Hofstra (CAA),2,0-2,28,26,54,0.519,02/21/2015,2015.0
32,Georgetown (Big East),1,0-1,15,14,29,0.517,02/21/2015,2015.0
33,Furman (SoCon),3,1-2,36,36,72,0.500,02/21/2015,2015.0
34,Siena (MAAC),3,1-2,39,41,80,0.488,02/21/2015,2015.0
35,Duke (ACC),4,3-1,56,61,117,0.479,02/21/2015,2015.0
36,Canisius (MAAC),2,0-2,22,25,47,0.468,02/21/2015,2015.0
37,Lafayette (Patriot),2,1-1,20,23,43,0.465,02/21/2015,2015.0
38,Lehigh (Patriot),3,2-1,33,38,71,0.465,02/21/2015,2015.0
39,North Carolina (ACC),4,4-0,52,60,112,0.464,02/21/2015,2015.0
40,Monmouth (MAAC),1,0-1,5,6,11,0.455,02/21/2015,2015.0
41,Towson (CAA),2,1-1,20,25,45,0.444,02/21/2015,2015.0
42,Colgate (Patriot),3,3-0,28,36,64,0.438,02/21/2015,2015.0
43,Bucknell (Patriot),3,2-1,25,35,60,0.417,02/21/2015,2015.0
44,Mercer (SoCon),2,0-2,22,32,54,0.407,02/21/2015,2015.0
45,Delaware (CAA),3,1-2,28,41,69,0.406,02/21/2015,2015.0
46,Virginia (ACC),3,3-0,32,47,79,0.405,02/21/2015,2015.0
47,Robert Morris (NEC),3,0-3,28,42,70,0.400,02/21/2015,2015.0
48,Massachusetts (CAA),3,0-3,33,51,84,0.393,02/21/2015,2015.0
49,Sacred Heart (NEC),1,0-1,8,13,21,0.381,02/21/2015,2015.0
49,Mount St. Mary's (NEC),1,1-0,8,13,21,0.381,02/21/2015,2015.0
51,VMI (SoCon),3,0-3,31,51,82,0.378,02/21/2015,2015.0
52,St. John's (NY) (Big East),3,1-2,26,45,71,0.366,02/21/2015,2015.0
53,Holy Cross (Patriot),2,2-0,18,33,51,0.353,02/21/2015,2015.0
54,Air Force (ECAC),3,0-3,22,41,63,0.349,02/21/2015,2015.0
55,Manhattan (MAAC),3,0-3,23,43,66,0.348,02/21/2015,2015.0
56,Dartmouth (Ivy League),1,0-1,8,15,23,0.348,02/21/2015,2015.0
57,Detroit Mercy (MAAC),3,2-1,24,46,70,0.343,02/21/2015,2015.0
58,Providence (Big East),2,1-1,14,28,42,0.333,02/21/2015,2015.0
58,Wagner (NEC),1,0-1,6,12,18,0.333,02/21/2015,2015.0
60,Maryland (Big Ten),2,1-1,9,20,29,0.310,02/21/2015,2015.0
61,UMBC (America East),3,1-2,17,38,55,0.309,02/21/2015,2015.0
62,Hobart (NEC),2,1-1,16,36,52,0.308,02/21/2015,2015.0
63,Villanova (Big East),2,1-1,15,34,49,0.306,02/21/2015,2015.0
64,Richmond (SoCon),2,2-0,13,31,44,0.295,02/21/2015,2015.0
65,Quinnipiac (MAAC),1,0-1,7,19,26,0.269,02/21/2015,2015.0
65,NJIT (Independent),1,0-1,7,19,26,0.269,02/21/2015,2015.0
67,UMass Lowell (America East),2,0-2,11,41,52,0.212,02/21/2015,2015.0
1,Yale (Ivy League),1,1-0,22,4,26,0.846,02/20/2015,2015.0
2,Ohio St. (Big Ten),3,2-1,43,14,57,0.754,02/20/2015,2015.0
3,Bryant (NEC),2,0-2,25,9,34,0.735,02/20/2015,2015.0
3,Denver (Big East),1,1-0,25,9,34,0.735,02/20/2015,2015.0
5,Navy (Patriot),2,1-1,30,13,43,0.698,02/20/2015,2015.0
6,Cornell (Ivy League),2,1-1,35,16,51,0.686,02/20/2015,2015.0
7,Lafayette (Patriot),1,1-0,12,6,18,0.667,02/20/2015,2015.0
8,Army West Point (Patriot),3,3-0,50,27,77,0.649,02/20/2015,2015.0
9,Johns Hopkins (Big Ten),3,2-1,42,23,65,0.646,02/20/2015,2015.0
10,Stony Brook (America East),3,2-1,47,26,73,0.644,02/20/2015,2015.0
11,Syracuse (ACC),2,2-0,34,19,53,0.642,02/20/2015,2015.0
12,Saint Joseph's (NEC),3,1-2,43,26,69,0.623,02/20/2015,2015.0
13,Fairfield (CAA),2,1-1,26,16,42,0.619,02/20/2015,2015.0
13,Princeton (Ivy League),1,1-0,13,8,21,0.619,02/20/2015,2015.0
15,Penn (Ivy League),2,2-0,29,18,47,0.617,02/20/2015,2015.0
16,Boston U. (Patriot),2,2-0,33,21,54,0.611,02/20/2015,2015.0
17,Drexel (CAA),1,0-1,17,11,28,0.607,02/20/2015,2015.0
18,Rutgers (Big Ten),2,1-1,29,19,48,0.604,02/20/2015,2015.0
19,Michigan (Big Ten),2,2-0,32,21,53,0.604,02/20/2015,2015.0
20,Loyola Maryland (Patriot),3,2-1,45,30,75,0.600,02/20/2015,2015.0
21,Marist (MAAC),1,1-0,10,7,17,0.588,02/20/2015,2015.0
22,Vermont (America East),2,0-2,28,20,48,0.583,02/20/2015,2015.0
23,High Point (SoCon),4,1-3,62,53,115,0.539,02/20/2015,2015.0
24,Penn St. (Big Ten),2,1-1,23,21,44,0.523,02/20/2015,2015.0
25,Marquette (Big East),2,2-0,25,23,48,0.521,02/20/2015,2015.0
26,Bellarmine (SoCon),2,1-1,28,26,54,0.519,02/20/2015,2015.0
27,Georgetown (Big East),1,0-1,15,14,29,0.517,02/20/2015,2015.0
28,Furman (SoCon),2,0-2,25,26,51,0.490,02/20/2015,2015.0
29,Lehigh (Patriot),2,1-1,24,25,49,0.490,02/20/2015,2015.0
30,Notre Dame (ACC),1,1-0,14,15,29,0.483,02/20/2015,2015.0
31,Hofstra (CAA),1,0-1,12,13,25,0.480,02/20/2015,2015.0
32,Duke (ACC),4,3-1,56,61,117,0.479,02/20/2015,2015.0
33,North Carolina (ACC),3,3-0,40,45,85,0.471,02/20/2015,2015.0
34,Canisius (MAAC),1,0-1,12,14,26,0.462,02/20/2015,2015.0
34,Jacksonville (SoCon),1,0-1,12,14,26,0.462,02/20/2015,2015.0
36,Towson (CAA),2,1-1,20,25,45,0.444,02/20/2015,2015.0
36,St. John's (NY) (Big East),2,1-1,20,25,45,0.444,02/20/2015,2015.0
38,Holy Cross (Patriot),1,1-0,10,13,23,0.435,02/20/2015,2015.0
39,Air Force (ECAC),2,0-2,17,24,41,0.415,02/20/2015,2015.0
40,Mercer (SoCon),2,0-2,22,32,54,0.407,02/20/2015,2015.0
41,Delaware (CAA),3,1-2,28,41,69,0.406,02/20/2015,2015.0
42,Bucknell (Patriot),2,1-1,16,25,41,0.390,02/20/2015,2015.0
43,Mount St. Mary's (NEC),1,1-0,8,13,21,0.381,02/20/2015,2015.0
44,VMI (SoCon),3,0-3,31,51,82,0.378,02/20/2015,2015.0
45,Manhattan (MAAC),2,0-2,17,28,45,0.378,02/20/2015,2015.0
46,Siena (MAAC),2,0-2,20,34,54,0.370,02/20/2015,2015.0
47,Maryland (Big Ten),1,1-0,4,7,11,0.364,02/20/2015,2015.0
48,Virginia (ACC),2,2-0,20,36,56,0.357,02/20/2015,2015.0
49,Massachusetts (CAA),2,0-2,19,35,54,0.352,02/20/2015,2015.0
50,Wagner (NEC),1,0-1,6,12,18,0.333,02/20/2015,2015.0
51,Providence (Big East),1,0-1,6,13,19,0.316,02/20/2015,2015.0
52,Hobart (NEC),2,1-1,16,36,52,0.308,02/20/2015,2015.0
53,Detroit Mercy (MAAC),2,1-1,14,32,46,0.304,02/20/2015,2015.0
53,Robert Morris (NEC),2,0-2,14,32,46,0.304,02/20/2015,2015.0
55,Richmond (SoCon),2,2-0,13,31,44,0.295,02/20/2015,2015.0
56,Villanova (Big East),1,0-1,8,20,28,0.286,02/20/2015,2015.0
57,Colgate (Patriot),2,2-0,11,28,39,0.282,02/20/2015,2015.0
58,NJIT (Independent),1,0-1,7,19,26,0.269,02/20/2015,2015.0
59,UMBC (America East),2,0-2,11,33,44,0.250,02/20/2015,2015.0
60,UMass Lowell (America East),1,0-1,4,22,26,0.154,02/20/2015,2015.0
1,Yale (Ivy League),1,1-0,22,4,26,0.846,02/18/2015,2015.0
2,Ohio St. (Big Ten),3,2-1,43,14,57,0.754,02/18/2015,2015.0
3,Bryant (NEC),2,0-2,25,9,34,0.735,02/18/2015,2015.0
3,Denver (Big East),1,1-0,25,9,34,0.735,02/18/2015,2015.0
5,Navy (Patriot),2,1-1,30,13,43,0.698,02/18/2015,2015.0
6,Lafayette (Patriot),1,1-0,12,6,18,0.667,02/18/2015,2015.0
7,Army West Point (Patriot),3,3-0,50,27,77,0.649,02/18/2015,2015.0
8,Johns Hopkins (Big Ten),3,2-1,42,23,65,0.646,02/18/2015,2015.0
9,Syracuse (ACC),2,2-0,34,19,53,0.642,02/18/2015,2015.0
10,Saint Joseph's (NEC),3,1-2,43,26,69,0.623,02/18/2015,2015.0
11,Fairfield (CAA),2,1-1,26,16,42,0.619,02/18/2015,2015.0
11,Princeton (Ivy League),1,1-0,13,8,21,0.619,02/18/2015,2015.0
13,Penn (Ivy League),2,2-0,29,18,47,0.617,02/18/2015,2015.0
14,Boston U. (Patriot),2,2-0,33,21,54,0.611,02/18/2015,2015.0
15,Cornell (Ivy League),1,0-1,14,9,23,0.609,02/18/2015,2015.0
16,Drexel (CAA),1,0-1,17,11,28,0.607,02/18/2015,2015.0
17,Rutgers (Big Ten),2,1-1,29,19,48,0.604,02/18/2015,2015.0
18,Michigan (Big Ten),2,2-0,32,21,53,0.604,02/18/2015,2015.0
19,Loyola Maryland (Patriot),3,2-1,45,30,75,0.600,02/18/2015,2015.0
20,Stony Brook (America East),2,1-1,28,19,47,0.596,02/18/2015,2015.0
21,Marist (MAAC),1,1-0,10,7,17,0.588,02/18/2015,2015.0
22,Vermont (America East),2,0-2,28,20,48,0.583,02/18/2015,2015.0
23,High Point (SoCon),4,1-3,62,53,115,0.539,02/18/2015,2015.0
24,Penn St. (Big Ten),2,1-1,23,21,44,0.523,02/18/2015,2015.0
25,Marquette (Big East),2,2-0,25,23,48,0.521,02/18/2015,2015.0
26,Bellarmine (SoCon),2,1-1,28,26,54,0.519,02/18/2015,2015.0
27,Georgetown (Big East),1,0-1,15,14,29,0.517,02/18/2015,2015.0
28,Furman (SoCon),2,0-2,25,26,51,0.490,02/18/2015,2015.0
29,Lehigh (Patriot),2,1-1,24,25,49,0.490,02/18/2015,2015.0
30,Notre Dame (ACC),1,1-0,14,15,29,0.483,02/18/2015,2015.0
31,Hofstra (CAA),1,0-1,12,13,25,0.480,02/18/2015,2015.0
32,Duke (ACC),4,3-1,56,61,117,0.479,02/18/2015,2015.0
33,North Carolina (ACC),3,3-0,40,45,85,0.471,02/18/2015,2015.0
34,Canisius (MAAC),1,0-1,12,14,26,0.462,02/18/2015,2015.0
34,Jacksonville (SoCon),1,0-1,12,14,26,0.462,02/18/2015,2015.0
36,St. John's (NY) (Big East),2,1-1,20,25,45,0.444,02/18/2015,2015.0
36,Towson (CAA),2,1-1,20,25,45,0.444,02/18/2015,2015.0
38,Holy Cross (Patriot),1,1-0,10,13,23,0.435,02/18/2015,2015.0
39,Air Force (ECAC),2,0-2,17,24,41,0.415,02/18/2015,2015.0
40,Mercer (SoCon),2,0-2,22,32,54,0.407,02/18/2015,2015.0
41,Delaware (CAA),3,1-2,28,41,69,0.406,02/18/2015,2015.0
42,Bucknell (Patriot),2,1-1,16,25,41,0.390,02/18/2015,2015.0
43,Mount St. Mary's (NEC),1,1-0,8,13,21,0.381,02/18/2015,2015.0
44,VMI (SoCon),3,0-3,31,51,82,0.378,02/18/2015,2015.0
45,Manhattan (MAAC),2,0-2,17,28,45,0.378,02/18/2015,2015.0
46,Hobart (NEC),1,1-0,9,15,24,0.375,02/18/2015,2015.0
47,Siena (MAAC),2,0-2,20,34,54,0.370,02/18/2015,2015.0
48,Maryland (Big Ten),1,1-0,4,7,11,0.364,02/18/2015,2015.0
49,Virginia (ACC),2,2-0,20,36,56,0.357,02/18/2015,2015.0
50,Massachusetts (CAA),2,0-2,19,35,54,0.352,02/18/2015,2015.0
51,Wagner (NEC),1,0-1,6,12,18,0.333,02/18/2015,2015.0
52,Providence (Big East),1,0-1,6,13,19,0.316,02/18/2015,2015.0
53,Robert Morris (NEC),2,0-2,14,32,46,0.304,02/18/2015,2015.0
53,Detroit Mercy (MAAC),2,1-1,14,32,46,0.304,02/18/2015,2015.0
55,Richmond (SoCon),2,2-0,13,31,44,0.295,02/18/2015,2015.0
56,Villanova (Big East),1,0-1,8,20,28,0.286,02/18/2015,2015.0
57,Colgate (Patriot),2,2-0,11,28,39,0.282,02/18/2015,2015.0
58,UMBC (America East),2,0-2,11,33,44,0.250,02/18/2015,2015.0
59,UMass Lowell (America East),1,0-1,4,22,26,0.154,02/18/2015,2015.0
1,Yale (Ivy League),1,1-0,22,4,26,0.846,02/17/2015,2015.0
2,Ohio St. (Big Ten),3,2-1,43,14,57,0.754,02/17/2015,2015.0
3,Bryant (NEC),2,0-2,25,9,34,0.735,02/17/2015,2015.0
3,Denver (Big East),1,1-0,25,9,34,0.735,02/17/2015,2015.0
5,Navy (Patriot),2,1-1,30,13,43,0.698,02/17/2015,2015.0
6,Lafayette (Patriot),1,1-0,12,6,18,0.667,02/17/2015,2015.0
7,Army West Point (Patriot),3,3-0,50,27,77,0.649,02/17/2015,2015.0
8,Johns Hopkins (Big Ten),3,2-1,42,23,65,0.646,02/17/2015,2015.0
9,Syracuse (ACC),2,2-0,34,19,53,0.642,02/17/2015,2015.0
10,Saint Joseph's (NEC),3,1-2,43,26,69,0.623,02/17/2015,2015.0
11,Princeton (Ivy League),1,1-0,13,8,21,0.619,02/17/2015,2015.0
12,Penn (Ivy League),2,2-0,29,18,47,0.617,02/17/2015,2015.0
13,Boston U. (Patriot),2,2-0,33,21,54,0.611,02/17/2015,2015.0
14,Cornell (Ivy League),1,0-1,14,9,23,0.609,02/17/2015,2015.0
15,Drexel (CAA),1,0-1,17,11,28,0.607,02/17/2015,2015.0
16,Rutgers (Big Ten),2,1-1,29,19,48,0.604,02/17/2015,2015.0
17,Michigan (Big Ten),2,2-0,32,21,53,0.604,02/17/2015,2015.0
18,Loyola Maryland (Patriot),2,1-1,27,18,45,0.600,02/17/2015,2015.0
19,Stony Brook (America East),2,1-1,28,19,47,0.596,02/17/2015,2015.0
20,Marist (MAAC),1,1-0,10,7,17,0.588,02/17/2015,2015.0
21,Vermont (America East),2,0-2,28,20,48,0.583,02/17/2015,2015.0
22,Fairfield (CAA),1,0-1,13,10,23,0.565,02/17/2015,2015.0
23,High Point (SoCon),4,1-3,62,53,115,0.539,02/17/2015,2015.0
24,Towson (CAA),1,1-0,8,7,15,0.533,02/17/2015,2015.0
25,Penn St. (Big Ten),2,1-1,23,21,44,0.523,02/17/2015,2015.0
26,Marquette (Big East),2,2-0,25,23,48,0.521,02/17/2015,2015.0
27,Bellarmine (SoCon),2,1-1,28,26,54,0.519,02/17/2015,2015.0
28,Georgetown (Big East),1,0-1,15,14,29,0.517,02/17/2015,2015.0
29,Furman (SoCon),2,0-2,25,26,51,0.490,02/17/2015,2015.0
30,Lehigh (Patriot),2,1-1,24,25,49,0.490,02/17/2015,2015.0
31,Notre Dame (ACC),1,1-0,14,15,29,0.483,02/17/2015,2015.0
32,Hofstra (CAA),1,0-1,12,13,25,0.480,02/17/2015,2015.0
33,Duke (ACC),4,3-1,56,61,117,0.479,02/17/2015,2015.0
34,North Carolina (ACC),3,3-0,40,45,85,0.471,02/17/2015,2015.0
35,Canisius (MAAC),1,0-1,12,14,26,0.462,02/17/2015,2015.0
35,Jacksonville (SoCon),1,0-1,12,14,26,0.462,02/17/2015,2015.0
37,St. John's (NY) (Big East),2,1-1,20,25,45,0.444,02/17/2015,2015.0
38,Holy Cross (Patriot),1,1-0,10,13,23,0.435,02/17/2015,2015.0
39,Air Force (ECAC),2,0-2,17,24,41,0.415,02/17/2015,2015.0
40,Mercer (SoCon),2,0-2,22,32,54,0.407,02/17/2015,2015.0
41,Delaware (CAA),3,1-2,28,41,69,0.406,02/17/2015,2015.0
42,Bucknell (Patriot),2,1-1,16,25,41,0.390,02/17/2015,2015.0
43,Mount St. Mary's (NEC),1,1-0,8,13,21,0.381,02/17/2015,2015.0
44,VMI (SoCon),3,0-3,31,51,82,0.378,02/17/2015,2015.0
45,Manhattan (MAAC),2,0-2,17,28,45,0.378,02/17/2015,2015.0
46,Hobart (NEC),1,1-0,9,15,24,0.375,02/17/2015,2015.0
47,Siena (MAAC),2,0-2,20,34,54,0.370,02/17/2015,2015.0
48,Maryland (Big Ten),1,1-0,4,7,11,0.364,02/17/2015,2015.0
49,Virginia (ACC),2,2-0,20,36,56,0.357,02/17/2015,2015.0
50,Massachusetts (CAA),2,0-2,19,35,54,0.352,02/17/2015,2015.0
51,Wagner (NEC),1,0-1,6,12,18,0.333,02/17/2015,2015.0
52,Robert Morris (NEC),2,0-2,14,32,46,0.304,02/17/2015,2015.0
52,Detroit Mercy (MAAC),2,1-1,14,32,46,0.304,02/17/2015,2015.0
54,Richmond (SoCon),2,2-0,13,31,44,0.295,02/17/2015,2015.0
55,Villanova (Big East),1,0-1,8,20,28,0.286,02/17/2015,2015.0
56,Colgate (Patriot),2,2-0,11,28,39,0.282,02/17/2015,2015.0
57,UMBC (America East),2,0-2,11,33,44,0.250,02/17/2015,2015.0
58,UMass Lowell (America East),1,0-1,4,22,26,0.154,02/17/2015,2015.0
1,Yale (Ivy League),1,1-0,22,4,26,0.846,02/15/2015,2015.0
2,Penn (Ivy League),1,1-0,18,4,22,0.818,02/15/2015,2015.0
3,Ohio St. (Big Ten),3,2-1,43,14,57,0.754,02/15/2015,2015.0
4,Bryant (NEC),2,0-2,25,9,34,0.735,02/15/2015,2015.0
4,Denver (Big East),1,1-0,25,9,34,0.735,02/15/2015,2015.0
6,Navy (Patriot),2,1-1,30,13,43,0.698,02/15/2015,2015.0
7,Lafayette (Patriot),1,1-0,12,6,18,0.667,02/15/2015,2015.0
8,Saint Joseph's (NEC),2,1-1,29,15,44,0.659,02/15/2015,2015.0
9,Army West Point (Patriot),3,3-0,50,27,77,0.649,02/15/2015,2015.0
10,Johns Hopkins (Big Ten),3,2-1,42,23,65,0.646,02/15/2015,2015.0
11,Syracuse (ACC),2,2-0,34,19,53,0.642,02/15/2015,2015.0
12,Boston U. (Patriot),2,2-0,33,21,54,0.611,02/15/2015,2015.0
13,Cornell (Ivy League),1,0-1,14,9,23,0.609,02/15/2015,2015.0
14,Drexel (CAA),1,0-1,17,11,28,0.607,02/15/2015,2015.0
15,Rutgers (Big Ten),2,1-1,29,19,48,0.604,02/15/2015,2015.0
16,Michigan (Big Ten),2,2-0,32,21,53,0.604,02/15/2015,2015.0
17,Loyola Maryland (Patriot),2,1-1,27,18,45,0.600,02/15/2015,2015.0
18,Stony Brook (America East),2,1-1,28,19,47,0.596,02/15/2015,2015.0
19,Princeton (Ivy League),1,1-0,13,9,22,0.591,02/15/2015,2015.0
20,Marist (MAAC),1,1-0,10,7,17,0.588,02/15/2015,2015.0
21,Vermont (America East),2,0-2,28,20,48,0.583,02/15/2015,2015.0
22,Fairfield (CAA),1,0-1,13,10,23,0.565,02/15/2015,2015.0
23,High Point (SoCon),4,1-3,62,53,115,0.539,02/15/2015,2015.0
24,Towson (CAA),1,1-0,8,7,15,0.533,02/15/2015,2015.0
25,Penn St. (Big Ten),2,1-1,23,21,44,0.523,02/15/2015,2015.0
26,Marquette (Big East),2,2-0,25,23,48,0.521,02/15/2015,2015.0
27,Bellarmine (SoCon),2,1-1,28,26,54,0.519,02/15/2015,2015.0
28,Georgetown (Big East),1,0-1,15,14,29,0.517,02/15/2015,2015.0
29,Furman (SoCon),2,0-2,25,26,51,0.490,02/15/2015,2015.0
30,Lehigh (Patriot),2,1-1,24,25,49,0.490,02/15/2015,2015.0
31,Notre Dame (ACC),1,1-0,14,15,29,0.483,02/15/2015,2015.0
32,Hofstra (CAA),1,0-1,12,13,25,0.480,02/15/2015,2015.0
33,Duke (ACC),4,3-1,56,61,117,0.479,02/15/2015,2015.0
34,North Carolina (ACC),3,3-0,40,45,85,0.471,02/15/2015,2015.0
35,Canisius (MAAC),1,0-1,12,14,26,0.462,02/15/2015,2015.0
35,Jacksonville (SoCon),1,0-1,12,14,26,0.462,02/15/2015,2015.0
37,St. John's (NY) (Big East),2,1-1,20,25,45,0.444,02/15/2015,2015.0
38,Holy Cross (Patriot),1,1-0,10,13,23,0.435,02/15/2015,2015.0
39,Air Force (ECAC),2,0-2,17,24,41,0.415,02/15/2015,2015.0
40,Mercer (SoCon),2,0-2,22,32,54,0.407,02/15/2015,2015.0
41,Delaware (CAA),3,1-2,28,41,69,0.406,02/15/2015,2015.0
42,Manhattan (MAAC),2,0-2,18,28,46,0.391,02/15/2015,2015.0
43,Bucknell (Patriot),2,1-1,16,25,41,0.390,02/15/2015,2015.0
44,Mount St. Mary's (NEC),1,1-0,8,13,21,0.381,02/15/2015,2015.0
45,VMI (SoCon),3,0-3,31,51,82,0.378,02/15/2015,2015.0
46,Hobart (NEC),1,1-0,9,15,24,0.375,02/15/2015,2015.0
47,Siena (MAAC),2,0-2,20,34,54,0.370,02/15/2015,2015.0
48,Maryland (Big Ten),1,1-0,4,7,11,0.364,02/15/2015,2015.0
49,Virginia (ACC),2,2-0,20,36,56,0.357,02/15/2015,2015.0
50,Massachusetts (CAA),2,0-2,19,35,54,0.352,02/15/2015,2015.0
51,Wagner (NEC),1,0-1,6,12,18,0.333,02/15/2015,2015.0
52,Robert Morris (NEC),2,0-2,14,32,46,0.304,02/15/2015,2015.0
52,Detroit Mercy (MAAC),2,1-1,14,32,46,0.304,02/15/2015,2015.0
54,Richmond (SoCon),2,2-0,13,31,44,0.295,02/15/2015,2015.0
55,Villanova (Big East),1,0-1,8,20,28,0.286,02/15/2015,2015.0
56,Colgate (Patriot),2,2-0,11,28,39,0.282,02/15/2015,2015.0
57,UMBC (America East),2,0-2,11,33,44,0.250,02/15/2015,2015.0
58,UMass Lowell (America East),1,0-1,4,22,26,0.154,02/15/2015,2015.0
1,Syracuse (ACC),1,1-0,25,5,30,0.833,02/10/2015,2015.0
2,Ohio St. (Big Ten),2,1-1,32,9,41,0.780,02/10/2015,2015.0
3,Saint Joseph's (NEC),1,0-1,14,4,18,0.778,02/10/2015,2015.0
4,Bryant (NEC),1,0-1,13,5,18,0.722,02/10/2015,2015.0
5,Navy (Patriot),1,1-0,23,9,32,0.719,02/10/2015,2015.0
6,Army West Point (Patriot),2,2-0,36,15,51,0.706,02/10/2015,2015.0
7,Loyola Maryland (Patriot),1,0-1,19,9,28,0.679,02/10/2015,2015.0
7,Boston U. (Patriot),1,1-0,19,9,28,0.679,02/10/2015,2015.0
9,Stony Brook (America East),1,1-0,15,9,24,0.625,02/10/2015,2015.0
10,Michigan (Big Ten),1,1-0,17,11,28,0.607,02/10/2015,2015.0
11,Duke (ACC),2,2-0,34,23,57,0.596,02/10/2015,2015.0
12,Johns Hopkins (Big Ten),2,1-1,22,15,37,0.595,02/10/2015,2015.0
13,Rutgers (Big Ten),1,1-0,12,10,22,0.545,02/10/2015,2015.0
14,Towson (CAA),1,1-0,8,7,15,0.533,02/10/2015,2015.0
15,Marquette (Big East),1,1-0,12,11,23,0.522,02/10/2015,2015.0
16,North Carolina (ACC),1,1-0,13,12,25,0.520,02/10/2015,2015.0
17,Penn St. (Big Ten),1,1-0,14,13,27,0.519,02/10/2015,2015.0
18,High Point (SoCon),2,1-1,31,30,61,0.508,02/10/2015,2015.0
19,Vermont (America East),1,0-1,13,14,27,0.481,02/10/2015,2015.0
20,Bucknell (Patriot),1,0-1,12,13,25,0.480,02/10/2015,2015.0
20,Furman (SoCon),1,0-1,12,13,25,0.480,02/10/2015,2015.0
22,Lehigh (Patriot),1,0-1,11,12,23,0.478,02/10/2015,2015.0
23,St. John's (NY) (Big East),1,0-1,10,12,22,0.455,02/10/2015,2015.0
24,Delaware (CAA),2,1-1,23,30,53,0.434,02/10/2015,2015.0
25,Air Force (ECAC),1,0-1,10,14,24,0.417,02/10/2015,2015.0
26,Bellarmine (SoCon),1,0-1,11,17,28,0.393,02/10/2015,2015.0
27,Manhattan (MAAC),1,0-1,9,15,24,0.375,02/10/2015,2015.0
28,Virginia (ACC),1,1-0,9,19,28,0.321,02/10/2015,2015.0
28,Mercer (SoCon),1,0-1,9,19,28,0.321,02/10/2015,2015.0
30,UMBC (America East),1,0-1,7,15,22,0.318,02/10/2015,2015.0
31,VMI (SoCon),2,0-2,18,43,61,0.295,02/10/2015,2015.0
32,Colgate (Patriot),1,1-0,5,13,18,0.278,02/10/2015,2015.0
33,Massachusetts (CAA),1,0-1,6,16,22,0.273,02/10/2015,2015.0
34,Robert Morris (NEC),1,0-1,5,15,20,0.250,02/10/2015,2015.0
35,Richmond (SoCon),1,1-0,4,14,18,0.222,02/10/2015,2015.0
36,Detroit Mercy (MAAC),1,1-0,4,17,21,0.190,02/10/2015,2015.0
37,Siena (MAAC),1,0-1,5,25,30,0.167,02/10/2015,2015.0
1,Syracuse (ACC),1,1-0,25,5,30,0.833,02/09/2015,2015.0
2,Ohio St. (Big Ten),1,0-1,17,4,21,0.810,02/09/2015,2015.0
3,Saint Joseph's (NEC),1,0-1,14,4,18,0.778,02/09/2015,2015.0
4,Bryant (NEC),1,0-1,13,5,18,0.722,02/09/2015,2015.0
5,Navy (Patriot),1,1-0,23,9,32,0.719,02/09/2015,2015.0
6,Army West Point (Patriot),2,2-0,36,15,51,0.706,02/09/2015,2015.0
7,Johns Hopkins (Big Ten),1,1-0,15,7,22,0.682,02/09/2015,2015.0
8,Boston U. (Patriot),1,1-0,19,9,28,0.679,02/09/2015,2015.0
8,Loyola Maryland (Patriot),1,0-1,19,9,28,0.679,02/09/2015,2015.0
10,Stony Brook (America East),1,1-0,15,9,24,0.625,02/09/2015,2015.0
11,Michigan (Big Ten),1,1-0,17,11,28,0.607,02/09/2015,2015.0
12,Duke (ACC),2,2-0,34,23,57,0.596,02/09/2015,2015.0
13,Rutgers (Big Ten),1,1-0,12,10,22,0.545,02/09/2015,2015.0
14,Marquette (Big East),1,1-0,12,11,23,0.522,02/09/2015,2015.0
15,North Carolina (ACC),1,1-0,13,12,25,0.520,02/09/2015,2015.0
16,Penn St. (Big Ten),1,1-0,14,13,27,0.519,02/09/2015,2015.0
17,High Point (SoCon),2,1-1,31,30,61,0.508,02/09/2015,2015.0
18,Vermont (America East),1,0-1,13,14,27,0.481,02/09/2015,2015.0
19,Furman (SoCon),1,0-1,12,13,25,0.480,02/09/2015,2015.0
19,Bucknell (Patriot),1,0-1,12,13,25,0.480,02/09/2015,2015.0
21,Lehigh (Patriot),1,0-1,11,12,23,0.478,02/09/2015,2015.0
22,St. John's (NY) (Big East),1,0-1,10,12,22,0.455,02/09/2015,2015.0
23,Delaware (CAA),2,1-1,23,30,53,0.434,02/09/2015,2015.0
24,Air Force (ECAC),1,0-1,10,14,24,0.417,02/09/2015,2015.0
25,Bellarmine (SoCon),1,0-1,11,17,28,0.393,02/09/2015,2015.0
26,Manhattan (MAAC),1,0-1,9,15,24,0.375,02/09/2015,2015.0
27,Virginia (ACC),1,1-0,9,19,28,0.321,02/09/2015,2015.0
27,Mercer (SoCon),1,0-1,9,19,28,0.321,02/09/2015,2015.0
29,UMBC (America East),1,0-1,7,15,22,0.318,02/09/2015,2015.0
30,VMI (SoCon),2,0-2,18,43,61,0.295,02/09/2015,2015.0
31,Colgate (Patriot),1,1-0,5,13,18,0.278,02/09/2015,2015.0
32,Massachusetts (CAA),1,0-1,6,16,22,0.273,02/09/2015,2015.0
33,Richmond (SoCon),1,1-0,4,14,18,0.222,02/09/2015,2015.0
34,Detroit Mercy (MAAC),1,1-0,4,17,21,0.190,02/09/2015,2015.0
35,Siena (MAAC),1,0-1,5,25,30,0.167,02/09/2015,2015.0
1,Syracuse (ACC),1,1-0,25,5,30,0.833,02/08/2015,2015.0
2,Ohio St. (Big Ten),1,0-1,17,4,21,0.810,02/08/2015,2015.0
3,Saint Joseph's (NEC),1,0-1,14,4,18,0.778,02/08/2015,2015.0
4,Army West Point (Patriot),1,1-0,16,6,22,0.727,02/08/2015,2015.0
5,Bryant (NEC),1,0-1,13,5,18,0.722,02/08/2015,2015.0
6,Navy (Patriot),1,1-0,23,9,32,0.719,02/08/2015,2015.0
7,Johns Hopkins (Big Ten),1,1-0,15,7,22,0.682,02/08/2015,2015.0
8,Boston U. (Patriot),1,1-0,19,9,28,0.679,02/08/2015,2015.0
8,Loyola Maryland (Patriot),1,0-1,19,9,28,0.679,02/08/2015,2015.0
10,Stony Brook (America East),1,1-0,15,9,24,0.625,02/08/2015,2015.0
11,Michigan (Big Ten),1,1-0,17,11,28,0.607,02/08/2015,2015.0
12,Duke (ACC),2,2-0,34,23,57,0.596,02/08/2015,2015.0
13,Rutgers (Big Ten),1,1-0,12,10,22,0.545,02/08/2015,2015.0
14,Marquette (Big East),1,1-0,12,11,23,0.522,02/08/2015,2015.0
15,North Carolina (ACC),1,1-0,13,12,25,0.520,02/08/2015,2015.0
16,Penn St. (Big Ten),1,1-0,14,13,27,0.519,02/08/2015,2015.0
17,High Point (SoCon),2,1-1,31,30,61,0.508,02/08/2015,2015.0
18,Vermont (America East),1,0-1,13,14,27,0.481,02/08/2015,2015.0
19,Furman (SoCon),1,0-1,12,13,25,0.480,02/08/2015,2015.0
19,Bucknell (Patriot),1,0-1,12,13,25,0.480,02/08/2015,2015.0
21,Lehigh (Patriot),1,0-1,11,12,23,0.478,02/08/2015,2015.0
22,St. John's (NY) (Big East),1,0-1,10,12,22,0.455,02/08/2015,2015.0
23,Delaware (CAA),2,1-1,23,30,53,0.434,02/08/2015,2015.0
24,Air Force (ECAC),1,0-1,10,14,24,0.417,02/08/2015,2015.0
25,Bellarmine (SoCon),1,0-1,11,17,28,0.393,02/08/2015,2015.0
26,Manhattan (MAAC),1,0-1,9,15,24,0.375,02/08/2015,2015.0
27,Virginia (ACC),1,1-0,9,19,28,0.321,02/08/2015,2015.0
27,Mercer (SoCon),1,0-1,9,19,28,0.321,02/08/2015,2015.0
29,UMBC (America East),1,0-1,7,15,22,0.318,02/08/2015,2015.0
30,VMI (SoCon),1,0-1,9,23,32,0.281,02/08/2015,2015.0
31,Colgate (Patriot),1,1-0,5,13,18,0.278,02/08/2015,2015.0
32,Massachusetts (CAA),1,0-1,6,16,22,0.273,02/08/2015,2015.0
33,Richmond (SoCon),1,1-0,4,14,18,0.222,02/08/2015,2015.0
34,Detroit Mercy (MAAC),1,1-0,4,17,21,0.190,02/08/2015,2015.0
35,Siena (MAAC),1,0-1,5,25,30,0.167,02/08/2015,2015.0
1,Hartford (America East),18,11-7,305,136,441,0.692,05/30/2016-Final Statistics,2016.0
2,Denver (Big East),16,13-3,280,136,416,0.673,05/30/2016-Final Statistics,2016.0
3,Brown (Ivy League),19,16-3,360,179,539,0.668,05/30/2016-Final Statistics,2016.0
4,Cornell (Ivy League),13,6-7,188,109,297,0.633,05/30/2016-Final Statistics,2016.0
5,Syracuse (ACC),17,12-5,258,154,412,0.626,05/30/2016-Final Statistics,2016.0
6,Boston U. (Patriot),15,8-7,210,128,338,0.621,05/30/2016-Final Statistics,2016.0
7,Army West Point (Patriot),17,10-7,238,150,388,0.613,05/30/2016-Final Statistics,2016.0
8,Saint Joseph's (NEC),16,12-4,228,147,375,0.608,05/30/2016-Final Statistics,2016.0
9,Ohio St. (Big Ten),15,7-8,194,130,324,0.599,05/30/2016-Final Statistics,2016.0
10,Duke (ACC),19,11-8,301,203,504,0.597,05/30/2016-Final Statistics,2016.0
11,Bucknell (Patriot),15,10-5,203,153,356,0.570,05/30/2016-Final Statistics,2016.0
12,Navy (Patriot),16,11-5,185,142,327,0.566,05/30/2016-Final Statistics,2016.0
13,North Carolina (ACC),18,12-6,266,209,475,0.560,05/30/2016-Final Statistics,2016.0
14,Marquette (Big East),16,11-5,184,147,331,0.556,05/30/2016-Final Statistics,2016.0
15,Virginia (ACC),15,7-8,196,159,355,0.552,05/30/2016-Final Statistics,2016.0
16,Villanova (Big East),14,9-5,212,172,384,0.552,05/30/2016-Final Statistics,2016.0
17,Hobart (NEC),17,10-7,215,175,390,0.551,05/30/2016-Final Statistics,2016.0
18,Bryant (NEC),15,10-5,191,156,347,0.550,05/30/2016-Final Statistics,2016.0
19,Bellarmine (SoCon),15,6-9,169,141,310,0.545,05/30/2016-Final Statistics,2016.0
20,Jacksonville (SoCon),13,3-10,164,138,302,0.543,05/30/2016-Final Statistics,2016.0
21,Hofstra (CAA),15,9-6,178,151,329,0.541,05/30/2016-Final Statistics,2016.0
22,High Point (SoCon),15,9-6,197,172,369,0.534,05/30/2016-Final Statistics,2016.0
23,Michigan (Big Ten),13,3-10,178,156,334,0.533,05/30/2016-Final Statistics,2016.0
24,Johns Hopkins (Big Ten),15,8-7,215,190,405,0.531,05/30/2016-Final Statistics,2016.0
25,Fairfield (CAA),17,9-8,194,172,366,0.530,05/30/2016-Final Statistics,2016.0
26,Maryland (Big Ten),20,17-3,243,221,464,0.524,05/30/2016-Final Statistics,2016.0
27,Richmond (SoCon),16,11-5,162,148,310,0.523,05/30/2016-Final Statistics,2016.0
28,Stony Brook (America East),16,12-4,212,198,410,0.517,05/30/2016-Final Statistics,2016.0
29,Quinnipiac (MAAC),16,12-4,185,174,359,0.515,05/30/2016-Final Statistics,2016.0
30,Vermont (America East),17,9-8,227,216,443,0.512,05/30/2016-Final Statistics,2016.0
31,Air Force (SoCon),18,15-3,198,189,387,0.512,05/30/2016-Final Statistics,2016.0
32,Mount St. Mary's (NEC),14,6-8,161,154,315,0.511,05/30/2016-Final Statistics,2016.0
33,Loyola Maryland (Patriot),18,14-4,212,203,415,0.511,05/30/2016-Final Statistics,2016.0
34,Canisius (MAAC),12,4-8,142,138,280,0.507,05/30/2016-Final Statistics,2016.0
35,UAlbany (America East),16,12-4,207,211,418,0.495,05/30/2016-Final Statistics,2016.0
36,Notre Dame (ACC),15,11-4,166,171,337,0.493,05/30/2016-Final Statistics,2016.0
37,Yale (Ivy League),16,13-3,186,192,378,0.492,05/30/2016-Final Statistics,2016.0
38,Massachusetts (CAA),13,4-9,138,143,281,0.491,05/30/2016-Final Statistics,2016.0
39,Delaware (CAA),15,5-10,163,169,332,0.491,05/30/2016-Final Statistics,2016.0
40,Lafayette (Patriot),14,3-11,154,160,314,0.490,05/30/2016-Final Statistics,2016.0
41,Mercer (SoCon),13,5-8,148,156,304,0.487,05/30/2016-Final Statistics,2016.0
42,Binghamton (America East),14,4-10,169,181,350,0.483,05/30/2016-Final Statistics,2016.0
43,Rutgers (Big Ten),16,11-5,199,214,413,0.482,05/30/2016-Final Statistics,2016.0
44,Towson (CAA),19,16-3,195,210,405,0.481,05/30/2016-Final Statistics,2016.0
45,Penn St. (Big Ten),15,8-7,185,209,394,0.470,05/30/2016-Final Statistics,2016.0
46,Princeton (Ivy League),13,5-8,152,172,324,0.469,05/30/2016-Final Statistics,2016.0
47,Penn (Ivy League),15,8-7,163,191,354,0.460,05/30/2016-Final Statistics,2016.0
48,Wagner (NEC),15,6-9,153,186,339,0.451,05/30/2016-Final Statistics,2016.0
49,Furman (SoCon),13,2-11,133,162,295,0.451,05/30/2016-Final Statistics,2016.0
50,Siena (MAAC),13,3-10,143,175,318,0.450,05/30/2016-Final Statistics,2016.0
51,Detroit Mercy (MAAC),12,2-10,101,125,226,0.447,05/30/2016-Final Statistics,2016.0
52,Robert Morris (NEC),15,7-8,174,220,394,0.442,05/30/2016-Final Statistics,2016.0
53,Monmouth (MAAC),14,7-7,130,168,298,0.436,05/30/2016-Final Statistics,2016.0
54,St. John's (NY) (Big East),14,2-12,150,197,347,0.432,05/30/2016-Final Statistics,2016.0
55,Sacred Heart (NEC),16,2-14,155,223,378,0.410,05/30/2016-Final Statistics,2016.0
56,Colgate (Patriot),14,4-10,121,175,296,0.409,05/30/2016-Final Statistics,2016.0
57,VMI (SoCon),16,2-14,149,219,368,0.405,05/30/2016-Final Statistics,2016.0
58,Providence (Big East),16,7-9,153,229,382,0.401,05/30/2016-Final Statistics,2016.0
59,Drexel (CAA),15,6-9,131,197,328,0.399,05/30/2016-Final Statistics,2016.0
60,Dartmouth (Ivy League),14,1-13,122,192,314,0.389,05/30/2016-Final Statistics,2016.0
61,NJIT (Independent),15,1-14,133,211,344,0.387,05/30/2016-Final Statistics,2016.0
62,Harvard (Ivy League),16,8-8,155,250,405,0.383,05/30/2016-Final Statistics,2016.0
63,Georgetown (Big East),14,2-12,114,188,302,0.377,05/30/2016-Final Statistics,2016.0
64,Manhattan (MAAC),15,3-12,125,215,340,0.368,05/30/2016-Final Statistics,2016.0
65,Holy Cross (Patriot),15,4-11,131,227,358,0.366,05/30/2016-Final Statistics,2016.0
66,Lehigh (Patriot),15,6-9,119,243,362,0.329,05/30/2016-Final Statistics,2016.0
67,UMBC (America East),14,4-10,105,232,337,0.312,05/30/2016-Final Statistics,2016.0
68,Marist (MAAC),16,9-7,106,238,344,0.308,05/30/2016-Final Statistics,2016.0
-,UMass Lowell (America East),16,4-12,154,219,373,0.413,05/30/2016-Final Statistics,2016.0
1,Hartford (America East),18,11-7,305,136,441,0.692,05/30/2016,2016.0
2,Denver (Big East),16,13-3,280,136,416,0.673,05/30/2016,2016.0
3,Brown (Ivy League),19,16-3,360,179,539,0.668,05/30/2016,2016.0
4,Cornell (Ivy League),13,6-7,188,109,297,0.633,05/30/2016,2016.0
5,Syracuse (ACC),17,12-5,258,154,412,0.626,05/30/2016,2016.0
6,Boston U. (Patriot),15,8-7,210,128,338,0.621,05/30/2016,2016.0
7,Army West Point (Patriot),17,10-7,238,150,388,0.613,05/30/2016,2016.0
8,Saint Joseph's (NEC),16,12-4,228,147,375,0.608,05/30/2016,2016.0
9,Ohio St. (Big Ten),15,7-8,194,130,324,0.599,05/30/2016,2016.0
10,Duke (ACC),19,11-8,301,203,504,0.597,05/30/2016,2016.0
11,Bucknell (Patriot),15,10-5,203,153,356,0.570,05/30/2016,2016.0
12,Navy (Patriot),16,11-5,185,142,327,0.566,05/30/2016,2016.0
13,North Carolina (ACC),18,12-6,266,209,475,0.560,05/30/2016,2016.0
14,Marquette (Big East),16,11-5,184,147,331,0.556,05/30/2016,2016.0
15,Virginia (ACC),15,7-8,196,159,355,0.552,05/30/2016,2016.0
16,Villanova (Big East),14,9-5,212,172,384,0.552,05/30/2016,2016.0
17,Hobart (NEC),17,10-7,215,175,390,0.551,05/30/2016,2016.0
18,Bryant (NEC),15,10-5,191,156,347,0.550,05/30/2016,2016.0
19,Bellarmine (SoCon),15,6-9,169,141,310,0.545,05/30/2016,2016.0
20,Jacksonville (SoCon),13,3-10,164,138,302,0.543,05/30/2016,2016.0
21,Hofstra (CAA),15,9-6,178,151,329,0.541,05/30/2016,2016.0
22,High Point (SoCon),15,9-6,197,172,369,0.534,05/30/2016,2016.0
23,Michigan (Big Ten),13,3-10,178,156,334,0.533,05/30/2016,2016.0
24,Johns Hopkins (Big Ten),15,8-7,215,190,405,0.531,05/30/2016,2016.0
25,Fairfield (CAA),17,9-8,194,172,366,0.530,05/30/2016,2016.0
26,Maryland (Big Ten),20,17-3,243,221,464,0.524,05/30/2016,2016.0
27,Richmond (SoCon),16,11-5,162,148,310,0.523,05/30/2016,2016.0
28,Stony Brook (America East),16,12-4,212,198,410,0.517,05/30/2016,2016.0
29,Quinnipiac (MAAC),16,12-4,185,174,359,0.515,05/30/2016,2016.0
30,Vermont (America East),17,9-8,227,216,443,0.512,05/30/2016,2016.0
31,Air Force (SoCon),18,15-3,198,189,387,0.512,05/30/2016,2016.0
32,Mount St. Mary's (NEC),14,6-8,161,154,315,0.511,05/30/2016,2016.0
33,Loyola Maryland (Patriot),18,14-4,212,203,415,0.511,05/30/2016,2016.0
34,Canisius (MAAC),12,4-8,142,138,280,0.507,05/30/2016,2016.0
35,UAlbany (America East),16,12-4,207,211,418,0.495,05/30/2016,2016.0
36,Notre Dame (ACC),15,11-4,166,171,337,0.493,05/30/2016,2016.0
37,Yale (Ivy League),16,13-3,186,192,378,0.492,05/30/2016,2016.0
38,Massachusetts (CAA),13,4-9,138,143,281,0.491,05/30/2016,2016.0
39,Delaware (CAA),15,5-10,163,169,332,0.491,05/30/2016,2016.0
40,Lafayette (Patriot),14,3-11,154,160,314,0.490,05/30/2016,2016.0
41,Mercer (SoCon),13,5-8,148,156,304,0.487,05/30/2016,2016.0
42,Binghamton (America East),14,4-10,169,181,350,0.483,05/30/2016,2016.0
43,Rutgers (Big Ten),16,11-5,199,214,413,0.482,05/30/2016,2016.0
44,Towson (CAA),19,16-3,195,210,405,0.481,05/30/2016,2016.0
45,Penn St. (Big Ten),15,8-7,185,209,394,0.470,05/30/2016,2016.0
46,Princeton (Ivy League),13,5-8,152,172,324,0.469,05/30/2016,2016.0
47,Penn (Ivy League),15,8-7,163,191,354,0.460,05/30/2016,2016.0
48,Wagner (NEC),15,6-9,153,186,339,0.451,05/30/2016,2016.0
49,Furman (SoCon),13,2-11,133,162,295,0.451,05/30/2016,2016.0
50,Siena (MAAC),13,3-10,143,175,318,0.450,05/30/2016,2016.0
51,Detroit Mercy (MAAC),12,2-10,101,125,226,0.447,05/30/2016,2016.0
52,Robert Morris (NEC),15,7-8,174,220,394,0.442,05/30/2016,2016.0
53,Monmouth (MAAC),14,7-7,130,168,298,0.436,05/30/2016,2016.0
54,St. John's (NY) (Big East),14,2-12,150,197,347,0.432,05/30/2016,2016.0
55,Sacred Heart (NEC),16,2-14,155,223,378,0.410,05/30/2016,2016.0
56,Colgate (Patriot),14,4-10,121,175,296,0.409,05/30/2016,2016.0
57,VMI (SoCon),16,2-14,149,219,368,0.405,05/30/2016,2016.0
58,Providence (Big East),16,7-9,153,229,382,0.401,05/30/2016,2016.0
59,Drexel (CAA),15,6-9,131,197,328,0.399,05/30/2016,2016.0
60,Dartmouth (Ivy League),14,1-13,122,192,314,0.389,05/30/2016,2016.0
61,NJIT (Independent),15,1-14,133,211,344,0.387,05/30/2016,2016.0
62,Harvard (Ivy League),16,8-8,155,250,405,0.383,05/30/2016,2016.0
63,Georgetown (Big East),14,2-12,114,188,302,0.377,05/30/2016,2016.0
64,Manhattan (MAAC),15,3-12,125,215,340,0.368,05/30/2016,2016.0
65,Holy Cross (Patriot),15,4-11,131,227,358,0.366,05/30/2016,2016.0
66,Lehigh (Patriot),15,6-9,119,243,362,0.329,05/30/2016,2016.0
67,UMBC (America East),14,4-10,105,232,337,0.312,05/30/2016,2016.0
68,Marist (MAAC),16,9-7,106,238,344,0.308,05/30/2016,2016.0
-,UMass Lowell (America East),16,4-12,154,219,373,0.413,05/30/2016,2016.0
1,Hartford (America East),18,11-7,305,136,441,0.692,05/28/2016,2016.0
2,Denver (Big East),16,13-3,280,136,416,0.673,05/28/2016,2016.0
3,Brown (Ivy League),19,16-3,360,179,539,0.668,05/28/2016,2016.0
4,Cornell (Ivy League),13,6-7,188,109,297,0.633,05/28/2016,2016.0
5,Syracuse (ACC),17,12-5,258,154,412,0.626,05/28/2016,2016.0
6,Boston U. (Patriot),15,8-7,210,128,338,0.621,05/28/2016,2016.0
7,Army West Point (Patriot),17,10-7,238,150,388,0.613,05/28/2016,2016.0
8,Saint Joseph's (NEC),16,12-4,228,147,375,0.608,05/28/2016,2016.0
9,Ohio St. (Big Ten),15,7-8,194,130,324,0.599,05/28/2016,2016.0
10,Duke (ACC),19,11-8,301,203,504,0.597,05/28/2016,2016.0
11,North Carolina (ACC),17,11-6,255,190,445,0.573,05/28/2016,2016.0
12,Bucknell (Patriot),15,10-5,203,153,356,0.570,05/28/2016,2016.0
13,Navy (Patriot),16,11-5,185,142,327,0.566,05/28/2016,2016.0
14,Marquette (Big East),16,11-5,184,147,331,0.556,05/28/2016,2016.0
15,Virginia (ACC),15,7-8,196,159,355,0.552,05/28/2016,2016.0
16,Villanova (Big East),14,9-5,212,172,384,0.552,05/28/2016,2016.0
17,Hobart (NEC),17,10-7,215,175,390,0.551,05/28/2016,2016.0
18,Bryant (NEC),15,10-5,191,156,347,0.550,05/28/2016,2016.0
19,Bellarmine (SoCon),15,6-9,169,141,310,0.545,05/28/2016,2016.0
20,Jacksonville (SoCon),13,3-10,164,138,302,0.543,05/28/2016,2016.0
21,Hofstra (CAA),15,9-6,178,151,329,0.541,05/28/2016,2016.0
22,High Point (SoCon),15,9-6,197,172,369,0.534,05/28/2016,2016.0
23,Michigan (Big Ten),13,3-10,178,156,334,0.533,05/28/2016,2016.0
24,Johns Hopkins (Big Ten),15,8-7,215,190,405,0.531,05/28/2016,2016.0
25,Fairfield (CAA),17,9-8,194,172,366,0.530,05/28/2016,2016.0
26,Richmond (SoCon),16,11-5,162,148,310,0.523,05/28/2016,2016.0
27,Stony Brook (America East),16,12-4,212,198,410,0.517,05/28/2016,2016.0
28,Maryland (Big Ten),19,17-2,224,210,434,0.516,05/28/2016,2016.0
29,Quinnipiac (MAAC),16,12-4,185,174,359,0.515,05/28/2016,2016.0
30,Vermont (America East),17,9-8,227,216,443,0.512,05/28/2016,2016.0
31,Air Force (SoCon),18,15-3,198,189,387,0.512,05/28/2016,2016.0
32,Mount St. Mary's (NEC),14,6-8,161,154,315,0.511,05/28/2016,2016.0
33,Loyola Maryland (Patriot),18,14-4,212,203,415,0.511,05/28/2016,2016.0
34,Canisius (MAAC),12,4-8,142,138,280,0.507,05/28/2016,2016.0
35,UAlbany (America East),16,12-4,207,211,418,0.495,05/28/2016,2016.0
36,Notre Dame (ACC),15,11-4,166,171,337,0.493,05/28/2016,2016.0
37,Yale (Ivy League),16,13-3,186,192,378,0.492,05/28/2016,2016.0
38,Massachusetts (CAA),13,4-9,138,143,281,0.491,05/28/2016,2016.0
39,Delaware (CAA),15,5-10,163,169,332,0.491,05/28/2016,2016.0
40,Lafayette (Patriot),14,3-11,154,160,314,0.490,05/28/2016,2016.0
41,Mercer (SoCon),13,5-8,148,156,304,0.487,05/28/2016,2016.0
42,Binghamton (America East),14,4-10,169,181,350,0.483,05/28/2016,2016.0
43,Rutgers (Big Ten),16,11-5,199,214,413,0.482,05/28/2016,2016.0
44,Towson (CAA),19,16-3,195,210,405,0.481,05/28/2016,2016.0
45,Penn St. (Big Ten),15,8-7,185,209,394,0.470,05/28/2016,2016.0
46,Princeton (Ivy League),13,5-8,152,172,324,0.469,05/28/2016,2016.0
47,Penn (Ivy League),15,8-7,163,191,354,0.460,05/28/2016,2016.0
48,Wagner (NEC),15,6-9,153,186,339,0.451,05/28/2016,2016.0
49,Furman (SoCon),13,2-11,133,162,295,0.451,05/28/2016,2016.0
50,Siena (MAAC),13,3-10,143,175,318,0.450,05/28/2016,2016.0
51,Detroit Mercy (MAAC),12,2-10,101,125,226,0.447,05/28/2016,2016.0
52,Robert Morris (NEC),15,7-8,174,220,394,0.442,05/28/2016,2016.0
53,Monmouth (MAAC),14,7-7,130,168,298,0.436,05/28/2016,2016.0
54,St. John's (NY) (Big East),14,2-12,150,197,347,0.432,05/28/2016,2016.0
55,Sacred Heart (NEC),16,2-14,155,223,378,0.410,05/28/2016,2016.0
56,Colgate (Patriot),14,4-10,121,175,296,0.409,05/28/2016,2016.0
57,VMI (SoCon),16,2-14,149,219,368,0.405,05/28/2016,2016.0
58,Providence (Big East),16,7-9,153,229,382,0.401,05/28/2016,2016.0
59,Drexel (CAA),15,6-9,131,197,328,0.399,05/28/2016,2016.0
60,Dartmouth (Ivy League),14,1-13,122,192,314,0.389,05/28/2016,2016.0
61,NJIT (Independent),15,1-14,133,211,344,0.387,05/28/2016,2016.0
62,Harvard (Ivy League),16,8-8,155,250,405,0.383,05/28/2016,2016.0
63,Georgetown (Big East),14,2-12,114,188,302,0.377,05/28/2016,2016.0
64,Manhattan (MAAC),15,3-12,125,215,340,0.368,05/28/2016,2016.0
65,Holy Cross (Patriot),15,4-11,131,227,358,0.366,05/28/2016,2016.0
66,Lehigh (Patriot),15,6-9,119,243,362,0.329,05/28/2016,2016.0
67,UMBC (America East),14,4-10,105,232,337,0.312,05/28/2016,2016.0
68,Marist (MAAC),16,9-7,106,238,344,0.308,05/28/2016,2016.0
-,UMass Lowell (America East),16,4-12,154,219,373,0.413,05/28/2016,2016.0
1,Hartford (America East),18,11-7,305,136,441,0.692,05/22/2016,2016.0
2,Denver (Big East),16,13-3,280,136,416,0.673,05/22/2016,2016.0
3,Brown (Ivy League),18,16-2,340,167,507,0.671,05/22/2016,2016.0
4,Cornell (Ivy League),13,6-7,188,109,297,0.633,05/22/2016,2016.0
5,Syracuse (ACC),17,12-5,258,154,412,0.626,05/22/2016,2016.0
6,Boston U. (Patriot),15,8-7,210,128,338,0.621,05/22/2016,2016.0
7,Army West Point (Patriot),17,10-7,238,150,388,0.613,05/22/2016,2016.0
8,Saint Joseph's (NEC),16,12-4,228,147,375,0.608,05/22/2016,2016.0
9,Ohio St. (Big Ten),15,7-8,194,130,324,0.599,05/22/2016,2016.0
10,Duke (ACC),19,11-8,301,203,504,0.597,05/22/2016,2016.0
11,North Carolina (ACC),16,10-6,236,174,410,0.576,05/22/2016,2016.0
12,Bucknell (Patriot),15,10-5,203,153,356,0.570,05/22/2016,2016.0
13,Navy (Patriot),16,11-5,185,142,327,0.566,05/22/2016,2016.0
14,Marquette (Big East),16,11-5,184,147,331,0.556,05/22/2016,2016.0
15,Virginia (ACC),15,7-8,196,159,355,0.552,05/22/2016,2016.0
16,Villanova (Big East),14,9-5,212,172,384,0.552,05/22/2016,2016.0
17,Hobart (NEC),17,10-7,215,175,390,0.551,05/22/2016,2016.0
18,Bryant (NEC),15,10-5,191,156,347,0.550,05/22/2016,2016.0
19,Bellarmine (SoCon),15,6-9,169,141,310,0.545,05/22/2016,2016.0
20,Jacksonville (SoCon),13,3-10,164,138,302,0.543,05/22/2016,2016.0
21,Hofstra (CAA),15,9-6,178,151,329,0.541,05/22/2016,2016.0
22,High Point (SoCon),15,9-6,197,172,369,0.534,05/22/2016,2016.0
23,Michigan (Big Ten),13,3-10,178,156,334,0.533,05/22/2016,2016.0
24,Johns Hopkins (Big Ten),15,8-7,215,190,405,0.531,05/22/2016,2016.0
25,Fairfield (CAA),17,9-8,194,172,366,0.530,05/22/2016,2016.0
26,Maryland (Big Ten),18,16-2,212,190,402,0.527,05/22/2016,2016.0
27,Richmond (SoCon),16,11-5,162,148,310,0.523,05/22/2016,2016.0
28,Stony Brook (America East),16,12-4,212,198,410,0.517,05/22/2016,2016.0
29,Loyola Maryland (Patriot),17,14-3,196,184,380,0.516,05/22/2016,2016.0
30,Quinnipiac (MAAC),16,12-4,185,174,359,0.515,05/22/2016,2016.0
31,Vermont (America East),17,9-8,227,216,443,0.512,05/22/2016,2016.0
32,Air Force (SoCon),18,15-3,198,189,387,0.512,05/22/2016,2016.0
33,Mount St. Mary's (NEC),14,6-8,161,154,315,0.511,05/22/2016,2016.0
34,Canisius (MAAC),12,4-8,142,138,280,0.507,05/22/2016,2016.0
35,UAlbany (America East),16,12-4,207,211,418,0.495,05/22/2016,2016.0
36,Notre Dame (ACC),15,11-4,166,171,337,0.493,05/22/2016,2016.0
37,Yale (Ivy League),16,13-3,186,192,378,0.492,05/22/2016,2016.0
38,Massachusetts (CAA),13,4-9,138,143,281,0.491,05/22/2016,2016.0
39,Delaware (CAA),15,5-10,163,169,332,0.491,05/22/2016,2016.0
40,Lafayette (Patriot),14,3-11,154,160,314,0.490,05/22/2016,2016.0
41,Mercer (SoCon),13,5-8,148,156,304,0.487,05/22/2016,2016.0
42,Binghamton (America East),14,4-10,169,181,350,0.483,05/22/2016,2016.0
43,Rutgers (Big Ten),16,11-5,199,214,413,0.482,05/22/2016,2016.0
44,Towson (CAA),19,16-3,195,210,405,0.481,05/22/2016,2016.0
45,Penn St. (Big Ten),15,8-7,185,209,394,0.470,05/22/2016,2016.0
46,Princeton (Ivy League),13,5-8,152,172,324,0.469,05/22/2016,2016.0
47,Penn (Ivy League),15,8-7,163,191,354,0.460,05/22/2016,2016.0
48,Wagner (NEC),15,6-9,153,186,339,0.451,05/22/2016,2016.0
49,Furman (SoCon),13,2-11,133,162,295,0.451,05/22/2016,2016.0
50,Siena (MAAC),13,3-10,143,175,318,0.450,05/22/2016,2016.0
51,Detroit Mercy (MAAC),12,2-10,101,125,226,0.447,05/22/2016,2016.0
52,Robert Morris (NEC),15,7-8,174,220,394,0.442,05/22/2016,2016.0
53,Monmouth (MAAC),14,7-7,130,168,298,0.436,05/22/2016,2016.0
54,St. John's (NY) (Big East),14,2-12,150,197,347,0.432,05/22/2016,2016.0
55,Sacred Heart (NEC),16,2-14,155,223,378,0.410,05/22/2016,2016.0
56,Colgate (Patriot),14,4-10,121,175,296,0.409,05/22/2016,2016.0
57,VMI (SoCon),16,2-14,149,219,368,0.405,05/22/2016,2016.0
58,Providence (Big East),16,7-9,153,229,382,0.401,05/22/2016,2016.0
59,Drexel (CAA),15,6-9,131,197,328,0.399,05/22/2016,2016.0
60,Dartmouth (Ivy League),14,1-13,122,192,314,0.389,05/22/2016,2016.0
61,NJIT (Independent),15,1-14,133,211,344,0.387,05/22/2016,2016.0
62,Harvard (Ivy League),16,8-8,155,250,405,0.383,05/22/2016,2016.0
63,Georgetown (Big East),14,2-12,114,188,302,0.377,05/22/2016,2016.0
64,Manhattan (MAAC),15,3-12,125,215,340,0.368,05/22/2016,2016.0
65,Holy Cross (Patriot),15,4-11,131,227,358,0.366,05/22/2016,2016.0
66,Lehigh (Patriot),15,6-9,119,243,362,0.329,05/22/2016,2016.0
67,UMBC (America East),14,4-10,105,232,337,0.312,05/22/2016,2016.0
68,Marist (MAAC),16,9-7,106,238,344,0.308,05/22/2016,2016.0
-,UMass Lowell (America East),16,4-12,154,219,373,0.413,05/22/2016,2016.0
1,Hartford (America East),18,11-7,305,136,441,0.692,05/21/2016,2016.0
2,Denver (Big East),16,13-3,280,136,416,0.673,05/21/2016,2016.0
3,Brown (Ivy League),18,16-2,340,167,507,0.671,05/21/2016,2016.0
4,Cornell (Ivy League),13,6-7,188,109,297,0.633,05/21/2016,2016.0
5,Syracuse (ACC),17,12-5,258,154,412,0.626,05/21/2016,2016.0
6,Boston U. (Patriot),15,8-7,210,128,338,0.621,05/21/2016,2016.0
7,Army West Point (Patriot),17,10-7,238,150,388,0.613,05/21/2016,2016.0
8,Saint Joseph's (NEC),16,12-4,228,147,375,0.608,05/21/2016,2016.0
9,Ohio St. (Big Ten),15,7-8,194,130,324,0.599,05/21/2016,2016.0
10,Duke (ACC),19,11-8,301,203,504,0.597,05/21/2016,2016.0
11,Bucknell (Patriot),15,10-5,203,153,356,0.570,05/21/2016,2016.0
12,North Carolina (ACC),15,9-6,219,166,385,0.569,05/21/2016,2016.0
13,Navy (Patriot),16,11-5,185,142,327,0.566,05/21/2016,2016.0
14,Marquette (Big East),16,11-5,184,147,331,0.556,05/21/2016,2016.0
15,Virginia (ACC),15,7-8,196,159,355,0.552,05/21/2016,2016.0
16,Villanova (Big East),14,9-5,212,172,384,0.552,05/21/2016,2016.0
17,Hobart (NEC),17,10-7,215,175,390,0.551,05/21/2016,2016.0
18,Bryant (NEC),15,10-5,191,156,347,0.550,05/21/2016,2016.0
19,Bellarmine (SoCon),15,6-9,169,141,310,0.545,05/21/2016,2016.0
20,Jacksonville (SoCon),13,3-10,164,138,302,0.543,05/21/2016,2016.0
21,Hofstra (CAA),15,9-6,178,151,329,0.541,05/21/2016,2016.0
22,High Point (SoCon),15,9-6,197,172,369,0.534,05/21/2016,2016.0
23,Michigan (Big Ten),13,3-10,178,156,334,0.533,05/21/2016,2016.0
24,Johns Hopkins (Big Ten),15,8-7,215,190,405,0.531,05/21/2016,2016.0
25,Fairfield (CAA),17,9-8,194,172,366,0.530,05/21/2016,2016.0
26,Maryland (Big Ten),18,16-2,212,190,402,0.527,05/21/2016,2016.0
27,Richmond (SoCon),16,11-5,162,148,310,0.523,05/21/2016,2016.0
28,Stony Brook (America East),16,12-4,212,198,410,0.517,05/21/2016,2016.0
29,Quinnipiac (MAAC),16,12-4,185,174,359,0.515,05/21/2016,2016.0
30,Vermont (America East),17,9-8,227,216,443,0.512,05/21/2016,2016.0
31,Air Force (SoCon),18,15-3,198,189,387,0.512,05/21/2016,2016.0
32,Mount St. Mary's (NEC),14,6-8,161,154,315,0.511,05/21/2016,2016.0
33,Canisius (MAAC),12,4-8,142,138,280,0.507,05/21/2016,2016.0
34,Notre Dame (ACC),14,11-3,158,154,312,0.506,05/21/2016,2016.0
35,Loyola Maryland (Patriot),16,13-3,181,177,358,0.506,05/21/2016,2016.0
36,UAlbany (America East),16,12-4,207,211,418,0.495,05/21/2016,2016.0
37,Yale (Ivy League),16,13-3,186,192,378,0.492,05/21/2016,2016.0
38,Massachusetts (CAA),13,4-9,138,143,281,0.491,05/21/2016,2016.0
39,Delaware (CAA),15,5-10,163,169,332,0.491,05/21/2016,2016.0
40,Towson (CAA),18,16-2,188,195,383,0.491,05/21/2016,2016.0
41,Lafayette (Patriot),14,3-11,154,160,314,0.490,05/21/2016,2016.0
42,Mercer (SoCon),13,5-8,148,156,304,0.487,05/21/2016,2016.0
43,Binghamton (America East),14,4-10,169,181,350,0.483,05/21/2016,2016.0
44,Rutgers (Big Ten),16,11-5,199,214,413,0.482,05/21/2016,2016.0
45,Penn St. (Big Ten),15,8-7,185,209,394,0.470,05/21/2016,2016.0
46,Princeton (Ivy League),13,5-8,152,172,324,0.469,05/21/2016,2016.0
47,Penn (Ivy League),15,8-7,163,191,354,0.460,05/21/2016,2016.0
48,Wagner (NEC),15,6-9,153,186,339,0.451,05/21/2016,2016.0
49,Furman (SoCon),13,2-11,133,162,295,0.451,05/21/2016,2016.0
50,Siena (MAAC),13,3-10,143,175,318,0.450,05/21/2016,2016.0
51,Detroit Mercy (MAAC),12,2-10,101,125,226,0.447,05/21/2016,2016.0
52,Robert Morris (NEC),15,7-8,174,220,394,0.442,05/21/2016,2016.0
53,Monmouth (MAAC),14,7-7,130,168,298,0.436,05/21/2016,2016.0
54,St. John's (NY) (Big East),14,2-12,150,197,347,0.432,05/21/2016,2016.0
55,Sacred Heart (NEC),16,2-14,155,223,378,0.410,05/21/2016,2016.0
56,Colgate (Patriot),14,4-10,121,175,296,0.409,05/21/2016,2016.0
57,VMI (SoCon),16,2-14,149,219,368,0.405,05/21/2016,2016.0
58,Providence (Big East),16,7-9,153,229,382,0.401,05/21/2016,2016.0
59,Drexel (CAA),15,6-9,131,197,328,0.399,05/21/2016,2016.0
60,Dartmouth (Ivy League),14,1-13,122,192,314,0.389,05/21/2016,2016.0
61,NJIT (Independent),15,1-14,133,211,344,0.387,05/21/2016,2016.0
62,Harvard (Ivy League),16,8-8,155,250,405,0.383,05/21/2016,2016.0
63,Georgetown (Big East),14,2-12,114,188,302,0.377,05/21/2016,2016.0
64,Manhattan (MAAC),15,3-12,125,215,340,0.368,05/21/2016,2016.0
65,Holy Cross (Patriot),15,4-11,131,227,358,0.366,05/21/2016,2016.0
66,Lehigh (Patriot),15,6-9,119,243,362,0.329,05/21/2016,2016.0
67,UMBC (America East),14,4-10,105,232,337,0.312,05/21/2016,2016.0
68,Marist (MAAC),16,9-7,106,238,344,0.308,05/21/2016,2016.0
-,UMass Lowell (America East),16,4-12,154,219,373,0.413,05/21/2016,2016.0
1,Hartford (America East),18,11-7,305,136,441,0.692,05/15/2016,2016.0
2,Denver (Big East),16,13-3,280,136,416,0.673,05/15/2016,2016.0
3,Brown (Ivy League),17,15-2,322,160,482,0.668,05/15/2016,2016.0
4,Cornell (Ivy League),13,6-7,188,109,297,0.633,05/15/2016,2016.0
5,Syracuse (ACC),16,12-4,243,145,388,0.626,05/15/2016,2016.0
6,Boston U. (Patriot),15,8-7,210,128,338,0.621,05/15/2016,2016.0
7,Army West Point (Patriot),17,10-7,238,150,388,0.613,05/15/2016,2016.0
8,Saint Joseph's (NEC),16,12-4,228,147,375,0.608,05/15/2016,2016.0
9,Ohio St. (Big Ten),15,7-8,194,130,324,0.599,05/15/2016,2016.0
10,Duke (ACC),19,11-8,301,203,504,0.597,05/15/2016,2016.0
11,Navy (Patriot),15,11-4,178,124,302,0.589,05/15/2016,2016.0
12,Bucknell (Patriot),15,10-5,203,153,356,0.570,05/15/2016,2016.0
13,North Carolina (ACC),15,9-6,219,166,385,0.569,05/15/2016,2016.0
14,Marquette (Big East),16,11-5,184,147,331,0.556,05/15/2016,2016.0
15,Virginia (ACC),15,7-8,196,159,355,0.552,05/15/2016,2016.0
16,Villanova (Big East),14,9-5,212,172,384,0.552,05/15/2016,2016.0
17,Hobart (NEC),17,10-7,215,175,390,0.551,05/15/2016,2016.0
18,Bryant (NEC),15,10-5,191,156,347,0.550,05/15/2016,2016.0
19,Bellarmine (SoCon),15,6-9,169,141,310,0.545,05/15/2016,2016.0
20,Jacksonville (SoCon),13,3-10,164,138,302,0.543,05/15/2016,2016.0
21,Hofstra (CAA),15,9-6,178,151,329,0.541,05/15/2016,2016.0
22,Maryland (Big Ten),17,15-2,203,175,378,0.537,05/15/2016,2016.0
23,High Point (SoCon),15,9-6,197,172,369,0.534,05/15/2016,2016.0
24,Michigan (Big Ten),13,3-10,178,156,334,0.533,05/15/2016,2016.0
25,Johns Hopkins (Big Ten),15,8-7,215,190,405,0.531,05/15/2016,2016.0
26,Fairfield (CAA),17,9-8,194,172,366,0.530,05/15/2016,2016.0
27,Richmond (SoCon),16,11-5,162,148,310,0.523,05/15/2016,2016.0
28,Stony Brook (America East),16,12-4,212,198,410,0.517,05/15/2016,2016.0
29,Quinnipiac (MAAC),16,12-4,185,174,359,0.515,05/15/2016,2016.0
30,Vermont (America East),17,9-8,227,216,443,0.512,05/15/2016,2016.0
31,Air Force (SoCon),18,15-3,198,189,387,0.512,05/15/2016,2016.0
32,Mount St. Mary's (NEC),14,6-8,161,154,315,0.511,05/15/2016,2016.0
33,Canisius (MAAC),12,4-8,142,138,280,0.507,05/15/2016,2016.0
34,Notre Dame (ACC),14,11-3,158,154,312,0.506,05/15/2016,2016.0
35,Loyola Maryland (Patriot),16,13-3,181,177,358,0.506,05/15/2016,2016.0
36,UAlbany (America East),16,12-4,207,211,418,0.495,05/15/2016,2016.0
37,Yale (Ivy League),16,13-3,186,192,378,0.492,05/15/2016,2016.0
38,Massachusetts (CAA),13,4-9,138,143,281,0.491,05/15/2016,2016.0
39,Delaware (CAA),15,5-10,163,169,332,0.491,05/15/2016,2016.0
40,Towson (CAA),18,16-2,188,195,383,0.491,05/15/2016,2016.0
41,Lafayette (Patriot),14,3-11,154,160,314,0.490,05/15/2016,2016.0
42,Mercer (SoCon),13,5-8,148,156,304,0.487,05/15/2016,2016.0
43,Binghamton (America East),14,4-10,169,181,350,0.483,05/15/2016,2016.0
44,Rutgers (Big Ten),16,11-5,199,214,413,0.482,05/15/2016,2016.0
45,Penn St. (Big Ten),15,8-7,185,209,394,0.470,05/15/2016,2016.0
46,Princeton (Ivy League),13,5-8,152,172,324,0.469,05/15/2016,2016.0
47,Penn (Ivy League),15,8-7,163,191,354,0.460,05/15/2016,2016.0
48,Wagner (NEC),15,6-9,153,186,339,0.451,05/15/2016,2016.0
49,Furman (SoCon),13,2-11,133,162,295,0.451,05/15/2016,2016.0
50,Siena (MAAC),13,3-10,143,175,318,0.450,05/15/2016,2016.0
51,Detroit Mercy (MAAC),12,2-10,101,125,226,0.447,05/15/2016,2016.0
52,Robert Morris (NEC),15,7-8,174,220,394,0.442,05/15/2016,2016.0
53,Monmouth (MAAC),14,7-7,130,168,298,0.436,05/15/2016,2016.0
54,St. John's (NY) (Big East),14,2-12,150,197,347,0.432,05/15/2016,2016.0
55,Sacred Heart (NEC),16,2-14,155,223,378,0.410,05/15/2016,2016.0
56,Colgate (Patriot),14,4-10,121,175,296,0.409,05/15/2016,2016.0
57,VMI (SoCon),16,2-14,149,219,368,0.405,05/15/2016,2016.0
58,Providence (Big East),16,7-9,153,229,382,0.401,05/15/2016,2016.0
59,Drexel (CAA),15,6-9,131,197,328,0.399,05/15/2016,2016.0
60,Dartmouth (Ivy League),14,1-13,122,192,314,0.389,05/15/2016,2016.0
61,NJIT (Independent),15,1-14,133,211,344,0.387,05/15/2016,2016.0
62,Harvard (Ivy League),16,8-8,155,250,405,0.383,05/15/2016,2016.0
63,Georgetown (Big East),14,2-12,114,188,302,0.377,05/15/2016,2016.0
64,Manhattan (MAAC),15,3-12,125,215,340,0.368,05/15/2016,2016.0
65,Holy Cross (Patriot),15,4-11,131,227,358,0.366,05/15/2016,2016.0
66,Lehigh (Patriot),15,6-9,119,243,362,0.329,05/15/2016,2016.0
67,UMBC (America East),14,4-10,105,232,337,0.312,05/15/2016,2016.0
68,Marist (MAAC),16,9-7,106,238,344,0.308,05/15/2016,2016.0
-,UMass Lowell (America East),16,4-12,154,219,373,0.413,05/15/2016,2016.0
1,Hartford (America East),18,11-7,305,136,441,0.692,05/14/2016,2016.0
2,Brown (Ivy League),17,15-2,322,160,482,0.668,05/14/2016,2016.0
3,Denver (Big East),15,13-2,260,134,394,0.660,05/14/2016,2016.0
4,Syracuse (ACC),15,11-4,231,133,364,0.635,05/14/2016,2016.0
5,Cornell (Ivy League),13,6-7,188,109,297,0.633,05/14/2016,2016.0
6,Boston U. (Patriot),15,8-7,210,128,338,0.621,05/14/2016,2016.0
7,Army West Point (Patriot),17,10-7,238,150,388,0.613,05/14/2016,2016.0
8,Saint Joseph's (NEC),16,12-4,228,147,375,0.608,05/14/2016,2016.0
9,Ohio St. (Big Ten),15,7-8,194,130,324,0.599,05/14/2016,2016.0
10,Duke (ACC),19,11-8,301,203,504,0.597,05/14/2016,2016.0
11,Navy (Patriot),14,10-4,162,114,276,0.587,05/14/2016,2016.0
12,Bucknell (Patriot),15,10-5,203,153,356,0.570,05/14/2016,2016.0
13,North Carolina (ACC),15,9-6,219,166,385,0.569,05/14/2016,2016.0
14,Marquette (Big East),16,11-5,184,147,331,0.556,05/14/2016,2016.0
15,Virginia (ACC),15,7-8,196,159,355,0.552,05/14/2016,2016.0
16,Villanova (Big East),14,9-5,212,172,384,0.552,05/14/2016,2016.0
17,Hobart (NEC),17,10-7,215,175,390,0.551,05/14/2016,2016.0
18,Bryant (NEC),15,10-5,191,156,347,0.550,05/14/2016,2016.0
19,Bellarmine (SoCon),15,6-9,169,141,310,0.545,05/14/2016,2016.0
20,Jacksonville (SoCon),13,3-10,164,138,302,0.543,05/14/2016,2016.0
21,Hofstra (CAA),15,9-6,178,151,329,0.541,05/14/2016,2016.0
22,High Point (SoCon),15,9-6,197,172,369,0.534,05/14/2016,2016.0
23,Michigan (Big Ten),13,3-10,178,156,334,0.533,05/14/2016,2016.0
24,Johns Hopkins (Big Ten),15,8-7,215,190,405,0.531,05/14/2016,2016.0
25,Fairfield (CAA),17,9-8,194,172,366,0.530,05/14/2016,2016.0
26,Quinnipiac (MAAC),15,12-3,179,159,338,0.530,05/14/2016,2016.0
27,Maryland (Big Ten),16,14-2,188,169,357,0.527,05/14/2016,2016.0
28,Richmond (SoCon),16,11-5,162,148,310,0.523,05/14/2016,2016.0
29,Stony Brook (America East),16,12-4,212,198,410,0.517,05/14/2016,2016.0
30,Towson (CAA),17,15-2,186,175,361,0.515,05/14/2016,2016.0
31,Vermont (America East),17,9-8,227,216,443,0.512,05/14/2016,2016.0
32,Air Force (SoCon),18,15-3,198,189,387,0.512,05/14/2016,2016.0
33,Mount St. Mary's (NEC),14,6-8,161,154,315,0.511,05/14/2016,2016.0
34,Canisius (MAAC),12,4-8,142,138,280,0.507,05/14/2016,2016.0
35,Notre Dame (ACC),14,11-3,158,154,312,0.506,05/14/2016,2016.0
36,Loyola Maryland (Patriot),16,13-3,181,177,358,0.506,05/14/2016,2016.0
37,Yale (Ivy League),15,13-2,176,176,352,0.500,05/14/2016,2016.0
38,UAlbany (America East),15,12-3,195,199,394,0.495,05/14/2016,2016.0
39,Massachusetts (CAA),13,4-9,138,143,281,0.491,05/14/2016,2016.0
40,Delaware (CAA),15,5-10,163,169,332,0.491,05/14/2016,2016.0
41,Lafayette (Patriot),14,3-11,154,160,314,0.490,05/14/2016,2016.0
42,Mercer (SoCon),13,5-8,148,156,304,0.487,05/14/2016,2016.0
43,Binghamton (America East),14,4-10,169,181,350,0.483,05/14/2016,2016.0
44,Rutgers (Big Ten),16,11-5,199,214,413,0.482,05/14/2016,2016.0
45,Penn St. (Big Ten),15,8-7,185,209,394,0.470,05/14/2016,2016.0
46,Princeton (Ivy League),13,5-8,152,172,324,0.469,05/14/2016,2016.0
47,Penn (Ivy League),15,8-7,163,191,354,0.460,05/14/2016,2016.0
48,Wagner (NEC),15,6-9,153,186,339,0.451,05/14/2016,2016.0
49,Furman (SoCon),13,2-11,133,162,295,0.451,05/14/2016,2016.0
50,Siena (MAAC),13,3-10,143,175,318,0.450,05/14/2016,2016.0
51,Detroit Mercy (MAAC),12,2-10,101,125,226,0.447,05/14/2016,2016.0
52,Robert Morris (NEC),15,7-8,174,220,394,0.442,05/14/2016,2016.0
53,Monmouth (MAAC),14,7-7,130,168,298,0.436,05/14/2016,2016.0
54,St. John's (NY) (Big East),14,2-12,150,197,347,0.432,05/14/2016,2016.0
55,Sacred Heart (NEC),16,2-14,155,223,378,0.410,05/14/2016,2016.0
56,Colgate (Patriot),14,4-10,121,175,296,0.409,05/14/2016,2016.0
57,VMI (SoCon),16,2-14,149,219,368,0.405,05/14/2016,2016.0
58,Providence (Big East),16,7-9,153,229,382,0.401,05/14/2016,2016.0
59,Drexel (CAA),15,6-9,131,197,328,0.399,05/14/2016,2016.0
60,Dartmouth (Ivy League),14,1-13,122,192,314,0.389,05/14/2016,2016.0
61,NJIT (Independent),15,1-14,133,211,344,0.387,05/14/2016,2016.0
62,Harvard (Ivy League),16,8-8,155,250,405,0.383,05/14/2016,2016.0
63,Georgetown (Big East),14,2-12,114,188,302,0.377,05/14/2016,2016.0
64,Manhattan (MAAC),15,3-12,125,215,340,0.368,05/14/2016,2016.0
65,Holy Cross (Patriot),15,4-11,131,227,358,0.366,05/14/2016,2016.0
66,Lehigh (Patriot),15,6-9,119,243,362,0.329,05/14/2016,2016.0
67,UMBC (America East),14,4-10,105,232,337,0.312,05/14/2016,2016.0
68,Marist (MAAC),16,9-7,106,238,344,0.308,05/14/2016,2016.0
-,UMass Lowell (America East),16,4-12,154,219,373,0.413,05/14/2016,2016.0
1,Hartford (America East),18,11-7,305,136,441,0.692,05/11/2016,2016.0
2,Brown (Ivy League),16,14-2,302,152,454,0.665,05/11/2016,2016.0
3,Denver (Big East),15,13-2,260,134,394,0.660,05/11/2016,2016.0
4,Syracuse (ACC),15,11-4,231,133,364,0.635,05/11/2016,2016.0
5,Cornell (Ivy League),13,6-7,188,109,297,0.633,05/11/2016,2016.0
6,Boston U. (Patriot),15,8-7,210,128,338,0.621,05/11/2016,2016.0
7,Army West Point (Patriot),17,10-7,238,150,388,0.613,05/11/2016,2016.0
8,Saint Joseph's (NEC),16,12-4,228,147,375,0.608,05/11/2016,2016.0
9,Ohio St. (Big Ten),15,7-8,194,130,324,0.599,05/11/2016,2016.0
10,Duke (ACC),18,11-7,278,195,473,0.588,05/11/2016,2016.0
11,Navy (Patriot),14,10-4,162,114,276,0.587,05/11/2016,2016.0
12,Bucknell (Patriot),15,10-5,203,153,356,0.570,05/11/2016,2016.0
13,North Carolina (ACC),14,8-6,207,157,364,0.569,05/11/2016,2016.0
14,Marquette (Big East),15,11-4,175,135,310,0.565,05/11/2016,2016.0
15,Virginia (ACC),15,7-8,196,159,355,0.552,05/11/2016,2016.0
16,Villanova (Big East),14,9-5,212,172,384,0.552,05/11/2016,2016.0
17,Hobart (NEC),17,10-7,215,175,390,0.551,05/11/2016,2016.0
18,Bryant (NEC),15,10-5,191,156,347,0.550,05/11/2016,2016.0
19,Johns Hopkins (Big Ten),14,8-6,207,170,377,0.549,05/11/2016,2016.0
20,Bellarmine (SoCon),15,6-9,169,141,310,0.545,05/11/2016,2016.0
21,Jacksonville (SoCon),13,3-10,164,138,302,0.543,05/11/2016,2016.0
22,Hofstra (CAA),15,9-6,178,151,329,0.541,05/11/2016,2016.0
23,High Point (SoCon),15,9-6,197,172,369,0.534,05/11/2016,2016.0
24,Michigan (Big Ten),13,3-10,178,156,334,0.533,05/11/2016,2016.0
25,Fairfield (CAA),17,9-8,194,172,366,0.530,05/11/2016,2016.0
26,Quinnipiac (MAAC),15,12-3,179,159,338,0.530,05/11/2016,2016.0
27,Loyola Maryland (Patriot),15,12-3,173,154,327,0.529,05/11/2016,2016.0
28,Maryland (Big Ten),16,14-2,188,169,357,0.527,05/11/2016,2016.0
29,Air Force (SoCon),17,15-2,189,172,361,0.524,05/11/2016,2016.0
30,Richmond (SoCon),16,11-5,162,148,310,0.523,05/11/2016,2016.0
31,Stony Brook (America East),16,12-4,212,198,410,0.517,05/11/2016,2016.0
32,Towson (CAA),17,15-2,186,175,361,0.515,05/11/2016,2016.0
33,Vermont (America East),17,9-8,227,216,443,0.512,05/11/2016,2016.0
34,Mount St. Mary's (NEC),14,6-8,161,154,315,0.511,05/11/2016,2016.0
35,Canisius (MAAC),12,4-8,142,138,280,0.507,05/11/2016,2016.0
36,Yale (Ivy League),15,13-2,176,176,352,0.500,05/11/2016,2016.0
37,UAlbany (America East),15,12-3,195,199,394,0.495,05/11/2016,2016.0
38,Notre Dame (ACC),13,10-3,141,145,286,0.493,05/11/2016,2016.0
39,Massachusetts (CAA),13,4-9,138,143,281,0.491,05/11/2016,2016.0
40,Delaware (CAA),15,5-10,163,169,332,0.491,05/11/2016,2016.0
41,Lafayette (Patriot),14,3-11,154,160,314,0.490,05/11/2016,2016.0
42,Mercer (SoCon),13,5-8,148,156,304,0.487,05/11/2016,2016.0
43,Binghamton (America East),14,4-10,169,181,350,0.483,05/11/2016,2016.0
44,Rutgers (Big Ten),16,11-5,199,214,413,0.482,05/11/2016,2016.0
45,Penn St. (Big Ten),15,8-7,185,209,394,0.470,05/11/2016,2016.0
46,Princeton (Ivy League),13,5-8,152,172,324,0.469,05/11/2016,2016.0
47,Penn (Ivy League),15,8-7,163,191,354,0.460,05/11/2016,2016.0
48,Wagner (NEC),15,6-9,153,186,339,0.451,05/11/2016,2016.0
49,Furman (SoCon),13,2-11,133,162,295,0.451,05/11/2016,2016.0
50,Siena (MAAC),13,3-10,143,175,318,0.450,05/11/2016,2016.0
51,Detroit Mercy (MAAC),12,2-10,101,125,226,0.447,05/11/2016,2016.0
52,Robert Morris (NEC),15,7-8,174,220,394,0.442,05/11/2016,2016.0
53,Monmouth (MAAC),14,7-7,130,168,298,0.436,05/11/2016,2016.0
54,St. John's (NY) (Big East),14,2-12,150,197,347,0.432,05/11/2016,2016.0
55,Sacred Heart (NEC),16,2-14,155,223,378,0.410,05/11/2016,2016.0
56,Colgate (Patriot),14,4-10,121,175,296,0.409,05/11/2016,2016.0
57,VMI (SoCon),16,2-14,149,219,368,0.405,05/11/2016,2016.0
58,Providence (Big East),16,7-9,153,229,382,0.401,05/11/2016,2016.0
59,Drexel (CAA),15,6-9,131,197,328,0.399,05/11/2016,2016.0
60,Dartmouth (Ivy League),14,1-13,122,192,314,0.389,05/11/2016,2016.0
61,NJIT (Independent),15,1-14,133,211,344,0.387,05/11/2016,2016.0
62,Harvard (Ivy League),16,8-8,155,250,405,0.383,05/11/2016,2016.0
63,Georgetown (Big East),14,2-12,114,188,302,0.377,05/11/2016,2016.0
64,Manhattan (MAAC),15,3-12,125,215,340,0.368,05/11/2016,2016.0
65,Holy Cross (Patriot),15,4-11,131,227,358,0.366,05/11/2016,2016.0
66,Lehigh (Patriot),15,6-9,119,243,362,0.329,05/11/2016,2016.0
67,UMBC (America East),14,4-10,105,232,337,0.312,05/11/2016,2016.0
68,Marist (MAAC),16,9-7,106,238,344,0.308,05/11/2016,2016.0
-,UMass Lowell (America East),16,4-12,154,219,373,0.413,05/11/2016,2016.0
1,Hartford (America East),17,11-6,287,127,414,0.693,05/08/2016,2016.0
2,Brown (Ivy League),16,14-2,302,152,454,0.665,05/08/2016,2016.0
3,Denver (Big East),15,13-2,260,134,394,0.660,05/08/2016,2016.0
4,Syracuse (ACC),15,11-4,231,133,364,0.635,05/08/2016,2016.0
5,Cornell (Ivy League),13,6-7,188,109,297,0.633,05/08/2016,2016.0
6,Boston U. (Patriot),15,8-7,210,128,338,0.621,05/08/2016,2016.0
7,Army West Point (Patriot),17,10-7,238,150,388,0.613,05/08/2016,2016.0
8,Saint Joseph's (NEC),16,12-4,228,147,375,0.608,05/08/2016,2016.0
9,Ohio St. (Big Ten),15,7-8,194,130,324,0.599,05/08/2016,2016.0
10,Duke (ACC),18,11-7,278,195,473,0.588,05/08/2016,2016.0
11,Navy (Patriot),14,10-4,162,114,276,0.587,05/08/2016,2016.0
12,Bucknell (Patriot),15,10-5,203,153,356,0.570,05/08/2016,2016.0
13,North Carolina (ACC),14,8-6,207,157,364,0.569,05/08/2016,2016.0
14,Marquette (Big East),15,11-4,175,135,310,0.565,05/08/2016,2016.0
15,Hobart (NEC),16,10-6,203,161,364,0.558,05/08/2016,2016.0
16,Virginia (ACC),15,7-8,196,159,355,0.552,05/08/2016,2016.0
17,Villanova (Big East),14,9-5,212,172,384,0.552,05/08/2016,2016.0
18,Bryant (NEC),15,10-5,191,156,347,0.550,05/08/2016,2016.0
19,Johns Hopkins (Big Ten),14,8-6,207,170,377,0.549,05/08/2016,2016.0
20,Quinnipiac (MAAC),14,11-3,170,141,311,0.547,05/08/2016,2016.0
21,Bellarmine (SoCon),15,6-9,169,141,310,0.545,05/08/2016,2016.0
22,Jacksonville (SoCon),13,3-10,164,138,302,0.543,05/08/2016,2016.0
23,Hofstra (CAA),15,9-6,178,151,329,0.541,05/08/2016,2016.0
24,High Point (SoCon),15,9-6,197,172,369,0.534,05/08/2016,2016.0
25,Michigan (Big Ten),13,3-10,178,156,334,0.533,05/08/2016,2016.0
26,Fairfield (CAA),17,9-8,194,172,366,0.530,05/08/2016,2016.0
27,Loyola Maryland (Patriot),15,12-3,173,154,327,0.529,05/08/2016,2016.0
28,Maryland (Big Ten),16,14-2,188,169,357,0.527,05/08/2016,2016.0
29,Air Force (SoCon),17,15-2,189,172,361,0.524,05/08/2016,2016.0
30,Richmond (SoCon),16,11-5,162,148,310,0.523,05/08/2016,2016.0
31,Stony Brook (America East),16,12-4,212,198,410,0.517,05/08/2016,2016.0
32,Towson (CAA),16,14-2,172,163,335,0.513,05/08/2016,2016.0
33,Vermont (America East),17,9-8,227,216,443,0.512,05/08/2016,2016.0
34,Mount St. Mary's (NEC),14,6-8,161,154,315,0.511,05/08/2016,2016.0
35,Canisius (MAAC),12,4-8,142,138,280,0.507,05/08/2016,2016.0
36,Yale (Ivy League),15,13-2,176,176,352,0.500,05/08/2016,2016.0
37,UAlbany (America East),15,12-3,195,199,394,0.495,05/08/2016,2016.0
38,Notre Dame (ACC),13,10-3,141,145,286,0.493,05/08/2016,2016.0
39,Massachusetts (CAA),13,4-9,138,143,281,0.491,05/08/2016,2016.0
40,Delaware (CAA),15,5-10,163,169,332,0.491,05/08/2016,2016.0
41,Lafayette (Patriot),14,3-11,154,160,314,0.490,05/08/2016,2016.0
42,Mercer (SoCon),13,5-8,148,156,304,0.487,05/08/2016,2016.0
43,Binghamton (America East),14,4-10,169,181,350,0.483,05/08/2016,2016.0
44,Rutgers (Big Ten),16,11-5,199,214,413,0.482,05/08/2016,2016.0
45,Penn St. (Big Ten),15,8-7,185,209,394,0.470,05/08/2016,2016.0
46,Princeton (Ivy League),13,5-8,152,172,324,0.469,05/08/2016,2016.0
47,Penn (Ivy League),15,8-7,163,191,354,0.460,05/08/2016,2016.0
48,Wagner (NEC),15,6-9,153,186,339,0.451,05/08/2016,2016.0
49,Furman (SoCon),13,2-11,133,162,295,0.451,05/08/2016,2016.0
50,Siena (MAAC),13,3-10,143,175,318,0.450,05/08/2016,2016.0
51,Detroit Mercy (MAAC),12,2-10,101,125,226,0.447,05/08/2016,2016.0
52,Robert Morris (NEC),15,7-8,174,220,394,0.442,05/08/2016,2016.0
53,Monmouth (MAAC),14,7-7,130,168,298,0.436,05/08/2016,2016.0
54,St. John's (NY) (Big East),14,2-12,150,197,347,0.432,05/08/2016,2016.0
55,Sacred Heart (NEC),16,2-14,155,223,378,0.410,05/08/2016,2016.0
56,Colgate (Patriot),14,4-10,121,175,296,0.409,05/08/2016,2016.0
57,VMI (SoCon),16,2-14,149,219,368,0.405,05/08/2016,2016.0
58,Providence (Big East),16,7-9,153,229,382,0.401,05/08/2016,2016.0
59,Drexel (CAA),15,6-9,131,197,328,0.399,05/08/2016,2016.0
60,Dartmouth (Ivy League),14,1-13,122,192,314,0.389,05/08/2016,2016.0
61,NJIT (Independent),15,1-14,133,211,344,0.387,05/08/2016,2016.0
62,Harvard (Ivy League),16,8-8,155,250,405,0.383,05/08/2016,2016.0
63,Georgetown (Big East),14,2-12,114,188,302,0.377,05/08/2016,2016.0
64,Manhattan (MAAC),15,3-12,125,215,340,0.368,05/08/2016,2016.0
65,Holy Cross (Patriot),15,4-11,131,227,358,0.366,05/08/2016,2016.0
66,Lehigh (Patriot),15,6-9,119,243,362,0.329,05/08/2016,2016.0
67,UMBC (America East),14,4-10,105,232,337,0.312,05/08/2016,2016.0
68,Marist (MAAC),16,9-7,106,238,344,0.308,05/08/2016,2016.0
-,UMass Lowell (America East),16,4-12,154,219,373,0.413,05/08/2016,2016.0
1,Hartford (America East),17,11-6,287,127,414,0.693,05/07/2016,2016.0
2,Brown (Ivy League),16,14-2,302,152,454,0.665,05/07/2016,2016.0
3,Denver (Big East),15,13-2,260,134,394,0.660,05/07/2016,2016.0
4,Boston U. (Patriot),14,8-6,201,111,312,0.644,05/07/2016,2016.0
5,Syracuse (ACC),15,11-4,231,133,364,0.635,05/07/2016,2016.0
6,Cornell (Ivy League),13,6-7,188,109,297,0.633,05/07/2016,2016.0
7,Army West Point (Patriot),16,10-6,226,138,364,0.621,05/07/2016,2016.0
8,Saint Joseph's (NEC),16,12-4,228,147,375,0.608,05/07/2016,2016.0
9,Ohio St. (Big Ten),15,7-8,194,130,324,0.599,05/07/2016,2016.0
10,Navy (Patriot),14,10-4,162,114,276,0.587,05/07/2016,2016.0
11,Duke (ACC),17,10-7,261,186,447,0.584,05/07/2016,2016.0
12,Bucknell (Patriot),15,10-5,203,153,356,0.570,05/07/2016,2016.0
13,North Carolina (ACC),14,8-6,207,157,364,0.569,05/07/2016,2016.0
14,Marquette (Big East),15,11-4,175,135,310,0.565,05/07/2016,2016.0
15,Hobart (NEC),16,10-6,203,161,364,0.558,05/07/2016,2016.0
16,Virginia (ACC),15,7-8,196,159,355,0.552,05/07/2016,2016.0
17,Villanova (Big East),14,9-5,212,172,384,0.552,05/07/2016,2016.0
18,Bryant (NEC),15,10-5,191,156,347,0.550,05/07/2016,2016.0
19,Johns Hopkins (Big Ten),14,8-6,207,170,377,0.549,05/07/2016,2016.0
20,Quinnipiac (MAAC),14,11-3,170,141,311,0.547,05/07/2016,2016.0
21,Bellarmine (SoCon),15,6-9,169,141,310,0.545,05/07/2016,2016.0
22,Jacksonville (SoCon),13,3-10,164,138,302,0.543,05/07/2016,2016.0
23,Hofstra (CAA),15,9-6,178,151,329,0.541,05/07/2016,2016.0
24,High Point (SoCon),15,9-6,197,172,369,0.534,05/07/2016,2016.0
25,Michigan (Big Ten),13,3-10,178,156,334,0.533,05/07/2016,2016.0
26,Fairfield (CAA),17,9-8,194,172,366,0.530,05/07/2016,2016.0
27,Loyola Maryland (Patriot),15,12-3,173,154,327,0.529,05/07/2016,2016.0
28,Maryland (Big Ten),16,14-2,188,169,357,0.527,05/07/2016,2016.0
29,Air Force (SoCon),17,15-2,189,172,361,0.524,05/07/2016,2016.0
30,Richmond (SoCon),16,11-5,162,148,310,0.523,05/07/2016,2016.0
31,Stony Brook (America East),16,12-4,212,198,410,0.517,05/07/2016,2016.0
32,Towson (CAA),16,14-2,172,163,335,0.513,05/07/2016,2016.0
33,Vermont (America East),17,9-8,227,216,443,0.512,05/07/2016,2016.0
34,Mount St. Mary's (NEC),14,6-8,161,154,315,0.511,05/07/2016,2016.0
35,Canisius (MAAC),12,4-8,142,138,280,0.507,05/07/2016,2016.0
36,UAlbany (America East),15,12-3,195,199,394,0.495,05/07/2016,2016.0
37,Notre Dame (ACC),12,9-3,129,133,262,0.492,05/07/2016,2016.0
38,Massachusetts (CAA),13,4-9,138,143,281,0.491,05/07/2016,2016.0
39,Delaware (CAA),15,5-10,163,169,332,0.491,05/07/2016,2016.0
40,Lafayette (Patriot),14,3-11,154,160,314,0.490,05/07/2016,2016.0
41,Mercer (SoCon),13,5-8,148,156,304,0.487,05/07/2016,2016.0
42,Yale (Ivy League),14,12-2,159,168,327,0.486,05/07/2016,2016.0
43,Binghamton (America East),14,4-10,169,181,350,0.483,05/07/2016,2016.0
44,Rutgers (Big Ten),16,11-5,199,214,413,0.482,05/07/2016,2016.0
45,Penn St. (Big Ten),15,8-7,185,209,394,0.470,05/07/2016,2016.0
46,Princeton (Ivy League),13,5-8,152,172,324,0.469,05/07/2016,2016.0
47,Penn (Ivy League),15,8-7,163,191,354,0.460,05/07/2016,2016.0
48,Wagner (NEC),15,6-9,153,186,339,0.451,05/07/2016,2016.0
49,Furman (SoCon),13,2-11,133,162,295,0.451,05/07/2016,2016.0
50,Siena (MAAC),13,3-10,143,175,318,0.450,05/07/2016,2016.0
51,Detroit Mercy (MAAC),12,2-10,101,125,226,0.447,05/07/2016,2016.0
52,Robert Morris (NEC),15,7-8,174,220,394,0.442,05/07/2016,2016.0
53,Monmouth (MAAC),14,7-7,130,168,298,0.436,05/07/2016,2016.0
54,St. John's (NY) (Big East),14,2-12,150,197,347,0.432,05/07/2016,2016.0
55,Sacred Heart (NEC),16,2-14,155,223,378,0.410,05/07/2016,2016.0
56,Colgate (Patriot),14,4-10,121,175,296,0.409,05/07/2016,2016.0
57,VMI (SoCon),16,2-14,149,219,368,0.405,05/07/2016,2016.0
58,Providence (Big East),16,7-9,153,229,382,0.401,05/07/2016,2016.0
59,Drexel (CAA),15,6-9,131,197,328,0.399,05/07/2016,2016.0
60,Dartmouth (Ivy League),14,1-13,122,192,314,0.389,05/07/2016,2016.0
61,Harvard (Ivy League),15,8-7,147,233,380,0.387,05/07/2016,2016.0
62,NJIT (Independent),15,1-14,133,211,344,0.387,05/07/2016,2016.0
63,Georgetown (Big East),14,2-12,114,188,302,0.377,05/07/2016,2016.0
64,Manhattan (MAAC),15,3-12,125,215,340,0.368,05/07/2016,2016.0
65,Holy Cross (Patriot),15,4-11,131,227,358,0.366,05/07/2016,2016.0
66,Lehigh (Patriot),15,6-9,119,243,362,0.329,05/07/2016,2016.0
67,UMBC (America East),14,4-10,105,232,337,0.312,05/07/2016,2016.0
68,Marist (MAAC),16,9-7,106,238,344,0.308,05/07/2016,2016.0
-,UMass Lowell (America East),16,4-12,154,219,373,0.413,05/07/2016,2016.0
1,Hartford (America East),16,10-6,265,113,378,0.701,05/06/2016,2016.0
2,Denver (Big East),14,13-1,249,122,371,0.671,05/06/2016,2016.0
3,Brown (Ivy League),16,14-2,302,152,454,0.665,05/06/2016,2016.0
4,Boston U. (Patriot),14,8-6,201,111,312,0.644,05/06/2016,2016.0
5,Syracuse (ACC),14,10-4,217,125,342,0.635,05/06/2016,2016.0
6,Cornell (Ivy League),13,6-7,188,109,297,0.633,05/06/2016,2016.0
7,Saint Joseph's (NEC),15,12-3,220,134,354,0.621,05/06/2016,2016.0
8,Army West Point (Patriot),16,10-6,226,138,364,0.621,05/06/2016,2016.0
9,Ohio St. (Big Ten),15,7-8,194,130,324,0.599,05/06/2016,2016.0
10,Navy (Patriot),14,10-4,162,114,276,0.587,05/06/2016,2016.0
11,Duke (ACC),17,10-7,261,186,447,0.584,05/06/2016,2016.0
12,Bucknell (Patriot),15,10-5,203,153,356,0.570,05/06/2016,2016.0
13,North Carolina (ACC),14,8-6,207,157,364,0.569,05/06/2016,2016.0
14,Marquette (Big East),14,10-4,163,124,287,0.568,05/06/2016,2016.0
15,Hobart (NEC),15,9-6,190,153,343,0.554,05/06/2016,2016.0
16,Virginia (ACC),15,7-8,196,159,355,0.552,05/06/2016,2016.0
17,Villanova (Big East),14,9-5,212,172,384,0.552,05/06/2016,2016.0
18,Bryant (NEC),15,10-5,191,156,347,0.550,05/06/2016,2016.0
19,Johns Hopkins (Big Ten),14,8-6,207,170,377,0.549,05/06/2016,2016.0
20,Bellarmine (SoCon),15,6-9,169,141,310,0.545,05/06/2016,2016.0
21,Jacksonville (SoCon),13,3-10,164,138,302,0.543,05/06/2016,2016.0
22,Hofstra (CAA),15,9-6,178,151,329,0.541,05/06/2016,2016.0
23,High Point (SoCon),15,9-6,197,172,369,0.534,05/06/2016,2016.0
24,Michigan (Big Ten),13,3-10,178,156,334,0.533,05/06/2016,2016.0
25,Maryland (Big Ten),15,13-2,177,156,333,0.532,05/06/2016,2016.0
26,Loyola Maryland (Patriot),15,12-3,173,154,327,0.529,05/06/2016,2016.0
27,Fairfield (CAA),16,9-7,188,168,356,0.528,05/06/2016,2016.0
28,Richmond (SoCon),15,11-4,152,136,288,0.528,05/06/2016,2016.0
29,Quinnipiac (MAAC),13,10-3,150,135,285,0.526,05/06/2016,2016.0
30,Vermont (America East),16,9-7,213,194,407,0.523,05/06/2016,2016.0
31,Air Force (SoCon),16,14-2,177,162,339,0.522,05/06/2016,2016.0
32,Stony Brook (America East),16,12-4,212,198,410,0.517,05/06/2016,2016.0
33,Towson (CAA),15,13-2,168,157,325,0.517,05/06/2016,2016.0
34,Mount St. Mary's (NEC),14,6-8,161,154,315,0.511,05/06/2016,2016.0
35,Canisius (MAAC),12,4-8,142,138,280,0.507,05/06/2016,2016.0
36,UAlbany (America East),15,12-3,195,199,394,0.495,05/06/2016,2016.0
37,Notre Dame (ACC),12,9-3,129,133,262,0.492,05/06/2016,2016.0
38,Massachusetts (CAA),13,4-9,138,143,281,0.491,05/06/2016,2016.0
39,Delaware (CAA),15,5-10,163,169,332,0.491,05/06/2016,2016.0
40,Lafayette (Patriot),14,3-11,154,160,314,0.490,05/06/2016,2016.0
41,Mercer (SoCon),13,5-8,148,156,304,0.487,05/06/2016,2016.0
42,Yale (Ivy League),14,12-2,159,168,327,0.486,05/06/2016,2016.0
43,Binghamton (America East),14,4-10,169,181,350,0.483,05/06/2016,2016.0
44,Rutgers (Big Ten),15,11-4,186,203,389,0.478,05/06/2016,2016.0
45,Penn St. (Big Ten),15,8-7,185,209,394,0.470,05/06/2016,2016.0
46,Princeton (Ivy League),13,5-8,152,172,324,0.469,05/06/2016,2016.0
47,Penn (Ivy League),15,8-7,163,191,354,0.460,05/06/2016,2016.0
48,Wagner (NEC),15,6-9,153,186,339,0.451,05/06/2016,2016.0
49,Furman (SoCon),13,2-11,133,162,295,0.451,05/06/2016,2016.0
50,Siena (MAAC),13,3-10,143,175,318,0.450,05/06/2016,2016.0
51,Detroit Mercy (MAAC),12,2-10,101,125,226,0.447,05/06/2016,2016.0
52,Robert Morris (NEC),15,7-8,174,220,394,0.442,05/06/2016,2016.0
53,Monmouth (MAAC),14,7-7,130,168,298,0.436,05/06/2016,2016.0
54,St. John's (NY) (Big East),14,2-12,150,197,347,0.432,05/06/2016,2016.0
55,Colgate (Patriot),13,4-9,113,161,274,0.412,05/06/2016,2016.0
56,Sacred Heart (NEC),16,2-14,155,223,378,0.410,05/06/2016,2016.0
57,VMI (SoCon),16,2-14,149,219,368,0.405,05/06/2016,2016.0
58,Providence (Big East),16,7-9,153,229,382,0.401,05/06/2016,2016.0
59,Drexel (CAA),15,6-9,131,197,328,0.399,05/06/2016,2016.0
60,Dartmouth (Ivy League),14,1-13,122,192,314,0.389,05/06/2016,2016.0
61,Harvard (Ivy League),15,8-7,147,233,380,0.387,05/06/2016,2016.0
62,NJIT (Independent),15,1-14,133,211,344,0.387,05/06/2016,2016.0
63,Georgetown (Big East),14,2-12,114,188,302,0.377,05/06/2016,2016.0
64,Manhattan (MAAC),15,3-12,125,215,340,0.368,05/06/2016,2016.0
65,Holy Cross (Patriot),15,4-11,131,227,358,0.366,05/06/2016,2016.0
66,Lehigh (Patriot),15,6-9,119,243,362,0.329,05/06/2016,2016.0
67,Marist (MAAC),15,9-6,100,218,318,0.314,05/06/2016,2016.0
68,UMBC (America East),14,4-10,105,232,337,0.312,05/06/2016,2016.0
-,UMass Lowell (America East),16,4-12,154,219,373,0.413,05/06/2016,2016.0
1,Hartford (America East),16,10-6,265,113,378,0.701,05/05/2016,2016.0
2,Denver (Big East),14,13-1,249,122,371,0.671,05/05/2016,2016.0
3,Brown (Ivy League),15,14-1,283,143,426,0.664,05/05/2016,2016.0
4,Boston U. (Patriot),14,8-6,201,111,312,0.644,05/05/2016,2016.0
5,Syracuse (ACC),14,10-4,217,125,342,0.635,05/05/2016,2016.0
6,Cornell (Ivy League),13,6-7,188,109,297,0.633,05/05/2016,2016.0
7,Saint Joseph's (NEC),15,12-3,220,134,354,0.621,05/05/2016,2016.0
8,Army West Point (Patriot),16,10-6,226,138,364,0.621,05/05/2016,2016.0
9,Ohio St. (Big Ten),15,7-8,194,130,324,0.599,05/05/2016,2016.0
10,Navy (Patriot),14,10-4,162,114,276,0.587,05/05/2016,2016.0
11,Duke (ACC),17,10-7,261,186,447,0.584,05/05/2016,2016.0
12,Bucknell (Patriot),15,10-5,203,153,356,0.570,05/05/2016,2016.0
13,North Carolina (ACC),14,8-6,207,157,364,0.569,05/05/2016,2016.0
14,Marquette (Big East),14,10-4,163,124,287,0.568,05/05/2016,2016.0
15,Hobart (NEC),15,9-6,190,153,343,0.554,05/05/2016,2016.0
16,Virginia (ACC),15,7-8,196,159,355,0.552,05/05/2016,2016.0
17,Villanova (Big East),14,9-5,212,172,384,0.552,05/05/2016,2016.0
18,Bryant (NEC),15,10-5,191,156,347,0.550,05/05/2016,2016.0
19,Johns Hopkins (Big Ten),14,8-6,207,170,377,0.549,05/05/2016,2016.0
20,Bellarmine (SoCon),15,6-9,169,141,310,0.545,05/05/2016,2016.0
21,Jacksonville (SoCon),13,3-10,164,138,302,0.543,05/05/2016,2016.0
22,Hofstra (CAA),15,9-6,178,151,329,0.541,05/05/2016,2016.0
23,High Point (SoCon),15,9-6,197,172,369,0.534,05/05/2016,2016.0
24,Michigan (Big Ten),13,3-10,178,156,334,0.533,05/05/2016,2016.0
25,Maryland (Big Ten),15,13-2,177,156,333,0.532,05/05/2016,2016.0
26,Loyola Maryland (Patriot),15,12-3,173,154,327,0.529,05/05/2016,2016.0
27,Fairfield (CAA),16,9-7,188,168,356,0.528,05/05/2016,2016.0
28,Richmond (SoCon),15,11-4,152,136,288,0.528,05/05/2016,2016.0
29,Quinnipiac (MAAC),13,10-3,150,135,285,0.526,05/05/2016,2016.0
30,Vermont (America East),16,9-7,213,194,407,0.523,05/05/2016,2016.0
31,Air Force (SoCon),16,14-2,177,162,339,0.522,05/05/2016,2016.0
32,Stony Brook (America East),16,12-4,212,198,410,0.517,05/05/2016,2016.0
33,Towson (CAA),15,13-2,168,157,325,0.517,05/05/2016,2016.0
34,Mount St. Mary's (NEC),14,6-8,161,154,315,0.511,05/05/2016,2016.0
35,Canisius (MAAC),12,4-8,142,138,280,0.507,05/05/2016,2016.0
36,UAlbany (America East),15,12-3,195,199,394,0.495,05/05/2016,2016.0
37,Notre Dame (ACC),12,9-3,129,133,262,0.492,05/05/2016,2016.0
38,Massachusetts (CAA),13,4-9,138,143,281,0.491,05/05/2016,2016.0
39,Delaware (CAA),15,5-10,163,169,332,0.491,05/05/2016,2016.0
40,Lafayette (Patriot),14,3-11,154,160,314,0.490,05/05/2016,2016.0
41,Mercer (SoCon),13,5-8,148,156,304,0.487,05/05/2016,2016.0
42,Binghamton (America East),14,4-10,169,181,350,0.483,05/05/2016,2016.0
43,Yale (Ivy League),13,11-2,149,161,310,0.481,05/05/2016,2016.0
44,Rutgers (Big Ten),15,11-4,186,203,389,0.478,05/05/2016,2016.0
45,Penn St. (Big Ten),15,8-7,185,209,394,0.470,05/05/2016,2016.0
46,Princeton (Ivy League),13,5-8,152,172,324,0.469,05/05/2016,2016.0
47,Penn (Ivy League),14,8-6,156,181,337,0.463,05/05/2016,2016.0
48,Wagner (NEC),15,6-9,153,186,339,0.451,05/05/2016,2016.0
49,Furman (SoCon),13,2-11,133,162,295,0.451,05/05/2016,2016.0
50,Siena (MAAC),13,3-10,143,175,318,0.450,05/05/2016,2016.0
51,Detroit Mercy (MAAC),12,2-10,101,125,226,0.447,05/05/2016,2016.0
52,Robert Morris (NEC),15,7-8,174,220,394,0.442,05/05/2016,2016.0
53,Monmouth (MAAC),14,7-7,130,168,298,0.436,05/05/2016,2016.0
54,St. John's (NY) (Big East),14,2-12,150,197,347,0.432,05/05/2016,2016.0
55,Colgate (Patriot),13,4-9,113,161,274,0.412,05/05/2016,2016.0
56,Sacred Heart (NEC),16,2-14,155,223,378,0.410,05/05/2016,2016.0
57,VMI (SoCon),16,2-14,149,219,368,0.405,05/05/2016,2016.0
58,Providence (Big East),16,7-9,153,229,382,0.401,05/05/2016,2016.0
59,Drexel (CAA),15,6-9,131,197,328,0.399,05/05/2016,2016.0
60,Harvard (Ivy League),14,7-7,138,214,352,0.392,05/05/2016,2016.0
61,Dartmouth (Ivy League),14,1-13,122,192,314,0.389,05/05/2016,2016.0
62,NJIT (Independent),15,1-14,133,211,344,0.387,05/05/2016,2016.0
63,Georgetown (Big East),14,2-12,114,188,302,0.377,05/05/2016,2016.0
64,Manhattan (MAAC),15,3-12,125,215,340,0.368,05/05/2016,2016.0
65,Holy Cross (Patriot),15,4-11,131,227,358,0.366,05/05/2016,2016.0
66,Lehigh (Patriot),15,6-9,119,243,362,0.329,05/05/2016,2016.0
67,Marist (MAAC),15,9-6,100,218,318,0.314,05/05/2016,2016.0
68,UMBC (America East),14,4-10,105,232,337,0.312,05/05/2016,2016.0
-,UMass Lowell (America East),16,4-12,154,219,373,0.413,05/05/2016,2016.0
1,Hartford (America East),15,9-6,245,109,354,0.692,05/01/2016,2016.0
2,Brown (Ivy League),15,14-1,283,143,426,0.664,05/01/2016,2016.0
3,Denver (Big East),13,12-1,227,115,342,0.664,05/01/2016,2016.0
4,Boston U. (Patriot),14,8-6,201,111,312,0.644,05/01/2016,2016.0
5,Syracuse (ACC),14,10-4,217,125,342,0.635,05/01/2016,2016.0
6,Cornell (Ivy League),13,6-7,188,109,297,0.633,05/01/2016,2016.0
7,Army West Point (Patriot),16,10-6,226,138,364,0.621,05/01/2016,2016.0
8,Saint Joseph's (NEC),14,11-3,202,127,329,0.614,05/01/2016,2016.0
9,Ohio St. (Big Ten),15,7-8,194,130,324,0.599,05/01/2016,2016.0
10,Navy (Patriot),14,10-4,162,114,276,0.587,05/01/2016,2016.0
11,Duke (ACC),17,10-7,261,186,447,0.584,05/01/2016,2016.0
12,Marquette (Big East),13,9-4,149,111,260,0.573,05/01/2016,2016.0
13,Bucknell (Patriot),15,10-5,203,153,356,0.570,05/01/2016,2016.0
14,North Carolina (ACC),14,8-6,207,157,364,0.569,05/01/2016,2016.0
15,Hobart (NEC),14,8-6,182,144,326,0.558,05/01/2016,2016.0
16,Villanova (Big East),13,9-4,199,158,357,0.557,05/01/2016,2016.0
17,High Point (SoCon),14,9-5,190,154,344,0.552,05/01/2016,2016.0
18,Virginia (ACC),15,7-8,196,159,355,0.552,05/01/2016,2016.0
19,Bryant (NEC),14,10-4,182,148,330,0.552,05/01/2016,2016.0
20,Bellarmine (SoCon),14,6-8,158,130,288,0.549,05/01/2016,2016.0
21,Johns Hopkins (Big Ten),13,8-5,189,158,347,0.545,05/01/2016,2016.0
22,Jacksonville (SoCon),13,3-10,164,138,302,0.543,05/01/2016,2016.0
23,Maryland (Big Ten),14,12-2,165,139,304,0.543,05/01/2016,2016.0
24,Hofstra (CAA),14,9-5,165,142,307,0.537,05/01/2016,2016.0
25,Quinnipiac (MAAC),12,9-3,141,122,263,0.536,05/01/2016,2016.0
26,Fairfield (CAA),15,8-7,179,155,334,0.536,05/01/2016,2016.0
27,Michigan (Big Ten),13,3-10,178,156,334,0.533,05/01/2016,2016.0
28,Vermont (America East),15,8-7,204,181,385,0.530,05/01/2016,2016.0
29,Loyola Maryland (Patriot),15,12-3,173,154,327,0.529,05/01/2016,2016.0
30,Air Force (SoCon),15,13-2,166,151,317,0.524,05/01/2016,2016.0
31,UAlbany (America East),14,12-2,191,179,370,0.516,05/01/2016,2016.0
32,Stony Brook (America East),15,12-3,199,189,388,0.513,05/01/2016,2016.0
33,Mount St. Mary's (NEC),14,6-8,161,154,315,0.511,05/01/2016,2016.0
34,Richmond (SoCon),14,10-4,134,129,263,0.510,05/01/2016,2016.0
35,Towson (CAA),14,12-2,155,151,306,0.507,05/01/2016,2016.0
36,Canisius (MAAC),11,4-7,129,129,258,0.500,05/01/2016,2016.0
37,Notre Dame (ACC),12,9-3,129,133,262,0.492,05/01/2016,2016.0
38,Massachusetts (CAA),13,4-9,138,143,281,0.491,05/01/2016,2016.0
39,Delaware (CAA),15,5-10,163,169,332,0.491,05/01/2016,2016.0
40,Lafayette (Patriot),14,3-11,154,160,314,0.490,05/01/2016,2016.0
41,Mercer (SoCon),13,5-8,148,156,304,0.487,05/01/2016,2016.0
42,Rutgers (Big Ten),14,10-4,174,185,359,0.485,05/01/2016,2016.0
43,Binghamton (America East),14,4-10,169,181,350,0.483,05/01/2016,2016.0
44,Yale (Ivy League),13,11-2,149,161,310,0.481,05/01/2016,2016.0
45,Princeton (Ivy League),13,5-8,152,172,324,0.469,05/01/2016,2016.0
46,Penn (Ivy League),14,8-6,156,181,337,0.463,05/01/2016,2016.0
47,Penn St. (Big Ten),14,8-6,168,197,365,0.460,05/01/2016,2016.0
48,Robert Morris (NEC),14,7-7,167,202,369,0.453,05/01/2016,2016.0
49,Wagner (NEC),15,6-9,153,186,339,0.451,05/01/2016,2016.0
50,Furman (SoCon),13,2-11,133,162,295,0.451,05/01/2016,2016.0
51,Siena (MAAC),13,3-10,143,175,318,0.450,05/01/2016,2016.0
52,Detroit Mercy (MAAC),12,2-10,101,125,226,0.447,05/01/2016,2016.0
53,St. John's (NY) (Big East),14,2-12,150,197,347,0.432,05/01/2016,2016.0
54,Monmouth (MAAC),13,7-6,117,163,280,0.418,05/01/2016,2016.0
55,Providence (Big East),15,7-8,146,207,353,0.414,05/01/2016,2016.0
56,Colgate (Patriot),13,4-9,113,161,274,0.412,05/01/2016,2016.0
57,Sacred Heart (NEC),16,2-14,155,223,378,0.410,05/01/2016,2016.0
58,VMI (SoCon),16,2-14,149,219,368,0.405,05/01/2016,2016.0
59,Drexel (CAA),14,6-8,125,184,309,0.405,05/01/2016,2016.0
60,Harvard (Ivy League),14,7-7,138,214,352,0.392,05/01/2016,2016.0
61,Dartmouth (Ivy League),14,1-13,122,192,314,0.389,05/01/2016,2016.0
62,NJIT (Independent),15,1-14,133,211,344,0.387,05/01/2016,2016.0
63,Georgetown (Big East),14,2-12,114,188,302,0.377,05/01/2016,2016.0
64,Manhattan (MAAC),15,3-12,125,215,340,0.368,05/01/2016,2016.0
65,Holy Cross (Patriot),15,4-11,131,227,358,0.366,05/01/2016,2016.0
66,Lehigh (Patriot),15,6-9,119,243,362,0.329,05/01/2016,2016.0
67,Marist (MAAC),14,8-6,95,205,300,0.317,05/01/2016,2016.0
68,UMBC (America East),14,4-10,105,232,337,0.312,05/01/2016,2016.0
-,UMass Lowell (America East),16,4-12,154,219,373,0.413,05/01/2016,2016.0
1,Hartford (America East),14,9-5,234,94,328,0.713,04/29/2016,2016.0
2,Brown (Ivy League),14,13-1,262,131,393,0.667,04/29/2016,2016.0
3,Denver (Big East),12,11-1,208,106,314,0.662,04/29/2016,2016.0
4,Boston U. (Patriot),14,8-6,201,111,312,0.644,04/29/2016,2016.0
5,Syracuse (ACC),13,9-4,203,114,317,0.640,04/29/2016,2016.0
6,Army West Point (Patriot),15,10-5,218,123,341,0.639,04/29/2016,2016.0
7,Cornell (Ivy League),12,6-6,177,103,280,0.632,04/29/2016,2016.0
8,Saint Joseph's (NEC),13,10-3,187,122,309,0.605,04/29/2016,2016.0
9,Marquette (Big East),12,9-3,140,92,232,0.603,04/29/2016,2016.0
10,Duke (ACC),16,10-6,250,172,422,0.592,04/29/2016,2016.0
11,Ohio St. (Big Ten),14,6-8,177,123,300,0.590,04/29/2016,2016.0
12,Navy (Patriot),14,10-4,162,114,276,0.587,04/29/2016,2016.0
13,Virginia (ACC),14,7-7,184,138,322,0.571,04/29/2016,2016.0
14,Bucknell (Patriot),15,10-5,203,153,356,0.570,04/29/2016,2016.0
15,North Carolina (ACC),14,8-6,207,157,364,0.569,04/29/2016,2016.0
16,Maryland (Big Ten),13,11-2,160,122,282,0.567,04/29/2016,2016.0
17,Villanova (Big East),12,8-4,188,145,333,0.565,04/29/2016,2016.0
18,Jacksonville (SoCon),12,3-9,156,126,282,0.553,04/29/2016,2016.0
19,Bryant (NEC),14,10-4,182,148,330,0.552,04/29/2016,2016.0
20,High Point (SoCon),13,8-5,173,142,315,0.549,04/29/2016,2016.0
21,Hobart (NEC),13,7-6,161,136,297,0.542,04/29/2016,2016.0
22,Fairfield (CAA),15,8-7,179,155,334,0.536,04/29/2016,2016.0
23,Hofstra (CAA),13,9-4,153,135,288,0.531,04/29/2016,2016.0
24,Johns Hopkins (Big Ten),12,8-4,172,153,325,0.529,04/29/2016,2016.0
25,Mount St. Mary's (NEC),13,6-7,156,139,295,0.529,04/29/2016,2016.0
26,Bellarmine (SoCon),13,5-8,138,123,261,0.529,04/29/2016,2016.0
27,Quinnipiac (MAAC),11,8-3,130,116,246,0.528,04/29/2016,2016.0
28,Loyola Maryland (Patriot),14,11-3,158,146,304,0.520,04/29/2016,2016.0
29,Vermont (America East),14,7-7,185,171,356,0.520,04/29/2016,2016.0
30,Air Force (SoCon),14,12-2,154,143,297,0.519,04/29/2016,2016.0
31,Michigan (Big Ten),12,3-9,159,149,308,0.516,04/29/2016,2016.0
32,Towson (CAA),13,11-2,148,139,287,0.516,04/29/2016,2016.0
33,Stony Brook (America East),14,11-3,184,178,362,0.508,04/29/2016,2016.0
34,Richmond (SoCon),13,9-4,122,121,243,0.502,04/29/2016,2016.0
35,Canisius (MAAC),11,4-7,129,129,258,0.500,04/29/2016,2016.0
36,Rutgers (Big Ten),13,10-3,167,168,335,0.499,04/29/2016,2016.0
37,Binghamton (America East),13,4-9,159,162,321,0.495,04/29/2016,2016.0
38,Mercer (SoCon),12,5-7,140,144,284,0.493,04/29/2016,2016.0
39,Notre Dame (ACC),12,9-3,129,133,262,0.492,04/29/2016,2016.0
40,UAlbany (America East),13,11-2,166,172,338,0.491,04/29/2016,2016.0
41,Massachusetts (CAA),13,4-9,138,143,281,0.491,04/29/2016,2016.0
42,Delaware (CAA),15,5-10,163,169,332,0.491,04/29/2016,2016.0
43,Lafayette (Patriot),14,3-11,154,160,314,0.490,04/29/2016,2016.0
44,Yale (Ivy League),12,10-2,139,151,290,0.479,04/29/2016,2016.0
45,Princeton (Ivy League),12,4-8,146,161,307,0.476,04/29/2016,2016.0
46,Penn St. (Big Ten),13,7-6,161,178,339,0.475,04/29/2016,2016.0
47,Furman (SoCon),12,2-10,126,142,268,0.470,04/29/2016,2016.0
48,Penn (Ivy League),14,8-6,156,181,337,0.463,04/29/2016,2016.0
49,Wagner (NEC),14,6-8,138,168,306,0.451,04/29/2016,2016.0
50,Robert Morris (NEC),13,6-7,149,187,336,0.443,04/29/2016,2016.0
51,Siena (MAAC),12,3-9,126,161,287,0.439,04/29/2016,2016.0
52,St. John's (NY) (Big East),13,1-12,144,187,331,0.435,04/29/2016,2016.0
53,Detroit Mercy (MAAC),11,2-9,89,119,208,0.428,04/29/2016,2016.0
54,Sacred Heart (NEC),15,2-13,147,202,349,0.421,04/29/2016,2016.0
55,Monmouth (MAAC),12,6-6,103,146,249,0.414,04/29/2016,2016.0
56,Colgate (Patriot),13,4-9,113,161,274,0.412,04/29/2016,2016.0
57,Drexel (CAA),14,6-8,125,184,309,0.405,04/29/2016,2016.0
58,Providence (Big East),14,7-7,133,196,329,0.404,04/29/2016,2016.0
59,VMI (SoCon),15,2-13,137,202,339,0.404,04/29/2016,2016.0
60,Dartmouth (Ivy League),14,1-13,122,192,314,0.389,04/29/2016,2016.0
61,Harvard (Ivy League),13,7-6,128,204,332,0.386,04/29/2016,2016.0
62,NJIT (Independent),14,1-13,122,205,327,0.373,04/29/2016,2016.0
63,Manhattan (MAAC),14,3-11,119,204,323,0.368,04/29/2016,2016.0
64,Holy Cross (Patriot),15,4-11,131,227,358,0.366,04/29/2016,2016.0
65,Georgetown (Big East),13,2-11,104,182,286,0.364,04/29/2016,2016.0
66,Lehigh (Patriot),15,6-9,119,243,362,0.329,04/29/2016,2016.0
67,UMBC (America East),13,4-9,98,207,305,0.321,04/29/2016,2016.0
68,Marist (MAAC),13,7-6,89,193,282,0.316,04/29/2016,2016.0
-,UMass Lowell (America East),15,3-12,148,208,356,0.416,04/29/2016,2016.0
1,Hartford (America East),14,9-5,234,94,328,0.713,04/27/2016,2016.0
2,Brown (Ivy League),14,13-1,262,131,393,0.667,04/27/2016,2016.0
3,Denver (Big East),12,11-1,208,106,314,0.662,04/27/2016,2016.0
4,Syracuse (ACC),12,8-4,191,105,296,0.645,04/27/2016,2016.0
5,Boston U. (Patriot),14,8-6,201,111,312,0.644,04/27/2016,2016.0
6,Army West Point (Patriot),14,9-5,207,119,326,0.635,04/27/2016,2016.0
7,Cornell (Ivy League),12,6-6,177,103,280,0.632,04/27/2016,2016.0
8,Navy (Patriot),13,10-3,158,103,261,0.605,04/27/2016,2016.0
9,Saint Joseph's (NEC),13,10-3,187,122,309,0.605,04/27/2016,2016.0
10,Marquette (Big East),12,9-3,140,92,232,0.603,04/27/2016,2016.0
11,Ohio St. (Big Ten),14,6-8,177,123,300,0.590,04/27/2016,2016.0
12,Duke (ACC),15,9-6,232,167,399,0.581,04/27/2016,2016.0
13,Bucknell (Patriot),14,10-4,197,142,339,0.581,04/27/2016,2016.0
14,North Carolina (ACC),13,8-5,198,145,343,0.577,04/27/2016,2016.0
15,Virginia (ACC),14,7-7,184,138,322,0.571,04/27/2016,2016.0
16,Maryland (Big Ten),13,11-2,160,122,282,0.567,04/27/2016,2016.0
17,Villanova (Big East),12,8-4,188,145,333,0.565,04/27/2016,2016.0
18,Jacksonville (SoCon),12,3-9,156,126,282,0.553,04/27/2016,2016.0
19,Bryant (NEC),14,10-4,182,148,330,0.552,04/27/2016,2016.0
20,High Point (SoCon),13,8-5,173,142,315,0.549,04/27/2016,2016.0
21,Hobart (NEC),13,7-6,161,136,297,0.542,04/27/2016,2016.0
22,Hofstra (CAA),13,9-4,153,135,288,0.531,04/27/2016,2016.0
23,Johns Hopkins (Big Ten),12,8-4,172,153,325,0.529,04/27/2016,2016.0
24,Mount St. Mary's (NEC),13,6-7,156,139,295,0.529,04/27/2016,2016.0
25,Bellarmine (SoCon),13,5-8,138,123,261,0.529,04/27/2016,2016.0
26,Fairfield (CAA),14,7-7,167,149,316,0.528,04/27/2016,2016.0
27,Quinnipiac (MAAC),11,8-3,130,116,246,0.528,04/27/2016,2016.0
28,Vermont (America East),14,7-7,185,171,356,0.520,04/27/2016,2016.0
29,Notre Dame (ACC),11,9-2,124,115,239,0.519,04/27/2016,2016.0
30,Air Force (SoCon),14,12-2,154,143,297,0.519,04/27/2016,2016.0
31,Michigan (Big Ten),12,3-9,159,149,308,0.516,04/27/2016,2016.0
32,Towson (CAA),13,11-2,148,139,287,0.516,04/27/2016,2016.0
33,Loyola Maryland (Patriot),13,10-3,147,140,287,0.512,04/27/2016,2016.0
34,Stony Brook (America East),14,11-3,184,178,362,0.508,04/27/2016,2016.0
35,Richmond (SoCon),13,9-4,122,121,243,0.502,04/27/2016,2016.0
36,Delaware (CAA),14,5-9,157,157,314,0.500,04/27/2016,2016.0
36,Massachusetts (CAA),12,4-8,131,131,262,0.500,04/27/2016,2016.0
36,Canisius (MAAC),11,4-7,129,129,258,0.500,04/27/2016,2016.0
39,Rutgers (Big Ten),13,10-3,167,168,335,0.499,04/27/2016,2016.0
40,Binghamton (America East),13,4-9,159,162,321,0.495,04/27/2016,2016.0
41,Mercer (SoCon),12,5-7,140,144,284,0.493,04/27/2016,2016.0
42,UAlbany (America East),13,11-2,166,172,338,0.491,04/27/2016,2016.0
43,Lafayette (Patriot),14,3-11,154,160,314,0.490,04/27/2016,2016.0
44,Yale (Ivy League),12,10-2,139,151,290,0.479,04/27/2016,2016.0
45,Princeton (Ivy League),12,4-8,146,161,307,0.476,04/27/2016,2016.0
46,Penn St. (Big Ten),13,7-6,161,178,339,0.475,04/27/2016,2016.0
47,Furman (SoCon),12,2-10,126,142,268,0.470,04/27/2016,2016.0
48,Penn (Ivy League),14,8-6,156,181,337,0.463,04/27/2016,2016.0
49,Wagner (NEC),14,6-8,138,168,306,0.451,04/27/2016,2016.0
50,Robert Morris (NEC),13,6-7,149,187,336,0.443,04/27/2016,2016.0
51,Siena (MAAC),12,3-9,126,161,287,0.439,04/27/2016,2016.0
52,St. John's (NY) (Big East),13,1-12,144,187,331,0.435,04/27/2016,2016.0
53,Detroit Mercy (MAAC),11,2-9,89,119,208,0.428,04/27/2016,2016.0
54,Sacred Heart (NEC),15,2-13,147,202,349,0.421,04/27/2016,2016.0
55,Monmouth (MAAC),12,6-6,103,146,249,0.414,04/27/2016,2016.0
56,Colgate (Patriot),13,4-9,113,161,274,0.412,04/27/2016,2016.0
57,Providence (Big East),14,7-7,133,196,329,0.404,04/27/2016,2016.0
58,VMI (SoCon),15,2-13,137,202,339,0.404,04/27/2016,2016.0
59,Drexel (CAA),13,5-8,113,177,290,0.390,04/27/2016,2016.0
60,Dartmouth (Ivy League),14,1-13,122,192,314,0.389,04/27/2016,2016.0
61,Harvard (Ivy League),13,7-6,128,204,332,0.386,04/27/2016,2016.0
62,NJIT (Independent),14,1-13,122,205,327,0.373,04/27/2016,2016.0
63,Manhattan (MAAC),14,3-11,119,204,323,0.368,04/27/2016,2016.0
64,Holy Cross (Patriot),15,4-11,131,227,358,0.366,04/27/2016,2016.0
65,Georgetown (Big East),13,2-11,104,182,286,0.364,04/27/2016,2016.0
66,Lehigh (Patriot),15,6-9,119,243,362,0.329,04/27/2016,2016.0
67,UMBC (America East),13,4-9,98,207,305,0.321,04/27/2016,2016.0
68,Marist (MAAC),13,7-6,89,193,282,0.316,04/27/2016,2016.0
-,UMass Lowell (America East),15,3-12,148,208,356,0.416,04/27/2016,2016.0
1,Hartford (America East),14,9-5,234,94,328,0.713,04/26/2016,2016.0
2,Denver (Big East),12,11-1,208,106,314,0.662,04/26/2016,2016.0
3,Brown (Ivy League),13,12-1,241,129,370,0.651,04/26/2016,2016.0
4,Syracuse (ACC),12,8-4,191,105,296,0.645,04/26/2016,2016.0
5,Boston U. (Patriot),14,8-6,201,111,312,0.644,04/26/2016,2016.0
6,Army West Point (Patriot),14,9-5,207,119,326,0.635,04/26/2016,2016.0
7,Cornell (Ivy League),12,6-6,177,103,280,0.632,04/26/2016,2016.0
8,Navy (Patriot),13,10-3,158,103,261,0.605,04/26/2016,2016.0
9,Saint Joseph's (NEC),13,10-3,187,122,309,0.605,04/26/2016,2016.0
10,Marquette (Big East),12,9-3,140,92,232,0.603,04/26/2016,2016.0
11,Ohio St. (Big Ten),14,6-8,177,123,300,0.590,04/26/2016,2016.0
12,Duke (ACC),15,9-6,232,167,399,0.581,04/26/2016,2016.0
13,Bucknell (Patriot),14,10-4,197,142,339,0.581,04/26/2016,2016.0
14,North Carolina (ACC),13,8-5,198,145,343,0.577,04/26/2016,2016.0
15,Virginia (ACC),14,7-7,184,138,322,0.571,04/26/2016,2016.0
16,Maryland (Big Ten),13,11-2,160,122,282,0.567,04/26/2016,2016.0
17,Villanova (Big East),12,8-4,188,145,333,0.565,04/26/2016,2016.0
18,Jacksonville (SoCon),12,3-9,156,126,282,0.553,04/26/2016,2016.0
19,Bryant (NEC),14,10-4,182,148,330,0.552,04/26/2016,2016.0
20,High Point (SoCon),13,8-5,173,142,315,0.549,04/26/2016,2016.0
21,Hobart (NEC),13,7-6,161,136,297,0.542,04/26/2016,2016.0
22,Hofstra (CAA),13,9-4,153,135,288,0.531,04/26/2016,2016.0
23,Johns Hopkins (Big Ten),12,8-4,172,153,325,0.529,04/26/2016,2016.0
24,Mount St. Mary's (NEC),13,6-7,156,139,295,0.529,04/26/2016,2016.0
25,Bellarmine (SoCon),13,5-8,138,123,261,0.529,04/26/2016,2016.0
26,Fairfield (CAA),14,7-7,167,149,316,0.528,04/26/2016,2016.0
27,Quinnipiac (MAAC),11,8-3,130,116,246,0.528,04/26/2016,2016.0
28,Vermont (America East),14,7-7,185,171,356,0.520,04/26/2016,2016.0
29,Notre Dame (ACC),11,9-2,124,115,239,0.519,04/26/2016,2016.0
30,Air Force (SoCon),14,12-2,154,143,297,0.519,04/26/2016,2016.0
31,Michigan (Big Ten),12,3-9,159,149,308,0.516,04/26/2016,2016.0
32,Towson (CAA),13,11-2,148,139,287,0.516,04/26/2016,2016.0
33,Loyola Maryland (Patriot),13,10-3,147,140,287,0.512,04/26/2016,2016.0
34,Stony Brook (America East),14,11-3,184,178,362,0.508,04/26/2016,2016.0
35,Richmond (SoCon),13,9-4,122,121,243,0.502,04/26/2016,2016.0
36,Delaware (CAA),14,5-9,157,157,314,0.500,04/26/2016,2016.0
36,Massachusetts (CAA),12,4-8,131,131,262,0.500,04/26/2016,2016.0
36,Canisius (MAAC),11,4-7,129,129,258,0.500,04/26/2016,2016.0
39,Rutgers (Big Ten),13,10-3,167,168,335,0.499,04/26/2016,2016.0
40,Binghamton (America East),13,4-9,159,162,321,0.495,04/26/2016,2016.0
41,Mercer (SoCon),12,5-7,140,144,284,0.493,04/26/2016,2016.0
42,UAlbany (America East),13,11-2,166,172,338,0.491,04/26/2016,2016.0
43,Lafayette (Patriot),14,3-11,154,160,314,0.490,04/26/2016,2016.0
44,Yale (Ivy League),12,10-2,139,151,290,0.479,04/26/2016,2016.0
45,Princeton (Ivy League),12,4-8,146,161,307,0.476,04/26/2016,2016.0
46,Penn St. (Big Ten),13,7-6,161,178,339,0.475,04/26/2016,2016.0
47,Furman (SoCon),12,2-10,126,142,268,0.470,04/26/2016,2016.0
48,Penn (Ivy League),14,8-6,156,181,337,0.463,04/26/2016,2016.0
49,Wagner (NEC),14,6-8,138,168,306,0.451,04/26/2016,2016.0
50,Robert Morris (NEC),13,6-7,149,187,336,0.443,04/26/2016,2016.0
51,Siena (MAAC),12,3-9,126,161,287,0.439,04/26/2016,2016.0
52,St. John's (NY) (Big East),13,1-12,144,187,331,0.435,04/26/2016,2016.0
53,Detroit Mercy (MAAC),11,2-9,89,119,208,0.428,04/26/2016,2016.0
54,Sacred Heart (NEC),15,2-13,147,202,349,0.421,04/26/2016,2016.0
55,Monmouth (MAAC),12,6-6,103,146,249,0.414,04/26/2016,2016.0
56,Colgate (Patriot),13,4-9,113,161,274,0.412,04/26/2016,2016.0
57,Dartmouth (Ivy League),13,1-12,120,171,291,0.412,04/26/2016,2016.0
58,Providence (Big East),14,7-7,133,196,329,0.404,04/26/2016,2016.0
59,VMI (SoCon),15,2-13,137,202,339,0.404,04/26/2016,2016.0
60,Drexel (CAA),13,5-8,113,177,290,0.390,04/26/2016,2016.0
61,Harvard (Ivy League),13,7-6,128,204,332,0.386,04/26/2016,2016.0
62,NJIT (Independent),14,1-13,122,205,327,0.373,04/26/2016,2016.0
63,Manhattan (MAAC),14,3-11,119,204,323,0.368,04/26/2016,2016.0
64,Holy Cross (Patriot),15,4-11,131,227,358,0.366,04/26/2016,2016.0
65,Georgetown (Big East),13,2-11,104,182,286,0.364,04/26/2016,2016.0
66,Lehigh (Patriot),15,6-9,119,243,362,0.329,04/26/2016,2016.0
67,UMBC (America East),13,4-9,98,207,305,0.321,04/26/2016,2016.0
68,Marist (MAAC),13,7-6,89,193,282,0.316,04/26/2016,2016.0
-,UMass Lowell (America East),15,3-12,148,208,356,0.416,04/26/2016,2016.0
1,Hartford (America East),14,9-5,234,94,328,0.713,04/24/2016,2016.0
2,Denver (Big East),12,11-1,208,106,314,0.662,04/24/2016,2016.0
3,Brown (Ivy League),13,12-1,241,129,370,0.651,04/24/2016,2016.0
4,Syracuse (ACC),12,8-4,191,105,296,0.645,04/24/2016,2016.0
5,Boston U. (Patriot),14,8-6,201,111,312,0.644,04/24/2016,2016.0
6,Cornell (Ivy League),12,6-6,177,103,280,0.632,04/24/2016,2016.0
7,Army West Point (Patriot),13,8-5,189,115,304,0.622,04/24/2016,2016.0
8,Navy (Patriot),13,10-3,158,103,261,0.605,04/24/2016,2016.0
9,Marquette (Big East),12,9-3,140,92,232,0.603,04/24/2016,2016.0
10,Saint Joseph's (NEC),12,9-3,173,116,289,0.599,04/24/2016,2016.0
11,Ohio St. (Big Ten),14,6-8,177,123,300,0.590,04/24/2016,2016.0
12,Bucknell (Patriot),13,9-4,186,130,316,0.589,04/24/2016,2016.0
13,Duke (ACC),15,9-6,232,167,399,0.581,04/24/2016,2016.0
14,North Carolina (ACC),13,8-5,198,145,343,0.577,04/24/2016,2016.0
15,Virginia (ACC),14,7-7,184,138,322,0.571,04/24/2016,2016.0
16,Maryland (Big Ten),13,11-2,160,122,282,0.567,04/24/2016,2016.0
17,Villanova (Big East),12,8-4,188,145,333,0.565,04/24/2016,2016.0
18,Jacksonville (SoCon),12,3-9,156,126,282,0.553,04/24/2016,2016.0
19,High Point (SoCon),13,8-5,173,142,315,0.549,04/24/2016,2016.0
20,Hobart (NEC),13,7-6,161,136,297,0.542,04/24/2016,2016.0
21,Hofstra (CAA),13,9-4,154,134,288,0.535,04/24/2016,2016.0
22,Bryant (NEC),13,9-4,167,147,314,0.532,04/24/2016,2016.0
23,Johns Hopkins (Big Ten),12,8-4,172,153,325,0.529,04/24/2016,2016.0
24,Mount St. Mary's (NEC),13,6-7,156,139,295,0.529,04/24/2016,2016.0
25,Bellarmine (SoCon),13,5-8,138,123,261,0.529,04/24/2016,2016.0
26,Fairfield (CAA),14,7-7,167,149,316,0.528,04/24/2016,2016.0
27,Quinnipiac (MAAC),11,8-3,130,116,246,0.528,04/24/2016,2016.0
28,Vermont (America East),14,7-7,185,171,356,0.520,04/24/2016,2016.0
29,Notre Dame (ACC),11,9-2,124,115,239,0.519,04/24/2016,2016.0
30,Air Force (SoCon),14,12-2,154,143,297,0.519,04/24/2016,2016.0
31,Michigan (Big Ten),12,3-9,159,149,308,0.516,04/24/2016,2016.0
32,Towson (CAA),13,11-2,148,139,287,0.516,04/24/2016,2016.0
33,Loyola Maryland (Patriot),13,10-3,147,140,287,0.512,04/24/2016,2016.0
34,Stony Brook (America East),14,11-3,184,178,362,0.508,04/24/2016,2016.0
35,Richmond (SoCon),13,9-4,122,121,243,0.502,04/24/2016,2016.0
36,Delaware (CAA),14,5-9,157,157,314,0.500,04/24/2016,2016.0
36,Canisius (MAAC),11,4-7,129,129,258,0.500,04/24/2016,2016.0
38,Rutgers (Big Ten),13,10-3,167,168,335,0.499,04/24/2016,2016.0
39,Massachusetts (CAA),12,4-8,130,132,262,0.496,04/24/2016,2016.0
40,Binghamton (America East),13,4-9,159,162,321,0.495,04/24/2016,2016.0
41,Mercer (SoCon),12,5-7,140,144,284,0.493,04/24/2016,2016.0
42,Lafayette (Patriot),14,3-11,154,160,314,0.490,04/24/2016,2016.0
43,Yale (Ivy League),12,10-2,139,151,290,0.479,04/24/2016,2016.0
44,Princeton (Ivy League),12,4-8,146,161,307,0.476,04/24/2016,2016.0
45,Penn St. (Big Ten),13,7-6,161,178,339,0.475,04/24/2016,2016.0
46,Penn (Ivy League),13,8-5,150,167,317,0.473,04/24/2016,2016.0
47,UAlbany (America East),12,10-2,146,164,310,0.471,04/24/2016,2016.0
48,Furman (SoCon),12,2-10,126,142,268,0.470,04/24/2016,2016.0
49,Siena (MAAC),11,3-8,118,141,259,0.456,04/24/2016,2016.0
50,Wagner (NEC),14,6-8,138,168,306,0.451,04/24/2016,2016.0
51,Robert Morris (NEC),13,6-7,149,187,336,0.443,04/24/2016,2016.0
52,Sacred Heart (NEC),14,2-12,146,187,333,0.438,04/24/2016,2016.0
53,St. John's (NY) (Big East),13,1-12,144,187,331,0.435,04/24/2016,2016.0
54,Detroit Mercy (MAAC),11,2-9,89,119,208,0.428,04/24/2016,2016.0
55,Monmouth (MAAC),12,6-6,103,146,249,0.414,04/24/2016,2016.0
56,Colgate (Patriot),13,4-9,113,161,274,0.412,04/24/2016,2016.0
57,Dartmouth (Ivy League),13,1-12,120,171,291,0.412,04/24/2016,2016.0
58,Providence (Big East),14,7-7,133,196,329,0.404,04/24/2016,2016.0
59,VMI (SoCon),15,2-13,137,202,339,0.404,04/24/2016,2016.0
60,Drexel (CAA),13,5-8,113,177,290,0.390,04/24/2016,2016.0
61,Harvard (Ivy League),13,7-6,128,204,332,0.386,04/24/2016,2016.0
62,NJIT (Independent),14,1-13,122,205,327,0.373,04/24/2016,2016.0
63,Manhattan (MAAC),14,3-11,119,204,323,0.368,04/24/2016,2016.0
64,Georgetown (Big East),13,2-11,104,182,286,0.364,04/24/2016,2016.0
65,Holy Cross (Patriot),14,4-10,119,216,335,0.355,04/24/2016,2016.0
66,Lehigh (Patriot),14,6-8,115,225,340,0.338,04/24/2016,2016.0
67,UMBC (America East),13,4-9,98,207,305,0.321,04/24/2016,2016.0
68,Marist (MAAC),13,7-6,89,193,282,0.316,04/24/2016,2016.0
-,UMass Lowell (America East),15,3-12,148,208,356,0.416,04/24/2016,2016.0
1,Hartford (America East),13,9-4,218,89,307,0.710,04/22/2016,2016.0
2,Brown (Ivy League),12,11-1,224,116,340,0.659,04/22/2016,2016.0
3,Cornell (Ivy League),11,6-5,164,86,250,0.656,04/22/2016,2016.0
4,Denver (Big East),11,10-1,188,100,288,0.653,04/22/2016,2016.0
5,Syracuse (ACC),12,8-4,191,105,296,0.645,04/22/2016,2016.0
6,Boston U. (Patriot),14,8-6,201,111,312,0.644,04/22/2016,2016.0
7,Army West Point (Patriot),13,8-5,189,115,304,0.622,04/22/2016,2016.0
8,Navy (Patriot),13,10-3,158,103,261,0.605,04/22/2016,2016.0
9,Marquette (Big East),12,9-3,140,92,232,0.603,04/22/2016,2016.0
10,Saint Joseph's (NEC),11,9-2,159,105,264,0.602,04/22/2016,2016.0
11,Ohio St. (Big Ten),13,6-7,166,115,281,0.591,04/22/2016,2016.0
12,Bucknell (Patriot),13,9-4,186,130,316,0.589,04/22/2016,2016.0
13,Duke (ACC),15,9-6,232,167,399,0.581,04/22/2016,2016.0
14,North Carolina (ACC),12,7-5,179,129,308,0.581,04/22/2016,2016.0
15,Maryland (Big Ten),12,10-2,152,111,263,0.578,04/22/2016,2016.0
16,Villanova (Big East),11,7-4,173,127,300,0.577,04/22/2016,2016.0
17,Virginia (ACC),13,6-7,175,130,305,0.574,04/22/2016,2016.0
18,Hobart (NEC),12,7-5,152,124,276,0.551,04/22/2016,2016.0
19,Jacksonville (SoCon),11,3-8,143,118,261,0.548,04/22/2016,2016.0
20,High Point (SoCon),12,7-5,161,135,296,0.544,04/22/2016,2016.0
21,Hofstra (CAA),12,8-4,144,122,266,0.541,04/22/2016,2016.0
22,Vermont (America East),13,6-7,180,155,335,0.537,04/22/2016,2016.0
23,Towson (CAA),12,10-2,135,120,255,0.529,04/22/2016,2016.0
23,Notre Dame (ACC),10,9-1,108,96,204,0.529,04/22/2016,2016.0
25,Bryant (NEC),12,8-4,155,138,293,0.529,04/22/2016,2016.0
26,Michigan (Big Ten),11,3-8,144,129,273,0.527,04/22/2016,2016.0
27,Johns Hopkins (Big Ten),11,7-4,152,138,290,0.524,04/22/2016,2016.0
28,Mount St. Mary's (NEC),12,5-7,147,134,281,0.523,04/22/2016,2016.0
29,Fairfield (CAA),13,7-6,148,136,284,0.521,04/22/2016,2016.0
30,Bellarmine (SoCon),12,4-8,124,114,238,0.521,04/22/2016,2016.0
31,Air Force (SoCon),13,11-2,144,133,277,0.520,04/22/2016,2016.0
32,Quinnipiac (MAAC),10,7-3,118,112,230,0.513,04/22/2016,2016.0
33,Loyola Maryland (Patriot),13,10-3,147,140,287,0.512,04/22/2016,2016.0
34,Delaware (CAA),13,5-8,151,148,299,0.505,04/22/2016,2016.0
35,Stony Brook (America East),13,10-3,167,164,331,0.505,04/22/2016,2016.0
36,Richmond (SoCon),12,9-3,112,111,223,0.502,04/22/2016,2016.0
37,Mercer (SoCon),11,4-7,132,131,263,0.502,04/22/2016,2016.0
38,Binghamton (America East),12,4-8,145,145,290,0.500,04/22/2016,2016.0
39,Rutgers (Big Ten),13,10-3,167,168,335,0.499,04/22/2016,2016.0
40,Canisius (MAAC),10,3-7,119,122,241,0.494,04/22/2016,2016.0
41,Massachusetts (CAA),11,4-7,118,122,240,0.492,04/22/2016,2016.0
42,Lafayette (Patriot),14,3-11,154,160,314,0.490,04/22/2016,2016.0
43,Princeton (Ivy League),11,4-7,134,143,277,0.484,04/22/2016,2016.0
44,Yale (Ivy League),11,10-1,125,135,260,0.481,04/22/2016,2016.0
45,Furman (SoCon),11,2-9,119,130,249,0.478,04/22/2016,2016.0
46,Penn St. (Big Ten),13,7-6,161,178,339,0.475,04/22/2016,2016.0
47,Penn (Ivy League),12,7-5,141,157,298,0.473,04/22/2016,2016.0
48,UAlbany (America East),11,9-2,130,150,280,0.464,04/22/2016,2016.0
49,Wagner (NEC),13,6-7,133,159,292,0.455,04/22/2016,2016.0
50,Robert Morris (NEC),12,5-7,138,173,311,0.444,04/22/2016,2016.0
51,Siena (MAAC),10,2-8,101,127,228,0.443,04/22/2016,2016.0
52,Sacred Heart (NEC),14,2-12,146,187,333,0.438,04/22/2016,2016.0
53,Detroit Mercy (MAAC),10,2-8,82,109,191,0.429,04/22/2016,2016.0
54,Monmouth (MAAC),11,6-5,99,134,233,0.425,04/22/2016,2016.0
55,St. John's (NY) (Big East),12,1-11,126,172,298,0.423,04/22/2016,2016.0
56,Providence (Big East),13,7-6,127,176,303,0.419,04/22/2016,2016.0
57,Colgate (Patriot),13,4-9,113,161,274,0.412,04/22/2016,2016.0
58,VMI (SoCon),14,2-12,128,188,316,0.405,04/22/2016,2016.0
59,Dartmouth (Ivy League),12,1-11,110,162,272,0.404,04/22/2016,2016.0
60,Drexel (CAA),12,4-8,104,171,275,0.378,04/22/2016,2016.0
61,Harvard (Ivy League),12,6-6,110,192,302,0.364,04/22/2016,2016.0
62,NJIT (Independent),13,1-12,109,191,300,0.363,04/22/2016,2016.0
63,Manhattan (MAAC),13,3-10,105,187,292,0.360,04/22/2016,2016.0
64,Georgetown (Big East),12,2-10,96,173,269,0.357,04/22/2016,2016.0
65,Holy Cross (Patriot),14,4-10,119,216,335,0.355,04/22/2016,2016.0
66,Lehigh (Patriot),14,6-8,115,225,340,0.338,04/22/2016,2016.0
67,UMBC (America East),12,3-9,93,191,284,0.327,04/22/2016,2016.0
68,Marist (MAAC),12,6-6,75,180,255,0.294,04/22/2016,2016.0
-,UMass Lowell (America East),14,3-11,132,203,335,0.394,04/22/2016,2016.0
1,Hartford (America East),13,9-4,218,89,307,0.710,04/20/2016,2016.0
2,Brown (Ivy League),12,11-1,224,116,340,0.659,04/20/2016,2016.0
3,Cornell (Ivy League),11,6-5,164,86,250,0.656,04/20/2016,2016.0
4,Denver (Big East),11,10-1,188,100,288,0.653,04/20/2016,2016.0
5,Syracuse (ACC),12,8-4,191,105,296,0.645,04/20/2016,2016.0
6,Boston U. (Patriot),13,8-5,186,105,291,0.639,04/20/2016,2016.0
7,Army West Point (Patriot),12,8-4,178,104,282,0.631,04/20/2016,2016.0
8,Marquette (Big East),11,9-2,131,80,211,0.621,04/20/2016,2016.0
9,Navy (Patriot),12,9-3,151,99,250,0.604,04/20/2016,2016.0
10,Saint Joseph's (NEC),11,9-2,159,105,264,0.602,04/20/2016,2016.0
11,Ohio St. (Big Ten),13,6-7,166,115,281,0.591,04/20/2016,2016.0
12,Duke (ACC),14,8-6,220,158,378,0.582,04/20/2016,2016.0
13,North Carolina (ACC),12,7-5,179,129,308,0.581,04/20/2016,2016.0
14,Maryland (Big Ten),12,10-2,152,111,263,0.578,04/20/2016,2016.0
15,Villanova (Big East),11,7-4,173,127,300,0.577,04/20/2016,2016.0
16,Virginia (ACC),13,6-7,175,130,305,0.574,04/20/2016,2016.0
17,Bucknell (Patriot),12,8-4,162,128,290,0.559,04/20/2016,2016.0
18,Hobart (NEC),12,7-5,152,124,276,0.551,04/20/2016,2016.0
19,Jacksonville (SoCon),11,3-8,143,118,261,0.548,04/20/2016,2016.0
20,High Point (SoCon),12,7-5,161,135,296,0.544,04/20/2016,2016.0
21,Hofstra (CAA),12,8-4,144,122,266,0.541,04/20/2016,2016.0
22,Vermont (America East),13,6-7,180,155,335,0.537,04/20/2016,2016.0
23,Towson (CAA),12,10-2,135,120,255,0.529,04/20/2016,2016.0
23,Notre Dame (ACC),10,9-1,108,96,204,0.529,04/20/2016,2016.0
25,Bryant (NEC),12,8-4,155,138,293,0.529,04/20/2016,2016.0
26,Michigan (Big Ten),11,3-8,144,129,273,0.527,04/20/2016,2016.0
27,Johns Hopkins (Big Ten),11,7-4,152,138,290,0.524,04/20/2016,2016.0
28,Mount St. Mary's (NEC),12,5-7,147,134,281,0.523,04/20/2016,2016.0
29,Fairfield (CAA),13,7-6,148,136,284,0.521,04/20/2016,2016.0
30,Bellarmine (SoCon),12,4-8,124,114,238,0.521,04/20/2016,2016.0
31,Air Force (SoCon),13,11-2,144,133,277,0.520,04/20/2016,2016.0
32,Loyola Maryland (Patriot),12,9-3,136,129,265,0.513,04/20/2016,2016.0
33,Quinnipiac (MAAC),10,7-3,118,112,230,0.513,04/20/2016,2016.0
34,Delaware (CAA),13,5-8,151,148,299,0.505,04/20/2016,2016.0
35,Rutgers (Big Ten),12,9-3,153,150,303,0.505,04/20/2016,2016.0
36,Stony Brook (America East),13,10-3,167,164,331,0.505,04/20/2016,2016.0
37,Richmond (SoCon),12,9-3,112,111,223,0.502,04/20/2016,2016.0
38,Mercer (SoCon),11,4-7,132,131,263,0.502,04/20/2016,2016.0
39,Binghamton (America East),12,4-8,145,145,290,0.500,04/20/2016,2016.0
40,Canisius (MAAC),10,3-7,119,122,241,0.494,04/20/2016,2016.0
41,Massachusetts (CAA),11,4-7,118,122,240,0.492,04/20/2016,2016.0
42,Princeton (Ivy League),11,4-7,134,143,277,0.484,04/20/2016,2016.0
43,Lafayette (Patriot),13,3-10,139,149,288,0.483,04/20/2016,2016.0
44,Yale (Ivy League),11,10-1,125,135,260,0.481,04/20/2016,2016.0
45,Furman (SoCon),11,2-9,119,130,249,0.478,04/20/2016,2016.0
46,Penn (Ivy League),12,7-5,141,157,298,0.473,04/20/2016,2016.0
47,Penn St. (Big Ten),12,7-5,143,164,307,0.466,04/20/2016,2016.0
48,UAlbany (America East),11,9-2,130,150,280,0.464,04/20/2016,2016.0
49,Wagner (NEC),13,6-7,133,159,292,0.455,04/20/2016,2016.0
50,Robert Morris (NEC),12,5-7,138,173,311,0.444,04/20/2016,2016.0
51,Siena (MAAC),10,2-8,101,127,228,0.443,04/20/2016,2016.0
52,Sacred Heart (NEC),13,2-11,142,180,322,0.441,04/20/2016,2016.0
53,Detroit Mercy (MAAC),10,2-8,82,109,191,0.429,04/20/2016,2016.0
54,Monmouth (MAAC),11,6-5,99,134,233,0.425,04/20/2016,2016.0
55,St. John's (NY) (Big East),12,1-11,126,172,298,0.423,04/20/2016,2016.0
56,Providence (Big East),13,7-6,127,176,303,0.419,04/20/2016,2016.0
57,Colgate (Patriot),12,3-9,102,146,248,0.411,04/20/2016,2016.0
58,VMI (SoCon),14,2-12,128,188,316,0.405,04/20/2016,2016.0
59,Dartmouth (Ivy League),12,1-11,110,162,272,0.404,04/20/2016,2016.0
60,Drexel (CAA),12,4-8,104,171,275,0.378,04/20/2016,2016.0
61,Harvard (Ivy League),12,6-6,110,192,302,0.364,04/20/2016,2016.0
62,NJIT (Independent),13,1-12,109,191,300,0.363,04/20/2016,2016.0
63,Holy Cross (Patriot),13,3-10,113,201,314,0.360,04/20/2016,2016.0
63,Lehigh (Patriot),13,6-7,113,201,314,0.360,04/20/2016,2016.0
65,Manhattan (MAAC),13,3-10,105,187,292,0.360,04/20/2016,2016.0
66,Georgetown (Big East),12,2-10,96,173,269,0.357,04/20/2016,2016.0
67,UMBC (America East),12,3-9,93,191,284,0.327,04/20/2016,2016.0
68,Marist (MAAC),12,6-6,75,180,255,0.294,04/20/2016,2016.0
-,UMass Lowell (America East),14,3-11,132,203,335,0.394,04/20/2016,2016.0
1,Hartford (America East),13,9-4,218,89,307,0.710,04/19/2016,2016.0
2,Brown (Ivy League),12,11-1,224,116,340,0.659,04/19/2016,2016.0
3,Cornell (Ivy League),11,6-5,164,86,250,0.656,04/19/2016,2016.0
4,Denver (Big East),11,10-1,188,100,288,0.653,04/19/2016,2016.0
5,Boston U. (Patriot),13,8-5,186,105,291,0.639,04/19/2016,2016.0
6,Syracuse (ACC),11,7-4,176,100,276,0.638,04/19/2016,2016.0
7,Army West Point (Patriot),12,8-4,178,104,282,0.631,04/19/2016,2016.0
8,Marquette (Big East),11,9-2,131,80,211,0.621,04/19/2016,2016.0
9,Navy (Patriot),12,9-3,151,99,250,0.604,04/19/2016,2016.0
10,Saint Joseph's (NEC),11,9-2,159,105,264,0.602,04/19/2016,2016.0
11,Ohio St. (Big Ten),13,6-7,166,115,281,0.591,04/19/2016,2016.0
12,Duke (ACC),14,8-6,220,158,378,0.582,04/19/2016,2016.0
13,North Carolina (ACC),12,7-5,179,129,308,0.581,04/19/2016,2016.0
14,Maryland (Big Ten),12,10-2,152,111,263,0.578,04/19/2016,2016.0
15,Villanova (Big East),11,7-4,173,127,300,0.577,04/19/2016,2016.0
16,Virginia (ACC),13,6-7,175,130,305,0.574,04/19/2016,2016.0
17,Bucknell (Patriot),12,8-4,162,128,290,0.559,04/19/2016,2016.0
18,Hobart (NEC),12,7-5,152,124,276,0.551,04/19/2016,2016.0
19,Jacksonville (SoCon),11,3-8,143,118,261,0.548,04/19/2016,2016.0
20,High Point (SoCon),12,7-5,161,135,296,0.544,04/19/2016,2016.0
21,Hofstra (CAA),12,8-4,144,122,266,0.541,04/19/2016,2016.0
22,Vermont (America East),13,6-7,180,155,335,0.537,04/19/2016,2016.0
23,Towson (CAA),12,10-2,135,120,255,0.529,04/19/2016,2016.0
23,Notre Dame (ACC),10,9-1,108,96,204,0.529,04/19/2016,2016.0
25,Bryant (NEC),12,8-4,155,138,293,0.529,04/19/2016,2016.0
26,Michigan (Big Ten),11,3-8,144,129,273,0.527,04/19/2016,2016.0
27,Johns Hopkins (Big Ten),11,7-4,152,138,290,0.524,04/19/2016,2016.0
28,Mount St. Mary's (NEC),12,5-7,147,134,281,0.523,04/19/2016,2016.0
29,Fairfield (CAA),13,7-6,148,136,284,0.521,04/19/2016,2016.0
30,Bellarmine (SoCon),12,4-8,124,114,238,0.521,04/19/2016,2016.0
31,Air Force (SoCon),13,11-2,144,133,277,0.520,04/19/2016,2016.0
32,Binghamton (America East),11,4-7,140,130,270,0.519,04/19/2016,2016.0
33,Loyola Maryland (Patriot),12,9-3,136,129,265,0.513,04/19/2016,2016.0
34,Quinnipiac (MAAC),10,7-3,118,112,230,0.513,04/19/2016,2016.0
35,Delaware (CAA),13,5-8,151,148,299,0.505,04/19/2016,2016.0
36,Rutgers (Big Ten),12,9-3,153,150,303,0.505,04/19/2016,2016.0
37,Stony Brook (America East),13,10-3,167,164,331,0.505,04/19/2016,2016.0
38,Richmond (SoCon),12,9-3,112,111,223,0.502,04/19/2016,2016.0
39,Mercer (SoCon),11,4-7,132,131,263,0.502,04/19/2016,2016.0
40,Canisius (MAAC),10,3-7,119,122,241,0.494,04/19/2016,2016.0
41,Massachusetts (CAA),11,4-7,118,122,240,0.492,04/19/2016,2016.0
42,Princeton (Ivy League),11,4-7,134,143,277,0.484,04/19/2016,2016.0
43,Lafayette (Patriot),13,3-10,139,149,288,0.483,04/19/2016,2016.0
44,Yale (Ivy League),11,10-1,125,135,260,0.481,04/19/2016,2016.0
45,Furman (SoCon),11,2-9,119,130,249,0.478,04/19/2016,2016.0
46,Penn (Ivy League),12,7-5,141,157,298,0.473,04/19/2016,2016.0
47,Penn St. (Big Ten),12,7-5,143,164,307,0.466,04/19/2016,2016.0
48,UAlbany (America East),11,9-2,130,150,280,0.464,04/19/2016,2016.0
49,Wagner (NEC),13,6-7,133,159,292,0.455,04/19/2016,2016.0
50,Robert Morris (NEC),12,5-7,138,173,311,0.444,04/19/2016,2016.0
51,Siena (MAAC),10,2-8,101,127,228,0.443,04/19/2016,2016.0
52,Sacred Heart (NEC),13,2-11,142,180,322,0.441,04/19/2016,2016.0
53,Detroit Mercy (MAAC),10,2-8,82,109,191,0.429,04/19/2016,2016.0
54,Monmouth (MAAC),11,6-5,99,134,233,0.425,04/19/2016,2016.0
55,St. John's (NY) (Big East),12,1-11,126,172,298,0.423,04/19/2016,2016.0
56,Providence (Big East),13,7-6,127,176,303,0.419,04/19/2016,2016.0
57,Colgate (Patriot),12,3-9,102,146,248,0.411,04/19/2016,2016.0
58,VMI (SoCon),14,2-12,128,188,316,0.405,04/19/2016,2016.0
59,Dartmouth (Ivy League),12,1-11,110,162,272,0.404,04/19/2016,2016.0
60,Drexel (CAA),12,4-8,104,171,275,0.378,04/19/2016,2016.0
61,Harvard (Ivy League),12,6-6,110,192,302,0.364,04/19/2016,2016.0
62,NJIT (Independent),13,1-12,109,191,300,0.363,04/19/2016,2016.0
63,Holy Cross (Patriot),13,3-10,113,201,314,0.360,04/19/2016,2016.0
63,Lehigh (Patriot),13,6-7,113,201,314,0.360,04/19/2016,2016.0
65,Manhattan (MAAC),13,3-10,105,187,292,0.360,04/19/2016,2016.0
66,Georgetown (Big East),12,2-10,96,173,269,0.357,04/19/2016,2016.0
67,UMBC (America East),12,3-9,93,191,284,0.327,04/19/2016,2016.0
68,Marist (MAAC),12,6-6,75,180,255,0.294,04/19/2016,2016.0
-,UMass Lowell (America East),14,3-11,132,203,335,0.394,04/19/2016,2016.0
1,Hartford (America East),12,8-4,203,83,286,0.710,04/17/2016,2016.0
2,Cornell (Ivy League),11,6-5,164,86,250,0.656,04/17/2016,2016.0
3,Denver (Big East),11,10-1,188,100,288,0.653,04/17/2016,2016.0
4,Boston U. (Patriot),13,8-5,186,105,291,0.639,04/17/2016,2016.0
5,Syracuse (ACC),11,7-4,176,100,276,0.638,04/17/2016,2016.0
6,Brown (Ivy League),11,10-1,198,113,311,0.637,04/17/2016,2016.0
7,Army West Point (Patriot),12,8-4,178,104,282,0.631,04/17/2016,2016.0
8,Marquette (Big East),11,9-2,131,80,211,0.621,04/17/2016,2016.0
9,Navy (Patriot),11,9-2,140,91,231,0.606,04/17/2016,2016.0
10,Saint Joseph's (NEC),11,9-2,159,105,264,0.602,04/17/2016,2016.0
11,Ohio St. (Big Ten),13,6-7,166,115,281,0.591,04/17/2016,2016.0
12,Maryland (Big Ten),11,9-2,144,100,244,0.590,04/17/2016,2016.0
13,Duke (ACC),14,8-6,220,158,378,0.582,04/17/2016,2016.0
14,North Carolina (ACC),12,7-5,179,129,308,0.581,04/17/2016,2016.0
15,Villanova (Big East),11,7-4,173,127,300,0.577,04/17/2016,2016.0
16,Virginia (ACC),13,6-7,175,130,305,0.574,04/17/2016,2016.0
17,Bucknell (Patriot),12,8-4,162,128,290,0.559,04/17/2016,2016.0
18,Hobart (NEC),12,7-5,152,124,276,0.551,04/17/2016,2016.0
19,Jacksonville (SoCon),11,3-8,143,118,261,0.548,04/17/2016,2016.0
20,High Point (SoCon),12,7-5,161,135,296,0.544,04/17/2016,2016.0
21,Hofstra (CAA),12,8-4,144,122,266,0.541,04/17/2016,2016.0
22,Vermont (America East),13,6-7,180,155,335,0.537,04/17/2016,2016.0
23,Bryant (NEC),11,7-4,144,126,270,0.533,04/17/2016,2016.0
24,Towson (CAA),12,10-2,135,120,255,0.529,04/17/2016,2016.0
24,Notre Dame (ACC),10,9-1,108,96,204,0.529,04/17/2016,2016.0
26,Michigan (Big Ten),11,3-8,144,129,273,0.527,04/17/2016,2016.0
27,Johns Hopkins (Big Ten),11,7-4,152,138,290,0.524,04/17/2016,2016.0
28,Mount St. Mary's (NEC),11,5-6,135,123,258,0.523,04/17/2016,2016.0
29,Fairfield (CAA),13,7-6,148,136,284,0.521,04/17/2016,2016.0
30,Bellarmine (SoCon),12,4-8,124,114,238,0.521,04/17/2016,2016.0
31,Air Force (SoCon),13,11-2,144,133,277,0.520,04/17/2016,2016.0
32,Binghamton (America East),11,4-7,140,130,270,0.519,04/17/2016,2016.0
33,Loyola Maryland (Patriot),12,9-3,136,129,265,0.513,04/17/2016,2016.0
34,Quinnipiac (MAAC),10,7-3,118,112,230,0.513,04/17/2016,2016.0
35,Canisius (MAAC),9,3-6,110,106,216,0.509,04/17/2016,2016.0
36,Delaware (CAA),13,5-8,151,148,299,0.505,04/17/2016,2016.0
37,Rutgers (Big Ten),12,9-3,153,150,303,0.505,04/17/2016,2016.0
38,Stony Brook (America East),13,10-3,167,164,331,0.505,04/17/2016,2016.0
39,Richmond (SoCon),12,9-3,112,111,223,0.502,04/17/2016,2016.0
40,Mercer (SoCon),11,4-7,131,132,263,0.498,04/17/2016,2016.0
41,Massachusetts (CAA),11,4-7,118,122,240,0.492,04/17/2016,2016.0
42,Princeton (Ivy League),11,4-7,134,143,277,0.484,04/17/2016,2016.0
43,Lafayette (Patriot),13,3-10,139,149,288,0.483,04/17/2016,2016.0
44,Furman (SoCon),11,2-9,120,129,249,0.482,04/17/2016,2016.0
45,Yale (Ivy League),11,10-1,125,135,260,0.481,04/17/2016,2016.0
46,Penn St. (Big Ten),12,7-5,143,164,307,0.466,04/17/2016,2016.0
47,UAlbany (America East),11,9-2,130,150,280,0.464,04/17/2016,2016.0
48,Wagner (NEC),13,6-7,133,159,292,0.455,04/17/2016,2016.0
49,Penn (Ivy League),11,6-5,127,152,279,0.455,04/17/2016,2016.0
50,Providence (Big East),12,7-5,124,150,274,0.453,04/17/2016,2016.0
51,Sacred Heart (NEC),12,2-10,136,165,301,0.452,04/17/2016,2016.0
52,Siena (MAAC),10,2-8,101,127,228,0.443,04/17/2016,2016.0
53,Detroit Mercy (MAAC),10,2-8,82,109,191,0.429,04/17/2016,2016.0
54,Robert Morris (NEC),11,4-7,122,164,286,0.427,04/17/2016,2016.0
55,Monmouth (MAAC),11,6-5,99,134,233,0.425,04/17/2016,2016.0
56,St. John's (NY) (Big East),12,1-11,126,172,298,0.423,04/17/2016,2016.0
57,Colgate (Patriot),12,3-9,102,146,248,0.411,04/17/2016,2016.0
58,VMI (SoCon),14,2-12,128,188,316,0.405,04/17/2016,2016.0
59,Dartmouth (Ivy League),11,1-10,98,150,248,0.395,04/17/2016,2016.0
60,Drexel (CAA),12,4-8,104,171,275,0.378,04/17/2016,2016.0
61,Harvard (Ivy League),12,6-6,110,192,302,0.364,04/17/2016,2016.0
62,NJIT (Independent),13,1-12,109,191,300,0.363,04/17/2016,2016.0
63,Lehigh (Patriot),13,6-7,113,201,314,0.360,04/17/2016,2016.0
63,Holy Cross (Patriot),13,3-10,113,201,314,0.360,04/17/2016,2016.0
65,Manhattan (MAAC),13,3-10,105,187,292,0.360,04/17/2016,2016.0
66,Georgetown (Big East),12,2-10,96,173,269,0.357,04/17/2016,2016.0
67,UMBC (America East),11,3-8,88,177,265,0.332,04/17/2016,2016.0
68,Marist (MAAC),12,6-6,75,180,255,0.294,04/17/2016,2016.0
-,UMass Lowell (America East),13,2-11,120,191,311,0.386,04/17/2016,2016.0
1,Hartford (America East),11,7-4,192,71,263,0.730,04/15/2016,2016.0
2,Boston U. (Patriot),12,8-4,170,93,263,0.646,04/15/2016,2016.0
3,Army West Point (Patriot),11,8-3,166,91,257,0.646,04/15/2016,2016.0
4,Denver (Big East),10,9-1,166,93,259,0.641,04/15/2016,2016.0
5,Syracuse (ACC),10,6-4,160,92,252,0.635,04/15/2016,2016.0
6,Brown (Ivy League),10,9-1,178,104,282,0.631,04/15/2016,2016.0
7,Marquette (Big East),10,8-2,121,72,193,0.627,04/15/2016,2016.0
8,Saint Joseph's (NEC),10,8-2,151,91,242,0.624,04/15/2016,2016.0
9,Cornell (Ivy League),10,5-5,139,84,223,0.623,04/15/2016,2016.0
10,Navy (Patriot),10,8-2,127,79,206,0.617,04/15/2016,2016.0
11,North Carolina (ACC),11,7-4,171,113,284,0.602,04/15/2016,2016.0
12,Duke (ACC),13,7-6,209,144,353,0.592,04/15/2016,2016.0
13,Ohio St. (Big Ten),12,5-7,153,107,260,0.588,04/15/2016,2016.0
14,Maryland (Big Ten),10,8-2,129,92,221,0.584,04/15/2016,2016.0
15,Virginia (ACC),12,6-6,161,119,280,0.575,04/15/2016,2016.0
16,Villanova (Big East),10,6-4,157,120,277,0.567,04/15/2016,2016.0
17,Hobart (NEC),11,6-5,143,111,254,0.563,04/15/2016,2016.0
18,Bucknell (Patriot),12,8-4,162,128,290,0.559,04/15/2016,2016.0
19,Jacksonville (SoCon),10,3-7,129,104,233,0.554,04/15/2016,2016.0
20,High Point (SoCon),11,6-5,147,121,268,0.549,04/15/2016,2016.0
21,Michigan (Big Ten),10,3-7,136,116,252,0.540,04/15/2016,2016.0
22,Bellarmine (SoCon),11,4-7,116,101,217,0.535,04/15/2016,2016.0
23,Johns Hopkins (Big Ten),10,6-4,141,123,264,0.534,04/15/2016,2016.0
24,Hofstra (CAA),11,7-4,132,117,249,0.530,04/15/2016,2016.0
25,Notre Dame (ACC),10,9-1,108,96,204,0.529,04/15/2016,2016.0
26,Vermont (America East),12,5-7,162,145,307,0.528,04/15/2016,2016.0
27,Towson (CAA),11,10-1,124,111,235,0.528,04/15/2016,2016.0
28,Canisius (MAAC),8,3-5,98,88,186,0.527,04/15/2016,2016.0
29,Bryant (NEC),10,7-3,130,118,248,0.524,04/15/2016,2016.0
30,Loyola Maryland (Patriot),11,8-3,124,113,237,0.523,04/15/2016,2016.0
31,Fairfield (CAA),12,6-6,139,127,266,0.523,04/15/2016,2016.0
32,Binghamton (America East),10,4-6,129,118,247,0.522,04/15/2016,2016.0
33,Air Force (SoCon),12,10-2,135,125,260,0.519,04/15/2016,2016.0
34,Rutgers (Big Ten),11,9-2,145,135,280,0.518,04/15/2016,2016.0
35,Mount St. Mary's (NEC),10,5-5,122,114,236,0.517,04/15/2016,2016.0
36,Stony Brook (America East),12,9-3,156,150,306,0.510,04/15/2016,2016.0
37,Delaware (CAA),12,4-8,142,137,279,0.509,04/15/2016,2016.0
38,Yale (Ivy League),10,10-0,116,115,231,0.502,04/15/2016,2016.0
39,Quinnipiac (MAAC),9,6-3,100,100,200,0.500,04/15/2016,2016.0
40,Furman (SoCon),10,2-8,112,113,225,0.498,04/15/2016,2016.0
41,Massachusetts (CAA),10,4-6,109,113,222,0.491,04/15/2016,2016.0
42,Richmond (SoCon),11,8-3,99,103,202,0.490,04/15/2016,2016.0
43,Lafayette (Patriot),13,3-10,139,149,288,0.483,04/15/2016,2016.0
44,Mercer (SoCon),10,3-7,115,124,239,0.481,04/15/2016,2016.0
45,Princeton (Ivy League),10,3-7,124,139,263,0.471,04/15/2016,2016.0
46,UAlbany (America East),10,8-2,118,139,257,0.459,04/15/2016,2016.0
47,Penn St. (Big Ten),11,7-4,128,153,281,0.456,04/15/2016,2016.0
48,Providence (Big East),11,7-4,116,140,256,0.453,04/15/2016,2016.0
49,Wagner (NEC),12,5-7,121,148,269,0.450,04/15/2016,2016.0
50,Sacred Heart (NEC),11,2-9,125,153,278,0.450,04/15/2016,2016.0
51,St. John's (NY) (Big East),11,1-10,119,150,269,0.442,04/15/2016,2016.0
52,Siena (MAAC),9,2-7,89,116,205,0.434,04/15/2016,2016.0
53,Monmouth (MAAC),10,6-4,92,120,212,0.434,04/15/2016,2016.0
54,Penn (Ivy League),10,5-5,107,142,249,0.430,04/15/2016,2016.0
55,Robert Morris (NEC),11,4-7,122,164,286,0.427,04/15/2016,2016.0
56,Dartmouth (Ivy League),10,1-9,94,140,234,0.402,04/15/2016,2016.0
57,VMI (SoCon),13,2-11,120,179,299,0.401,04/15/2016,2016.0
58,Detroit Mercy (MAAC),9,1-8,68,102,170,0.400,04/15/2016,2016.0
59,Lehigh (Patriot),12,6-6,111,176,287,0.387,04/15/2016,2016.0
60,Drexel (CAA),11,4-7,99,159,258,0.384,04/15/2016,2016.0
61,Colgate (Patriot),11,3-8,87,140,227,0.383,04/15/2016,2016.0
62,Harvard (Ivy League),11,6-5,100,172,272,0.368,04/15/2016,2016.0
63,Holy Cross (Patriot),12,2-10,107,186,293,0.365,04/15/2016,2016.0
64,NJIT (Independent),13,1-12,109,191,300,0.363,04/15/2016,2016.0
65,Georgetown (Big East),11,2-9,89,157,246,0.362,04/15/2016,2016.0
66,Manhattan (MAAC),12,2-10,89,179,268,0.332,04/15/2016,2016.0
67,UMBC (America East),10,3-7,78,159,237,0.329,04/15/2016,2016.0
68,Marist (MAAC),11,6-5,67,164,231,0.290,04/15/2016,2016.0
-,UMass Lowell (America East),12,2-10,106,180,286,0.371,04/15/2016,2016.0
1,Hartford (America East),11,7-4,192,71,263,0.730,04/13/2016,2016.0
2,Boston U. (Patriot),12,8-4,170,93,263,0.646,04/13/2016,2016.0
3,Army West Point (Patriot),11,8-3,166,91,257,0.646,04/13/2016,2016.0
4,Denver (Big East),10,9-1,166,93,259,0.641,04/13/2016,2016.0
5,Syracuse (ACC),10,6-4,160,92,252,0.635,04/13/2016,2016.0
6,Brown (Ivy League),10,9-1,178,104,282,0.631,04/13/2016,2016.0
7,Marquette (Big East),10,8-2,121,72,193,0.627,04/13/2016,2016.0
8,Saint Joseph's (NEC),10,8-2,151,91,242,0.624,04/13/2016,2016.0
9,Cornell (Ivy League),10,5-5,139,84,223,0.623,04/13/2016,2016.0
10,Navy (Patriot),10,8-2,127,79,206,0.617,04/13/2016,2016.0
11,North Carolina (ACC),11,7-4,171,113,284,0.602,04/13/2016,2016.0
12,Duke (ACC),13,7-6,209,144,353,0.592,04/13/2016,2016.0
13,Ohio St. (Big Ten),12,5-7,153,107,260,0.588,04/13/2016,2016.0
14,Maryland (Big Ten),10,8-2,129,92,221,0.584,04/13/2016,2016.0
15,Virginia (ACC),12,6-6,161,119,280,0.575,04/13/2016,2016.0
16,Villanova (Big East),10,6-4,157,120,277,0.567,04/13/2016,2016.0
17,Hobart (NEC),11,6-5,143,111,254,0.563,04/13/2016,2016.0
18,Bucknell (Patriot),11,7-4,148,118,266,0.556,04/13/2016,2016.0
19,Jacksonville (SoCon),10,3-7,129,104,233,0.554,04/13/2016,2016.0
20,High Point (SoCon),11,6-5,147,121,268,0.549,04/13/2016,2016.0
21,Michigan (Big Ten),10,3-7,136,116,252,0.540,04/13/2016,2016.0
22,Bellarmine (SoCon),11,4-7,116,101,217,0.535,04/13/2016,2016.0
23,Johns Hopkins (Big Ten),10,6-4,141,123,264,0.534,04/13/2016,2016.0
24,Hofstra (CAA),11,7-4,132,117,249,0.530,04/13/2016,2016.0
25,Notre Dame (ACC),10,9-1,108,96,204,0.529,04/13/2016,2016.0
26,Vermont (America East),12,5-7,162,145,307,0.528,04/13/2016,2016.0
27,Towson (CAA),11,10-1,124,111,235,0.528,04/13/2016,2016.0
28,Canisius (MAAC),8,3-5,98,88,186,0.527,04/13/2016,2016.0
29,Bryant (NEC),10,7-3,130,118,248,0.524,04/13/2016,2016.0
30,Loyola Maryland (Patriot),11,8-3,124,113,237,0.523,04/13/2016,2016.0
31,Fairfield (CAA),12,6-6,139,127,266,0.523,04/13/2016,2016.0
32,Binghamton (America East),10,4-6,129,118,247,0.522,04/13/2016,2016.0
33,Air Force (SoCon),12,10-2,135,125,260,0.519,04/13/2016,2016.0
34,Rutgers (Big Ten),11,9-2,145,135,280,0.518,04/13/2016,2016.0
35,Mount St. Mary's (NEC),10,5-5,122,114,236,0.517,04/13/2016,2016.0
36,Stony Brook (America East),12,9-3,156,150,306,0.510,04/13/2016,2016.0
37,Delaware (CAA),12,4-8,142,137,279,0.509,04/13/2016,2016.0
38,Yale (Ivy League),10,10-0,116,115,231,0.502,04/13/2016,2016.0
39,Quinnipiac (MAAC),9,6-3,100,100,200,0.500,04/13/2016,2016.0
40,Furman (SoCon),10,2-8,112,113,225,0.498,04/13/2016,2016.0
41,Massachusetts (CAA),10,4-6,109,113,222,0.491,04/13/2016,2016.0
42,Richmond (SoCon),11,8-3,99,103,202,0.490,04/13/2016,2016.0
43,Lafayette (Patriot),12,3-9,129,135,264,0.489,04/13/2016,2016.0
44,Mercer (SoCon),10,3-7,115,124,239,0.481,04/13/2016,2016.0
45,Princeton (Ivy League),10,3-7,124,139,263,0.471,04/13/2016,2016.0
46,UAlbany (America East),10,8-2,118,139,257,0.459,04/13/2016,2016.0
47,Penn St. (Big Ten),11,7-4,128,153,281,0.456,04/13/2016,2016.0
48,Providence (Big East),11,7-4,116,140,256,0.453,04/13/2016,2016.0
49,Wagner (NEC),12,5-7,121,148,269,0.450,04/13/2016,2016.0
50,Sacred Heart (NEC),11,2-9,125,153,278,0.450,04/13/2016,2016.0
51,St. John's (NY) (Big East),11,1-10,119,150,269,0.442,04/13/2016,2016.0
52,Siena (MAAC),9,2-7,89,116,205,0.434,04/13/2016,2016.0
53,Monmouth (MAAC),10,6-4,92,120,212,0.434,04/13/2016,2016.0
54,Penn (Ivy League),10,5-5,107,142,249,0.430,04/13/2016,2016.0
55,Robert Morris (NEC),11,4-7,122,164,286,0.427,04/13/2016,2016.0
56,Dartmouth (Ivy League),10,1-9,94,140,234,0.402,04/13/2016,2016.0
57,VMI (SoCon),13,2-11,120,179,299,0.401,04/13/2016,2016.0
58,Detroit Mercy (MAAC),9,1-8,68,102,170,0.400,04/13/2016,2016.0
59,Lehigh (Patriot),12,6-6,111,176,287,0.387,04/13/2016,2016.0
60,Drexel (CAA),11,4-7,99,159,258,0.384,04/13/2016,2016.0
61,Colgate (Patriot),11,3-8,87,140,227,0.383,04/13/2016,2016.0
62,Harvard (Ivy League),11,6-5,100,172,272,0.368,04/13/2016,2016.0
63,Holy Cross (Patriot),12,2-10,107,186,293,0.365,04/13/2016,2016.0
64,NJIT (Independent),13,1-12,109,191,300,0.363,04/13/2016,2016.0
65,Georgetown (Big East),11,2-9,89,157,246,0.362,04/13/2016,2016.0
66,Manhattan (MAAC),12,2-10,89,179,268,0.332,04/13/2016,2016.0
67,UMBC (America East),10,3-7,78,159,237,0.329,04/13/2016,2016.0
68,Marist (MAAC),11,6-5,67,164,231,0.290,04/13/2016,2016.0
-,UMass Lowell (America East),12,2-10,106,180,286,0.371,04/13/2016,2016.0
1,Hartford (America East),11,7-4,192,71,263,0.730,04/12/2016,2016.0
2,Marquette (Big East),9,8-1,116,59,175,0.663,04/12/2016,2016.0
3,Boston U. (Patriot),12,8-4,170,93,263,0.646,04/12/2016,2016.0
4,Army West Point (Patriot),11,8-3,166,91,257,0.646,04/12/2016,2016.0
5,Denver (Big East),10,9-1,166,93,259,0.641,04/12/2016,2016.0
6,Syracuse (ACC),10,6-4,160,92,252,0.635,04/12/2016,2016.0
7,Brown (Ivy League),10,9-1,178,104,282,0.631,04/12/2016,2016.0
8,Saint Joseph's (NEC),10,8-2,151,91,242,0.624,04/12/2016,2016.0
9,Cornell (Ivy League),10,5-5,139,84,223,0.623,04/12/2016,2016.0
10,Navy (Patriot),10,8-2,127,79,206,0.617,04/12/2016,2016.0
11,North Carolina (ACC),11,7-4,171,113,284,0.602,04/12/2016,2016.0
12,Duke (ACC),13,7-6,209,144,353,0.592,04/12/2016,2016.0
13,Ohio St. (Big Ten),12,5-7,153,107,260,0.588,04/12/2016,2016.0
14,Maryland (Big Ten),10,8-2,129,92,221,0.584,04/12/2016,2016.0
15,Virginia (ACC),12,6-6,161,119,280,0.575,04/12/2016,2016.0
16,Villanova (Big East),10,6-4,157,120,277,0.567,04/12/2016,2016.0
17,Hobart (NEC),11,6-5,143,111,254,0.563,04/12/2016,2016.0
18,Bucknell (Patriot),11,7-4,148,118,266,0.556,04/12/2016,2016.0
19,Jacksonville (SoCon),10,3-7,129,104,233,0.554,04/12/2016,2016.0
20,High Point (SoCon),11,6-5,147,121,268,0.549,04/12/2016,2016.0
21,Michigan (Big Ten),10,3-7,136,116,252,0.540,04/12/2016,2016.0
22,Bellarmine (SoCon),11,4-7,116,101,217,0.535,04/12/2016,2016.0
23,Johns Hopkins (Big Ten),10,6-4,141,123,264,0.534,04/12/2016,2016.0
24,Hofstra (CAA),11,7-4,132,117,249,0.530,04/12/2016,2016.0
25,Vermont (America East),12,5-7,162,145,307,0.528,04/12/2016,2016.0
26,Towson (CAA),11,10-1,124,111,235,0.528,04/12/2016,2016.0
27,Canisius (MAAC),8,3-5,98,88,186,0.527,04/12/2016,2016.0
28,Bryant (NEC),10,7-3,130,118,248,0.524,04/12/2016,2016.0
29,Loyola Maryland (Patriot),11,8-3,124,113,237,0.523,04/12/2016,2016.0
30,Fairfield (CAA),12,6-6,139,127,266,0.523,04/12/2016,2016.0
31,Binghamton (America East),10,4-6,129,118,247,0.522,04/12/2016,2016.0
32,Air Force (SoCon),12,10-2,135,125,260,0.519,04/12/2016,2016.0
33,Rutgers (Big Ten),11,9-2,145,135,280,0.518,04/12/2016,2016.0
34,Mount St. Mary's (NEC),10,5-5,122,114,236,0.517,04/12/2016,2016.0
35,Notre Dame (ACC),9,8-1,95,91,186,0.511,04/12/2016,2016.0
36,Stony Brook (America East),12,9-3,156,150,306,0.510,04/12/2016,2016.0
37,Delaware (CAA),12,4-8,142,137,279,0.509,04/12/2016,2016.0
38,Yale (Ivy League),10,10-0,116,115,231,0.502,04/12/2016,2016.0
39,Quinnipiac (MAAC),9,6-3,100,100,200,0.500,04/12/2016,2016.0
40,Furman (SoCon),10,2-8,112,113,225,0.498,04/12/2016,2016.0
41,Massachusetts (CAA),10,4-6,109,113,222,0.491,04/12/2016,2016.0
42,Richmond (SoCon),11,8-3,99,103,202,0.490,04/12/2016,2016.0
43,Lafayette (Patriot),12,3-9,129,135,264,0.489,04/12/2016,2016.0
44,Mercer (SoCon),10,3-7,115,124,239,0.481,04/12/2016,2016.0
45,Princeton (Ivy League),10,3-7,124,139,263,0.471,04/12/2016,2016.0
46,UAlbany (America East),10,8-2,118,139,257,0.459,04/12/2016,2016.0
47,Penn St. (Big Ten),11,7-4,128,153,281,0.456,04/12/2016,2016.0
48,Providence (Big East),11,7-4,116,140,256,0.453,04/12/2016,2016.0
49,Wagner (NEC),12,5-7,121,148,269,0.450,04/12/2016,2016.0
50,Sacred Heart (NEC),11,2-9,125,153,278,0.450,04/12/2016,2016.0
51,St. John's (NY) (Big East),11,1-10,119,150,269,0.442,04/12/2016,2016.0
52,Siena (MAAC),9,2-7,89,116,205,0.434,04/12/2016,2016.0
53,Monmouth (MAAC),10,6-4,92,120,212,0.434,04/12/2016,2016.0
54,Penn (Ivy League),10,5-5,107,142,249,0.430,04/12/2016,2016.0
55,Robert Morris (NEC),11,4-7,122,164,286,0.427,04/12/2016,2016.0
56,Dartmouth (Ivy League),10,1-9,94,140,234,0.402,04/12/2016,2016.0
57,VMI (SoCon),13,2-11,120,179,299,0.401,04/12/2016,2016.0
58,Detroit Mercy (MAAC),9,1-8,68,102,170,0.400,04/12/2016,2016.0
59,Lehigh (Patriot),12,6-6,111,176,287,0.387,04/12/2016,2016.0
60,Drexel (CAA),11,4-7,99,159,258,0.384,04/12/2016,2016.0
61,Colgate (Patriot),11,3-8,87,140,227,0.383,04/12/2016,2016.0
62,Harvard (Ivy League),11,6-5,100,172,272,0.368,04/12/2016,2016.0
63,Holy Cross (Patriot),12,2-10,107,186,293,0.365,04/12/2016,2016.0
64,NJIT (Independent),13,1-12,109,191,300,0.363,04/12/2016,2016.0
65,Georgetown (Big East),11,2-9,89,157,246,0.362,04/12/2016,2016.0
66,Manhattan (MAAC),12,2-10,89,179,268,0.332,04/12/2016,2016.0
67,UMBC (America East),10,3-7,78,159,237,0.329,04/12/2016,2016.0
68,Marist (MAAC),11,6-5,67,164,231,0.290,04/12/2016,2016.0
-,UMass Lowell (America East),12,2-10,106,180,286,0.371,04/12/2016,2016.0
1,Hartford (America East),11,7-4,192,71,263,0.730,04/10/2016,2016.0
2,Cornell (Ivy League),9,4-5,135,66,201,0.672,04/10/2016,2016.0
3,Marquette (Big East),9,8-1,116,59,175,0.663,04/10/2016,2016.0
4,Boston U. (Patriot),12,8-4,170,93,263,0.646,04/10/2016,2016.0
5,Army West Point (Patriot),11,8-3,166,91,257,0.646,04/10/2016,2016.0
6,Denver (Big East),10,9-1,166,93,259,0.641,04/10/2016,2016.0
7,Brown (Ivy League),10,9-1,178,104,282,0.631,04/10/2016,2016.0
8,Saint Joseph's (NEC),10,8-2,151,91,242,0.624,04/10/2016,2016.0
9,Syracuse (ACC),9,6-3,142,88,230,0.617,04/10/2016,2016.0
10,Navy (Patriot),10,8-2,127,79,206,0.617,04/10/2016,2016.0
11,North Carolina (ACC),11,7-4,171,113,284,0.602,04/10/2016,2016.0
12,Duke (ACC),13,7-6,209,144,353,0.592,04/10/2016,2016.0
13,Ohio St. (Big Ten),12,5-7,153,107,260,0.588,04/10/2016,2016.0
14,Maryland (Big Ten),10,8-2,129,92,221,0.584,04/10/2016,2016.0
15,Virginia (ACC),12,6-6,161,119,280,0.575,04/10/2016,2016.0
16,Villanova (Big East),10,6-4,157,120,277,0.567,04/10/2016,2016.0
17,Hobart (NEC),11,6-5,143,111,254,0.563,04/10/2016,2016.0
18,Bucknell (Patriot),11,7-4,148,118,266,0.556,04/10/2016,2016.0
19,Jacksonville (SoCon),10,3-7,129,104,233,0.554,04/10/2016,2016.0
20,High Point (SoCon),11,6-5,147,121,268,0.549,04/10/2016,2016.0
21,Michigan (Big Ten),10,3-7,136,116,252,0.540,04/10/2016,2016.0
22,Binghamton (America East),9,3-6,117,101,218,0.537,04/10/2016,2016.0
23,Bellarmine (SoCon),11,4-7,116,101,217,0.535,04/10/2016,2016.0
24,Johns Hopkins (Big Ten),10,6-4,141,123,264,0.534,04/10/2016,2016.0
25,Hofstra (CAA),11,7-4,132,117,249,0.530,04/10/2016,2016.0
26,Vermont (America East),12,5-7,162,145,307,0.528,04/10/2016,2016.0
27,Towson (CAA),11,10-1,124,111,235,0.528,04/10/2016,2016.0
28,Bryant (NEC),10,7-3,130,118,248,0.524,04/10/2016,2016.0
29,Loyola Maryland (Patriot),11,8-3,124,113,237,0.523,04/10/2016,2016.0
30,Fairfield (CAA),12,6-6,139,127,266,0.523,04/10/2016,2016.0
31,Air Force (SoCon),12,10-2,135,125,260,0.519,04/10/2016,2016.0
32,Rutgers (Big Ten),11,9-2,145,135,280,0.518,04/10/2016,2016.0
33,Canisius (MAAC),7,3-4,81,76,157,0.516,04/10/2016,2016.0
34,Notre Dame (ACC),9,8-1,95,91,186,0.511,04/10/2016,2016.0
35,Delaware (CAA),12,4-8,142,137,279,0.509,04/10/2016,2016.0
36,Yale (Ivy League),10,10-0,116,115,231,0.502,04/10/2016,2016.0
37,Quinnipiac (MAAC),9,6-3,100,100,200,0.500,04/10/2016,2016.0
38,Furman (SoCon),10,2-8,112,113,225,0.498,04/10/2016,2016.0
39,Mount St. Mary's (NEC),9,5-4,104,107,211,0.493,04/10/2016,2016.0
40,Stony Brook (America East),11,9-2,140,145,285,0.491,04/10/2016,2016.0
41,Massachusetts (CAA),10,4-6,109,113,222,0.491,04/10/2016,2016.0
42,Richmond (SoCon),11,8-3,99,103,202,0.490,04/10/2016,2016.0
43,Mercer (SoCon),10,3-7,115,124,239,0.481,04/10/2016,2016.0
44,Lafayette (Patriot),11,2-9,117,128,245,0.478,04/10/2016,2016.0
45,Princeton (Ivy League),9,2-7,113,129,242,0.467,04/10/2016,2016.0
46,UAlbany (America East),10,8-2,118,139,257,0.459,04/10/2016,2016.0
47,Penn St. (Big Ten),11,7-4,128,153,281,0.456,04/10/2016,2016.0
48,Providence (Big East),11,7-4,116,140,256,0.453,04/10/2016,2016.0
49,Wagner (NEC),12,5-7,121,148,269,0.450,04/10/2016,2016.0
50,Sacred Heart (NEC),11,2-9,125,153,278,0.450,04/10/2016,2016.0
51,St. John's (NY) (Big East),11,1-10,119,150,269,0.442,04/10/2016,2016.0
52,Siena (MAAC),9,2-7,89,116,205,0.434,04/10/2016,2016.0
53,Monmouth (MAAC),10,6-4,92,120,212,0.434,04/10/2016,2016.0
54,Penn (Ivy League),10,5-5,107,142,249,0.430,04/10/2016,2016.0
55,Robert Morris (NEC),11,4-7,122,164,286,0.427,04/10/2016,2016.0
56,Dartmouth (Ivy League),10,1-9,94,140,234,0.402,04/10/2016,2016.0
57,VMI (SoCon),13,2-11,120,179,299,0.401,04/10/2016,2016.0
58,Detroit Mercy (MAAC),9,1-8,68,102,170,0.400,04/10/2016,2016.0
59,Drexel (CAA),11,4-7,99,159,258,0.384,04/10/2016,2016.0
60,Colgate (Patriot),11,3-8,87,140,227,0.383,04/10/2016,2016.0
61,Lehigh (Patriot),11,6-5,101,165,266,0.380,04/10/2016,2016.0
62,Harvard (Ivy League),11,6-5,100,172,272,0.368,04/10/2016,2016.0
63,Holy Cross (Patriot),12,2-10,107,186,293,0.365,04/10/2016,2016.0
64,NJIT (Independent),12,1-11,102,179,281,0.363,04/10/2016,2016.0
65,Georgetown (Big East),11,2-9,89,157,246,0.362,04/10/2016,2016.0
66,UMBC (America East),9,2-7,71,141,212,0.335,04/10/2016,2016.0
67,Manhattan (MAAC),12,2-10,89,179,268,0.332,04/10/2016,2016.0
68,Marist (MAAC),10,5-5,62,148,210,0.295,04/10/2016,2016.0
-,UMass Lowell (America East),12,2-10,106,180,286,0.371,04/10/2016,2016.0
1,Hartford (America East),10,6-4,178,68,246,0.724,04/08/2016,2016.0
2,Marquette (Big East),8,7-1,103,51,154,0.669,04/08/2016,2016.0
3,Army West Point (Patriot),10,7-3,156,78,234,0.667,04/08/2016,2016.0
4,Brown (Ivy League),9,8-1,169,87,256,0.660,04/08/2016,2016.0
5,Boston U. (Patriot),11,8-3,157,83,240,0.654,04/08/2016,2016.0
6,Cornell (Ivy League),8,4-4,115,62,177,0.650,04/08/2016,2016.0
7,Denver (Big East),9,8-1,150,82,232,0.647,04/08/2016,2016.0
8,Saint Joseph's (NEC),9,7-2,135,82,217,0.622,04/08/2016,2016.0
9,Syracuse (ACC),9,6-3,142,88,230,0.617,04/08/2016,2016.0
10,Navy (Patriot),9,7-2,109,71,180,0.606,04/08/2016,2016.0
11,North Carolina (ACC),10,6-4,154,103,257,0.599,04/08/2016,2016.0
12,Virginia (ACC),11,6-5,151,102,253,0.597,04/08/2016,2016.0
13,Duke (ACC),12,7-5,198,137,335,0.591,04/08/2016,2016.0
14,Villanova (Big East),9,6-3,146,104,250,0.584,04/08/2016,2016.0
15,Ohio St. (Big Ten),11,5-6,135,97,232,0.582,04/08/2016,2016.0
16,Maryland (Big Ten),9,7-2,114,82,196,0.582,04/08/2016,2016.0
17,Bellarmine (SoCon),10,4-6,109,85,194,0.562,04/08/2016,2016.0
18,Hobart (NEC),10,5-5,126,99,225,0.560,04/08/2016,2016.0
19,Bucknell (Patriot),11,7-4,148,118,266,0.556,04/08/2016,2016.0
20,Johns Hopkins (Big Ten),9,5-4,131,105,236,0.555,04/08/2016,2016.0
21,Towson (CAA),10,9-1,117,95,212,0.552,04/08/2016,2016.0
22,Vermont (America East),11,5-6,153,130,283,0.541,04/08/2016,2016.0
23,Jacksonville (SoCon),9,2-7,115,98,213,0.540,04/08/2016,2016.0
24,Rutgers (Big Ten),10,8-2,138,119,257,0.537,04/08/2016,2016.0
25,High Point (SoCon),10,5-5,131,114,245,0.535,04/08/2016,2016.0
26,Fairfield (CAA),11,5-6,132,116,248,0.532,04/08/2016,2016.0
27,Hofstra (CAA),10,6-4,118,107,225,0.524,04/08/2016,2016.0
28,Michigan (Big Ten),9,3-6,120,109,229,0.524,04/08/2016,2016.0
29,Notre Dame (ACC),8,7-1,88,80,168,0.524,04/08/2016,2016.0
30,Binghamton (America East),8,2-6,101,92,193,0.523,04/08/2016,2016.0
31,Quinnipiac (MAAC),8,5-3,93,85,178,0.522,04/08/2016,2016.0
32,Delaware (CAA),11,4-7,132,123,255,0.518,04/08/2016,2016.0
33,Canisius (MAAC),6,2-4,67,63,130,0.515,04/08/2016,2016.0
34,Bryant (NEC),9,6-3,115,109,224,0.513,04/08/2016,2016.0
35,Loyola Maryland (Patriot),10,7-3,109,104,213,0.512,04/08/2016,2016.0
36,Stony Brook (America East),10,8-2,132,126,258,0.512,04/08/2016,2016.0
37,Air Force (SoCon),11,9-2,116,112,228,0.509,04/08/2016,2016.0
38,Furman (SoCon),9,2-7,103,105,208,0.495,04/08/2016,2016.0
39,Mount St. Mary's (NEC),9,5-4,104,107,211,0.493,04/08/2016,2016.0
40,Mercer (SoCon),9,3-6,102,105,207,0.493,04/08/2016,2016.0
41,Richmond (SoCon),10,7-3,91,94,185,0.492,04/08/2016,2016.0
42,Lafayette (Patriot),10,2-8,109,115,224,0.487,04/08/2016,2016.0
43,Yale (Ivy League),9,9-0,99,109,208,0.476,04/08/2016,2016.0
44,Massachusetts (CAA),9,4-5,93,106,199,0.467,04/08/2016,2016.0
45,Penn St. (Big Ten),10,7-3,118,138,256,0.461,04/08/2016,2016.0
46,Sacred Heart (NEC),10,2-8,116,137,253,0.458,04/08/2016,2016.0
47,Wagner (NEC),11,5-6,112,133,245,0.457,04/08/2016,2016.0
48,Providence (Big East),10,7-3,107,132,239,0.448,04/08/2016,2016.0
49,St. John's (NY) (Big East),10,1-9,111,137,248,0.448,04/08/2016,2016.0
50,UAlbany (America East),9,7-2,103,130,233,0.442,04/08/2016,2016.0
51,Princeton (Ivy League),8,2-6,94,121,215,0.437,04/08/2016,2016.0
52,Monmouth (MAAC),10,6-4,92,120,212,0.434,04/08/2016,2016.0
53,Robert Morris (NEC),10,4-6,110,147,257,0.428,04/08/2016,2016.0
54,Dartmouth (Ivy League),9,1-8,88,123,211,0.417,04/08/2016,2016.0
55,Siena (MAAC),8,2-6,76,108,184,0.413,04/08/2016,2016.0
56,VMI (SoCon),12,2-10,114,165,279,0.409,04/08/2016,2016.0
57,Penn (Ivy League),9,5-4,90,133,223,0.404,04/08/2016,2016.0
58,Colgate (Patriot),10,3-7,79,122,201,0.393,04/08/2016,2016.0
59,Harvard (Ivy League),10,5-5,96,152,248,0.387,04/08/2016,2016.0
60,Lehigh (Patriot),10,6-4,92,150,242,0.380,04/08/2016,2016.0
61,Drexel (CAA),10,4-6,88,152,240,0.367,04/08/2016,2016.0
62,NJIT (Independent),12,1-11,102,179,281,0.363,04/08/2016,2016.0
63,Detroit Mercy (MAAC),8,1-7,53,95,148,0.358,04/08/2016,2016.0
64,Georgetown (Big East),10,1-9,81,148,229,0.354,04/08/2016,2016.0
65,UMBC (America East),8,2-6,68,127,195,0.349,04/08/2016,2016.0
66,Holy Cross (Patriot),11,1-10,94,178,272,0.346,04/08/2016,2016.0
67,Manhattan (MAAC),11,2-9,76,165,241,0.315,04/08/2016,2016.0
68,Marist (MAAC),9,4-5,54,135,189,0.286,04/08/2016,2016.0
-,UMass Lowell (America East),11,2-9,97,164,261,0.372,04/08/2016,2016.0
1,Hartford (America East),10,6-4,178,68,246,0.724,04/06/2016,2016.0
2,Marquette (Big East),8,7-1,103,51,154,0.669,04/06/2016,2016.0
3,Army West Point (Patriot),10,7-3,156,78,234,0.667,04/06/2016,2016.0
4,Brown (Ivy League),9,8-1,169,87,256,0.660,04/06/2016,2016.0
5,Boston U. (Patriot),11,8-3,157,83,240,0.654,04/06/2016,2016.0
6,Cornell (Ivy League),8,4-4,115,62,177,0.650,04/06/2016,2016.0
7,Denver (Big East),9,8-1,150,82,232,0.647,04/06/2016,2016.0
8,Saint Joseph's (NEC),9,7-2,135,82,217,0.622,04/06/2016,2016.0
9,Syracuse (ACC),9,6-3,142,88,230,0.617,04/06/2016,2016.0
10,Navy (Patriot),9,7-2,109,71,180,0.606,04/06/2016,2016.0
11,North Carolina (ACC),10,6-4,154,103,257,0.599,04/06/2016,2016.0
12,Virginia (ACC),11,6-5,151,102,253,0.597,04/06/2016,2016.0
13,Duke (ACC),12,7-5,198,137,335,0.591,04/06/2016,2016.0
14,Villanova (Big East),9,6-3,146,104,250,0.584,04/06/2016,2016.0
15,Ohio St. (Big Ten),11,5-6,135,97,232,0.582,04/06/2016,2016.0
16,Maryland (Big Ten),9,7-2,114,82,196,0.582,04/06/2016,2016.0
17,Bellarmine (SoCon),10,4-6,109,85,194,0.562,04/06/2016,2016.0
18,Hobart (NEC),10,5-5,126,99,225,0.560,04/06/2016,2016.0
19,Johns Hopkins (Big Ten),9,5-4,131,105,236,0.555,04/06/2016,2016.0
20,Towson (CAA),10,9-1,117,95,212,0.552,04/06/2016,2016.0
21,Vermont (America East),11,5-6,153,130,283,0.541,04/06/2016,2016.0
22,Jacksonville (SoCon),9,2-7,115,98,213,0.540,04/06/2016,2016.0
23,Rutgers (Big Ten),10,8-2,138,119,257,0.537,04/06/2016,2016.0
24,High Point (SoCon),10,5-5,131,114,245,0.535,04/06/2016,2016.0
25,Bucknell (Patriot),10,6-4,127,111,238,0.534,04/06/2016,2016.0
26,Fairfield (CAA),11,5-6,132,116,248,0.532,04/06/2016,2016.0
27,Mount St. Mary's (NEC),8,5-3,97,86,183,0.530,04/06/2016,2016.0
28,Hofstra (CAA),10,6-4,118,107,225,0.524,04/06/2016,2016.0
29,Michigan (Big Ten),9,3-6,120,109,229,0.524,04/06/2016,2016.0
30,Notre Dame (ACC),8,7-1,88,80,168,0.524,04/06/2016,2016.0
31,Binghamton (America East),8,2-6,101,92,193,0.523,04/06/2016,2016.0
32,Quinnipiac (MAAC),8,5-3,93,85,178,0.522,04/06/2016,2016.0
33,Delaware (CAA),11,4-7,132,123,255,0.518,04/06/2016,2016.0
34,Canisius (MAAC),6,2-4,67,63,130,0.515,04/06/2016,2016.0
35,Bryant (NEC),9,6-3,115,109,224,0.513,04/06/2016,2016.0
36,Loyola Maryland (Patriot),10,7-3,109,104,213,0.512,04/06/2016,2016.0
37,Stony Brook (America East),10,8-2,132,126,258,0.512,04/06/2016,2016.0
38,Air Force (SoCon),11,9-2,116,112,228,0.509,04/06/2016,2016.0
39,Furman (SoCon),9,2-7,103,105,208,0.495,04/06/2016,2016.0
40,Mercer (SoCon),9,3-6,102,105,207,0.493,04/06/2016,2016.0
41,Richmond (SoCon),10,7-3,91,94,185,0.492,04/06/2016,2016.0
42,Lafayette (Patriot),10,2-8,109,115,224,0.487,04/06/2016,2016.0
43,Yale (Ivy League),9,9-0,99,109,208,0.476,04/06/2016,2016.0
44,Massachusetts (CAA),9,4-5,93,106,199,0.467,04/06/2016,2016.0
45,Penn St. (Big Ten),10,7-3,118,138,256,0.461,04/06/2016,2016.0
46,Sacred Heart (NEC),10,2-8,116,137,253,0.458,04/06/2016,2016.0
47,Wagner (NEC),11,5-6,112,133,245,0.457,04/06/2016,2016.0
48,Providence (Big East),10,7-3,107,132,239,0.448,04/06/2016,2016.0
49,St. John's (NY) (Big East),10,1-9,111,137,248,0.448,04/06/2016,2016.0
50,UAlbany (America East),9,7-2,103,130,233,0.442,04/06/2016,2016.0
51,Princeton (Ivy League),8,2-6,94,121,215,0.437,04/06/2016,2016.0
52,Monmouth (MAAC),10,6-4,92,120,212,0.434,04/06/2016,2016.0
53,Robert Morris (NEC),10,4-6,110,147,257,0.428,04/06/2016,2016.0
54,Dartmouth (Ivy League),9,1-8,88,123,211,0.417,04/06/2016,2016.0
55,Siena (MAAC),8,2-6,76,108,184,0.413,04/06/2016,2016.0
56,VMI (SoCon),12,2-10,114,165,279,0.409,04/06/2016,2016.0
57,Penn (Ivy League),9,5-4,90,133,223,0.404,04/06/2016,2016.0
58,Colgate (Patriot),10,3-7,79,122,201,0.393,04/06/2016,2016.0
59,Harvard (Ivy League),10,5-5,96,152,248,0.387,04/06/2016,2016.0
60,Lehigh (Patriot),10,6-4,92,150,242,0.380,04/06/2016,2016.0
61,Drexel (CAA),10,4-6,88,152,240,0.367,04/06/2016,2016.0
62,NJIT (Independent),12,1-11,102,179,281,0.363,04/06/2016,2016.0
63,Detroit Mercy (MAAC),8,1-7,53,95,148,0.358,04/06/2016,2016.0
64,Georgetown (Big East),10,1-9,81,148,229,0.354,04/06/2016,2016.0
65,UMBC (America East),8,2-6,68,127,195,0.349,04/06/2016,2016.0
66,Holy Cross (Patriot),11,1-10,94,178,272,0.346,04/06/2016,2016.0
67,Manhattan (MAAC),11,2-9,76,165,241,0.315,04/06/2016,2016.0
68,Marist (MAAC),9,4-5,54,135,189,0.286,04/06/2016,2016.0
-,UMass Lowell (America East),11,2-9,97,164,261,0.372,04/06/2016,2016.0
1,Hartford (America East),10,6-4,178,68,246,0.724,04/05/2016,2016.0
2,Marquette (Big East),8,7-1,103,51,154,0.669,04/05/2016,2016.0
3,Army West Point (Patriot),10,7-3,156,78,234,0.667,04/05/2016,2016.0
4,Brown (Ivy League),9,8-1,169,87,256,0.660,04/05/2016,2016.0
5,Boston U. (Patriot),11,8-3,157,83,240,0.654,04/05/2016,2016.0
6,Cornell (Ivy League),8,4-4,115,62,177,0.650,04/05/2016,2016.0
7,Denver (Big East),9,8-1,150,82,232,0.647,04/05/2016,2016.0
8,Saint Joseph's (NEC),9,7-2,135,82,217,0.622,04/05/2016,2016.0
9,Syracuse (ACC),8,5-3,129,80,209,0.617,04/05/2016,2016.0
10,Navy (Patriot),9,7-2,109,71,180,0.606,04/05/2016,2016.0
11,North Carolina (ACC),10,6-4,154,103,257,0.599,04/05/2016,2016.0
12,Virginia (ACC),11,6-5,151,102,253,0.597,04/05/2016,2016.0
13,Duke (ACC),12,7-5,198,137,335,0.591,04/05/2016,2016.0
14,Villanova (Big East),9,6-3,146,104,250,0.584,04/05/2016,2016.0
15,Ohio St. (Big Ten),11,5-6,135,97,232,0.582,04/05/2016,2016.0
16,Maryland (Big Ten),9,7-2,114,82,196,0.582,04/05/2016,2016.0
17,Hobart (NEC),9,5-4,118,86,204,0.578,04/05/2016,2016.0
18,Bellarmine (SoCon),10,4-6,109,85,194,0.562,04/05/2016,2016.0
19,Johns Hopkins (Big Ten),9,5-4,131,105,236,0.555,04/05/2016,2016.0
20,Towson (CAA),10,9-1,117,95,212,0.552,04/05/2016,2016.0
21,Vermont (America East),11,5-6,153,130,283,0.541,04/05/2016,2016.0
22,Jacksonville (SoCon),9,2-7,115,98,213,0.540,04/05/2016,2016.0
23,Rutgers (Big Ten),10,8-2,138,119,257,0.537,04/05/2016,2016.0
24,High Point (SoCon),10,5-5,131,114,245,0.535,04/05/2016,2016.0
25,Bucknell (Patriot),10,6-4,127,111,238,0.534,04/05/2016,2016.0
26,Fairfield (CAA),11,5-6,132,116,248,0.532,04/05/2016,2016.0
27,Mount St. Mary's (NEC),8,5-3,97,86,183,0.530,04/05/2016,2016.0
28,Hofstra (CAA),10,6-4,118,107,225,0.524,04/05/2016,2016.0
29,Michigan (Big Ten),9,3-6,120,109,229,0.524,04/05/2016,2016.0
30,Notre Dame (ACC),8,7-1,88,80,168,0.524,04/05/2016,2016.0
31,Binghamton (America East),8,2-6,101,92,193,0.523,04/05/2016,2016.0
32,Quinnipiac (MAAC),8,5-3,93,85,178,0.522,04/05/2016,2016.0
33,Delaware (CAA),11,4-7,132,123,255,0.518,04/05/2016,2016.0
34,Canisius (MAAC),6,2-4,67,63,130,0.515,04/05/2016,2016.0
35,Bryant (NEC),9,6-3,115,109,224,0.513,04/05/2016,2016.0
36,Loyola Maryland (Patriot),10,7-3,109,104,213,0.512,04/05/2016,2016.0
37,Stony Brook (America East),10,8-2,132,126,258,0.512,04/05/2016,2016.0
38,Air Force (SoCon),11,9-2,116,112,228,0.509,04/05/2016,2016.0
39,Furman (SoCon),9,2-7,103,105,208,0.495,04/05/2016,2016.0
40,Mercer (SoCon),9,3-6,102,105,207,0.493,04/05/2016,2016.0
41,Richmond (SoCon),10,7-3,91,94,185,0.492,04/05/2016,2016.0
42,Lafayette (Patriot),10,2-8,109,115,224,0.487,04/05/2016,2016.0
43,Yale (Ivy League),9,9-0,99,109,208,0.476,04/05/2016,2016.0
44,Massachusetts (CAA),9,4-5,93,106,199,0.467,04/05/2016,2016.0
45,Penn St. (Big Ten),10,7-3,118,138,256,0.461,04/05/2016,2016.0
46,Sacred Heart (NEC),10,2-8,116,137,253,0.458,04/05/2016,2016.0
47,Wagner (NEC),11,5-6,112,133,245,0.457,04/05/2016,2016.0
48,Providence (Big East),10,7-3,107,132,239,0.448,04/05/2016,2016.0
49,St. John's (NY) (Big East),10,1-9,111,137,248,0.448,04/05/2016,2016.0
50,UAlbany (America East),9,7-2,103,130,233,0.442,04/05/2016,2016.0
51,Princeton (Ivy League),8,2-6,94,121,215,0.437,04/05/2016,2016.0
52,Monmouth (MAAC),10,6-4,92,120,212,0.434,04/05/2016,2016.0
53,Robert Morris (NEC),10,4-6,110,147,257,0.428,04/05/2016,2016.0
54,Dartmouth (Ivy League),9,1-8,88,123,211,0.417,04/05/2016,2016.0
55,Siena (MAAC),8,2-6,76,108,184,0.413,04/05/2016,2016.0
56,VMI (SoCon),12,2-10,114,165,279,0.409,04/05/2016,2016.0
57,Penn (Ivy League),9,5-4,90,133,223,0.404,04/05/2016,2016.0
58,Colgate (Patriot),10,3-7,79,122,201,0.393,04/05/2016,2016.0
59,Harvard (Ivy League),10,5-5,96,152,248,0.387,04/05/2016,2016.0
60,Lehigh (Patriot),10,6-4,92,150,242,0.380,04/05/2016,2016.0
61,Drexel (CAA),10,4-6,88,152,240,0.367,04/05/2016,2016.0
62,NJIT (Independent),12,1-11,102,179,281,0.363,04/05/2016,2016.0
63,Detroit Mercy (MAAC),8,1-7,53,95,148,0.358,04/05/2016,2016.0
64,Georgetown (Big East),10,1-9,81,148,229,0.354,04/05/2016,2016.0
65,UMBC (America East),8,2-6,68,127,195,0.349,04/05/2016,2016.0
66,Holy Cross (Patriot),11,1-10,94,178,272,0.346,04/05/2016,2016.0
67,Manhattan (MAAC),11,2-9,76,165,241,0.315,04/05/2016,2016.0
68,Marist (MAAC),9,4-5,54,135,189,0.286,04/05/2016,2016.0
-,UMass Lowell (America East),11,2-9,97,164,261,0.372,04/05/2016,2016.0
1,Hartford (America East),10,6-4,178,68,246,0.724,04/03/2016,2016.0
2,Brown (Ivy League),8,8-0,156,76,232,0.672,04/03/2016,2016.0
3,Marquette (Big East),8,7-1,103,51,154,0.669,04/03/2016,2016.0
4,Army West Point (Patriot),10,7-3,156,78,234,0.667,04/03/2016,2016.0
5,Boston U. (Patriot),11,8-3,157,83,240,0.654,04/03/2016,2016.0
6,Cornell (Ivy League),8,4-4,115,62,177,0.650,04/03/2016,2016.0
7,Denver (Big East),9,8-1,150,82,232,0.647,04/03/2016,2016.0
8,Saint Joseph's (NEC),9,7-2,135,82,217,0.622,04/03/2016,2016.0
9,Syracuse (ACC),8,5-3,129,80,209,0.617,04/03/2016,2016.0
10,Navy (Patriot),9,7-2,109,71,180,0.606,04/03/2016,2016.0
11,North Carolina (ACC),10,6-4,154,103,257,0.599,04/03/2016,2016.0
12,Virginia (ACC),11,6-5,151,102,253,0.597,04/03/2016,2016.0
13,Duke (ACC),12,7-5,198,137,335,0.591,04/03/2016,2016.0
14,Villanova (Big East),9,6-3,146,104,250,0.584,04/03/2016,2016.0
15,Ohio St. (Big Ten),11,5-6,135,97,232,0.582,04/03/2016,2016.0
16,Maryland (Big Ten),9,7-2,114,82,196,0.582,04/03/2016,2016.0
17,Hobart (NEC),9,5-4,118,86,204,0.578,04/03/2016,2016.0
18,Bellarmine (SoCon),10,4-6,109,85,194,0.562,04/03/2016,2016.0
19,Johns Hopkins (Big Ten),9,5-4,131,105,236,0.555,04/03/2016,2016.0
20,Towson (CAA),10,9-1,117,95,212,0.552,04/03/2016,2016.0
21,Vermont (America East),11,5-6,153,130,283,0.541,04/03/2016,2016.0
22,Jacksonville (SoCon),9,2-7,115,98,213,0.540,04/03/2016,2016.0
23,High Point (SoCon),10,5-5,132,113,245,0.539,04/03/2016,2016.0
24,Rutgers (Big Ten),10,8-2,138,119,257,0.537,04/03/2016,2016.0
25,Bucknell (Patriot),10,6-4,127,111,238,0.534,04/03/2016,2016.0
26,Fairfield (CAA),11,5-6,132,116,248,0.532,04/03/2016,2016.0
27,Mount St. Mary's (NEC),8,5-3,97,86,183,0.530,04/03/2016,2016.0
28,Hofstra (CAA),10,6-4,118,107,225,0.524,04/03/2016,2016.0
29,Michigan (Big Ten),9,3-6,120,109,229,0.524,04/03/2016,2016.0
30,Notre Dame (ACC),8,7-1,88,80,168,0.524,04/03/2016,2016.0
31,Binghamton (America East),8,2-6,101,92,193,0.523,04/03/2016,2016.0
32,Quinnipiac (MAAC),8,5-3,93,85,178,0.522,04/03/2016,2016.0
33,Bryant (NEC),8,5-3,104,96,200,0.520,04/03/2016,2016.0
34,Delaware (CAA),11,4-7,132,123,255,0.518,04/03/2016,2016.0
35,Canisius (MAAC),6,2-4,67,63,130,0.515,04/03/2016,2016.0
36,Loyola Maryland (Patriot),10,7-3,109,104,213,0.512,04/03/2016,2016.0
37,Stony Brook (America East),10,8-2,132,126,258,0.512,04/03/2016,2016.0
38,Air Force (SoCon),11,9-2,116,112,228,0.509,04/03/2016,2016.0
39,Furman (SoCon),9,2-7,103,105,208,0.495,04/03/2016,2016.0
40,Richmond (SoCon),10,7-3,91,94,185,0.492,04/03/2016,2016.0
41,Mercer (SoCon),9,3-6,101,106,207,0.488,04/03/2016,2016.0
42,Massachusetts (CAA),9,4-5,93,106,199,0.467,04/03/2016,2016.0
43,Sacred Heart (NEC),9,2-7,105,122,227,0.463,04/03/2016,2016.0
44,Yale (Ivy League),8,8-0,84,98,182,0.462,04/03/2016,2016.0
45,Penn St. (Big Ten),10,7-3,118,138,256,0.461,04/03/2016,2016.0
46,Lafayette (Patriot),9,1-8,91,108,199,0.457,04/03/2016,2016.0
47,Wagner (NEC),11,5-6,112,133,245,0.457,04/03/2016,2016.0
48,Monmouth (MAAC),9,6-3,85,102,187,0.455,04/03/2016,2016.0
49,Providence (Big East),10,7-3,107,132,239,0.448,04/03/2016,2016.0
50,St. John's (NY) (Big East),10,1-9,111,137,248,0.448,04/03/2016,2016.0
51,UAlbany (America East),9,7-2,103,130,233,0.442,04/03/2016,2016.0
52,Princeton (Ivy League),8,2-6,94,121,215,0.437,04/03/2016,2016.0
53,Robert Morris (NEC),10,4-6,110,147,257,0.428,04/03/2016,2016.0
54,Dartmouth (Ivy League),9,1-8,88,123,211,0.417,04/03/2016,2016.0
55,Siena (MAAC),8,2-6,76,108,184,0.413,04/03/2016,2016.0
56,VMI (SoCon),12,2-10,114,165,279,0.409,04/03/2016,2016.0
57,Penn (Ivy League),9,5-4,90,133,223,0.404,04/03/2016,2016.0
58,Colgate (Patriot),10,3-7,79,122,201,0.393,04/03/2016,2016.0
59,Harvard (Ivy League),10,5-5,96,152,248,0.387,04/03/2016,2016.0
60,Lehigh (Patriot),10,6-4,92,150,242,0.380,04/03/2016,2016.0
61,Drexel (CAA),10,4-6,88,152,240,0.367,04/03/2016,2016.0
62,NJIT (Independent),12,1-11,102,179,281,0.363,04/03/2016,2016.0
63,Detroit Mercy (MAAC),8,1-7,53,95,148,0.358,04/03/2016,2016.0
64,Georgetown (Big East),10,1-9,81,148,229,0.354,04/03/2016,2016.0
65,UMBC (America East),8,2-6,68,127,195,0.349,04/03/2016,2016.0
66,Holy Cross (Patriot),11,1-10,94,178,272,0.346,04/03/2016,2016.0
67,Manhattan (MAAC),11,2-9,76,165,241,0.315,04/03/2016,2016.0
68,Marist (MAAC),9,4-5,54,135,189,0.286,04/03/2016,2016.0
-,UMass Lowell (America East),11,2-9,97,164,261,0.372,04/03/2016,2016.0
1,Hartford (America East),10,6-4,178,68,246,0.724,04/02/2016,2016.0
2,Brown (Ivy League),8,8-0,156,76,232,0.672,04/02/2016,2016.0
3,Marquette (Big East),8,7-1,103,51,154,0.669,04/02/2016,2016.0
4,Army West Point (Patriot),10,7-3,156,78,234,0.667,04/02/2016,2016.0
5,Boston U. (Patriot),11,8-3,157,83,240,0.654,04/02/2016,2016.0
6,Cornell (Ivy League),8,4-4,115,62,177,0.650,04/02/2016,2016.0
7,Denver (Big East),9,8-1,150,82,232,0.647,04/02/2016,2016.0
8,Saint Joseph's (NEC),9,7-2,135,82,217,0.622,04/02/2016,2016.0
9,Syracuse (ACC),8,5-3,129,80,209,0.617,04/02/2016,2016.0
10,Navy (Patriot),9,7-2,109,71,180,0.606,04/02/2016,2016.0
11,North Carolina (ACC),10,6-4,154,103,257,0.599,04/02/2016,2016.0
12,Virginia (ACC),11,6-5,151,102,253,0.597,04/02/2016,2016.0
13,Duke (ACC),12,7-5,198,137,335,0.591,04/02/2016,2016.0
14,Villanova (Big East),9,6-3,146,104,250,0.584,04/02/2016,2016.0
15,Maryland (Big Ten),9,7-2,114,82,196,0.582,04/02/2016,2016.0
16,Ohio St. (Big Ten),10,5-5,126,91,217,0.581,04/02/2016,2016.0
17,Hobart (NEC),9,5-4,118,86,204,0.578,04/02/2016,2016.0
18,Bellarmine (SoCon),10,4-6,109,85,194,0.562,04/02/2016,2016.0
19,Johns Hopkins (Big Ten),9,5-4,131,105,236,0.555,04/02/2016,2016.0
20,Towson (CAA),10,9-1,117,95,212,0.552,04/02/2016,2016.0
21,High Point (SoCon),9,4-5,118,98,216,0.546,04/02/2016,2016.0
22,Vermont (America East),10,5-5,139,117,256,0.543,04/02/2016,2016.0
23,Jacksonville (SoCon),9,2-7,115,98,213,0.540,04/02/2016,2016.0
24,Rutgers (Big Ten),10,8-2,138,119,257,0.537,04/02/2016,2016.0
25,Bucknell (Patriot),10,6-4,127,111,238,0.534,04/02/2016,2016.0
26,Fairfield (CAA),11,5-6,132,116,248,0.532,04/02/2016,2016.0
27,Mount St. Mary's (NEC),8,5-3,97,86,183,0.530,04/02/2016,2016.0
28,Hofstra (CAA),10,6-4,118,107,225,0.524,04/02/2016,2016.0
29,Michigan (Big Ten),9,3-6,120,109,229,0.524,04/02/2016,2016.0
30,Notre Dame (ACC),8,7-1,88,80,168,0.524,04/02/2016,2016.0
31,Binghamton (America East),8,2-6,101,92,193,0.523,04/02/2016,2016.0
32,Quinnipiac (MAAC),8,5-3,93,85,178,0.522,04/02/2016,2016.0
33,Bryant (NEC),8,5-3,104,96,200,0.520,04/02/2016,2016.0
34,Delaware (CAA),11,4-7,132,123,255,0.518,04/02/2016,2016.0
35,Canisius (MAAC),6,2-4,67,63,130,0.515,04/02/2016,2016.0
36,Stony Brook (America East),9,7-2,119,112,231,0.515,04/02/2016,2016.0
37,Air Force (SoCon),11,9-2,116,112,228,0.509,04/02/2016,2016.0
38,Furman (SoCon),9,2-7,103,105,208,0.495,04/02/2016,2016.0
39,Richmond (SoCon),10,7-3,91,94,185,0.492,04/02/2016,2016.0
40,Loyola Maryland (Patriot),9,6-3,94,100,194,0.485,04/02/2016,2016.0
41,Mercer (SoCon),8,3-5,86,92,178,0.483,04/02/2016,2016.0
42,Massachusetts (CAA),9,4-5,93,106,199,0.467,04/02/2016,2016.0
43,Penn St. (Big Ten),9,6-3,112,129,241,0.465,04/02/2016,2016.0
44,Sacred Heart (NEC),9,2-7,105,122,227,0.463,04/02/2016,2016.0
45,Yale (Ivy League),8,8-0,84,98,182,0.462,04/02/2016,2016.0
46,Lafayette (Patriot),9,1-8,91,108,199,0.457,04/02/2016,2016.0
47,Wagner (NEC),11,5-6,112,133,245,0.457,04/02/2016,2016.0
48,Monmouth (MAAC),9,6-3,85,102,187,0.455,04/02/2016,2016.0
49,Providence (Big East),10,7-3,107,132,239,0.448,04/02/2016,2016.0
50,St. John's (NY) (Big East),10,1-9,111,137,248,0.448,04/02/2016,2016.0
51,UAlbany (America East),9,7-2,103,130,233,0.442,04/02/2016,2016.0
52,Princeton (Ivy League),8,2-6,94,121,215,0.437,04/02/2016,2016.0
53,Robert Morris (NEC),10,4-6,110,147,257,0.428,04/02/2016,2016.0
54,Dartmouth (Ivy League),9,1-8,88,123,211,0.417,04/02/2016,2016.0
55,Siena (MAAC),8,2-6,76,108,184,0.413,04/02/2016,2016.0
56,Colgate (Patriot),9,3-6,75,107,182,0.412,04/02/2016,2016.0
57,VMI (SoCon),12,2-10,114,165,279,0.409,04/02/2016,2016.0
58,Penn (Ivy League),9,5-4,90,133,223,0.404,04/02/2016,2016.0
59,Harvard (Ivy League),10,5-5,96,152,248,0.387,04/02/2016,2016.0
60,Lehigh (Patriot),10,6-4,92,150,242,0.380,04/02/2016,2016.0
61,Drexel (CAA),10,4-6,88,152,240,0.367,04/02/2016,2016.0
62,NJIT (Independent),12,1-11,102,179,281,0.363,04/02/2016,2016.0
63,Detroit Mercy (MAAC),8,1-7,53,95,148,0.358,04/02/2016,2016.0
64,Georgetown (Big East),10,1-9,81,148,229,0.354,04/02/2016,2016.0
65,UMBC (America East),8,2-6,68,127,195,0.349,04/02/2016,2016.0
66,Holy Cross (Patriot),11,1-10,94,178,272,0.346,04/02/2016,2016.0
67,Manhattan (MAAC),11,2-9,76,165,241,0.315,04/02/2016,2016.0
68,Marist (MAAC),9,4-5,54,135,189,0.286,04/02/2016,2016.0
-,UMass Lowell (America East),11,2-9,97,164,261,0.372,04/02/2016,2016.0
1,Hartford (America East),9,5-4,153,63,216,0.708,04/01/2016,2016.0
2,Army West Point (Patriot),9,7-2,149,66,215,0.693,04/01/2016,2016.0
3,Brown (Ivy League),7,7-0,136,67,203,0.670,04/01/2016,2016.0
4,Marquette (Big East),7,6-1,91,46,137,0.664,04/01/2016,2016.0
5,Denver (Big East),8,7-1,136,71,207,0.657,04/01/2016,2016.0
6,Boston U. (Patriot),10,8-2,143,78,221,0.647,04/01/2016,2016.0
7,Syracuse (ACC),7,5-2,117,65,182,0.643,04/01/2016,2016.0
8,Cornell (Ivy League),7,3-4,96,54,150,0.640,04/01/2016,2016.0
9,Villanova (Big East),8,6-2,141,92,233,0.605,04/01/2016,2016.0
10,Virginia (ACC),10,5-5,145,95,240,0.604,04/01/2016,2016.0
11,North Carolina (ACC),10,6-4,154,103,257,0.599,04/01/2016,2016.0
12,Saint Joseph's (NEC),8,6-2,114,78,192,0.594,04/01/2016,2016.0
13,Duke (ACC),12,7-5,198,137,335,0.591,04/01/2016,2016.0
14,Maryland (Big Ten),8,6-2,105,73,178,0.590,04/01/2016,2016.0
15,Binghamton (America East),7,2-5,96,67,163,0.589,04/01/2016,2016.0
16,Navy (Patriot),8,6-2,94,67,161,0.584,04/01/2016,2016.0
17,Ohio St. (Big Ten),10,5-5,126,91,217,0.581,04/01/2016,2016.0
18,Hobart (NEC),9,5-4,118,86,204,0.578,04/01/2016,2016.0
19,Bellarmine (SoCon),9,4-5,100,75,175,0.571,04/01/2016,2016.0
20,Rutgers (Big Ten),9,7-2,126,102,228,0.553,04/01/2016,2016.0
21,Johns Hopkins (Big Ten),8,5-3,114,93,207,0.551,04/01/2016,2016.0
22,High Point (SoCon),9,4-5,118,98,216,0.546,04/01/2016,2016.0
23,Jacksonville (SoCon),8,2-6,103,86,189,0.545,04/01/2016,2016.0
24,Vermont (America East),10,5-5,139,117,256,0.543,04/01/2016,2016.0
25,Fairfield (CAA),10,4-6,123,105,228,0.539,04/01/2016,2016.0
26,Towson (CAA),9,8-1,101,90,191,0.529,04/01/2016,2016.0
27,Bryant (NEC),7,4-3,90,81,171,0.526,04/01/2016,2016.0
28,Michigan (Big Ten),8,3-5,111,100,211,0.526,04/01/2016,2016.0
29,Bucknell (Patriot),9,5-4,115,104,219,0.525,04/01/2016,2016.0
30,Hofstra (CAA),9,6-3,107,98,205,0.522,04/01/2016,2016.0
31,Delaware (CAA),10,3-7,122,113,235,0.519,04/01/2016,2016.0
32,Notre Dame (ACC),7,6-1,73,68,141,0.518,04/01/2016,2016.0
33,Stony Brook (America East),9,7-2,119,112,231,0.515,04/01/2016,2016.0
34,Air Force (SoCon),10,8-2,106,103,209,0.507,04/01/2016,2016.0
35,Canisius (MAAC),5,2-3,55,54,109,0.505,04/01/2016,2016.0
36,Mount St. Mary's (NEC),7,4-3,73,73,146,0.500,04/01/2016,2016.0
37,Furman (SoCon),8,1-7,91,93,184,0.495,04/01/2016,2016.0
38,Wagner (NEC),10,5-5,108,112,220,0.491,04/01/2016,2016.0
39,Yale (Ivy League),7,7-0,77,80,157,0.490,04/01/2016,2016.0
40,Richmond (SoCon),9,7-2,84,88,172,0.488,04/01/2016,2016.0
41,Loyola Maryland (Patriot),9,6-3,94,100,194,0.485,04/01/2016,2016.0
42,Sacred Heart (NEC),8,2-6,92,98,190,0.484,04/01/2016,2016.0
43,Mercer (SoCon),8,3-5,86,92,178,0.483,04/01/2016,2016.0
44,Quinnipiac (MAAC),7,4-3,74,85,159,0.465,04/01/2016,2016.0
45,Penn St. (Big Ten),9,6-3,112,129,241,0.465,04/01/2016,2016.0
46,Massachusetts (CAA),8,4-4,83,96,179,0.464,04/01/2016,2016.0
47,Monmouth (MAAC),8,5-3,76,90,166,0.458,04/01/2016,2016.0
48,Princeton (Ivy League),7,2-5,85,101,186,0.457,04/01/2016,2016.0
49,St. John's (NY) (Big East),9,1-8,99,120,219,0.452,04/01/2016,2016.0
50,Dartmouth (Ivy League),8,1-7,80,104,184,0.435,04/01/2016,2016.0
51,Providence (Big East),9,6-3,90,120,210,0.429,04/01/2016,2016.0
52,Lafayette (Patriot),8,1-7,74,101,175,0.423,04/01/2016,2016.0
53,UAlbany (America East),8,6-2,86,120,206,0.417,04/01/2016,2016.0
54,Robert Morris (NEC),9,4-5,95,133,228,0.417,04/01/2016,2016.0
55,Colgate (Patriot),9,3-6,75,107,182,0.412,04/01/2016,2016.0
56,Siena (MAAC),7,1-6,68,100,168,0.405,04/01/2016,2016.0
57,Lehigh (Patriot),9,5-4,87,136,223,0.390,04/01/2016,2016.0
58,Harvard (Ivy League),10,5-5,96,152,248,0.387,04/01/2016,2016.0
59,VMI (SoCon),11,1-10,95,151,246,0.386,04/01/2016,2016.0
60,Drexel (CAA),9,4-5,83,136,219,0.379,04/01/2016,2016.0
61,Penn (Ivy League),8,5-3,72,126,198,0.364,04/01/2016,2016.0
62,UMBC (America East),7,1-6,61,110,171,0.357,04/01/2016,2016.0
63,Holy Cross (Patriot),10,1-9,90,163,253,0.356,04/01/2016,2016.0
64,NJIT (Independent),11,1-10,92,167,259,0.355,04/01/2016,2016.0
65,Georgetown (Big East),9,1-8,70,134,204,0.343,04/01/2016,2016.0
66,Detroit Mercy (MAAC),7,1-6,45,87,132,0.341,04/01/2016,2016.0
67,Marist (MAAC),8,4-4,54,116,170,0.318,04/01/2016,2016.0
68,Manhattan (MAAC),10,1-9,64,155,219,0.292,04/01/2016,2016.0
-,UMass Lowell (America East),10,2-8,87,147,234,0.372,04/01/2016,2016.0
1,Hartford (America East),9,5-4,153,63,216,0.708,03/30/2016,2016.0
2,Army West Point (Patriot),9,7-2,149,66,215,0.693,03/30/2016,2016.0
3,Brown (Ivy League),7,7-0,136,67,203,0.670,03/30/2016,2016.0
4,Marquette (Big East),7,6-1,91,46,137,0.664,03/30/2016,2016.0
5,Denver (Big East),8,7-1,136,71,207,0.657,03/30/2016,2016.0
6,Boston U. (Patriot),10,8-2,143,78,221,0.647,03/30/2016,2016.0
7,Syracuse (ACC),7,5-2,117,65,182,0.643,03/30/2016,2016.0
8,Cornell (Ivy League),7,3-4,96,54,150,0.640,03/30/2016,2016.0
9,Duke (ACC),11,7-4,183,117,300,0.610,03/30/2016,2016.0
10,Villanova (Big East),8,6-2,141,92,233,0.605,03/30/2016,2016.0
11,Virginia (ACC),10,5-5,145,95,240,0.604,03/30/2016,2016.0
12,North Carolina (ACC),9,5-4,134,88,222,0.604,03/30/2016,2016.0
13,Saint Joseph's (NEC),8,6-2,114,78,192,0.594,03/30/2016,2016.0
14,Maryland (Big Ten),8,6-2,105,73,178,0.590,03/30/2016,2016.0
15,Binghamton (America East),7,2-5,96,67,163,0.589,03/30/2016,2016.0
16,Navy (Patriot),8,6-2,94,67,161,0.584,03/30/2016,2016.0
17,Ohio St. (Big Ten),10,5-5,126,91,217,0.581,03/30/2016,2016.0
18,Hobart (NEC),9,5-4,118,86,204,0.578,03/30/2016,2016.0
19,Bellarmine (SoCon),9,4-5,100,75,175,0.571,03/30/2016,2016.0
20,Rutgers (Big Ten),9,7-2,126,102,228,0.553,03/30/2016,2016.0
21,Johns Hopkins (Big Ten),8,5-3,114,93,207,0.551,03/30/2016,2016.0
22,High Point (SoCon),9,4-5,118,98,216,0.546,03/30/2016,2016.0
23,Jacksonville (SoCon),8,2-6,103,86,189,0.545,03/30/2016,2016.0
24,Vermont (America East),10,5-5,139,117,256,0.543,03/30/2016,2016.0
25,Fairfield (CAA),10,4-6,123,105,228,0.539,03/30/2016,2016.0
26,Towson (CAA),9,8-1,101,90,191,0.529,03/30/2016,2016.0
27,Bryant (NEC),7,4-3,90,81,171,0.526,03/30/2016,2016.0
28,Michigan (Big Ten),8,3-5,111,100,211,0.526,03/30/2016,2016.0
29,Bucknell (Patriot),9,5-4,115,104,219,0.525,03/30/2016,2016.0
30,Hofstra (CAA),9,6-3,107,98,205,0.522,03/30/2016,2016.0
31,Delaware (CAA),10,3-7,122,113,235,0.519,03/30/2016,2016.0
32,Notre Dame (ACC),7,6-1,73,68,141,0.518,03/30/2016,2016.0
33,Stony Brook (America East),9,7-2,119,112,231,0.515,03/30/2016,2016.0
34,Air Force (SoCon),10,8-2,106,103,209,0.507,03/30/2016,2016.0
35,Canisius (MAAC),5,2-3,55,54,109,0.505,03/30/2016,2016.0
36,Mount St. Mary's (NEC),7,4-3,73,73,146,0.500,03/30/2016,2016.0
37,Furman (SoCon),8,1-7,91,93,184,0.495,03/30/2016,2016.0
38,Wagner (NEC),10,5-5,108,112,220,0.491,03/30/2016,2016.0
39,Yale (Ivy League),7,7-0,77,80,157,0.490,03/30/2016,2016.0
40,Richmond (SoCon),9,7-2,84,88,172,0.488,03/30/2016,2016.0
41,Loyola Maryland (Patriot),9,6-3,94,100,194,0.485,03/30/2016,2016.0
42,Sacred Heart (NEC),8,2-6,92,98,190,0.484,03/30/2016,2016.0
43,Mercer (SoCon),8,3-5,86,92,178,0.483,03/30/2016,2016.0
44,Quinnipiac (MAAC),7,4-3,74,85,159,0.465,03/30/2016,2016.0
45,Penn St. (Big Ten),9,6-3,112,129,241,0.465,03/30/2016,2016.0
46,Massachusetts (CAA),8,4-4,83,96,179,0.464,03/30/2016,2016.0
47,Monmouth (MAAC),8,5-3,76,90,166,0.458,03/30/2016,2016.0
48,Princeton (Ivy League),7,2-5,85,101,186,0.457,03/30/2016,2016.0
49,St. John's (NY) (Big East),9,1-8,99,120,219,0.452,03/30/2016,2016.0
50,Dartmouth (Ivy League),8,1-7,80,104,184,0.435,03/30/2016,2016.0
51,Providence (Big East),9,6-3,90,120,210,0.429,03/30/2016,2016.0
52,Lafayette (Patriot),8,1-7,74,101,175,0.423,03/30/2016,2016.0
53,UAlbany (America East),8,6-2,86,120,206,0.417,03/30/2016,2016.0
54,Robert Morris (NEC),9,4-5,95,133,228,0.417,03/30/2016,2016.0
55,Colgate (Patriot),9,3-6,75,107,182,0.412,03/30/2016,2016.0
56,Siena (MAAC),7,1-6,68,100,168,0.405,03/30/2016,2016.0
57,Lehigh (Patriot),9,5-4,87,136,223,0.390,03/30/2016,2016.0
58,Harvard (Ivy League),10,5-5,96,152,248,0.387,03/30/2016,2016.0
59,VMI (SoCon),11,1-10,95,151,246,0.386,03/30/2016,2016.0
60,Drexel (CAA),9,4-5,83,136,219,0.379,03/30/2016,2016.0
61,Penn (Ivy League),8,5-3,72,126,198,0.364,03/30/2016,2016.0
62,UMBC (America East),7,1-6,61,110,171,0.357,03/30/2016,2016.0
63,Holy Cross (Patriot),10,1-9,90,163,253,0.356,03/30/2016,2016.0
64,NJIT (Independent),11,1-10,92,167,259,0.355,03/30/2016,2016.0
65,Georgetown (Big East),9,1-8,70,134,204,0.343,03/30/2016,2016.0
66,Detroit Mercy (MAAC),7,1-6,45,87,132,0.341,03/30/2016,2016.0
67,Marist (MAAC),8,4-4,54,116,170,0.318,03/30/2016,2016.0
68,Manhattan (MAAC),10,1-9,64,155,219,0.292,03/30/2016,2016.0
-,UMass Lowell (America East),10,2-8,87,147,234,0.372,03/30/2016,2016.0
1,Hartford (America East),9,5-4,153,63,216,0.708,03/29/2016,2016.0
2,Army West Point (Patriot),9,7-2,149,66,215,0.693,03/29/2016,2016.0
3,Brown (Ivy League),7,7-0,136,67,203,0.670,03/29/2016,2016.0
4,Marquette (Big East),7,6-1,91,46,137,0.664,03/29/2016,2016.0
5,Denver (Big East),8,7-1,136,71,207,0.657,03/29/2016,2016.0
6,Boston U. (Patriot),10,8-2,143,78,221,0.647,03/29/2016,2016.0
7,Syracuse (ACC),7,5-2,117,65,182,0.643,03/29/2016,2016.0
8,Cornell (Ivy League),7,3-4,96,54,150,0.640,03/29/2016,2016.0
9,Duke (ACC),11,7-4,183,117,300,0.610,03/29/2016,2016.0
10,Villanova (Big East),8,6-2,141,92,233,0.605,03/29/2016,2016.0
11,Virginia (ACC),10,5-5,145,95,240,0.604,03/29/2016,2016.0
12,North Carolina (ACC),9,5-4,134,88,222,0.604,03/29/2016,2016.0
13,Saint Joseph's (NEC),8,6-2,114,78,192,0.594,03/29/2016,2016.0
14,Maryland (Big Ten),8,6-2,105,73,178,0.590,03/29/2016,2016.0
15,Binghamton (America East),7,2-5,96,67,163,0.589,03/29/2016,2016.0
16,Navy (Patriot),8,6-2,94,67,161,0.584,03/29/2016,2016.0
17,Ohio St. (Big Ten),10,5-5,126,91,217,0.581,03/29/2016,2016.0
18,Hobart (NEC),9,5-4,118,86,204,0.578,03/29/2016,2016.0
19,Bellarmine (SoCon),9,4-5,100,75,175,0.571,03/29/2016,2016.0
20,Rutgers (Big Ten),9,7-2,126,102,228,0.553,03/29/2016,2016.0
21,High Point (SoCon),9,4-5,118,98,216,0.546,03/29/2016,2016.0
22,Jacksonville (SoCon),8,2-6,103,86,189,0.545,03/29/2016,2016.0
23,Vermont (America East),10,5-5,139,117,256,0.543,03/29/2016,2016.0
24,Fairfield (CAA),10,4-6,123,105,228,0.539,03/29/2016,2016.0
25,Towson (CAA),9,8-1,101,90,191,0.529,03/29/2016,2016.0
26,Bryant (NEC),7,4-3,90,81,171,0.526,03/29/2016,2016.0
27,Michigan (Big Ten),8,3-5,111,100,211,0.526,03/29/2016,2016.0
28,Bucknell (Patriot),9,5-4,115,104,219,0.525,03/29/2016,2016.0
29,Johns Hopkins (Big Ten),7,4-3,93,85,178,0.522,03/29/2016,2016.0
30,Hofstra (CAA),9,6-3,107,98,205,0.522,03/29/2016,2016.0
31,Delaware (CAA),10,3-7,122,113,235,0.519,03/29/2016,2016.0
32,Notre Dame (ACC),7,6-1,73,68,141,0.518,03/29/2016,2016.0
33,Stony Brook (America East),9,7-2,119,112,231,0.515,03/29/2016,2016.0
34,Air Force (SoCon),10,8-2,106,103,209,0.507,03/29/2016,2016.0
35,Canisius (MAAC),5,2-3,55,54,109,0.505,03/29/2016,2016.0
36,Mount St. Mary's (NEC),7,4-3,73,73,146,0.500,03/29/2016,2016.0
37,Furman (SoCon),8,1-7,91,93,184,0.495,03/29/2016,2016.0
38,Wagner (NEC),10,5-5,108,112,220,0.491,03/29/2016,2016.0
39,Yale (Ivy League),7,7-0,77,80,157,0.490,03/29/2016,2016.0
40,Richmond (SoCon),9,7-2,84,88,172,0.488,03/29/2016,2016.0
41,Loyola Maryland (Patriot),9,6-3,94,100,194,0.485,03/29/2016,2016.0
42,Sacred Heart (NEC),8,2-6,92,98,190,0.484,03/29/2016,2016.0
43,Mercer (SoCon),8,3-5,86,92,178,0.483,03/29/2016,2016.0
44,Quinnipiac (MAAC),7,4-3,74,85,159,0.465,03/29/2016,2016.0
45,Penn St. (Big Ten),9,6-3,112,129,241,0.465,03/29/2016,2016.0
46,Massachusetts (CAA),8,4-4,83,96,179,0.464,03/29/2016,2016.0
47,Monmouth (MAAC),8,5-3,76,90,166,0.458,03/29/2016,2016.0
48,Princeton (Ivy League),7,2-5,85,101,186,0.457,03/29/2016,2016.0
49,St. John's (NY) (Big East),9,1-8,99,120,219,0.452,03/29/2016,2016.0
50,Dartmouth (Ivy League),8,1-7,80,104,184,0.435,03/29/2016,2016.0
51,Providence (Big East),9,6-3,90,120,210,0.429,03/29/2016,2016.0
52,Lafayette (Patriot),8,1-7,74,101,175,0.423,03/29/2016,2016.0
53,Robert Morris (NEC),9,4-5,95,133,228,0.417,03/29/2016,2016.0
54,Colgate (Patriot),9,3-6,75,107,182,0.412,03/29/2016,2016.0
55,Siena (MAAC),7,1-6,68,100,168,0.405,03/29/2016,2016.0
56,Harvard (Ivy League),9,5-4,90,137,227,0.396,03/29/2016,2016.0
57,Lehigh (Patriot),9,5-4,87,136,223,0.390,03/29/2016,2016.0
58,VMI (SoCon),11,1-10,95,151,246,0.386,03/29/2016,2016.0
59,UAlbany (America East),7,5-2,71,114,185,0.384,03/29/2016,2016.0
60,Drexel (CAA),9,4-5,83,136,219,0.379,03/29/2016,2016.0
61,UMBC (America East),6,1-5,53,89,142,0.373,03/29/2016,2016.0
62,Penn (Ivy League),8,5-3,72,126,198,0.364,03/29/2016,2016.0
63,Holy Cross (Patriot),10,1-9,90,163,253,0.356,03/29/2016,2016.0
64,NJIT (Independent),11,1-10,92,167,259,0.355,03/29/2016,2016.0
65,Georgetown (Big East),9,1-8,70,134,204,0.343,03/29/2016,2016.0
66,Detroit Mercy (MAAC),7,1-6,45,87,132,0.341,03/29/2016,2016.0
67,Marist (MAAC),8,4-4,54,116,170,0.318,03/29/2016,2016.0
68,Manhattan (MAAC),10,1-9,64,155,219,0.292,03/29/2016,2016.0
-,UMass Lowell (America East),10,2-8,87,147,234,0.372,03/29/2016,2016.0
1,Brown (Ivy League),6,6-0,121,52,173,0.699,03/27/2016,2016.0
2,Army West Point (Patriot),9,7-2,149,66,215,0.693,03/27/2016,2016.0
3,Hartford (America East),8,4-4,135,60,195,0.692,03/27/2016,2016.0
4,Marquette (Big East),7,6-1,91,46,137,0.664,03/27/2016,2016.0
5,Denver (Big East),8,7-1,136,71,207,0.657,03/27/2016,2016.0
6,Boston U. (Patriot),10,8-2,143,78,221,0.647,03/27/2016,2016.0
7,Syracuse (ACC),7,5-2,117,65,182,0.643,03/27/2016,2016.0
8,Cornell (Ivy League),7,3-4,96,54,150,0.640,03/27/2016,2016.0
9,Villanova (Big East),7,6-1,126,77,203,0.621,03/27/2016,2016.0
10,Duke (ACC),11,7-4,183,117,300,0.610,03/27/2016,2016.0
11,North Carolina (ACC),9,5-4,134,88,222,0.604,03/27/2016,2016.0
12,Saint Joseph's (NEC),8,6-2,114,78,192,0.594,03/27/2016,2016.0
13,Binghamton (America East),7,2-5,96,67,163,0.589,03/27/2016,2016.0
14,Virginia (ACC),9,4-5,126,88,214,0.589,03/27/2016,2016.0
15,Navy (Patriot),8,6-2,94,67,161,0.584,03/27/2016,2016.0
16,Ohio St. (Big Ten),10,5-5,126,91,217,0.581,03/27/2016,2016.0
17,Hobart (NEC),9,5-4,118,86,204,0.578,03/27/2016,2016.0
18,Bellarmine (SoCon),9,4-5,100,75,175,0.571,03/27/2016,2016.0
19,Maryland (Big Ten),7,5-2,87,66,153,0.569,03/27/2016,2016.0
20,Rutgers (Big Ten),9,7-2,126,102,228,0.553,03/27/2016,2016.0
21,High Point (SoCon),9,4-5,118,98,216,0.546,03/27/2016,2016.0
22,Jacksonville (SoCon),8,2-6,103,86,189,0.545,03/27/2016,2016.0
23,Fairfield (CAA),10,4-6,123,105,228,0.539,03/27/2016,2016.0
24,Vermont (America East),9,4-5,123,107,230,0.535,03/27/2016,2016.0
25,Towson (CAA),9,8-1,101,90,191,0.529,03/27/2016,2016.0
26,Bryant (NEC),7,4-3,90,81,171,0.526,03/27/2016,2016.0
27,Michigan (Big Ten),8,3-5,111,100,211,0.526,03/27/2016,2016.0
28,Bucknell (Patriot),9,5-4,115,104,219,0.525,03/27/2016,2016.0
29,Johns Hopkins (Big Ten),7,4-3,93,85,178,0.522,03/27/2016,2016.0
30,Hofstra (CAA),9,6-3,107,98,205,0.522,03/27/2016,2016.0
31,Delaware (CAA),10,3-7,122,113,235,0.519,03/27/2016,2016.0
32,Notre Dame (ACC),7,6-1,73,68,141,0.518,03/27/2016,2016.0
33,Air Force (SoCon),10,8-2,106,103,209,0.507,03/27/2016,2016.0
34,Canisius (MAAC),5,2-3,55,54,109,0.505,03/27/2016,2016.0
35,Mount St. Mary's (NEC),7,4-3,73,73,146,0.500,03/27/2016,2016.0
36,Stony Brook (America East),8,6-2,102,103,205,0.498,03/27/2016,2016.0
37,Furman (SoCon),8,1-7,91,93,184,0.495,03/27/2016,2016.0
38,Wagner (NEC),10,5-5,108,112,220,0.491,03/27/2016,2016.0
39,Yale (Ivy League),7,7-0,77,80,157,0.490,03/27/2016,2016.0
40,Richmond (SoCon),9,7-2,84,88,172,0.488,03/27/2016,2016.0
41,Loyola Maryland (Patriot),9,6-3,94,100,194,0.485,03/27/2016,2016.0
42,Sacred Heart (NEC),8,2-6,92,98,190,0.484,03/27/2016,2016.0
43,Mercer (SoCon),8,3-5,86,92,178,0.483,03/27/2016,2016.0
44,Quinnipiac (MAAC),7,4-3,74,85,159,0.465,03/27/2016,2016.0
45,Penn St. (Big Ten),9,6-3,112,129,241,0.465,03/27/2016,2016.0
46,Massachusetts (CAA),8,4-4,83,96,179,0.464,03/27/2016,2016.0
47,Monmouth (MAAC),8,5-3,76,90,166,0.458,03/27/2016,2016.0
48,Princeton (Ivy League),7,2-5,85,101,186,0.457,03/27/2016,2016.0
49,St. John's (NY) (Big East),9,1-8,99,120,219,0.452,03/27/2016,2016.0
50,Dartmouth (Ivy League),7,1-6,70,88,158,0.443,03/27/2016,2016.0
51,Providence (Big East),9,6-3,90,120,210,0.429,03/27/2016,2016.0
52,Lafayette (Patriot),8,1-7,74,101,175,0.423,03/27/2016,2016.0
53,Robert Morris (NEC),9,4-5,95,133,228,0.417,03/27/2016,2016.0
54,Colgate (Patriot),9,3-6,75,107,182,0.412,03/27/2016,2016.0
55,Siena (MAAC),7,1-6,68,100,168,0.405,03/27/2016,2016.0
56,VMI (SoCon),10,1-9,88,132,220,0.400,03/27/2016,2016.0
57,Harvard (Ivy League),9,5-4,90,137,227,0.396,03/27/2016,2016.0
58,Lehigh (Patriot),8,5-3,78,119,197,0.396,03/27/2016,2016.0
59,UAlbany (America East),7,5-2,71,114,185,0.384,03/27/2016,2016.0
60,Drexel (CAA),9,4-5,83,136,219,0.379,03/27/2016,2016.0
61,Penn (Ivy League),7,5-2,65,108,173,0.376,03/27/2016,2016.0
62,Holy Cross (Patriot),9,1-8,87,145,232,0.375,03/27/2016,2016.0
63,UMBC (America East),6,1-5,53,89,142,0.373,03/27/2016,2016.0
64,NJIT (Independent),11,1-10,92,167,259,0.355,03/27/2016,2016.0
65,Georgetown (Big East),9,1-8,70,134,204,0.343,03/27/2016,2016.0
66,Detroit Mercy (MAAC),7,1-6,45,87,132,0.341,03/27/2016,2016.0
67,Marist (MAAC),8,4-4,54,116,170,0.318,03/27/2016,2016.0
68,Manhattan (MAAC),10,1-9,64,155,219,0.292,03/27/2016,2016.0
-,UMass Lowell (America East),10,2-8,87,147,234,0.372,03/27/2016,2016.0
1,Army West Point (Patriot),8,6-2,137,57,194,0.706,03/23/2016,2016.0
2,Brown (Ivy League),6,6-0,121,52,173,0.699,03/23/2016,2016.0
3,Syracuse (ACC),6,5-1,102,46,148,0.689,03/23/2016,2016.0
4,Hartford (America East),7,4-3,116,55,171,0.678,03/23/2016,2016.0
5,Denver (Big East),7,7-0,121,58,179,0.676,03/23/2016,2016.0
6,Marquette (Big East),6,5-1,76,40,116,0.655,03/23/2016,2016.0
7,Villanova (Big East),6,5-1,112,64,176,0.636,03/23/2016,2016.0
7,Cornell (Ivy League),6,3-3,84,48,132,0.636,03/23/2016,2016.0
9,Boston U. (Patriot),9,7-2,122,73,195,0.626,03/23/2016,2016.0
10,Duke (ACC),10,6-4,164,102,266,0.617,03/23/2016,2016.0
11,Saint Joseph's (NEC),7,5-2,105,66,171,0.614,03/23/2016,2016.0
12,North Carolina (ACC),8,5-3,121,78,199,0.608,03/23/2016,2016.0
13,Binghamton (America East),6,2-4,83,55,138,0.601,03/23/2016,2016.0
14,Maryland (Big Ten),6,4-2,77,53,130,0.592,03/23/2016,2016.0
15,Virginia (ACC),8,3-5,108,78,186,0.581,03/23/2016,2016.0
16,Hobart (NEC),8,5-3,106,77,183,0.579,03/23/2016,2016.0
17,Ohio St. (Big Ten),9,5-4,113,83,196,0.577,03/23/2016,2016.0
18,Navy (Patriot),7,5-2,78,61,139,0.561,03/23/2016,2016.0
19,Bellarmine (SoCon),8,4-4,88,69,157,0.561,03/23/2016,2016.0
20,Johns Hopkins (Big Ten),6,4-2,83,67,150,0.553,03/23/2016,2016.0
21,Rutgers (Big Ten),8,6-2,109,89,198,0.551,03/23/2016,2016.0
22,Hofstra (CAA),8,5-3,98,81,179,0.547,03/23/2016,2016.0
23,Fairfield (CAA),9,4-5,110,91,201,0.547,03/23/2016,2016.0
24,High Point (SoCon),8,4-4,110,93,203,0.542,03/23/2016,2016.0
25,Notre Dame (ACC),6,5-1,65,55,120,0.542,03/23/2016,2016.0
26,Bucknell (Patriot),8,5-3,107,91,198,0.540,03/23/2016,2016.0
27,Vermont (America East),8,3-5,112,96,208,0.538,03/23/2016,2016.0
28,Towson (CAA),8,7-1,89,77,166,0.536,03/23/2016,2016.0
29,Jacksonville (SoCon),7,2-5,90,79,169,0.533,03/23/2016,2016.0
30,Delaware (CAA),9,3-6,109,96,205,0.532,03/23/2016,2016.0
31,Bryant (NEC),7,4-3,90,81,171,0.526,03/23/2016,2016.0
32,Michigan (Big Ten),8,3-5,111,100,211,0.526,03/23/2016,2016.0
33,Canisius (MAAC),4,2-2,42,40,82,0.512,03/23/2016,2016.0
34,Mount St. Mary's (NEC),6,4-2,61,61,122,0.500,03/23/2016,2016.0
35,Richmond (SoCon),8,6-2,79,80,159,0.497,03/23/2016,2016.0
36,Air Force (SoCon),9,7-2,95,99,194,0.490,03/23/2016,2016.0
37,Mercer (SoCon),7,3-4,77,81,158,0.487,03/23/2016,2016.0
38,Sacred Heart (NEC),8,2-6,92,98,190,0.484,03/23/2016,2016.0
39,Yale (Ivy League),6,6-0,64,69,133,0.481,03/23/2016,2016.0
40,Stony Brook (America East),7,5-2,83,93,176,0.472,03/23/2016,2016.0
41,Wagner (NEC),9,4-5,93,105,198,0.470,03/23/2016,2016.0
42,Loyola Maryland (Patriot),8,5-3,81,92,173,0.468,03/23/2016,2016.0
43,Furman (SoCon),7,0-7,73,84,157,0.465,03/23/2016,2016.0
44,Penn St. (Big Ten),8,5-3,99,114,213,0.465,03/23/2016,2016.0
45,Massachusetts (CAA),8,4-4,83,96,179,0.464,03/23/2016,2016.0
46,Lafayette (Patriot),7,1-6,69,80,149,0.463,03/23/2016,2016.0
47,Monmouth (MAAC),7,4-3,68,80,148,0.459,03/23/2016,2016.0
48,Princeton (Ivy League),6,2-4,74,88,162,0.457,03/23/2016,2016.0
49,Providence (Big East),8,5-3,84,108,192,0.438,03/23/2016,2016.0
50,Siena (MAAC),6,1-5,63,84,147,0.429,03/23/2016,2016.0
51,Dartmouth (Ivy League),6,1-5,55,74,129,0.426,03/23/2016,2016.0
52,St. John's (NY) (Big East),8,1-7,82,111,193,0.425,03/23/2016,2016.0
53,Quinnipiac (MAAC),6,3-3,58,80,138,0.420,03/23/2016,2016.0
54,Lehigh (Patriot),7,5-2,72,103,175,0.411,03/23/2016,2016.0
55,UAlbany (America East),6,4-2,66,95,161,0.410,03/23/2016,2016.0
55,Colgate (Patriot),8,3-5,66,95,161,0.410,03/23/2016,2016.0
57,VMI (SoCon),9,1-8,79,114,193,0.409,03/23/2016,2016.0
58,Robert Morris (NEC),8,3-5,83,121,204,0.407,03/23/2016,2016.0
59,Harvard (Ivy League),8,4-4,76,122,198,0.384,03/23/2016,2016.0
60,Penn (Ivy League),6,4-2,59,96,155,0.381,03/23/2016,2016.0
61,UMBC (America East),5,1-4,43,70,113,0.381,03/23/2016,2016.0
62,Holy Cross (Patriot),8,0-8,80,132,212,0.377,03/23/2016,2016.0
63,Drexel (CAA),8,3-5,72,127,199,0.362,03/23/2016,2016.0
64,NJIT (Independent),10,1-9,85,152,237,0.359,03/23/2016,2016.0
65,Detroit Mercy (MAAC),6,1-5,41,76,117,0.350,03/23/2016,2016.0
66,Georgetown (Big East),8,1-7,64,119,183,0.350,03/23/2016,2016.0
67,Marist (MAAC),7,3-4,40,103,143,0.280,03/23/2016,2016.0
68,Manhattan (MAAC),9,1-8,54,147,201,0.269,03/23/2016,2016.0
-,UMass Lowell (America East),9,2-7,76,136,212,0.358,03/23/2016,2016.0
1,Army West Point (Patriot),8,6-2,137,57,194,0.706,03/22/2016,2016.0
2,Brown (Ivy League),6,6-0,121,52,173,0.699,03/22/2016,2016.0
3,Syracuse (ACC),6,5-1,102,46,148,0.689,03/22/2016,2016.0
4,Hartford (America East),7,4-3,116,55,171,0.678,03/22/2016,2016.0
5,Denver (Big East),7,7-0,121,58,179,0.676,03/22/2016,2016.0
6,Marquette (Big East),6,5-1,76,40,116,0.655,03/22/2016,2016.0
7,Villanova (Big East),6,5-1,112,64,176,0.636,03/22/2016,2016.0
7,Cornell (Ivy League),6,3-3,84,48,132,0.636,03/22/2016,2016.0
9,Boston U. (Patriot),9,7-2,122,73,195,0.626,03/22/2016,2016.0
10,Duke (ACC),10,6-4,164,102,266,0.617,03/22/2016,2016.0
11,Saint Joseph's (NEC),7,5-2,105,66,171,0.614,03/22/2016,2016.0
12,North Carolina (ACC),8,5-3,121,78,199,0.608,03/22/2016,2016.0
13,Binghamton (America East),6,2-4,83,55,138,0.601,03/22/2016,2016.0
14,Maryland (Big Ten),6,4-2,77,53,130,0.592,03/22/2016,2016.0
15,Virginia (ACC),8,3-5,108,78,186,0.581,03/22/2016,2016.0
16,Hobart (NEC),8,5-3,106,77,183,0.579,03/22/2016,2016.0
17,Ohio St. (Big Ten),9,5-4,113,83,196,0.577,03/22/2016,2016.0
18,Navy (Patriot),7,5-2,78,61,139,0.561,03/22/2016,2016.0
19,Bellarmine (SoCon),8,4-4,88,69,157,0.561,03/22/2016,2016.0
20,Johns Hopkins (Big Ten),6,4-2,83,67,150,0.553,03/22/2016,2016.0
21,Rutgers (Big Ten),8,6-2,109,89,198,0.551,03/22/2016,2016.0
22,Hofstra (CAA),8,5-3,98,81,179,0.547,03/22/2016,2016.0
23,Fairfield (CAA),9,4-5,110,91,201,0.547,03/22/2016,2016.0
24,High Point (SoCon),8,4-4,110,93,203,0.542,03/22/2016,2016.0
25,Notre Dame (ACC),6,5-1,65,55,120,0.542,03/22/2016,2016.0
26,Bucknell (Patriot),8,5-3,107,91,198,0.540,03/22/2016,2016.0
27,Vermont (America East),8,3-5,112,96,208,0.538,03/22/2016,2016.0
28,Towson (CAA),8,7-1,89,77,166,0.536,03/22/2016,2016.0
29,Jacksonville (SoCon),7,2-5,90,79,169,0.533,03/22/2016,2016.0
30,Delaware (CAA),9,3-6,109,96,205,0.532,03/22/2016,2016.0
31,Bryant (NEC),7,4-3,90,81,171,0.526,03/22/2016,2016.0
32,Michigan (Big Ten),7,3-4,101,93,194,0.521,03/22/2016,2016.0
33,Canisius (MAAC),4,2-2,42,40,82,0.512,03/22/2016,2016.0
34,Mount St. Mary's (NEC),6,4-2,61,61,122,0.500,03/22/2016,2016.0
35,Richmond (SoCon),8,6-2,79,80,159,0.497,03/22/2016,2016.0
36,Air Force (SoCon),9,7-2,95,99,194,0.490,03/22/2016,2016.0
37,Mercer (SoCon),7,3-4,77,81,158,0.487,03/22/2016,2016.0
38,Sacred Heart (NEC),8,2-6,92,98,190,0.484,03/22/2016,2016.0
39,Yale (Ivy League),6,6-0,64,69,133,0.481,03/22/2016,2016.0
40,Stony Brook (America East),7,5-2,83,93,176,0.472,03/22/2016,2016.0
41,Wagner (NEC),9,4-5,93,105,198,0.470,03/22/2016,2016.0
42,Furman (SoCon),7,0-7,73,84,157,0.465,03/22/2016,2016.0
43,Penn St. (Big Ten),8,5-3,99,114,213,0.465,03/22/2016,2016.0
44,Massachusetts (CAA),8,4-4,83,96,179,0.464,03/22/2016,2016.0
45,Lafayette (Patriot),7,1-6,69,80,149,0.463,03/22/2016,2016.0
46,Monmouth (MAAC),7,4-3,68,80,148,0.459,03/22/2016,2016.0
47,Princeton (Ivy League),6,2-4,74,88,162,0.457,03/22/2016,2016.0
48,Loyola Maryland (Patriot),7,4-3,67,86,153,0.438,03/22/2016,2016.0
49,Providence (Big East),8,5-3,84,108,192,0.438,03/22/2016,2016.0
50,Siena (MAAC),6,1-5,63,84,147,0.429,03/22/2016,2016.0
51,Dartmouth (Ivy League),6,1-5,55,74,129,0.426,03/22/2016,2016.0
52,St. John's (NY) (Big East),8,1-7,82,111,193,0.425,03/22/2016,2016.0
53,Quinnipiac (MAAC),6,3-3,58,80,138,0.420,03/22/2016,2016.0
54,Lehigh (Patriot),7,5-2,72,103,175,0.411,03/22/2016,2016.0
55,UAlbany (America East),6,4-2,66,95,161,0.410,03/22/2016,2016.0
55,Colgate (Patriot),8,3-5,66,95,161,0.410,03/22/2016,2016.0
57,VMI (SoCon),9,1-8,79,114,193,0.409,03/22/2016,2016.0
58,Robert Morris (NEC),8,3-5,83,121,204,0.407,03/22/2016,2016.0
59,Harvard (Ivy League),8,4-4,76,122,198,0.384,03/22/2016,2016.0
60,Penn (Ivy League),6,4-2,59,96,155,0.381,03/22/2016,2016.0
61,UMBC (America East),5,1-4,43,70,113,0.381,03/22/2016,2016.0
62,Holy Cross (Patriot),8,0-8,80,132,212,0.377,03/22/2016,2016.0
63,Drexel (CAA),8,3-5,72,127,199,0.362,03/22/2016,2016.0
64,NJIT (Independent),10,1-9,85,152,237,0.359,03/22/2016,2016.0
65,Georgetown (Big East),7,1-6,58,105,163,0.356,03/22/2016,2016.0
66,Detroit Mercy (MAAC),6,1-5,41,76,117,0.350,03/22/2016,2016.0
67,Manhattan (MAAC),9,1-8,54,147,201,0.269,03/22/2016,2016.0
68,Marist (MAAC),6,2-4,33,93,126,0.262,03/22/2016,2016.0
-,UMass Lowell (America East),9,2-7,76,136,212,0.358,03/22/2016,2016.0
1,Army West Point (Patriot),8,6-2,137,57,194,0.706,03/20/2016,2016.0
2,Brown (Ivy League),6,6-0,121,52,173,0.699,03/20/2016,2016.0
3,Syracuse (ACC),6,5-1,102,46,148,0.689,03/20/2016,2016.0
4,Hartford (America East),7,4-3,116,55,171,0.678,03/20/2016,2016.0
5,Denver (Big East),7,7-0,121,58,179,0.676,03/20/2016,2016.0
6,Marquette (Big East),6,5-1,76,40,116,0.655,03/20/2016,2016.0
7,Villanova (Big East),6,5-1,112,64,176,0.636,03/20/2016,2016.0
7,Cornell (Ivy League),6,3-3,84,48,132,0.636,03/20/2016,2016.0
9,Boston U. (Patriot),8,6-2,111,65,176,0.631,03/20/2016,2016.0
10,Saint Joseph's (NEC),7,5-2,105,66,171,0.614,03/20/2016,2016.0
11,North Carolina (ACC),8,5-3,121,78,199,0.608,03/20/2016,2016.0
12,Duke (ACC),9,6-3,147,97,244,0.602,03/20/2016,2016.0
13,Maryland (Big Ten),6,4-2,77,53,130,0.592,03/20/2016,2016.0
14,Hofstra (CAA),7,4-3,88,61,149,0.591,03/20/2016,2016.0
15,Virginia (ACC),8,3-5,108,78,186,0.581,03/20/2016,2016.0
16,Ohio St. (Big Ten),9,5-4,113,83,196,0.577,03/20/2016,2016.0
17,Hobart (NEC),8,5-3,104,77,181,0.575,03/20/2016,2016.0
18,Binghamton (America East),5,1-4,66,51,117,0.564,03/20/2016,2016.0
19,Bellarmine (SoCon),8,4-4,88,69,157,0.561,03/20/2016,2016.0
20,Navy (Patriot),6,4-2,67,54,121,0.554,03/20/2016,2016.0
21,Johns Hopkins (Big Ten),6,4-2,83,67,150,0.553,03/20/2016,2016.0
22,Rutgers (Big Ten),8,6-2,109,89,198,0.551,03/20/2016,2016.0
23,High Point (SoCon),8,4-4,110,93,203,0.542,03/20/2016,2016.0
24,Notre Dame (ACC),6,5-1,65,55,120,0.542,03/20/2016,2016.0
25,Bucknell (Patriot),8,5-3,107,91,198,0.540,03/20/2016,2016.0
26,Towson (CAA),8,7-1,89,77,166,0.536,03/20/2016,2016.0
27,Jacksonville (SoCon),7,2-5,90,79,169,0.533,03/20/2016,2016.0
28,Delaware (CAA),9,3-6,109,96,205,0.532,03/20/2016,2016.0
29,Bryant (NEC),7,4-3,90,81,171,0.526,03/20/2016,2016.0
30,Fairfield (CAA),8,3-5,93,84,177,0.525,03/20/2016,2016.0
31,Air Force (SoCon),8,6-2,90,82,172,0.523,03/20/2016,2016.0
32,Michigan (Big Ten),7,3-4,101,93,194,0.521,03/20/2016,2016.0
33,Vermont (America East),7,3-4,92,86,178,0.517,03/20/2016,2016.0
34,Canisius (MAAC),4,2-2,42,40,82,0.512,03/20/2016,2016.0
35,Mount St. Mary's (NEC),6,4-2,61,61,122,0.500,03/20/2016,2016.0
36,Richmond (SoCon),8,6-2,79,80,159,0.497,03/20/2016,2016.0
37,Mercer (SoCon),7,3-4,77,81,158,0.487,03/20/2016,2016.0
38,Sacred Heart (NEC),8,2-6,92,98,190,0.484,03/20/2016,2016.0
39,Yale (Ivy League),6,6-0,64,69,133,0.481,03/20/2016,2016.0
40,Wagner (NEC),9,4-5,93,103,196,0.474,03/20/2016,2016.0
41,Lafayette (Patriot),6,1-5,62,69,131,0.473,03/20/2016,2016.0
42,Stony Brook (America East),7,5-2,83,93,176,0.472,03/20/2016,2016.0
43,Furman (SoCon),7,0-7,73,84,157,0.465,03/20/2016,2016.0
44,Penn St. (Big Ten),8,5-3,99,114,213,0.465,03/20/2016,2016.0
45,Massachusetts (CAA),8,4-4,83,96,179,0.464,03/20/2016,2016.0
46,Monmouth (MAAC),7,4-3,68,80,148,0.459,03/20/2016,2016.0
47,Princeton (Ivy League),6,2-4,74,88,162,0.457,03/20/2016,2016.0
48,Quinnipiac (MAAC),5,3-2,51,63,114,0.447,03/20/2016,2016.0
49,Loyola Maryland (Patriot),7,4-3,67,86,153,0.438,03/20/2016,2016.0
50,Siena (MAAC),6,1-5,63,84,147,0.429,03/20/2016,2016.0
51,St. John's (NY) (Big East),8,1-7,82,111,193,0.425,03/20/2016,2016.0
52,Providence (Big East),7,4-3,67,95,162,0.414,03/20/2016,2016.0
53,Lehigh (Patriot),7,5-2,72,103,175,0.411,03/20/2016,2016.0
54,UAlbany (America East),6,4-2,66,95,161,0.410,03/20/2016,2016.0
54,Colgate (Patriot),8,3-5,66,95,161,0.410,03/20/2016,2016.0
56,VMI (SoCon),9,1-8,79,114,193,0.409,03/20/2016,2016.0
57,Robert Morris (NEC),8,3-5,83,121,204,0.407,03/20/2016,2016.0
58,Drexel (CAA),7,3-4,68,110,178,0.382,03/20/2016,2016.0
59,Penn (Ivy League),6,4-2,59,96,155,0.381,03/20/2016,2016.0
60,UMBC (America East),5,1-4,43,70,113,0.381,03/20/2016,2016.0
61,Harvard (Ivy League),7,4-3,68,111,179,0.380,03/20/2016,2016.0
62,Holy Cross (Patriot),8,0-8,80,132,212,0.377,03/20/2016,2016.0
63,NJIT (Independent),9,0-9,80,137,217,0.369,03/20/2016,2016.0
64,Dartmouth (Ivy League),5,1-4,40,69,109,0.367,03/20/2016,2016.0
65,Georgetown (Big East),7,1-6,58,105,163,0.356,03/20/2016,2016.0
66,Detroit Mercy (MAAC),6,1-5,41,76,117,0.350,03/20/2016,2016.0
67,Manhattan (MAAC),9,1-8,54,147,201,0.269,03/20/2016,2016.0
68,Marist (MAAC),6,2-4,33,93,126,0.262,03/20/2016,2016.0
-,UMass Lowell (America East),8,2-6,63,119,182,0.346,03/20/2016,2016.0
1,Syracuse (ACC),5,5-0,89,35,124,0.718,03/18/2016,2016.0
2,Brown (Ivy League),5,5-0,106,45,151,0.702,03/18/2016,2016.0
3,Army West Point (Patriot),7,5-2,115,52,167,0.689,03/18/2016,2016.0
4,Denver (Big East),6,6-0,105,49,154,0.682,03/18/2016,2016.0
5,Hartford (America East),6,3-3,100,49,149,0.671,03/18/2016,2016.0
6,Cornell (Ivy League),5,3-2,69,36,105,0.657,03/18/2016,2016.0
7,Boston U. (Patriot),7,6-1,99,54,153,0.647,03/18/2016,2016.0
8,Marquette (Big East),5,4-1,62,35,97,0.639,03/18/2016,2016.0
9,Villanova (Big East),6,5-1,112,64,176,0.636,03/18/2016,2016.0
10,Saint Joseph's (NEC),6,4-2,94,55,149,0.631,03/18/2016,2016.0
11,Ohio St. (Big Ten),8,5-3,104,67,171,0.608,03/18/2016,2016.0
12,Hofstra (CAA),6,4-2,76,51,127,0.598,03/18/2016,2016.0
13,Notre Dame (ACC),5,4-1,61,41,102,0.598,03/18/2016,2016.0
14,Maryland (Big Ten),6,4-2,77,53,130,0.592,03/18/2016,2016.0
15,North Carolina (ACC),7,4-3,104,72,176,0.591,03/18/2016,2016.0
16,Hobart (NEC),7,4-3,93,65,158,0.589,03/18/2016,2016.0
17,Duke (ACC),8,5-3,126,90,216,0.583,03/18/2016,2016.0
18,Johns Hopkins (Big Ten),5,3-2,72,54,126,0.571,03/18/2016,2016.0
19,Jacksonville (SoCon),6,2-4,84,64,148,0.568,03/18/2016,2016.0
20,Virginia (ACC),7,3-4,94,74,168,0.560,03/18/2016,2016.0
21,Navy (Patriot),5,3-2,54,44,98,0.551,03/18/2016,2016.0
22,Rutgers (Big Ten),8,6-2,109,89,198,0.551,03/18/2016,2016.0
23,High Point (SoCon),7,4-3,100,82,182,0.549,03/18/2016,2016.0
24,Bucknell (Patriot),7,4-3,96,79,175,0.549,03/18/2016,2016.0
25,Richmond (SoCon),7,6-1,73,63,136,0.537,03/18/2016,2016.0
25,Bellarmine (SoCon),7,3-4,73,63,136,0.537,03/18/2016,2016.0
27,Delaware (CAA),8,3-5,98,85,183,0.536,03/18/2016,2016.0
28,Fairfield (CAA),7,2-5,83,73,156,0.532,03/18/2016,2016.0
29,Bryant (NEC),7,4-3,90,81,171,0.526,03/18/2016,2016.0
30,Air Force (SoCon),7,5-2,79,72,151,0.523,03/18/2016,2016.0
31,Binghamton (America East),4,0-4,45,42,87,0.517,03/18/2016,2016.0
32,Vermont (America East),7,3-4,92,86,178,0.517,03/18/2016,2016.0
33,Towson (CAA),7,6-1,73,69,142,0.514,03/18/2016,2016.0
34,Mount St. Mary's (NEC),6,4-2,61,61,122,0.500,03/18/2016,2016.0
35,Michigan (Big Ten),6,3-3,82,83,165,0.497,03/18/2016,2016.0
36,Yale (Ivy League),5,5-0,52,54,106,0.491,03/18/2016,2016.0
37,Furman (SoCon),6,0-6,65,68,133,0.489,03/18/2016,2016.0
38,Quinnipiac (MAAC),4,3-1,46,49,95,0.484,03/18/2016,2016.0
39,Penn St. (Big Ten),7,5-2,91,98,189,0.481,03/18/2016,2016.0
40,Sacred Heart (NEC),7,2-5,80,88,168,0.476,03/18/2016,2016.0
40,Stony Brook (America East),6,5-1,70,77,147,0.476,03/18/2016,2016.0
42,Wagner (NEC),8,4-4,81,92,173,0.468,03/18/2016,2016.0
43,Canisius (MAAC),3,1-2,27,31,58,0.466,03/18/2016,2016.0
44,Lafayette (Patriot),5,1-4,52,60,112,0.464,03/18/2016,2016.0
45,Mercer (SoCon),6,2-4,64,75,139,0.460,03/18/2016,2016.0
46,Siena (MAAC),5,1-4,54,69,123,0.439,03/18/2016,2016.0
47,Loyola Maryland (Patriot),6,4-2,57,73,130,0.438,03/18/2016,2016.0
48,Massachusetts (CAA),7,3-4,67,88,155,0.432,03/18/2016,2016.0
49,Princeton (Ivy League),5,2-3,55,74,129,0.426,03/18/2016,2016.0
50,St. John's (NY) (Big East),7,1-6,73,99,172,0.424,03/18/2016,2016.0
51,VMI (SoCon),8,1-7,73,101,174,0.420,03/18/2016,2016.0
52,UMBC (America East),4,1-3,34,49,83,0.410,03/18/2016,2016.0
53,Providence (Big East),6,3-3,57,83,140,0.407,03/18/2016,2016.0
54,Holy Cross (Patriot),7,0-7,75,110,185,0.405,03/18/2016,2016.0
55,Lehigh (Patriot),6,4-2,63,93,156,0.404,03/18/2016,2016.0
56,Monmouth (MAAC),6,4-2,52,77,129,0.403,03/18/2016,2016.0
57,Robert Morris (NEC),7,2-5,73,109,182,0.401,03/18/2016,2016.0
58,Colgate (Patriot),7,3-4,55,85,140,0.393,03/18/2016,2016.0
59,Harvard (Ivy League),6,4-2,61,96,157,0.389,03/18/2016,2016.0
60,UAlbany (America East),5,3-2,50,82,132,0.379,03/18/2016,2016.0
61,Georgetown (Big East),6,1-5,51,84,135,0.378,03/18/2016,2016.0
62,Dartmouth (Ivy League),4,0-4,30,50,80,0.375,03/18/2016,2016.0
63,Penn (Ivy League),5,3-2,45,77,122,0.369,03/18/2016,2016.0
64,NJIT (Independent),9,0-9,80,137,217,0.369,03/18/2016,2016.0
65,Drexel (CAA),6,2-4,56,101,157,0.357,03/18/2016,2016.0
66,Detroit Mercy (MAAC),5,0-5,29,72,101,0.287,03/18/2016,2016.0
67,Marist (MAAC),5,1-4,30,77,107,0.280,03/18/2016,2016.0
68,Manhattan (MAAC),8,1-7,50,135,185,0.270,03/18/2016,2016.0
-,UMass Lowell (America East),7,2-5,57,103,160,0.356,03/18/2016,2016.0
1,Syracuse (ACC),5,5-0,89,35,124,0.718,03/16/2016,2016.0
2,Brown (Ivy League),5,5-0,106,45,151,0.702,03/16/2016,2016.0
3,Army West Point (Patriot),7,5-2,115,52,167,0.689,03/16/2016,2016.0
4,Denver (Big East),6,6-0,105,49,154,0.682,03/16/2016,2016.0
5,Hartford (America East),6,3-3,100,49,149,0.671,03/16/2016,2016.0
6,Cornell (Ivy League),5,3-2,69,36,105,0.657,03/16/2016,2016.0
7,Boston U. (Patriot),7,6-1,99,54,153,0.647,03/16/2016,2016.0
8,Marquette (Big East),5,4-1,62,35,97,0.639,03/16/2016,2016.0
9,Villanova (Big East),6,5-1,112,64,176,0.636,03/16/2016,2016.0
10,Saint Joseph's (NEC),6,4-2,94,55,149,0.631,03/16/2016,2016.0
11,Ohio St. (Big Ten),8,5-3,104,67,171,0.608,03/16/2016,2016.0
12,Hofstra (CAA),6,4-2,76,51,127,0.598,03/16/2016,2016.0
13,Notre Dame (ACC),5,4-1,61,41,102,0.598,03/16/2016,2016.0
14,Maryland (Big Ten),6,4-2,77,53,130,0.592,03/16/2016,2016.0
15,North Carolina (ACC),7,4-3,104,72,176,0.591,03/16/2016,2016.0
16,Hobart (NEC),7,4-3,93,65,158,0.589,03/16/2016,2016.0
17,Duke (ACC),8,5-3,126,90,216,0.583,03/16/2016,2016.0
18,Johns Hopkins (Big Ten),5,3-2,72,54,126,0.571,03/16/2016,2016.0
19,Jacksonville (SoCon),6,2-4,84,64,148,0.568,03/16/2016,2016.0
20,Virginia (ACC),7,3-4,94,74,168,0.560,03/16/2016,2016.0
21,Navy (Patriot),5,3-2,54,44,98,0.551,03/16/2016,2016.0
22,High Point (SoCon),7,4-3,100,82,182,0.549,03/16/2016,2016.0
23,Bucknell (Patriot),7,4-3,96,79,175,0.549,03/16/2016,2016.0
24,Rutgers (Big Ten),7,5-2,95,81,176,0.540,03/16/2016,2016.0
25,Bellarmine (SoCon),7,3-4,73,63,136,0.537,03/16/2016,2016.0
25,Richmond (SoCon),7,6-1,73,63,136,0.537,03/16/2016,2016.0
27,Delaware (CAA),8,3-5,98,85,183,0.536,03/16/2016,2016.0
28,Fairfield (CAA),7,2-5,83,73,156,0.532,03/16/2016,2016.0
29,Bryant (NEC),7,4-3,90,81,171,0.526,03/16/2016,2016.0
30,Air Force (SoCon),7,5-2,79,72,151,0.523,03/16/2016,2016.0
31,Binghamton (America East),4,0-4,45,42,87,0.517,03/16/2016,2016.0
32,Vermont (America East),7,3-4,92,86,178,0.517,03/16/2016,2016.0
33,Towson (CAA),7,6-1,73,69,142,0.514,03/16/2016,2016.0
34,Mount St. Mary's (NEC),6,4-2,61,61,122,0.500,03/16/2016,2016.0
35,Michigan (Big Ten),6,3-3,82,83,165,0.497,03/16/2016,2016.0
36,Yale (Ivy League),5,5-0,52,54,106,0.491,03/16/2016,2016.0
37,Furman (SoCon),6,0-6,65,68,133,0.489,03/16/2016,2016.0
38,Quinnipiac (MAAC),4,3-1,46,49,95,0.484,03/16/2016,2016.0
39,Penn St. (Big Ten),7,5-2,91,98,189,0.481,03/16/2016,2016.0
40,Sacred Heart (NEC),7,2-5,80,88,168,0.476,03/16/2016,2016.0
40,Stony Brook (America East),6,5-1,70,77,147,0.476,03/16/2016,2016.0
42,Wagner (NEC),8,4-4,81,92,173,0.468,03/16/2016,2016.0
43,Canisius (MAAC),3,1-2,27,31,58,0.466,03/16/2016,2016.0
44,Lafayette (Patriot),5,1-4,52,60,112,0.464,03/16/2016,2016.0
45,Mercer (SoCon),6,2-4,64,75,139,0.460,03/16/2016,2016.0
46,Siena (MAAC),5,1-4,54,69,123,0.439,03/16/2016,2016.0
47,Loyola Maryland (Patriot),6,4-2,57,73,130,0.438,03/16/2016,2016.0
48,Massachusetts (CAA),7,3-4,67,88,155,0.432,03/16/2016,2016.0
49,Princeton (Ivy League),5,2-3,55,74,129,0.426,03/16/2016,2016.0
50,St. John's (NY) (Big East),7,1-6,73,99,172,0.424,03/16/2016,2016.0
51,VMI (SoCon),8,1-7,73,101,174,0.420,03/16/2016,2016.0
52,UMBC (America East),4,1-3,34,49,83,0.410,03/16/2016,2016.0
53,Providence (Big East),6,3-3,57,83,140,0.407,03/16/2016,2016.0
54,Holy Cross (Patriot),7,0-7,75,110,185,0.405,03/16/2016,2016.0
55,Lehigh (Patriot),6,4-2,63,93,156,0.404,03/16/2016,2016.0
56,Monmouth (MAAC),6,4-2,52,77,129,0.403,03/16/2016,2016.0
57,Robert Morris (NEC),7,2-5,73,109,182,0.401,03/16/2016,2016.0
58,Colgate (Patriot),7,3-4,55,85,140,0.393,03/16/2016,2016.0
59,Harvard (Ivy League),6,4-2,61,96,157,0.389,03/16/2016,2016.0
60,UAlbany (America East),5,3-2,50,82,132,0.379,03/16/2016,2016.0
61,Georgetown (Big East),6,1-5,51,84,135,0.378,03/16/2016,2016.0
62,Dartmouth (Ivy League),4,0-4,30,50,80,0.375,03/16/2016,2016.0
63,NJIT (Independent),8,0-8,72,123,195,0.369,03/16/2016,2016.0
64,Penn (Ivy League),5,3-2,45,77,122,0.369,03/16/2016,2016.0
65,Drexel (CAA),6,2-4,56,101,157,0.357,03/16/2016,2016.0
66,Detroit Mercy (MAAC),5,0-5,29,72,101,0.287,03/16/2016,2016.0
67,Marist (MAAC),5,1-4,30,77,107,0.280,03/16/2016,2016.0
68,Manhattan (MAAC),8,1-7,50,135,185,0.270,03/16/2016,2016.0
-,UMass Lowell (America East),7,2-5,57,103,160,0.356,03/16/2016,2016.0
1,Syracuse (ACC),5,5-0,89,35,124,0.718,03/15/2016,2016.0
2,Brown (Ivy League),5,5-0,106,45,151,0.702,03/15/2016,2016.0
3,Army West Point (Patriot),7,5-2,115,52,167,0.689,03/15/2016,2016.0
4,Denver (Big East),6,6-0,105,49,154,0.682,03/15/2016,2016.0
5,Hartford (America East),6,3-3,100,49,149,0.671,03/15/2016,2016.0
6,Cornell (Ivy League),5,3-2,69,36,105,0.657,03/15/2016,2016.0
7,Boston U. (Patriot),7,6-1,99,54,153,0.647,03/15/2016,2016.0
8,Marquette (Big East),5,4-1,62,35,97,0.639,03/15/2016,2016.0
9,Villanova (Big East),6,5-1,112,64,176,0.636,03/15/2016,2016.0
10,Saint Joseph's (NEC),6,4-2,94,55,149,0.631,03/15/2016,2016.0
11,Ohio St. (Big Ten),8,5-3,104,67,171,0.608,03/15/2016,2016.0
12,Hofstra (CAA),6,4-2,76,51,127,0.598,03/15/2016,2016.0
13,Notre Dame (ACC),5,4-1,61,41,102,0.598,03/15/2016,2016.0
14,North Carolina (ACC),7,4-3,104,72,176,0.591,03/15/2016,2016.0
15,Hobart (NEC),7,4-3,93,65,158,0.589,03/15/2016,2016.0
16,Duke (ACC),8,5-3,126,90,216,0.583,03/15/2016,2016.0
17,Johns Hopkins (Big Ten),5,3-2,72,54,126,0.571,03/15/2016,2016.0
18,Jacksonville (SoCon),6,2-4,84,64,148,0.568,03/15/2016,2016.0
19,Virginia (ACC),7,3-4,94,74,168,0.560,03/15/2016,2016.0
20,Maryland (Big Ten),5,3-2,61,49,110,0.555,03/15/2016,2016.0
21,Navy (Patriot),5,3-2,54,44,98,0.551,03/15/2016,2016.0
22,High Point (SoCon),7,4-3,100,82,182,0.549,03/15/2016,2016.0
23,Bucknell (Patriot),7,4-3,96,79,175,0.549,03/15/2016,2016.0
24,Rutgers (Big Ten),7,5-2,95,81,176,0.540,03/15/2016,2016.0
25,Bellarmine (SoCon),7,3-4,73,63,136,0.537,03/15/2016,2016.0
25,Richmond (SoCon),7,6-1,73,63,136,0.537,03/15/2016,2016.0
27,Delaware (CAA),8,3-5,98,85,183,0.536,03/15/2016,2016.0
28,Fairfield (CAA),7,2-5,83,73,156,0.532,03/15/2016,2016.0
29,Bryant (NEC),7,4-3,90,81,171,0.526,03/15/2016,2016.0
30,Air Force (SoCon),7,5-2,79,72,151,0.523,03/15/2016,2016.0
31,Binghamton (America East),4,0-4,45,42,87,0.517,03/15/2016,2016.0
32,Vermont (America East),7,3-4,92,86,178,0.517,03/15/2016,2016.0
33,Towson (CAA),7,6-1,73,69,142,0.514,03/15/2016,2016.0
34,Mount St. Mary's (NEC),6,4-2,61,61,122,0.500,03/15/2016,2016.0
35,Michigan (Big Ten),6,3-3,82,83,165,0.497,03/15/2016,2016.0
36,Yale (Ivy League),5,5-0,52,54,106,0.491,03/15/2016,2016.0
37,Furman (SoCon),6,0-6,65,68,133,0.489,03/15/2016,2016.0
38,Quinnipiac (MAAC),4,3-1,46,49,95,0.484,03/15/2016,2016.0
39,Penn St. (Big Ten),7,5-2,91,98,189,0.481,03/15/2016,2016.0
40,Sacred Heart (NEC),7,2-5,80,88,168,0.476,03/15/2016,2016.0
40,Stony Brook (America East),6,5-1,70,77,147,0.476,03/15/2016,2016.0
42,Wagner (NEC),8,4-4,81,92,173,0.468,03/15/2016,2016.0
43,Canisius (MAAC),3,1-2,27,31,58,0.466,03/15/2016,2016.0
44,Lafayette (Patriot),5,1-4,52,60,112,0.464,03/15/2016,2016.0
45,Mercer (SoCon),6,2-4,64,75,139,0.460,03/15/2016,2016.0
46,Siena (MAAC),5,1-4,54,69,123,0.439,03/15/2016,2016.0
47,Loyola Maryland (Patriot),6,4-2,57,73,130,0.438,03/15/2016,2016.0
48,Massachusetts (CAA),7,3-4,67,88,155,0.432,03/15/2016,2016.0
49,Princeton (Ivy League),5,2-3,55,74,129,0.426,03/15/2016,2016.0
50,St. John's (NY) (Big East),7,1-6,73,99,172,0.424,03/15/2016,2016.0
51,VMI (SoCon),8,1-7,73,101,174,0.420,03/15/2016,2016.0
52,UAlbany (America East),4,3-1,46,66,112,0.411,03/15/2016,2016.0
53,UMBC (America East),4,1-3,34,49,83,0.410,03/15/2016,2016.0
54,Providence (Big East),6,3-3,57,83,140,0.407,03/15/2016,2016.0
55,Holy Cross (Patriot),7,0-7,75,110,185,0.405,03/15/2016,2016.0
56,Lehigh (Patriot),6,4-2,63,93,156,0.404,03/15/2016,2016.0
57,Monmouth (MAAC),6,4-2,52,77,129,0.403,03/15/2016,2016.0
58,Robert Morris (NEC),7,2-5,73,109,182,0.401,03/15/2016,2016.0
59,Colgate (Patriot),7,3-4,55,85,140,0.393,03/15/2016,2016.0
60,Harvard (Ivy League),6,4-2,61,96,157,0.389,03/15/2016,2016.0
61,Georgetown (Big East),6,1-5,51,84,135,0.378,03/15/2016,2016.0
62,Dartmouth (Ivy League),4,0-4,30,50,80,0.375,03/15/2016,2016.0
63,NJIT (Independent),8,0-8,72,123,195,0.369,03/15/2016,2016.0
64,Penn (Ivy League),5,3-2,45,77,122,0.369,03/15/2016,2016.0
65,Drexel (CAA),6,2-4,56,101,157,0.357,03/15/2016,2016.0
66,Detroit Mercy (MAAC),5,0-5,29,72,101,0.287,03/15/2016,2016.0
67,Marist (MAAC),5,1-4,30,77,107,0.280,03/15/2016,2016.0
68,Manhattan (MAAC),8,1-7,50,135,185,0.270,03/15/2016,2016.0
-,UMass Lowell (America East),7,2-5,57,103,160,0.356,03/15/2016,2016.0
1,Syracuse (ACC),5,5-0,89,35,124,0.718,03/14/2016,2016.0
2,Brown (Ivy League),5,5-0,106,45,151,0.702,03/14/2016,2016.0
3,Army West Point (Patriot),7,5-2,115,52,167,0.689,03/14/2016,2016.0
4,Denver (Big East),6,6-0,105,49,154,0.682,03/14/2016,2016.0
5,Hartford (America East),5,2-3,83,44,127,0.654,03/14/2016,2016.0
6,Villanova (Big East),5,4-1,99,53,152,0.651,03/14/2016,2016.0
7,Cornell (Ivy League),4,2-2,59,32,91,0.648,03/14/2016,2016.0
8,Boston U. (Patriot),7,6-1,99,54,153,0.647,03/14/2016,2016.0
9,Marquette (Big East),5,4-1,62,35,97,0.639,03/14/2016,2016.0
10,Saint Joseph's (NEC),6,4-2,94,55,149,0.631,03/14/2016,2016.0
11,Hofstra (CAA),5,4-1,65,41,106,0.613,03/14/2016,2016.0
12,Notre Dame (ACC),5,4-1,61,41,102,0.598,03/14/2016,2016.0
13,Hobart (NEC),6,3-3,83,56,139,0.597,03/14/2016,2016.0
14,North Carolina (ACC),7,4-3,104,72,176,0.591,03/14/2016,2016.0
15,Ohio St. (Big Ten),7,5-2,88,61,149,0.591,03/14/2016,2016.0
16,Duke (ACC),8,5-3,126,90,216,0.583,03/14/2016,2016.0
17,Johns Hopkins (Big Ten),5,3-2,72,54,126,0.571,03/14/2016,2016.0
18,Jacksonville (SoCon),6,2-4,84,64,148,0.568,03/14/2016,2016.0
19,Bucknell (Patriot),6,4-2,85,66,151,0.563,03/14/2016,2016.0
20,Virginia (ACC),7,3-4,94,74,168,0.560,03/14/2016,2016.0
21,Towson (CAA),6,5-1,67,53,120,0.558,03/14/2016,2016.0
22,Maryland (Big Ten),5,3-2,61,49,110,0.555,03/14/2016,2016.0
23,Navy (Patriot),5,3-2,54,44,98,0.551,03/14/2016,2016.0
24,High Point (SoCon),7,4-3,100,82,182,0.549,03/14/2016,2016.0
25,Rutgers (Big Ten),7,5-2,95,81,176,0.540,03/14/2016,2016.0
26,Richmond (SoCon),7,6-1,73,63,136,0.537,03/14/2016,2016.0
26,Bellarmine (SoCon),7,3-4,73,63,136,0.537,03/14/2016,2016.0
28,Delaware (CAA),8,3-5,98,85,183,0.536,03/14/2016,2016.0
29,Fairfield (CAA),7,2-5,83,73,156,0.532,03/14/2016,2016.0
30,Bryant (NEC),7,4-3,90,81,171,0.526,03/14/2016,2016.0
31,Air Force (SoCon),7,5-2,79,72,151,0.523,03/14/2016,2016.0
32,Binghamton (America East),4,0-4,45,42,87,0.517,03/14/2016,2016.0
33,Vermont (America East),7,3-4,92,86,178,0.517,03/14/2016,2016.0
34,Mount St. Mary's (NEC),6,4-2,61,61,122,0.500,03/14/2016,2016.0
35,Michigan (Big Ten),6,3-3,82,83,165,0.497,03/14/2016,2016.0
36,Yale (Ivy League),5,5-0,52,54,106,0.491,03/14/2016,2016.0
37,Furman (SoCon),6,0-6,65,68,133,0.489,03/14/2016,2016.0
38,Quinnipiac (MAAC),4,3-1,46,49,95,0.484,03/14/2016,2016.0
39,Penn St. (Big Ten),7,5-2,91,98,189,0.481,03/14/2016,2016.0
40,Sacred Heart (NEC),7,2-5,80,88,168,0.476,03/14/2016,2016.0
40,Wagner (NEC),7,4-3,70,77,147,0.476,03/14/2016,2016.0
40,Stony Brook (America East),5,4-1,60,66,126,0.476,03/14/2016,2016.0
43,Lafayette (Patriot),5,1-4,52,60,112,0.464,03/14/2016,2016.0
44,Canisius (MAAC),2,1-1,18,21,39,0.462,03/14/2016,2016.0
45,Mercer (SoCon),6,2-4,64,75,139,0.460,03/14/2016,2016.0
46,Siena (MAAC),5,1-4,54,69,123,0.439,03/14/2016,2016.0
47,Loyola Maryland (Patriot),6,4-2,57,73,130,0.438,03/14/2016,2016.0
48,Massachusetts (CAA),7,3-4,67,88,155,0.432,03/14/2016,2016.0
49,Princeton (Ivy League),5,2-3,55,74,129,0.426,03/14/2016,2016.0
50,St. John's (NY) (Big East),7,1-6,73,99,172,0.424,03/14/2016,2016.0
51,UAlbany (America East),4,3-1,46,66,112,0.411,03/14/2016,2016.0
52,UMBC (America East),4,1-3,34,49,83,0.410,03/14/2016,2016.0
53,Providence (Big East),6,3-3,57,83,140,0.407,03/14/2016,2016.0
54,Holy Cross (Patriot),7,0-7,75,110,185,0.405,03/14/2016,2016.0
55,Colgate (Patriot),6,3-3,51,75,126,0.405,03/14/2016,2016.0
56,Lehigh (Patriot),6,4-2,63,93,156,0.404,03/14/2016,2016.0
56,Monmouth (MAAC),5,3-2,42,62,104,0.404,03/14/2016,2016.0
58,Robert Morris (NEC),7,2-5,73,109,182,0.401,03/14/2016,2016.0
59,VMI (SoCon),7,1-6,58,91,149,0.389,03/14/2016,2016.0
60,Harvard (Ivy League),6,4-2,61,96,157,0.389,03/14/2016,2016.0
61,Georgetown (Big East),6,1-5,51,84,135,0.378,03/14/2016,2016.0
62,Dartmouth (Ivy League),4,0-4,30,50,80,0.375,03/14/2016,2016.0
63,NJIT (Independent),8,0-8,72,123,195,0.369,03/14/2016,2016.0
64,Penn (Ivy League),5,3-2,45,77,122,0.369,03/14/2016,2016.0
65,Drexel (CAA),6,2-4,56,101,157,0.357,03/14/2016,2016.0
66,Marist (MAAC),4,1-3,25,60,85,0.294,03/14/2016,2016.0
67,Detroit Mercy (MAAC),5,0-5,29,72,101,0.287,03/14/2016,2016.0
68,Manhattan (MAAC),8,1-7,50,135,185,0.270,03/14/2016,2016.0
-,UMass Lowell (America East),6,1-5,42,92,134,0.313,03/14/2016,2016.0
1,Syracuse (ACC),5,5-0,89,35,124,0.718,03/13/2016,2016.0
2,Brown (Ivy League),5,5-0,106,45,151,0.702,03/13/2016,2016.0
3,Army West Point (Patriot),7,5-2,115,52,167,0.689,03/13/2016,2016.0
4,Denver (Big East),6,6-0,105,49,154,0.682,03/13/2016,2016.0
5,Hartford (America East),5,2-3,83,44,127,0.654,03/13/2016,2016.0
6,Villanova (Big East),5,4-1,99,53,152,0.651,03/13/2016,2016.0
7,Cornell (Ivy League),4,2-2,59,32,91,0.648,03/13/2016,2016.0
8,Boston U. (Patriot),7,6-1,99,54,153,0.647,03/13/2016,2016.0
9,Marquette (Big East),5,4-1,62,35,97,0.639,03/13/2016,2016.0
10,Saint Joseph's (NEC),6,4-2,94,55,149,0.631,03/13/2016,2016.0
11,Hofstra (CAA),5,4-1,65,41,106,0.613,03/13/2016,2016.0
12,Notre Dame (ACC),5,4-1,61,41,102,0.598,03/13/2016,2016.0
13,Hobart (NEC),6,3-3,83,56,139,0.597,03/13/2016,2016.0
14,Ohio St. (Big Ten),7,5-2,88,61,149,0.591,03/13/2016,2016.0
15,Duke (ACC),8,5-3,126,90,216,0.583,03/13/2016,2016.0
16,Johns Hopkins (Big Ten),5,3-2,72,54,126,0.571,03/13/2016,2016.0
17,Jacksonville (SoCon),6,2-4,84,64,148,0.568,03/13/2016,2016.0
18,Bucknell (Patriot),6,4-2,85,66,151,0.563,03/13/2016,2016.0
19,Virginia (ACC),7,3-4,94,74,168,0.560,03/13/2016,2016.0
20,Towson (CAA),6,5-1,67,53,120,0.558,03/13/2016,2016.0
21,Maryland (Big Ten),5,3-2,61,49,110,0.555,03/13/2016,2016.0
22,Navy (Patriot),5,3-2,54,44,98,0.551,03/13/2016,2016.0
23,High Point (SoCon),7,4-3,100,82,182,0.549,03/13/2016,2016.0
24,North Carolina (ACC),6,3-3,84,70,154,0.545,03/13/2016,2016.0
25,Bellarmine (SoCon),7,3-4,73,63,136,0.537,03/13/2016,2016.0
25,Richmond (SoCon),7,6-1,73,63,136,0.537,03/13/2016,2016.0
27,Delaware (CAA),8,3-5,98,85,183,0.536,03/13/2016,2016.0
28,Fairfield (CAA),7,2-5,83,73,156,0.532,03/13/2016,2016.0
29,Rutgers (Big Ten),6,5-1,82,73,155,0.529,03/13/2016,2016.0
30,Bryant (NEC),7,4-3,90,81,171,0.526,03/13/2016,2016.0
31,Air Force (SoCon),7,5-2,79,72,151,0.523,03/13/2016,2016.0
32,Binghamton (America East),4,0-4,45,42,87,0.517,03/13/2016,2016.0
33,Vermont (America East),7,3-4,91,87,178,0.511,03/13/2016,2016.0
34,Mount St. Mary's (NEC),6,4-2,61,61,122,0.500,03/13/2016,2016.0
35,Michigan (Big Ten),6,3-3,82,83,165,0.497,03/13/2016,2016.0
36,Yale (Ivy League),5,5-0,52,54,106,0.491,03/13/2016,2016.0
37,Furman (SoCon),6,0-6,65,68,133,0.489,03/13/2016,2016.0
38,Quinnipiac (MAAC),4,3-1,46,49,95,0.484,03/13/2016,2016.0
39,Penn St. (Big Ten),7,5-2,91,98,189,0.481,03/13/2016,2016.0
40,Sacred Heart (NEC),7,2-5,80,88,168,0.476,03/13/2016,2016.0
40,Wagner (NEC),7,4-3,70,77,147,0.476,03/13/2016,2016.0
40,Stony Brook (America East),5,4-1,60,66,126,0.476,03/13/2016,2016.0
43,Lafayette (Patriot),5,1-4,52,60,112,0.464,03/13/2016,2016.0
44,Canisius (MAAC),2,1-1,18,21,39,0.462,03/13/2016,2016.0
45,Mercer (SoCon),6,2-4,64,75,139,0.460,03/13/2016,2016.0
46,Siena (MAAC),5,1-4,54,69,123,0.439,03/13/2016,2016.0
47,Loyola Maryland (Patriot),6,4-2,57,73,130,0.438,03/13/2016,2016.0
48,Princeton (Ivy League),4,1-3,47,61,108,0.435,03/13/2016,2016.0
49,Massachusetts (CAA),7,3-4,67,88,155,0.432,03/13/2016,2016.0
50,St. John's (NY) (Big East),7,1-6,73,99,172,0.424,03/13/2016,2016.0
51,UAlbany (America East),4,3-1,46,66,112,0.411,03/13/2016,2016.0
52,UMBC (America East),4,1-3,34,49,83,0.410,03/13/2016,2016.0
53,Providence (Big East),6,3-3,57,83,140,0.407,03/13/2016,2016.0
54,Holy Cross (Patriot),7,0-7,75,110,185,0.405,03/13/2016,2016.0
55,Colgate (Patriot),6,3-3,51,75,126,0.405,03/13/2016,2016.0
56,Lehigh (Patriot),6,4-2,63,93,156,0.404,03/13/2016,2016.0
56,Monmouth (MAAC),5,3-2,42,62,104,0.404,03/13/2016,2016.0
58,Robert Morris (NEC),7,2-5,73,109,182,0.401,03/13/2016,2016.0
59,VMI (SoCon),7,1-6,58,91,149,0.389,03/13/2016,2016.0
60,Harvard (Ivy League),6,4-2,61,96,157,0.389,03/13/2016,2016.0
61,Georgetown (Big East),6,1-5,51,84,135,0.378,03/13/2016,2016.0
62,Dartmouth (Ivy League),4,0-4,30,50,80,0.375,03/13/2016,2016.0
63,NJIT (Independent),8,0-8,72,123,195,0.369,03/13/2016,2016.0
64,Penn (Ivy League),5,3-2,45,77,122,0.369,03/13/2016,2016.0
65,Drexel (CAA),6,2-4,56,101,157,0.357,03/13/2016,2016.0
66,Manhattan (MAAC),7,1-6,48,115,163,0.294,03/13/2016,2016.0
67,Marist (MAAC),4,1-3,25,60,85,0.294,03/13/2016,2016.0
68,Detroit Mercy (MAAC),5,0-5,29,72,101,0.287,03/13/2016,2016.0
-,UMass Lowell (America East),6,1-5,42,92,134,0.313,03/13/2016,2016.0
1,Syracuse (ACC),5,5-0,89,35,124,0.718,03/12/2016,2016.0
2,Brown (Ivy League),5,5-0,106,45,151,0.702,03/12/2016,2016.0
3,Denver (Big East),5,5-0,93,40,133,0.699,03/12/2016,2016.0
4,Army West Point (Patriot),6,4-2,97,44,141,0.688,03/12/2016,2016.0
5,Hartford (America East),5,2-3,83,44,127,0.654,03/12/2016,2016.0
6,Villanova (Big East),5,4-1,99,53,152,0.651,03/12/2016,2016.0
7,Cornell (Ivy League),4,2-2,59,32,91,0.648,03/12/2016,2016.0
8,Boston U. (Patriot),7,6-1,99,54,153,0.647,03/12/2016,2016.0
9,Notre Dame (ACC),4,4-0,52,29,81,0.642,03/12/2016,2016.0
10,Marquette (Big East),5,4-1,62,35,97,0.639,03/12/2016,2016.0
11,Saint Joseph's (NEC),6,4-2,94,55,149,0.631,03/12/2016,2016.0
12,Hofstra (CAA),5,4-1,65,41,106,0.613,03/12/2016,2016.0
13,Hobart (NEC),6,3-3,83,56,139,0.597,03/12/2016,2016.0
14,Ohio St. (Big Ten),7,5-2,88,61,149,0.591,03/12/2016,2016.0
15,Duke (ACC),8,5-3,126,90,216,0.583,03/12/2016,2016.0
16,Johns Hopkins (Big Ten),5,3-2,72,54,126,0.571,03/12/2016,2016.0
17,Jacksonville (SoCon),6,2-4,84,64,148,0.568,03/12/2016,2016.0
18,Bucknell (Patriot),6,4-2,85,66,151,0.563,03/12/2016,2016.0
19,Virginia (ACC),7,3-4,94,74,168,0.560,03/12/2016,2016.0
20,Towson (CAA),6,5-1,67,53,120,0.558,03/12/2016,2016.0
21,Maryland (Big Ten),5,3-2,61,49,110,0.555,03/12/2016,2016.0
22,Navy (Patriot),5,3-2,54,44,98,0.551,03/12/2016,2016.0
23,High Point (SoCon),7,4-3,100,82,182,0.549,03/12/2016,2016.0
24,North Carolina (ACC),6,3-3,84,70,154,0.545,03/12/2016,2016.0
25,Bellarmine (SoCon),7,3-4,73,63,136,0.537,03/12/2016,2016.0
25,Richmond (SoCon),7,6-1,73,63,136,0.537,03/12/2016,2016.0
27,Delaware (CAA),8,3-5,98,85,183,0.536,03/12/2016,2016.0
28,Fairfield (CAA),7,2-5,83,73,156,0.532,03/12/2016,2016.0
29,Rutgers (Big Ten),6,5-1,82,73,155,0.529,03/12/2016,2016.0
30,Bryant (NEC),7,4-3,90,81,171,0.526,03/12/2016,2016.0
31,Air Force (SoCon),7,5-2,79,72,151,0.523,03/12/2016,2016.0
32,Binghamton (America East),4,0-4,45,42,87,0.517,03/12/2016,2016.0
33,Vermont (America East),7,3-4,91,87,178,0.511,03/12/2016,2016.0
34,Mount St. Mary's (NEC),6,4-2,61,61,122,0.500,03/12/2016,2016.0
35,Michigan (Big Ten),6,3-3,82,83,165,0.497,03/12/2016,2016.0
36,Yale (Ivy League),5,5-0,52,54,106,0.491,03/12/2016,2016.0
37,Furman (SoCon),6,0-6,65,68,133,0.489,03/12/2016,2016.0
38,Quinnipiac (MAAC),4,3-1,46,49,95,0.484,03/12/2016,2016.0
39,Penn St. (Big Ten),7,5-2,91,98,189,0.481,03/12/2016,2016.0
40,Sacred Heart (NEC),7,2-5,80,88,168,0.476,03/12/2016,2016.0
40,Wagner (NEC),7,4-3,70,77,147,0.476,03/12/2016,2016.0
40,Stony Brook (America East),5,4-1,60,66,126,0.476,03/12/2016,2016.0
43,Lafayette (Patriot),5,1-4,52,60,112,0.464,03/12/2016,2016.0
44,Canisius (MAAC),2,1-1,18,21,39,0.462,03/12/2016,2016.0
45,Mercer (SoCon),6,2-4,64,75,139,0.460,03/12/2016,2016.0
46,Siena (MAAC),5,1-4,54,69,123,0.439,03/12/2016,2016.0
47,Loyola Maryland (Patriot),6,4-2,57,73,130,0.438,03/12/2016,2016.0
48,Princeton (Ivy League),4,1-3,47,61,108,0.435,03/12/2016,2016.0
49,Massachusetts (CAA),7,3-4,67,88,155,0.432,03/12/2016,2016.0
50,St. John's (NY) (Big East),7,1-6,73,99,172,0.424,03/12/2016,2016.0
51,UAlbany (America East),4,3-1,46,66,112,0.411,03/12/2016,2016.0
52,UMBC (America East),4,1-3,34,49,83,0.410,03/12/2016,2016.0
53,Providence (Big East),6,3-3,57,83,140,0.407,03/12/2016,2016.0
54,Holy Cross (Patriot),7,0-7,75,110,185,0.405,03/12/2016,2016.0
55,Colgate (Patriot),6,3-3,51,75,126,0.405,03/12/2016,2016.0
56,Lehigh (Patriot),6,4-2,63,93,156,0.404,03/12/2016,2016.0
56,Monmouth (MAAC),5,3-2,42,62,104,0.404,03/12/2016,2016.0
58,Robert Morris (NEC),7,2-5,73,109,182,0.401,03/12/2016,2016.0
59,VMI (SoCon),7,1-6,58,91,149,0.389,03/12/2016,2016.0
60,Harvard (Ivy League),6,4-2,61,96,157,0.389,03/12/2016,2016.0
61,NJIT (Independent),7,0-7,64,105,169,0.379,03/12/2016,2016.0
62,Georgetown (Big East),6,1-5,51,84,135,0.378,03/12/2016,2016.0
63,Dartmouth (Ivy League),4,0-4,30,50,80,0.375,03/12/2016,2016.0
64,Penn (Ivy League),5,3-2,45,77,122,0.369,03/12/2016,2016.0
65,Drexel (CAA),6,2-4,56,101,157,0.357,03/12/2016,2016.0
66,Manhattan (MAAC),7,1-6,48,115,163,0.294,03/12/2016,2016.0
67,Marist (MAAC),4,1-3,25,60,85,0.294,03/12/2016,2016.0
68,Detroit Mercy (MAAC),5,0-5,29,72,101,0.287,03/12/2016,2016.0
-,UMass Lowell (America East),6,1-5,42,92,134,0.313,03/12/2016,2016.0
1,Brown (Ivy League),4,4-0,87,30,117,0.744,03/11/2016,2016.0
2,Denver (Big East),5,5-0,93,40,133,0.699,03/11/2016,2016.0
3,Syracuse (ACC),4,4-0,71,31,102,0.696,03/11/2016,2016.0
4,Cornell (Ivy League),3,1-2,44,20,64,0.688,03/11/2016,2016.0
5,Army West Point (Patriot),5,3-2,75,39,114,0.658,03/11/2016,2016.0
6,Hartford (America East),4,2-2,67,35,102,0.657,03/11/2016,2016.0
7,Villanova (Big East),4,3-1,81,44,125,0.648,03/11/2016,2016.0
8,Notre Dame (ACC),4,4-0,52,29,81,0.642,03/11/2016,2016.0
9,Saint Joseph's (NEC),5,3-2,75,46,121,0.620,03/11/2016,2016.0
10,Hofstra (CAA),4,3-1,55,34,89,0.618,03/11/2016,2016.0
11,Boston U. (Patriot),6,5-1,81,51,132,0.614,03/11/2016,2016.0
11,Ohio St. (Big Ten),6,5-1,81,51,132,0.614,03/11/2016,2016.0
13,Marquette (Big East),4,3-1,45,30,75,0.600,03/11/2016,2016.0
14,Jacksonville (SoCon),5,2-3,75,51,126,0.595,03/11/2016,2016.0
15,Towson (CAA),5,5-0,56,39,95,0.589,03/11/2016,2016.0
16,Virginia (ACC),6,3-3,82,59,141,0.582,03/11/2016,2016.0
17,Johns Hopkins (Big Ten),4,2-2,58,43,101,0.574,03/11/2016,2016.0
18,Maryland (Big Ten),4,2-2,48,36,84,0.571,03/11/2016,2016.0
19,Hobart (NEC),5,2-3,66,50,116,0.569,03/11/2016,2016.0
20,Binghamton (America East),3,0-3,34,27,61,0.557,03/11/2016,2016.0
21,Duke (ACC),7,4-3,107,85,192,0.557,03/11/2016,2016.0
22,Navy (Patriot),5,3-2,54,44,98,0.551,03/11/2016,2016.0
23,Bucknell (Patriot),5,3-2,65,54,119,0.546,03/11/2016,2016.0
24,Yale (Ivy League),4,4-0,48,41,89,0.539,03/11/2016,2016.0
25,High Point (SoCon),6,3-3,83,71,154,0.539,03/11/2016,2016.0
26,Air Force (SoCon),6,4-2,70,60,130,0.538,03/11/2016,2016.0
27,Bellarmine (SoCon),6,2-4,61,54,115,0.530,03/11/2016,2016.0
28,Bryant (NEC),6,4-2,79,70,149,0.530,03/11/2016,2016.0
29,Rutgers (Big Ten),6,5-1,82,73,155,0.529,03/11/2016,2016.0
30,Delaware (CAA),7,2-5,83,74,157,0.529,03/11/2016,2016.0
31,Quinnipiac (MAAC),3,2-1,37,33,70,0.529,03/11/2016,2016.0
32,Richmond (SoCon),6,5-1,60,54,114,0.526,03/11/2016,2016.0
33,North Carolina (ACC),5,3-2,67,62,129,0.519,03/11/2016,2016.0
34,Michigan (Big Ten),5,3-2,67,64,131,0.511,03/11/2016,2016.0
35,Vermont (America East),6,2-4,81,78,159,0.509,03/11/2016,2016.0
36,Fairfield (CAA),6,2-4,70,69,139,0.504,03/11/2016,2016.0
37,Loyola Maryland (Patriot),5,4-1,52,54,106,0.491,03/11/2016,2016.0
38,Sacred Heart (NEC),6,2-4,71,78,149,0.477,03/11/2016,2016.0
39,Wagner (NEC),7,4-3,70,77,147,0.476,03/11/2016,2016.0
39,Stony Brook (America East),5,4-1,60,66,126,0.476,03/11/2016,2016.0
41,Furman (SoCon),5,0-5,53,59,112,0.473,03/11/2016,2016.0
42,Mercer (SoCon),5,2-3,55,63,118,0.466,03/11/2016,2016.0
43,Lafayette (Patriot),5,1-4,52,60,112,0.464,03/11/2016,2016.0
44,Canisius (MAAC),2,1-1,18,21,39,0.462,03/11/2016,2016.0
45,St. John's (NY) (Big East),6,1-5,69,81,150,0.460,03/11/2016,2016.0
46,Colgate (Patriot),5,3-2,48,57,105,0.457,03/11/2016,2016.0
47,Penn St. (Big Ten),6,4-2,73,87,160,0.456,03/11/2016,2016.0
48,Massachusetts (CAA),6,2-4,59,71,130,0.454,03/11/2016,2016.0
49,Lehigh (Patriot),5,4-1,58,71,129,0.450,03/11/2016,2016.0
50,Mount St. Mary's (NEC),5,3-2,46,57,103,0.447,03/11/2016,2016.0
51,Siena (MAAC),5,1-4,54,69,123,0.439,03/11/2016,2016.0
52,Monmouth (MAAC),4,3-1,33,43,76,0.434,03/11/2016,2016.0
53,Robert Morris (NEC),6,2-4,68,92,160,0.425,03/11/2016,2016.0
54,VMI (SoCon),6,1-5,54,76,130,0.415,03/11/2016,2016.0
55,Princeton (Ivy League),3,1-2,34,48,82,0.415,03/11/2016,2016.0
56,Holy Cross (Patriot),6,0-6,63,90,153,0.412,03/11/2016,2016.0
57,UAlbany (America East),4,3-1,46,66,112,0.411,03/11/2016,2016.0
57,Providence (Big East),5,3-2,46,66,112,0.411,03/11/2016,2016.0
59,Georgetown (Big East),5,1-4,45,67,112,0.402,03/11/2016,2016.0
60,Harvard (Ivy League),5,4-1,50,78,128,0.391,03/11/2016,2016.0
61,Penn (Ivy League),4,3-1,36,59,95,0.379,03/11/2016,2016.0
62,NJIT (Independent),7,0-7,64,105,169,0.379,03/11/2016,2016.0
63,Dartmouth (Ivy League),4,0-4,30,50,80,0.375,03/11/2016,2016.0
64,UMBC (America East),3,0-3,23,39,62,0.371,03/11/2016,2016.0
65,Drexel (CAA),5,1-4,45,90,135,0.333,03/11/2016,2016.0
66,Manhattan (MAAC),6,0-6,43,103,146,0.295,03/11/2016,2016.0
67,Detroit Mercy (MAAC),5,0-5,29,72,101,0.287,03/11/2016,2016.0
68,Marist (MAAC),3,1-2,15,49,64,0.234,03/11/2016,2016.0
-,UMass Lowell (America East),5,1-4,30,87,117,0.256,03/11/2016,2016.0
1,Brown (Ivy League),4,4-0,87,30,117,0.744,02/01/2016 - 03/10/2016,2016.0
2,Denver (Big East),5,5-0,93,40,133,0.699,02/01/2016 - 03/10/2016,2016.0
3,Syracuse (ACC),4,4-0,71,31,102,0.696,02/01/2016 - 03/10/2016,2016.0
4,Cornell (Ivy League),3,1-2,44,20,64,0.688,02/01/2016 - 03/10/2016,2016.0
5,Army West Point (Patriot),5,3-2,75,39,114,0.658,02/01/2016 - 03/10/2016,2016.0
6,Hartford (America East),4,2-2,67,35,102,0.657,02/01/2016 - 03/10/2016,2016.0
7,Villanova (Big East),4,3-1,81,44,125,0.648,02/01/2016 - 03/10/2016,2016.0
8,Notre Dame (ACC),4,4-0,52,29,81,0.642,02/01/2016 - 03/10/2016,2016.0
9,Saint Joseph's (NEC),5,3-2,75,46,121,0.620,02/01/2016 - 03/10/2016,2016.0
10,Hofstra (CAA),4,3-1,55,34,89,0.618,02/01/2016 - 03/10/2016,2016.0
11,Boston U. (Patriot),6,5-1,81,51,132,0.614,02/01/2016 - 03/10/2016,2016.0
11,Ohio St. (Big Ten),6,5-1,81,51,132,0.614,02/01/2016 - 03/10/2016,2016.0
13,Marquette (Big East),4,3-1,45,30,75,0.600,02/01/2016 - 03/10/2016,2016.0
14,Jacksonville (SoCon),5,2-3,75,51,126,0.595,02/01/2016 - 03/10/2016,2016.0
15,Towson (CAA),5,5-0,56,39,95,0.589,02/01/2016 - 03/10/2016,2016.0
16,Virginia (ACC),6,3-3,82,59,141,0.582,02/01/2016 - 03/10/2016,2016.0
17,Johns Hopkins (Big Ten),4,2-2,58,43,101,0.574,02/01/2016 - 03/10/2016,2016.0
18,Maryland (Big Ten),4,2-2,48,36,84,0.571,02/01/2016 - 03/10/2016,2016.0
19,Hobart (NEC),5,2-3,66,50,116,0.569,02/01/2016 - 03/10/2016,2016.0
20,Binghamton (America East),3,0-3,34,27,61,0.557,02/01/2016 - 03/10/2016,2016.0
21,Duke (ACC),7,4-3,107,85,192,0.557,02/01/2016 - 03/10/2016,2016.0
22,Navy (Patriot),5,3-2,54,44,98,0.551,02/01/2016 - 03/10/2016,2016.0
23,Bucknell (Patriot),5,3-2,65,54,119,0.546,02/01/2016 - 03/10/2016,2016.0
24,Rutgers (Big Ten),5,5-0,71,60,131,0.542,02/01/2016 - 03/10/2016,2016.0
25,Yale (Ivy League),4,4-0,48,41,89,0.539,02/01/2016 - 03/10/2016,2016.0
26,High Point (SoCon),6,3-3,83,71,154,0.539,02/01/2016 - 03/10/2016,2016.0
27,Air Force (SoCon),6,4-2,70,60,130,0.538,02/01/2016 - 03/10/2016,2016.0
28,Bellarmine (SoCon),6,2-4,61,54,115,0.530,02/01/2016 - 03/10/2016,2016.0
29,Bryant (NEC),6,4-2,79,70,149,0.530,02/01/2016 - 03/10/2016,2016.0
30,Delaware (CAA),7,2-5,83,74,157,0.529,02/01/2016 - 03/10/2016,2016.0
31,Quinnipiac (MAAC),3,2-1,37,33,70,0.529,02/01/2016 - 03/10/2016,2016.0
32,Richmond (SoCon),6,5-1,60,54,114,0.526,02/01/2016 - 03/10/2016,2016.0
33,North Carolina (ACC),5,3-2,67,62,129,0.519,02/01/2016 - 03/10/2016,2016.0
34,Michigan (Big Ten),5,3-2,67,64,131,0.511,02/01/2016 - 03/10/2016,2016.0
35,Vermont (America East),6,2-4,81,78,159,0.509,02/01/2016 - 03/10/2016,2016.0
36,Fairfield (CAA),6,2-4,70,69,139,0.504,02/01/2016 - 03/10/2016,2016.0
37,Loyola Maryland (Patriot),5,4-1,52,54,106,0.491,02/01/2016 - 03/10/2016,2016.0
38,Sacred Heart (NEC),6,2-4,71,78,149,0.477,02/01/2016 - 03/10/2016,2016.0
39,Wagner (NEC),7,4-3,70,77,147,0.476,02/01/2016 - 03/10/2016,2016.0
40,Furman (SoCon),5,0-5,53,59,112,0.473,02/01/2016 - 03/10/2016,2016.0
41,Mercer (SoCon),5,2-3,55,63,118,0.466,02/01/2016 - 03/10/2016,2016.0
42,Lafayette (Patriot),5,1-4,52,60,112,0.464,02/01/2016 - 03/10/2016,2016.0
43,Canisius (MAAC),2,1-1,18,21,39,0.462,02/01/2016 - 03/10/2016,2016.0
44,Stony Brook (America East),4,3-1,47,55,102,0.461,02/01/2016 - 03/10/2016,2016.0
45,St. John's (NY) (Big East),6,1-5,69,81,150,0.460,02/01/2016 - 03/10/2016,2016.0
46,Colgate (Patriot),5,3-2,48,57,105,0.457,02/01/2016 - 03/10/2016,2016.0
47,Penn St. (Big Ten),6,4-2,73,87,160,0.456,02/01/2016 - 03/10/2016,2016.0
48,Massachusetts (CAA),6,2-4,59,71,130,0.454,02/01/2016 - 03/10/2016,2016.0
49,Lehigh (Patriot),5,4-1,58,71,129,0.450,02/01/2016 - 03/10/2016,2016.0
50,Mount St. Mary's (NEC),5,3-2,46,57,103,0.447,02/01/2016 - 03/10/2016,2016.0
51,Siena (MAAC),5,1-4,54,69,123,0.439,02/01/2016 - 03/10/2016,2016.0
52,Monmouth (MAAC),4,3-1,33,43,76,0.434,02/01/2016 - 03/10/2016,2016.0
53,Robert Morris (NEC),6,2-4,68,92,160,0.425,02/01/2016 - 03/10/2016,2016.0
54,VMI (SoCon),6,1-5,54,76,130,0.415,02/01/2016 - 03/10/2016,2016.0
55,Princeton (Ivy League),3,1-2,34,48,82,0.415,02/01/2016 - 03/10/2016,2016.0
56,Holy Cross (Patriot),6,0-6,63,90,153,0.412,02/01/2016 - 03/10/2016,2016.0
57,Providence (Big East),5,3-2,46,66,112,0.411,02/01/2016 - 03/10/2016,2016.0
57,UAlbany (America East),4,3-1,46,66,112,0.411,02/01/2016 - 03/10/2016,2016.0
59,Georgetown (Big East),5,1-4,45,67,112,0.402,02/01/2016 - 03/10/2016,2016.0
60,Harvard (Ivy League),5,4-1,50,78,128,0.391,02/01/2016 - 03/10/2016,2016.0
61,Penn (Ivy League),4,3-1,36,59,95,0.379,02/01/2016 - 03/10/2016,2016.0
62,NJIT (Independent),7,0-7,64,105,169,0.379,02/01/2016 - 03/10/2016,2016.0
63,Dartmouth (Ivy League),4,0-4,30,50,80,0.375,02/01/2016 - 03/10/2016,2016.0
64,UMBC (America East),3,0-3,23,39,62,0.371,02/01/2016 - 03/10/2016,2016.0
65,Drexel (CAA),5,1-4,45,90,135,0.333,02/01/2016 - 03/10/2016,2016.0
66,Manhattan (MAAC),6,0-6,43,103,146,0.295,02/01/2016 - 03/10/2016,2016.0
67,Detroit Mercy (MAAC),5,0-5,29,72,101,0.287,02/01/2016 - 03/10/2016,2016.0
68,Marist (MAAC),3,1-2,15,49,64,0.234,02/01/2016 - 03/10/2016,2016.0
-,UMass Lowell (America East),5,1-4,30,87,117,0.256,02/01/2016 - 03/10/2016,2016.0
1,Brown (Ivy League),4,4-0,87,30,117,0.744,03/08/2016,2016.0
2,Denver (Big East),5,5-0,93,40,133,0.699,03/08/2016,2016.0
3,Syracuse (ACC),4,4-0,71,31,102,0.696,03/08/2016,2016.0
4,Cornell (Ivy League),3,1-2,44,20,64,0.688,03/08/2016,2016.0
5,Army West Point (Patriot),5,3-2,75,39,114,0.658,03/08/2016,2016.0
6,Hartford (America East),4,2-2,67,35,102,0.657,03/08/2016,2016.0
7,Villanova (Big East),4,3-1,81,44,125,0.648,03/08/2016,2016.0
8,Notre Dame (ACC),4,4-0,52,29,81,0.642,03/08/2016,2016.0
9,Saint Joseph's (NEC),5,3-2,75,46,121,0.620,03/08/2016,2016.0
10,Boston U. (Patriot),6,5-1,81,51,132,0.614,03/08/2016,2016.0
10,Ohio St. (Big Ten),6,5-1,81,51,132,0.614,03/08/2016,2016.0
12,Hofstra (CAA),4,3-1,54,35,89,0.607,03/08/2016,2016.0
13,Marquette (Big East),4,3-1,45,30,75,0.600,03/08/2016,2016.0
14,Jacksonville (SoCon),5,2-3,75,51,126,0.595,03/08/2016,2016.0
15,Towson (CAA),5,5-0,56,39,95,0.589,03/08/2016,2016.0
16,Virginia (ACC),6,3-3,82,59,141,0.582,03/08/2016,2016.0
17,Johns Hopkins (Big Ten),4,2-2,58,43,101,0.574,03/08/2016,2016.0
18,Maryland (Big Ten),4,2-2,48,36,84,0.571,03/08/2016,2016.0
19,Hobart (NEC),5,2-3,66,50,116,0.569,03/08/2016,2016.0
20,Binghamton (America East),3,0-3,34,27,61,0.557,03/08/2016,2016.0
21,Duke (ACC),7,4-3,107,85,192,0.557,03/08/2016,2016.0
22,Air Force (SoCon),6,4-2,73,59,132,0.553,03/08/2016,2016.0
23,Navy (Patriot),5,3-2,54,44,98,0.551,03/08/2016,2016.0
24,Bucknell (Patriot),5,3-2,65,54,119,0.546,03/08/2016,2016.0
25,Rutgers (Big Ten),5,5-0,71,60,131,0.542,03/08/2016,2016.0
26,Yale (Ivy League),4,4-0,48,41,89,0.539,03/08/2016,2016.0
27,High Point (SoCon),6,3-3,83,71,154,0.539,03/08/2016,2016.0
28,Bellarmine (SoCon),6,2-4,61,54,115,0.530,03/08/2016,2016.0
29,Bryant (NEC),6,4-2,79,70,149,0.530,03/08/2016,2016.0
30,Delaware (CAA),7,2-5,83,74,157,0.529,03/08/2016,2016.0
31,Quinnipiac (MAAC),3,2-1,37,33,70,0.529,03/08/2016,2016.0
32,Richmond (SoCon),6,5-1,60,54,114,0.526,03/08/2016,2016.0
33,North Carolina (ACC),5,3-2,67,62,129,0.519,03/08/2016,2016.0
34,Michigan (Big Ten),5,3-2,67,64,131,0.511,03/08/2016,2016.0
35,Vermont (America East),6,2-4,81,78,159,0.509,03/08/2016,2016.0
36,Fairfield (CAA),6,2-4,70,69,139,0.504,03/08/2016,2016.0
37,Loyola Maryland (Patriot),5,4-1,52,54,106,0.491,03/08/2016,2016.0
38,Sacred Heart (NEC),6,2-4,71,78,149,0.477,03/08/2016,2016.0
39,Furman (SoCon),5,0-5,53,59,112,0.473,03/08/2016,2016.0
40,Mercer (SoCon),5,2-3,55,63,118,0.466,03/08/2016,2016.0
41,Lafayette (Patriot),5,1-4,52,60,112,0.464,03/08/2016,2016.0
42,Canisius (MAAC),2,1-1,18,21,39,0.462,03/08/2016,2016.0
43,Stony Brook (America East),4,3-1,47,55,102,0.461,03/08/2016,2016.0
44,St. John's (NY) (Big East),6,1-5,69,81,150,0.460,03/08/2016,2016.0
45,Colgate (Patriot),5,3-2,48,57,105,0.457,03/08/2016,2016.0
46,Penn St. (Big Ten),6,4-2,73,87,160,0.456,03/08/2016,2016.0
47,Massachusetts (CAA),6,2-4,59,71,130,0.454,03/08/2016,2016.0
48,Lehigh (Patriot),5,4-1,58,71,129,0.450,03/08/2016,2016.0
49,Mount St. Mary's (NEC),5,3-2,46,57,103,0.447,03/08/2016,2016.0
50,Siena (MAAC),5,1-4,54,69,123,0.439,03/08/2016,2016.0
51,Wagner (NEC),6,3-3,53,68,121,0.438,03/08/2016,2016.0
52,Monmouth (MAAC),4,3-1,33,43,76,0.434,03/08/2016,2016.0
53,VMI (SoCon),6,1-5,54,76,130,0.415,03/08/2016,2016.0
54,Princeton (Ivy League),3,1-2,34,48,82,0.415,03/08/2016,2016.0
55,Robert Morris (NEC),6,2-4,67,95,162,0.414,03/08/2016,2016.0
56,Holy Cross (Patriot),6,0-6,63,90,153,0.412,03/08/2016,2016.0
57,UAlbany (America East),4,3-1,46,66,112,0.411,03/08/2016,2016.0
57,Georgetown (Big East),5,1-4,46,66,112,0.411,03/08/2016,2016.0
57,Providence (Big East),5,3-2,46,66,112,0.411,03/08/2016,2016.0
60,Harvard (Ivy League),5,4-1,50,78,128,0.391,03/08/2016,2016.0
61,Penn (Ivy League),4,3-1,36,59,95,0.379,03/08/2016,2016.0
62,NJIT (Independent),7,0-7,64,105,169,0.379,03/08/2016,2016.0
63,Dartmouth (Ivy League),4,0-4,30,50,80,0.375,03/08/2016,2016.0
64,UMBC (America East),3,0-3,23,39,62,0.371,03/08/2016,2016.0
65,Drexel (CAA),5,1-4,45,90,135,0.333,03/08/2016,2016.0
66,Manhattan (MAAC),6,0-6,43,103,146,0.295,03/08/2016,2016.0
67,Detroit Mercy (MAAC),5,0-5,29,72,101,0.287,03/08/2016,2016.0
68,Marist (MAAC),3,1-2,15,49,64,0.234,03/08/2016,2016.0
-,UMass Lowell (America East),5,1-4,30,87,117,0.256,03/08/2016,2016.0
1,Brown (Ivy League),3,3-0,61,26,87,0.701,03/07/2016,2016.0
2,Denver (Big East),5,5-0,93,40,133,0.699,03/07/2016,2016.0
3,Syracuse (ACC),4,4-0,71,31,102,0.696,03/07/2016,2016.0
4,Cornell (Ivy League),3,1-2,44,20,64,0.688,03/07/2016,2016.0
5,Saint Joseph's (NEC),4,3-1,69,34,103,0.670,03/07/2016,2016.0
6,Army West Point (Patriot),5,3-2,75,39,114,0.658,03/07/2016,2016.0
7,Hartford (America East),4,2-2,67,35,102,0.657,03/07/2016,2016.0
8,Villanova (Big East),4,3-1,81,44,125,0.648,03/07/2016,2016.0
9,Notre Dame (ACC),4,4-0,52,29,81,0.642,03/07/2016,2016.0
10,Ohio St. (Big Ten),6,5-1,81,51,132,0.614,03/07/2016,2016.0
10,Boston U. (Patriot),6,5-1,81,51,132,0.614,03/07/2016,2016.0
12,Hofstra (CAA),4,3-1,54,35,89,0.607,03/07/2016,2016.0
13,Marquette (Big East),4,3-1,45,30,75,0.600,03/07/2016,2016.0
13,Maryland (Big Ten),3,1-2,36,24,60,0.600,03/07/2016,2016.0
15,Jacksonville (SoCon),5,2-3,75,51,126,0.595,03/07/2016,2016.0
16,Towson (CAA),5,5-0,56,39,95,0.589,03/07/2016,2016.0
17,Hobart (NEC),4,2-2,58,41,99,0.586,03/07/2016,2016.0
18,Johns Hopkins (Big Ten),4,2-2,58,43,101,0.574,03/07/2016,2016.0
19,Virginia (ACC),5,2-3,70,53,123,0.569,03/07/2016,2016.0
20,Binghamton (America East),3,0-3,34,27,61,0.557,03/07/2016,2016.0
21,Duke (ACC),7,4-3,107,85,192,0.557,03/07/2016,2016.0
22,Yale (Ivy League),3,3-0,36,29,65,0.554,03/07/2016,2016.0
23,Air Force (SoCon),6,4-2,73,59,132,0.553,03/07/2016,2016.0
24,Navy (Patriot),5,3-2,54,44,98,0.551,03/07/2016,2016.0
25,Bucknell (Patriot),5,3-2,65,54,119,0.546,03/07/2016,2016.0
26,Rutgers (Big Ten),5,5-0,71,60,131,0.542,03/07/2016,2016.0
27,High Point (SoCon),6,3-3,83,71,154,0.539,03/07/2016,2016.0
28,Bellarmine (SoCon),6,2-4,61,54,115,0.530,03/07/2016,2016.0
29,Quinnipiac (MAAC),3,2-1,37,33,70,0.529,03/07/2016,2016.0
30,Delaware (CAA),6,1-5,75,67,142,0.528,03/07/2016,2016.0
31,Richmond (SoCon),6,5-1,60,54,114,0.526,03/07/2016,2016.0
32,Vermont (America East),5,2-3,73,67,140,0.521,03/07/2016,2016.0
33,North Carolina (ACC),5,3-2,67,62,129,0.519,03/07/2016,2016.0
34,Bryant (NEC),5,3-2,64,60,124,0.516,03/07/2016,2016.0
35,Michigan (Big Ten),5,3-2,67,64,131,0.511,03/07/2016,2016.0
36,Fairfield (CAA),5,1-4,56,57,113,0.496,03/07/2016,2016.0
37,Loyola Maryland (Patriot),5,4-1,52,54,106,0.491,03/07/2016,2016.0
38,Furman (SoCon),4,0-4,42,45,87,0.483,03/07/2016,2016.0
39,Holy Cross (Patriot),5,0-5,59,64,123,0.480,03/07/2016,2016.0
40,Sacred Heart (NEC),6,2-4,71,78,149,0.477,03/07/2016,2016.0
41,Mercer (SoCon),4,2-2,43,50,93,0.462,03/07/2016,2016.0
42,Stony Brook (America East),4,3-1,47,55,102,0.461,03/07/2016,2016.0
43,St. John's (NY) (Big East),5,1-4,57,69,126,0.452,03/07/2016,2016.0
44,Wagner (NEC),5,2-3,47,57,104,0.452,03/07/2016,2016.0
45,Lafayette (Patriot),4,1-3,41,50,91,0.451,03/07/2016,2016.0
46,Lehigh (Patriot),5,4-1,58,71,129,0.450,03/07/2016,2016.0
47,Mount St. Mary's (NEC),5,3-2,46,57,103,0.447,03/07/2016,2016.0
48,Colgate (Patriot),4,2-2,39,49,88,0.443,03/07/2016,2016.0
49,Siena (MAAC),5,1-4,54,69,123,0.439,03/07/2016,2016.0
50,Penn St. (Big Ten),5,3-2,59,76,135,0.437,03/07/2016,2016.0
51,UAlbany (America East),3,2-1,38,51,89,0.427,03/07/2016,2016.0
52,Princeton (Ivy League),3,1-2,34,48,82,0.415,03/07/2016,2016.0
53,Massachusetts (CAA),5,2-3,44,63,107,0.411,03/07/2016,2016.0
54,Providence (Big East),5,3-2,46,66,112,0.411,03/07/2016,2016.0
55,Georgetown (Big East),4,1-3,34,52,86,0.395,03/07/2016,2016.0
56,Robert Morris (NEC),5,1-4,54,83,137,0.394,03/07/2016,2016.0
57,NJIT (Independent),6,0-6,58,91,149,0.389,03/07/2016,2016.0
58,Harvard (Ivy League),4,4-0,40,63,103,0.388,03/07/2016,2016.0
59,VMI (SoCon),5,1-4,43,70,113,0.381,03/07/2016,2016.0
60,Dartmouth (Ivy League),4,0-4,30,50,80,0.375,03/07/2016,2016.0
61,UMBC (America East),3,0-3,23,39,62,0.371,03/07/2016,2016.0
62,Penn (Ivy League),3,2-1,26,48,74,0.351,03/07/2016,2016.0
63,Canisius (MAAC),1,0-1,7,13,20,0.350,03/07/2016,2016.0
64,Monmouth (MAAC),3,2-1,19,37,56,0.339,03/07/2016,2016.0
65,Drexel (CAA),4,1-3,33,78,111,0.297,03/07/2016,2016.0
66,Detroit Mercy (MAAC),5,0-5,29,72,101,0.287,03/07/2016,2016.0
67,Manhattan (MAAC),5,0-5,36,95,131,0.275,03/07/2016,2016.0
68,Marist (MAAC),3,1-2,15,49,64,0.234,03/07/2016,2016.0
-,UMass Lowell (America East),5,1-4,30,87,117,0.256,03/07/2016,2016.0
1,Brown (Ivy League),3,3-0,61,26,87,0.701,03/06/2016,2016.0
2,Denver (Big East),5,5-0,93,40,133,0.699,03/06/2016,2016.0
3,Syracuse (ACC),4,4-0,71,31,102,0.696,03/06/2016,2016.0
4,Cornell (Ivy League),3,1-2,44,20,64,0.688,03/06/2016,2016.0
5,Saint Joseph's (NEC),4,3-1,69,34,103,0.670,03/06/2016,2016.0
6,Army West Point (Patriot),5,3-2,75,39,114,0.658,03/06/2016,2016.0
7,Hartford (America East),4,2-2,67,35,102,0.657,03/06/2016,2016.0
8,Villanova (Big East),4,3-1,81,44,125,0.648,03/06/2016,2016.0
9,Notre Dame (ACC),4,4-0,52,29,81,0.642,03/06/2016,2016.0
10,Boston U. (Patriot),6,5-1,81,51,132,0.614,03/06/2016,2016.0
10,Ohio St. (Big Ten),6,5-1,81,51,132,0.614,03/06/2016,2016.0
12,Hofstra (CAA),4,3-1,54,35,89,0.607,03/06/2016,2016.0
13,Marquette (Big East),4,3-1,45,30,75,0.600,03/06/2016,2016.0
13,Maryland (Big Ten),3,1-2,36,24,60,0.600,03/06/2016,2016.0
15,Richmond (SoCon),5,4-1,53,36,89,0.596,03/06/2016,2016.0
16,Jacksonville (SoCon),5,2-3,75,51,126,0.595,03/06/2016,2016.0
17,Towson (CAA),5,5-0,56,39,95,0.589,03/06/2016,2016.0
18,Hobart (NEC),4,2-2,58,41,99,0.586,03/06/2016,2016.0
19,Johns Hopkins (Big Ten),4,2-2,58,43,101,0.574,03/06/2016,2016.0
20,Virginia (ACC),5,2-3,70,53,123,0.569,03/06/2016,2016.0
21,Binghamton (America East),3,0-3,34,27,61,0.557,03/06/2016,2016.0
22,Yale (Ivy League),3,3-0,36,29,65,0.554,03/06/2016,2016.0
23,Air Force (SoCon),6,4-2,73,59,132,0.553,03/06/2016,2016.0
24,Navy (Patriot),5,3-2,54,44,98,0.551,03/06/2016,2016.0
25,Bucknell (Patriot),5,3-2,65,54,119,0.546,03/06/2016,2016.0
26,Rutgers (Big Ten),5,5-0,71,60,131,0.542,03/06/2016,2016.0
27,High Point (SoCon),6,3-3,83,71,154,0.539,03/06/2016,2016.0
28,Duke (ACC),6,4-2,89,78,167,0.533,03/06/2016,2016.0
29,Bellarmine (SoCon),6,2-4,61,54,115,0.530,03/06/2016,2016.0
30,Quinnipiac (MAAC),3,2-1,37,33,70,0.529,03/06/2016,2016.0
31,Delaware (CAA),6,1-5,75,67,142,0.528,03/06/2016,2016.0
32,Vermont (America East),5,2-3,73,67,140,0.521,03/06/2016,2016.0
33,North Carolina (ACC),5,3-2,67,62,129,0.519,03/06/2016,2016.0
34,Bryant (NEC),5,3-2,64,60,124,0.516,03/06/2016,2016.0
35,Michigan (Big Ten),5,3-2,67,64,131,0.511,03/06/2016,2016.0
36,Fairfield (CAA),5,1-4,56,57,113,0.496,03/06/2016,2016.0
37,Loyola Maryland (Patriot),5,4-1,52,54,106,0.491,03/06/2016,2016.0
38,Furman (SoCon),4,0-4,42,45,87,0.483,03/06/2016,2016.0
39,Holy Cross (Patriot),5,0-5,59,64,123,0.480,03/06/2016,2016.0
40,Sacred Heart (NEC),6,2-4,71,78,149,0.477,03/06/2016,2016.0
41,Mercer (SoCon),4,2-2,43,50,93,0.462,03/06/2016,2016.0
42,Stony Brook (America East),4,3-1,47,55,102,0.461,03/06/2016,2016.0
43,St. John's (NY) (Big East),5,1-4,57,69,126,0.452,03/06/2016,2016.0
44,Wagner (NEC),5,2-3,47,57,104,0.452,03/06/2016,2016.0
45,Lafayette (Patriot),4,1-3,41,50,91,0.451,03/06/2016,2016.0
46,Lehigh (Patriot),5,4-1,58,71,129,0.450,03/06/2016,2016.0
47,Mount St. Mary's (NEC),5,3-2,46,57,103,0.447,03/06/2016,2016.0
48,Colgate (Patriot),4,2-2,39,49,88,0.443,03/06/2016,2016.0
49,Siena (MAAC),5,1-4,54,69,123,0.439,03/06/2016,2016.0
50,Penn St. (Big Ten),5,3-2,59,76,135,0.437,03/06/2016,2016.0
51,UAlbany (America East),3,2-1,38,51,89,0.427,03/06/2016,2016.0
52,Princeton (Ivy League),3,1-2,34,48,82,0.415,03/06/2016,2016.0
53,Massachusetts (CAA),5,2-3,44,63,107,0.411,03/06/2016,2016.0
54,Providence (Big East),5,3-2,46,66,112,0.411,03/06/2016,2016.0
55,Georgetown (Big East),4,1-3,34,52,86,0.395,03/06/2016,2016.0
56,Robert Morris (NEC),5,1-4,54,83,137,0.394,03/06/2016,2016.0
57,NJIT (Independent),6,0-6,58,91,149,0.389,03/06/2016,2016.0
58,Harvard (Ivy League),4,4-0,40,63,103,0.388,03/06/2016,2016.0
59,VMI (SoCon),5,1-4,43,70,113,0.381,03/06/2016,2016.0
60,Dartmouth (Ivy League),4,0-4,30,50,80,0.375,03/06/2016,2016.0
61,UMBC (America East),3,0-3,23,39,62,0.371,03/06/2016,2016.0
62,Penn (Ivy League),3,2-1,26,48,74,0.351,03/06/2016,2016.0
63,Canisius (MAAC),1,0-1,7,13,20,0.350,03/06/2016,2016.0
64,Monmouth (MAAC),3,2-1,19,37,56,0.339,03/06/2016,2016.0
65,Drexel (CAA),4,1-3,33,78,111,0.297,03/06/2016,2016.0
66,Detroit Mercy (MAAC),5,0-5,29,72,101,0.287,03/06/2016,2016.0
67,Manhattan (MAAC),5,0-5,36,95,131,0.275,03/06/2016,2016.0
68,Marist (MAAC),3,1-2,15,49,64,0.234,03/06/2016,2016.0
-,UMass Lowell (America East),5,1-4,30,87,117,0.256,03/06/2016,2016.0
1,Villanova (Big East),3,2-1,65,22,87,0.747,03/04/2016,2016.0
2,Syracuse (ACC),4,4-0,71,31,102,0.696,03/04/2016,2016.0
3,Brown (Ivy League),2,2-0,43,19,62,0.694,03/04/2016,2016.0
4,Denver (Big East),4,4-0,72,33,105,0.686,03/04/2016,2016.0
5,Binghamton (America East),2,0-2,27,13,40,0.675,03/04/2016,2016.0
6,Notre Dame (ACC),3,3-0,43,21,64,0.672,03/04/2016,2016.0
7,Maryland (Big Ten),2,1-1,28,15,43,0.651,03/04/2016,2016.0
8,Army West Point (Patriot),4,2-2,58,34,92,0.630,03/04/2016,2016.0
9,Saint Joseph's (NEC),3,3-0,51,30,81,0.630,03/04/2016,2016.0
10,Ohio St. (Big Ten),5,4-1,73,43,116,0.629,03/04/2016,2016.0
11,Richmond (SoCon),4,3-1,44,26,70,0.629,03/04/2016,2016.0
12,Cornell (Ivy League),2,1-1,25,15,40,0.625,03/04/2016,2016.0
13,Bucknell (Patriot),4,3-1,59,37,96,0.615,03/04/2016,2016.0
14,Boston U. (Patriot),5,4-1,68,44,112,0.607,03/04/2016,2016.0
15,Hofstra (CAA),3,3-0,41,27,68,0.603,03/04/2016,2016.0
16,North Carolina (ACC),4,3-1,60,41,101,0.594,03/04/2016,2016.0
17,Hartford (America East),3,1-2,46,32,78,0.590,03/04/2016,2016.0
18,Towson (CAA),4,4-0,41,31,72,0.569,03/04/2016,2016.0
19,Virginia (ACC),5,2-3,70,53,123,0.569,03/04/2016,2016.0
20,Hobart (NEC),3,1-2,44,34,78,0.564,03/04/2016,2016.0
21,Bryant (NEC),4,3-1,58,45,103,0.563,03/04/2016,2016.0
22,Jacksonville (SoCon),4,2-2,55,46,101,0.545,03/04/2016,2016.0
23,Duke (ACC),5,4-1,76,64,140,0.543,03/04/2016,2016.0
24,Vermont (America East),4,2-2,58,50,108,0.537,03/04/2016,2016.0
25,Bellarmine (SoCon),5,2-3,53,46,99,0.535,03/04/2016,2016.0
26,Lafayette (Patriot),3,1-2,36,33,69,0.522,03/04/2016,2016.0
27,Johns Hopkins (Big Ten),3,1-2,38,35,73,0.521,03/04/2016,2016.0
28,Holy Cross (Patriot),4,0-4,51,49,100,0.510,03/04/2016,2016.0
29,Delaware (CAA),5,1-4,53,51,104,0.510,03/04/2016,2016.0
30,UAlbany (America East),2,1-1,33,32,65,0.508,03/04/2016,2016.0
31,Michigan (Big Ten),4,2-2,50,49,99,0.505,03/04/2016,2016.0
32,High Point (SoCon),5,2-3,65,66,131,0.496,03/04/2016,2016.0
33,Air Force (SoCon),5,3-2,52,53,105,0.495,03/04/2016,2016.0
34,Fairfield (CAA),4,1-3,47,48,95,0.495,03/04/2016,2016.0
35,Navy (Patriot),4,2-2,37,38,75,0.493,03/04/2016,2016.0
36,Wagner (NEC),4,1-3,42,45,87,0.483,03/04/2016,2016.0
37,Rutgers (Big Ten),4,4-0,53,57,110,0.482,03/04/2016,2016.0
38,Princeton (Ivy League),2,1-1,26,28,54,0.481,03/04/2016,2016.0
39,Quinnipiac (MAAC),2,1-1,24,26,50,0.480,03/04/2016,2016.0
40,Yale (Ivy League),2,2-0,21,23,44,0.477,03/04/2016,2016.0
41,Marquette (Big East),3,2-1,26,29,55,0.473,03/04/2016,2016.0
42,Mercer (SoCon),4,2-2,43,50,93,0.462,03/04/2016,2016.0
43,Mount St. Mary's (NEC),4,2-2,38,45,83,0.458,03/04/2016,2016.0
44,Monmouth (MAAC),2,2-0,16,19,35,0.457,03/04/2016,2016.0
45,Sacred Heart (NEC),5,2-3,58,69,127,0.457,03/04/2016,2016.0
46,Stony Brook (America East),3,2-1,38,46,84,0.452,03/04/2016,2016.0
47,Massachusetts (CAA),4,2-2,37,45,82,0.451,03/04/2016,2016.0
48,Siena (MAAC),4,1-3,45,55,100,0.450,03/04/2016,2016.0
49,Furman (SoCon),3,0-3,30,37,67,0.448,03/04/2016,2016.0
50,Loyola Maryland (Patriot),4,3-1,37,46,83,0.446,03/04/2016,2016.0
51,Robert Morris (NEC),4,1-3,48,62,110,0.436,03/04/2016,2016.0
52,Lehigh (Patriot),4,3-1,45,59,104,0.433,03/04/2016,2016.0
53,Colgate (Patriot),3,2-1,27,36,63,0.429,03/04/2016,2016.0
54,St. John's (NY) (Big East),4,0-4,43,60,103,0.417,03/04/2016,2016.0
55,Providence (Big East),4,2-2,37,53,90,0.411,03/04/2016,2016.0
56,Georgetown (Big East),3,0-3,26,39,65,0.400,03/04/2016,2016.0
57,NJIT (Independent),5,0-5,51,78,129,0.395,03/04/2016,2016.0
58,Penn St. (Big Ten),4,3-1,44,69,113,0.389,03/04/2016,2016.0
59,UMBC (America East),2,0-2,15,24,39,0.385,03/04/2016,2016.0
60,Penn (Ivy League),2,1-1,19,33,52,0.365,03/04/2016,2016.0
61,VMI (SoCon),4,1-3,33,61,94,0.351,03/04/2016,2016.0
62,Detroit Mercy (MAAC),4,0-4,28,53,81,0.346,03/04/2016,2016.0
63,Harvard (Ivy League),3,3-0,26,50,76,0.342,03/04/2016,2016.0
64,Drexel (CAA),3,0-3,29,60,89,0.326,03/04/2016,2016.0
65,Manhattan (MAAC),4,0-4,33,74,107,0.308,03/04/2016,2016.0
66,Dartmouth (Ivy League),3,0-3,18,45,63,0.286,03/04/2016,2016.0
67,Marist (MAAC),2,1-1,10,31,41,0.244,03/04/2016,2016.0
-,UMass Lowell (America East),4,0-4,25,67,92,0.272,03/04/2016,2016.0
1,Villanova (Big East),3,2-1,65,22,87,0.747,03/02/2016,2016.0
2,Syracuse (ACC),3,3-0,53,20,73,0.726,03/02/2016,2016.0
3,Brown (Ivy League),2,2-0,43,19,62,0.694,03/02/2016,2016.0
4,Denver (Big East),4,4-0,72,33,105,0.686,03/02/2016,2016.0
5,Binghamton (America East),2,0-2,27,13,40,0.675,03/02/2016,2016.0
6,Notre Dame (ACC),3,3-0,43,21,64,0.672,03/02/2016,2016.0
7,Ohio St. (Big Ten),4,3-1,60,32,92,0.652,03/02/2016,2016.0
8,Maryland (Big Ten),2,1-1,28,15,43,0.651,03/02/2016,2016.0
9,Army West Point (Patriot),4,2-2,58,34,92,0.630,03/02/2016,2016.0
10,Saint Joseph's (NEC),3,3-0,51,30,81,0.630,03/02/2016,2016.0
11,Richmond (SoCon),4,3-1,44,26,70,0.629,03/02/2016,2016.0
12,Virginia (ACC),4,2-2,59,35,94,0.628,03/02/2016,2016.0
13,Cornell (Ivy League),2,1-1,25,15,40,0.625,03/02/2016,2016.0
14,Bucknell (Patriot),4,3-1,59,37,96,0.615,03/02/2016,2016.0
15,Boston U. (Patriot),5,4-1,68,44,112,0.607,03/02/2016,2016.0
16,Hofstra (CAA),3,3-0,41,27,68,0.603,03/02/2016,2016.0
17,North Carolina (ACC),4,3-1,60,41,101,0.594,03/02/2016,2016.0
18,Hartford (America East),3,1-2,46,32,78,0.590,03/02/2016,2016.0
19,Towson (CAA),4,4-0,41,31,72,0.569,03/02/2016,2016.0
20,Hobart (NEC),3,1-2,44,34,78,0.564,03/02/2016,2016.0
21,Bryant (NEC),4,3-1,58,45,103,0.563,03/02/2016,2016.0
22,Jacksonville (SoCon),4,2-2,55,46,101,0.545,03/02/2016,2016.0
23,Duke (ACC),5,4-1,76,64,140,0.543,03/02/2016,2016.0
24,Vermont (America East),4,2-2,58,50,108,0.537,03/02/2016,2016.0
25,Bellarmine (SoCon),4,1-3,44,40,84,0.524,03/02/2016,2016.0
26,Lafayette (Patriot),3,1-2,36,33,69,0.522,03/02/2016,2016.0
27,Johns Hopkins (Big Ten),3,1-2,38,35,73,0.521,03/02/2016,2016.0
28,Holy Cross (Patriot),4,0-4,51,49,100,0.510,03/02/2016,2016.0
29,Delaware (CAA),5,1-4,53,51,104,0.510,03/02/2016,2016.0
30,UAlbany (America East),2,1-1,33,32,65,0.508,03/02/2016,2016.0
31,Michigan (Big Ten),4,2-2,50,49,99,0.505,03/02/2016,2016.0
32,High Point (SoCon),5,2-3,65,66,131,0.496,03/02/2016,2016.0
33,Air Force (SoCon),5,3-2,52,53,105,0.495,03/02/2016,2016.0
34,Fairfield (CAA),4,1-3,47,48,95,0.495,03/02/2016,2016.0
35,Navy (Patriot),4,2-2,37,38,75,0.493,03/02/2016,2016.0
36,Marquette (Big East),2,2-0,15,16,31,0.484,03/02/2016,2016.0
37,Wagner (NEC),4,1-3,42,45,87,0.483,03/02/2016,2016.0
38,Rutgers (Big Ten),4,4-0,53,57,110,0.482,03/02/2016,2016.0
39,Princeton (Ivy League),2,1-1,26,28,54,0.481,03/02/2016,2016.0
40,Quinnipiac (MAAC),2,1-1,24,26,50,0.480,03/02/2016,2016.0
41,Yale (Ivy League),2,2-0,21,23,44,0.477,03/02/2016,2016.0
42,Mercer (SoCon),4,2-2,43,50,93,0.462,03/02/2016,2016.0
43,Mount St. Mary's (NEC),4,2-2,38,45,83,0.458,03/02/2016,2016.0
44,Monmouth (MAAC),2,2-0,16,19,35,0.457,03/02/2016,2016.0
45,Sacred Heart (NEC),5,2-3,58,69,127,0.457,03/02/2016,2016.0
46,Stony Brook (America East),3,2-1,38,46,84,0.452,03/02/2016,2016.0
47,Massachusetts (CAA),4,2-2,37,45,82,0.451,03/02/2016,2016.0
48,Siena (MAAC),4,1-3,45,55,100,0.450,03/02/2016,2016.0
49,Furman (SoCon),3,0-3,30,37,67,0.448,03/02/2016,2016.0
50,Loyola Maryland (Patriot),4,3-1,37,46,83,0.446,03/02/2016,2016.0
51,Robert Morris (NEC),4,1-3,48,62,110,0.436,03/02/2016,2016.0
52,Lehigh (Patriot),4,3-1,45,59,104,0.433,03/02/2016,2016.0
53,Colgate (Patriot),3,2-1,27,36,63,0.429,03/02/2016,2016.0
54,St. John's (NY) (Big East),4,0-4,43,60,103,0.417,03/02/2016,2016.0
55,Providence (Big East),4,2-2,37,53,90,0.411,03/02/2016,2016.0
56,Georgetown (Big East),3,0-3,26,39,65,0.400,03/02/2016,2016.0
57,NJIT (Independent),5,0-5,51,78,129,0.395,03/02/2016,2016.0
58,Penn St. (Big Ten),4,3-1,44,69,113,0.389,03/02/2016,2016.0
59,UMBC (America East),2,0-2,15,24,39,0.385,03/02/2016,2016.0
60,Penn (Ivy League),2,1-1,19,33,52,0.365,03/02/2016,2016.0
61,VMI (SoCon),4,1-3,33,61,94,0.351,03/02/2016,2016.0
62,Harvard (Ivy League),3,3-0,26,50,76,0.342,03/02/2016,2016.0
63,Detroit Mercy (MAAC),3,0-3,22,44,66,0.333,03/02/2016,2016.0
64,Drexel (CAA),3,0-3,29,60,89,0.326,03/02/2016,2016.0
65,Manhattan (MAAC),4,0-4,33,74,107,0.308,03/02/2016,2016.0
66,Dartmouth (Ivy League),3,0-3,18,45,63,0.286,03/02/2016,2016.0
67,Marist (MAAC),2,1-1,10,31,41,0.244,03/02/2016,2016.0
-,UMass Lowell (America East),4,0-4,25,67,92,0.272,03/02/2016,2016.0
1,Villanova (Big East),3,2-1,65,22,87,0.747,03/01/2016,2016.0
2,Syracuse (ACC),3,3-0,53,20,73,0.726,03/01/2016,2016.0
3,Saint Joseph's (NEC),2,2-0,37,16,53,0.698,03/01/2016,2016.0
4,Brown (Ivy League),2,2-0,43,19,62,0.694,03/01/2016,2016.0
5,Denver (Big East),4,4-0,72,33,105,0.686,03/01/2016,2016.0
6,Binghamton (America East),2,0-2,27,13,40,0.675,03/01/2016,2016.0
7,Notre Dame (ACC),3,3-0,43,21,64,0.672,03/01/2016,2016.0
8,Ohio St. (Big Ten),4,3-1,60,32,92,0.652,03/01/2016,2016.0
9,Maryland (Big Ten),2,1-1,28,15,43,0.651,03/01/2016,2016.0
10,Army West Point (Patriot),4,2-2,58,34,92,0.630,03/01/2016,2016.0
11,Richmond (SoCon),4,3-1,44,26,70,0.629,03/01/2016,2016.0
12,Virginia (ACC),4,2-2,59,35,94,0.628,03/01/2016,2016.0
13,Cornell (Ivy League),2,1-1,25,15,40,0.625,03/01/2016,2016.0
14,Bucknell (Patriot),4,3-1,59,37,96,0.615,03/01/2016,2016.0
15,Boston U. (Patriot),5,4-1,68,44,112,0.607,03/01/2016,2016.0
16,Hofstra (CAA),3,3-0,41,27,68,0.603,03/01/2016,2016.0
17,North Carolina (ACC),4,3-1,60,41,101,0.594,03/01/2016,2016.0
18,Hartford (America East),3,1-2,46,32,78,0.590,03/01/2016,2016.0
19,Towson (CAA),3,3-0,29,22,51,0.569,03/01/2016,2016.0
20,Hobart (NEC),3,1-2,44,34,78,0.564,03/01/2016,2016.0
21,Bryant (NEC),4,3-1,58,45,103,0.563,03/01/2016,2016.0
22,Jacksonville (SoCon),4,2-2,55,46,101,0.545,03/01/2016,2016.0
23,Duke (ACC),5,4-1,76,64,140,0.543,03/01/2016,2016.0
24,Vermont (America East),4,2-2,58,50,108,0.537,03/01/2016,2016.0
25,Bellarmine (SoCon),4,1-3,44,40,84,0.524,03/01/2016,2016.0
26,Lafayette (Patriot),3,1-2,36,33,69,0.522,03/01/2016,2016.0
27,Johns Hopkins (Big Ten),3,1-2,38,35,73,0.521,03/01/2016,2016.0
28,Holy Cross (Patriot),4,0-4,51,49,100,0.510,03/01/2016,2016.0
29,Delaware (CAA),5,1-4,53,51,104,0.510,03/01/2016,2016.0
30,UAlbany (America East),2,1-1,33,32,65,0.508,03/01/2016,2016.0
31,Michigan (Big Ten),4,2-2,50,49,99,0.505,03/01/2016,2016.0
32,High Point (SoCon),5,2-3,65,66,131,0.496,03/01/2016,2016.0
33,Air Force (SoCon),5,3-2,52,53,105,0.495,03/01/2016,2016.0
34,Fairfield (CAA),4,1-3,47,48,95,0.495,03/01/2016,2016.0
35,Navy (Patriot),4,2-2,37,38,75,0.493,03/01/2016,2016.0
36,Marquette (Big East),2,2-0,15,16,31,0.484,03/01/2016,2016.0
37,Wagner (NEC),4,1-3,42,45,87,0.483,03/01/2016,2016.0
38,Rutgers (Big Ten),4,4-0,53,57,110,0.482,03/01/2016,2016.0
39,Princeton (Ivy League),2,1-1,26,28,54,0.481,03/01/2016,2016.0
40,Quinnipiac (MAAC),2,1-1,24,26,50,0.480,03/01/2016,2016.0
41,Yale (Ivy League),2,2-0,21,23,44,0.477,03/01/2016,2016.0
42,Mercer (SoCon),4,2-2,43,50,93,0.462,03/01/2016,2016.0
43,Mount St. Mary's (NEC),4,2-2,38,45,83,0.458,03/01/2016,2016.0
44,Monmouth (MAAC),2,2-0,16,19,35,0.457,03/01/2016,2016.0
45,Sacred Heart (NEC),5,2-3,58,69,127,0.457,03/01/2016,2016.0
46,Stony Brook (America East),3,2-1,38,46,84,0.452,03/01/2016,2016.0
47,Loyola Maryland (Patriot),3,3-0,28,34,62,0.452,03/01/2016,2016.0
48,Massachusetts (CAA),4,2-2,37,45,82,0.451,03/01/2016,2016.0
49,Siena (MAAC),4,1-3,45,55,100,0.450,03/01/2016,2016.0
50,Furman (SoCon),3,0-3,30,37,67,0.448,03/01/2016,2016.0
51,Robert Morris (NEC),4,1-3,48,62,110,0.436,03/01/2016,2016.0
52,Lehigh (Patriot),4,3-1,45,59,104,0.433,03/01/2016,2016.0
53,Colgate (Patriot),3,2-1,27,36,63,0.429,03/01/2016,2016.0
54,Providence (Big East),4,2-2,37,53,90,0.411,03/01/2016,2016.0
55,Georgetown (Big East),3,0-3,26,39,65,0.400,03/01/2016,2016.0
56,NJIT (Independent),5,0-5,51,78,129,0.395,03/01/2016,2016.0
57,Penn St. (Big Ten),4,3-1,44,69,113,0.389,03/01/2016,2016.0
58,St. John's (NY) (Big East),3,0-3,29,46,75,0.387,03/01/2016,2016.0
59,UMBC (America East),2,0-2,15,24,39,0.385,03/01/2016,2016.0
60,Penn (Ivy League),2,1-1,19,33,52,0.365,03/01/2016,2016.0
61,VMI (SoCon),4,1-3,33,61,94,0.351,03/01/2016,2016.0
62,Harvard (Ivy League),3,3-0,26,50,76,0.342,03/01/2016,2016.0
63,Detroit Mercy (MAAC),3,0-3,22,44,66,0.333,03/01/2016,2016.0
64,Drexel (CAA),3,0-3,29,60,89,0.326,03/01/2016,2016.0
65,Manhattan (MAAC),4,0-4,33,74,107,0.308,03/01/2016,2016.0
66,Dartmouth (Ivy League),3,0-3,18,45,63,0.286,03/01/2016,2016.0
67,Marist (MAAC),2,1-1,10,31,41,0.244,03/01/2016,2016.0
-,UMass Lowell (America East),4,0-4,25,67,92,0.272,03/01/2016,2016.0
1,Villanova (Big East),2,1-1,47,14,61,0.770,02/29/2016,2016.0
2,Syracuse (ACC),3,3-0,53,20,73,0.726,02/29/2016,2016.0
3,Saint Joseph's (NEC),2,2-0,37,16,53,0.698,02/29/2016,2016.0
4,Brown (Ivy League),2,2-0,43,19,62,0.694,02/29/2016,2016.0
5,Denver (Big East),4,4-0,72,33,105,0.686,02/29/2016,2016.0
6,Binghamton (America East),2,0-2,27,13,40,0.675,02/29/2016,2016.0
7,Notre Dame (ACC),3,3-0,43,21,64,0.672,02/29/2016,2016.0
8,Ohio St. (Big Ten),4,3-1,60,32,92,0.652,02/29/2016,2016.0
9,Maryland (Big Ten),2,1-1,28,15,43,0.651,02/29/2016,2016.0
10,Army West Point (Patriot),4,2-2,58,34,92,0.630,02/29/2016,2016.0
11,Richmond (SoCon),4,3-1,44,26,70,0.629,02/29/2016,2016.0
12,Virginia (ACC),4,2-2,59,35,94,0.628,02/29/2016,2016.0
13,Cornell (Ivy League),2,1-1,25,15,40,0.625,02/29/2016,2016.0
14,Bucknell (Patriot),4,3-1,59,37,96,0.615,02/29/2016,2016.0
15,Boston U. (Patriot),5,4-1,68,44,112,0.607,02/29/2016,2016.0
16,North Carolina (ACC),4,3-1,60,41,101,0.594,02/29/2016,2016.0
17,Hartford (America East),2,1-1,35,25,60,0.583,02/29/2016,2016.0
18,Towson (CAA),3,3-0,29,22,51,0.569,02/29/2016,2016.0
19,Hobart (NEC),3,1-2,44,34,78,0.564,02/29/2016,2016.0
20,Bryant (NEC),4,3-1,58,45,103,0.563,02/29/2016,2016.0
21,Hofstra (CAA),2,2-0,23,18,41,0.561,02/29/2016,2016.0
22,Jacksonville (SoCon),4,2-2,55,46,101,0.545,02/29/2016,2016.0
23,Duke (ACC),5,4-1,76,64,140,0.543,02/29/2016,2016.0
24,Vermont (America East),4,2-2,58,50,108,0.537,02/29/2016,2016.0
25,Bellarmine (SoCon),4,1-3,44,40,84,0.524,02/29/2016,2016.0
26,Lafayette (Patriot),3,1-2,36,33,69,0.522,02/29/2016,2016.0
27,Johns Hopkins (Big Ten),3,1-2,38,35,73,0.521,02/29/2016,2016.0
28,Holy Cross (Patriot),4,0-4,51,49,100,0.510,02/29/2016,2016.0
29,UAlbany (America East),2,1-1,33,32,65,0.508,02/29/2016,2016.0
30,Michigan (Big Ten),4,2-2,50,49,99,0.505,02/29/2016,2016.0
31,High Point (SoCon),5,2-3,65,66,131,0.496,02/29/2016,2016.0
32,Air Force (SoCon),5,3-2,52,53,105,0.495,02/29/2016,2016.0
33,Navy (Patriot),4,2-2,37,38,75,0.493,02/29/2016,2016.0
34,Wagner (NEC),3,1-2,30,31,61,0.492,02/29/2016,2016.0
35,Marquette (Big East),2,2-0,15,16,31,0.484,02/29/2016,2016.0
36,Princeton (Ivy League),2,1-1,26,28,54,0.481,02/29/2016,2016.0
37,Quinnipiac (MAAC),2,1-1,24,26,50,0.480,02/29/2016,2016.0
38,Yale (Ivy League),2,2-0,21,23,44,0.477,02/29/2016,2016.0
39,Delaware (CAA),4,0-4,38,42,80,0.475,02/29/2016,2016.0
40,Massachusetts (CAA),3,1-2,30,34,64,0.469,02/29/2016,2016.0
41,Rutgers (Big Ten),3,3-0,39,45,84,0.464,02/29/2016,2016.0
42,Mercer (SoCon),4,2-2,43,50,93,0.462,02/29/2016,2016.0
43,Monmouth (MAAC),2,2-0,16,19,35,0.457,02/29/2016,2016.0
44,Sacred Heart (NEC),5,2-3,58,69,127,0.457,02/29/2016,2016.0
45,Stony Brook (America East),3,2-1,38,46,84,0.452,02/29/2016,2016.0
46,Loyola Maryland (Patriot),3,3-0,28,34,62,0.452,02/29/2016,2016.0
47,Siena (MAAC),4,1-3,45,55,100,0.450,02/29/2016,2016.0
47,Mount St. Mary's (NEC),3,1-2,27,33,60,0.450,02/29/2016,2016.0
49,Furman (SoCon),3,0-3,30,37,67,0.448,02/29/2016,2016.0
50,Robert Morris (NEC),4,1-3,48,62,110,0.436,02/29/2016,2016.0
51,Lehigh (Patriot),4,3-1,45,59,104,0.433,02/29/2016,2016.0
52,Colgate (Patriot),3,2-1,27,36,63,0.429,02/29/2016,2016.0
53,NJIT (Independent),4,0-4,42,60,102,0.412,02/29/2016,2016.0
54,Providence (Big East),4,2-2,37,53,90,0.411,02/29/2016,2016.0
55,Penn St. (Big Ten),4,3-1,44,69,113,0.389,02/29/2016,2016.0
56,St. John's (NY) (Big East),3,0-3,29,46,75,0.387,02/29/2016,2016.0
57,Fairfield (CAA),3,0-3,27,43,70,0.386,02/29/2016,2016.0
58,UMBC (America East),2,0-2,15,24,39,0.385,02/29/2016,2016.0
59,Penn (Ivy League),2,1-1,19,33,52,0.365,02/29/2016,2016.0
60,VMI (SoCon),3,1-2,24,46,70,0.343,02/29/2016,2016.0
61,Harvard (Ivy League),3,3-0,26,50,76,0.342,02/29/2016,2016.0
62,Detroit Mercy (MAAC),3,0-3,22,44,66,0.333,02/29/2016,2016.0
62,Drexel (CAA),2,0-2,21,42,63,0.333,02/29/2016,2016.0
62,Georgetown (Big East),2,0-2,14,28,42,0.333,02/29/2016,2016.0
65,Manhattan (MAAC),4,0-4,33,74,107,0.308,02/29/2016,2016.0
66,Dartmouth (Ivy League),3,0-3,18,45,63,0.286,02/29/2016,2016.0
67,Marist (MAAC),2,1-1,10,31,41,0.244,02/29/2016,2016.0
-,UMass Lowell (America East),3,0-3,20,47,67,0.299,02/29/2016,2016.0
1,Villanova (Big East),2,1-1,47,14,61,0.770,02/28/2016,2016.0
2,Syracuse (ACC),3,3-0,53,20,73,0.726,02/28/2016,2016.0
3,Saint Joseph's (NEC),2,2-0,37,16,53,0.698,02/28/2016,2016.0
4,Brown (Ivy League),2,2-0,43,19,62,0.694,02/28/2016,2016.0
5,Denver (Big East),4,4-0,72,33,105,0.686,02/28/2016,2016.0
6,Binghamton (America East),2,0-2,27,13,40,0.675,02/28/2016,2016.0
7,Notre Dame (ACC),3,3-0,43,21,64,0.672,02/28/2016,2016.0
8,Ohio St. (Big Ten),4,3-1,60,32,92,0.652,02/28/2016,2016.0
9,Maryland (Big Ten),2,1-1,28,15,43,0.651,02/28/2016,2016.0
10,Army West Point (Patriot),4,2-2,58,34,92,0.630,02/28/2016,2016.0
11,Richmond (SoCon),4,3-1,44,26,70,0.629,02/28/2016,2016.0
12,Virginia (ACC),4,2-2,59,35,94,0.628,02/28/2016,2016.0
13,Cornell (Ivy League),2,1-1,25,15,40,0.625,02/28/2016,2016.0
14,Bucknell (Patriot),4,3-1,59,37,96,0.615,02/28/2016,2016.0
15,Boston U. (Patriot),5,4-1,68,44,112,0.607,02/28/2016,2016.0
16,North Carolina (ACC),4,3-1,60,41,101,0.594,02/28/2016,2016.0
17,Hartford (America East),2,1-1,35,25,60,0.583,02/28/2016,2016.0
18,Towson (CAA),3,3-0,29,22,51,0.569,02/28/2016,2016.0
19,Hobart (NEC),3,1-2,44,34,78,0.564,02/28/2016,2016.0
20,Bryant (NEC),4,3-1,58,45,103,0.563,02/28/2016,2016.0
21,Hofstra (CAA),2,2-0,23,18,41,0.561,02/28/2016,2016.0
22,Jacksonville (SoCon),4,2-2,55,46,101,0.545,02/28/2016,2016.0
23,Vermont (America East),4,2-2,56,49,105,0.533,02/28/2016,2016.0
24,Duke (ACC),4,3-1,58,51,109,0.532,02/28/2016,2016.0
25,Bellarmine (SoCon),4,1-3,44,40,84,0.524,02/28/2016,2016.0
26,Lafayette (Patriot),3,1-2,36,33,69,0.522,02/28/2016,2016.0
27,Johns Hopkins (Big Ten),3,1-2,38,35,73,0.521,02/28/2016,2016.0
28,Holy Cross (Patriot),4,0-4,51,49,100,0.510,02/28/2016,2016.0
29,UAlbany (America East),2,1-1,33,32,65,0.508,02/28/2016,2016.0
30,Michigan (Big Ten),4,2-2,50,49,99,0.505,02/28/2016,2016.0
31,High Point (SoCon),5,2-3,65,66,131,0.496,02/28/2016,2016.0
32,Air Force (SoCon),5,3-2,52,53,105,0.495,02/28/2016,2016.0
33,Navy (Patriot),4,2-2,37,38,75,0.493,02/28/2016,2016.0
34,Wagner (NEC),3,1-2,30,31,61,0.492,02/28/2016,2016.0
35,Mercer (SoCon),3,2-1,30,32,62,0.484,02/28/2016,2016.0
35,Marquette (Big East),2,2-0,15,16,31,0.484,02/28/2016,2016.0
37,Princeton (Ivy League),2,1-1,26,28,54,0.481,02/28/2016,2016.0
38,Quinnipiac (MAAC),2,1-1,24,26,50,0.480,02/28/2016,2016.0
39,Yale (Ivy League),2,2-0,21,23,44,0.477,02/28/2016,2016.0
40,Delaware (CAA),4,0-4,38,42,80,0.475,02/28/2016,2016.0
41,Massachusetts (CAA),3,1-2,30,34,64,0.469,02/28/2016,2016.0
42,Rutgers (Big Ten),3,3-0,39,45,84,0.464,02/28/2016,2016.0
43,Monmouth (MAAC),2,2-0,16,19,35,0.457,02/28/2016,2016.0
44,Sacred Heart (NEC),5,2-3,58,69,127,0.457,02/28/2016,2016.0
45,Stony Brook (America East),3,2-1,38,46,84,0.452,02/28/2016,2016.0
46,Loyola Maryland (Patriot),3,3-0,28,34,62,0.452,02/28/2016,2016.0
47,Siena (MAAC),4,1-3,45,55,100,0.450,02/28/2016,2016.0
47,Mount St. Mary's (NEC),3,1-2,27,33,60,0.450,02/28/2016,2016.0
49,Furman (SoCon),3,0-3,30,37,67,0.448,02/28/2016,2016.0
50,Robert Morris (NEC),4,1-3,48,62,110,0.436,02/28/2016,2016.0
51,Lehigh (Patriot),4,3-1,45,59,104,0.433,02/28/2016,2016.0
52,Colgate (Patriot),3,2-1,27,36,63,0.429,02/28/2016,2016.0
53,NJIT (Independent),4,0-4,42,60,102,0.412,02/28/2016,2016.0
54,Providence (Big East),4,2-2,35,52,87,0.402,02/28/2016,2016.0
55,Penn St. (Big Ten),4,3-1,44,69,113,0.389,02/28/2016,2016.0
56,St. John's (NY) (Big East),3,0-3,29,46,75,0.387,02/28/2016,2016.0
57,Fairfield (CAA),3,0-3,27,43,70,0.386,02/28/2016,2016.0
58,UMBC (America East),2,0-2,15,24,39,0.385,02/28/2016,2016.0
59,Penn (Ivy League),2,1-1,19,33,52,0.365,02/28/2016,2016.0
60,VMI (SoCon),3,1-2,24,46,70,0.343,02/28/2016,2016.0
61,Harvard (Ivy League),3,3-0,26,50,76,0.342,02/28/2016,2016.0
62,Detroit Mercy (MAAC),3,0-3,22,44,66,0.333,02/28/2016,2016.0
62,Drexel (CAA),2,0-2,21,42,63,0.333,02/28/2016,2016.0
62,Georgetown (Big East),2,0-2,14,28,42,0.333,02/28/2016,2016.0
65,Manhattan (MAAC),4,0-4,33,74,107,0.308,02/28/2016,2016.0
66,Dartmouth (Ivy League),3,0-3,18,45,63,0.286,02/28/2016,2016.0
67,Marist (MAAC),2,1-1,10,31,41,0.244,02/28/2016,2016.0
-,UMass Lowell (America East),3,0-3,20,47,67,0.299,02/28/2016,2016.0
1,Saint Joseph's (NEC),1,1-0,18,5,23,0.783,02/24/2016,2016.0
2,Syracuse (ACC),2,2-0,40,14,54,0.741,02/24/2016,2016.0
3,Cornell (Ivy League),1,0-1,14,5,19,0.737,02/24/2016,2016.0
4,Villanova (Big East),1,0-1,21,8,29,0.724,02/24/2016,2016.0
5,Army West Point (Patriot),3,2-1,52,21,73,0.712,02/24/2016,2016.0
6,Brown (Ivy League),1,1-0,19,9,28,0.679,02/24/2016,2016.0
7,Ohio St. (Big Ten),3,2-1,46,23,69,0.667,02/24/2016,2016.0
7,Notre Dame (ACC),2,2-0,28,14,42,0.667,02/24/2016,2016.0
9,Bucknell (Patriot),3,3-0,47,24,71,0.662,02/24/2016,2016.0
10,Bryant (NEC),3,2-1,48,25,73,0.658,02/24/2016,2016.0
11,Yale (Ivy League),1,1-0,18,10,28,0.643,02/24/2016,2016.0
12,Denver (Big East),2,2-0,34,19,53,0.642,02/24/2016,2016.0
13,Binghamton (America East),1,0-1,12,7,19,0.632,02/24/2016,2016.0
14,Boston U. (Patriot),4,3-1,56,35,91,0.615,02/24/2016,2016.0
15,Richmond (SoCon),3,3-0,35,22,57,0.614,02/24/2016,2016.0
16,Marquette (Big East),1,1-0,11,7,18,0.611,02/24/2016,2016.0
17,Johns Hopkins (Big Ten),2,1-1,27,18,45,0.600,02/24/2016,2016.0
18,Virginia (ACC),3,1-2,40,27,67,0.597,02/24/2016,2016.0
19,Bellarmine (SoCon),3,1-2,37,25,62,0.597,02/24/2016,2016.0
20,Hobart (NEC),2,1-1,34,23,57,0.596,02/24/2016,2016.0
21,North Carolina (ACC),3,2-1,43,30,73,0.589,02/24/2016,2016.0
22,Towson (CAA),2,2-0,18,13,31,0.581,02/24/2016,2016.0
23,Stony Brook (America East),2,2-0,28,22,50,0.560,02/24/2016,2016.0
24,Lafayette (Patriot),2,1-1,25,20,45,0.556,02/24/2016,2016.0
24,Maryland (Big Ten),1,1-0,15,12,27,0.556,02/24/2016,2016.0
26,Jacksonville (SoCon),3,2-1,41,33,74,0.554,02/24/2016,2016.0
26,Holy Cross (Patriot),3,0-3,41,33,74,0.554,02/24/2016,2016.0
28,Princeton (Ivy League),1,1-0,16,13,29,0.552,02/24/2016,2016.0
29,Duke (ACC),3,2-1,45,37,82,0.549,02/24/2016,2016.0
30,Vermont (America East),3,2-1,47,39,86,0.547,02/24/2016,2016.0
31,Navy (Patriot),3,2-1,28,26,54,0.519,02/24/2016,2016.0
32,Sacred Heart (NEC),3,2-1,38,36,74,0.514,02/24/2016,2016.0
33,Michigan (Big Ten),3,1-2,40,38,78,0.513,02/24/2016,2016.0
34,Rutgers (Big Ten),2,2-0,31,31,62,0.500,02/24/2016,2016.0
34,Hartford (America East),1,1-0,15,15,30,0.500,02/24/2016,2016.0
34,Hofstra (CAA),1,1-0,8,8,16,0.500,02/24/2016,2016.0
37,Wagner (NEC),3,1-2,30,31,61,0.492,02/24/2016,2016.0
38,Mercer (SoCon),3,2-1,30,32,62,0.484,02/24/2016,2016.0
39,Air Force (SoCon),3,1-2,30,33,63,0.476,02/24/2016,2016.0
40,Robert Morris (NEC),3,1-2,39,43,82,0.476,02/24/2016,2016.0
41,Penn St. (Big Ten),3,3-0,38,43,81,0.469,02/24/2016,2016.0
42,Delaware (CAA),3,0-3,27,32,59,0.458,02/24/2016,2016.0
43,Monmouth (MAAC),2,2-0,16,19,35,0.457,02/24/2016,2016.0
44,Mount St. Mary's (NEC),3,1-2,27,33,60,0.450,02/24/2016,2016.0
45,Furman (SoCon),3,0-3,30,37,67,0.448,02/24/2016,2016.0
46,High Point (SoCon),4,1-3,46,57,103,0.447,02/24/2016,2016.0
47,Penn (Ivy League),1,1-0,11,14,25,0.440,02/24/2016,2016.0
48,NJIT (Independent),3,0-3,34,48,82,0.415,02/24/2016,2016.0
49,Massachusetts (CAA),2,1-1,17,26,43,0.395,02/24/2016,2016.0
50,Loyola Maryland (Patriot),2,2-0,15,23,38,0.395,02/24/2016,2016.0
51,St. John's (NY) (Big East),3,0-3,29,46,75,0.387,02/24/2016,2016.0
52,UMBC (America East),1,0-1,6,10,16,0.375,02/24/2016,2016.0
53,Lehigh (Patriot),3,2-1,29,49,78,0.372,02/24/2016,2016.0
54,Colgate (Patriot),2,1-1,14,24,38,0.368,02/24/2016,2016.0
55,Providence (Big East),3,1-2,25,43,68,0.368,02/24/2016,2016.0
56,Drexel (CAA),1,0-1,9,16,25,0.360,02/24/2016,2016.0
57,Siena (MAAC),3,0-3,28,50,78,0.359,02/24/2016,2016.0
58,Detroit Mercy (MAAC),2,0-2,15,29,44,0.341,02/24/2016,2016.0
59,Harvard (Ivy League),2,2-0,18,37,55,0.327,02/24/2016,2016.0
60,Quinnipiac (MAAC),1,0-1,9,19,28,0.321,02/24/2016,2016.0
61,Manhattan (MAAC),3,0-3,22,55,77,0.286,02/24/2016,2016.0
62,Fairfield (CAA),2,0-2,13,35,48,0.271,02/24/2016,2016.0
63,UAlbany (America East),1,0-1,7,20,27,0.259,02/24/2016,2016.0
64,VMI (SoCon),2,0-2,12,38,50,0.240,02/24/2016,2016.0
65,Georgetown (Big East),1,0-1,5,17,22,0.227,02/24/2016,2016.0
66,Marist (MAAC),1,0-1,4,16,20,0.200,02/24/2016,2016.0
67,Dartmouth (Ivy League),1,0-1,4,18,22,0.182,02/24/2016,2016.0
-,UMass Lowell (America East),2,0-2,15,30,45,0.333,02/24/2016,2016.0
1,Saint Joseph's (NEC),1,1-0,18,5,23,0.783,02/23/2016,2016.0
2,Notre Dame (ACC),1,1-0,17,5,22,0.773,02/23/2016,2016.0
3,Syracuse (ACC),2,2-0,40,14,54,0.741,02/23/2016,2016.0
4,Cornell (Ivy League),1,0-1,14,5,19,0.737,02/23/2016,2016.0
5,Villanova (Big East),1,0-1,21,8,29,0.724,02/23/2016,2016.0
6,Army West Point (Patriot),3,2-1,52,21,73,0.712,02/23/2016,2016.0
7,Brown (Ivy League),1,1-0,19,9,28,0.679,02/23/2016,2016.0
8,Ohio St. (Big Ten),3,2-1,46,23,69,0.667,02/23/2016,2016.0
8,Bellarmine (SoCon),2,1-1,28,14,42,0.667,02/23/2016,2016.0
10,Bucknell (Patriot),3,3-0,47,24,71,0.662,02/23/2016,2016.0
11,Bryant (NEC),3,2-1,48,25,73,0.658,02/23/2016,2016.0
12,Yale (Ivy League),1,1-0,18,10,28,0.643,02/23/2016,2016.0
13,Denver (Big East),2,2-0,34,19,53,0.642,02/23/2016,2016.0
14,Binghamton (America East),1,0-1,12,7,19,0.632,02/23/2016,2016.0
15,Boston U. (Patriot),4,3-1,56,35,91,0.615,02/23/2016,2016.0
16,Richmond (SoCon),3,3-0,35,22,57,0.614,02/23/2016,2016.0
17,Marquette (Big East),1,1-0,11,7,18,0.611,02/23/2016,2016.0
18,Johns Hopkins (Big Ten),2,1-1,27,18,45,0.600,02/23/2016,2016.0
19,Virginia (ACC),3,1-2,40,27,67,0.597,02/23/2016,2016.0
20,Hobart (NEC),2,1-1,34,23,57,0.596,02/23/2016,2016.0
21,North Carolina (ACC),3,2-1,43,30,73,0.589,02/23/2016,2016.0
22,Towson (CAA),2,2-0,18,13,31,0.581,02/23/2016,2016.0
23,Stony Brook (America East),2,2-0,28,22,50,0.560,02/23/2016,2016.0
24,Lafayette (Patriot),2,1-1,25,20,45,0.556,02/23/2016,2016.0
24,Maryland (Big Ten),1,1-0,15,12,27,0.556,02/23/2016,2016.0
26,Jacksonville (SoCon),3,2-1,41,33,74,0.554,02/23/2016,2016.0
26,Holy Cross (Patriot),3,0-3,41,33,74,0.554,02/23/2016,2016.0
28,Princeton (Ivy League),1,1-0,16,13,29,0.552,02/23/2016,2016.0
29,Duke (ACC),3,2-1,45,37,82,0.549,02/23/2016,2016.0
30,Vermont (America East),3,2-1,47,39,86,0.547,02/23/2016,2016.0
31,Navy (Patriot),3,2-1,28,26,54,0.519,02/23/2016,2016.0
32,Sacred Heart (NEC),3,2-1,38,36,74,0.514,02/23/2016,2016.0
33,Michigan (Big Ten),3,1-2,40,38,78,0.513,02/23/2016,2016.0
34,Rutgers (Big Ten),2,2-0,31,31,62,0.500,02/23/2016,2016.0
34,Hartford (America East),1,1-0,15,15,30,0.500,02/23/2016,2016.0
34,Hofstra (CAA),1,1-0,8,8,16,0.500,02/23/2016,2016.0
37,Wagner (NEC),3,1-2,30,31,61,0.492,02/23/2016,2016.0
38,Mercer (SoCon),3,2-1,30,32,62,0.484,02/23/2016,2016.0
39,Air Force (SoCon),3,1-2,30,33,63,0.476,02/23/2016,2016.0
40,Robert Morris (NEC),3,1-2,39,43,82,0.476,02/23/2016,2016.0
41,Penn St. (Big Ten),3,3-0,38,43,81,0.469,02/23/2016,2016.0
42,Delaware (CAA),3,0-3,27,32,59,0.458,02/23/2016,2016.0
43,Monmouth (MAAC),2,2-0,16,19,35,0.457,02/23/2016,2016.0
44,Mount St. Mary's (NEC),3,1-2,27,33,60,0.450,02/23/2016,2016.0
45,Furman (SoCon),3,0-3,30,37,67,0.448,02/23/2016,2016.0
46,High Point (SoCon),4,1-3,46,57,103,0.447,02/23/2016,2016.0
47,Penn (Ivy League),1,1-0,11,14,25,0.440,02/23/2016,2016.0
48,NJIT (Independent),3,0-3,34,48,82,0.415,02/23/2016,2016.0
49,Massachusetts (CAA),2,1-1,17,26,43,0.395,02/23/2016,2016.0
50,Loyola Maryland (Patriot),2,2-0,15,23,38,0.395,02/23/2016,2016.0
51,St. John's (NY) (Big East),3,0-3,29,46,75,0.387,02/23/2016,2016.0
52,UMBC (America East),1,0-1,6,10,16,0.375,02/23/2016,2016.0
53,Lehigh (Patriot),3,2-1,29,49,78,0.372,02/23/2016,2016.0
54,Colgate (Patriot),2,1-1,14,24,38,0.368,02/23/2016,2016.0
55,Providence (Big East),3,1-2,25,43,68,0.368,02/23/2016,2016.0
56,Drexel (CAA),1,0-1,9,16,25,0.360,02/23/2016,2016.0
57,Siena (MAAC),3,0-3,28,50,78,0.359,02/23/2016,2016.0
58,Detroit Mercy (MAAC),2,0-2,15,29,44,0.341,02/23/2016,2016.0
59,Harvard (Ivy League),2,2-0,18,37,55,0.327,02/23/2016,2016.0
60,Quinnipiac (MAAC),1,0-1,9,19,28,0.321,02/23/2016,2016.0
61,Manhattan (MAAC),3,0-3,22,55,77,0.286,02/23/2016,2016.0
62,Fairfield (CAA),2,0-2,13,35,48,0.271,02/23/2016,2016.0
63,UAlbany (America East),1,0-1,7,20,27,0.259,02/23/2016,2016.0
64,VMI (SoCon),2,0-2,12,38,50,0.240,02/23/2016,2016.0
65,Georgetown (Big East),1,0-1,5,17,22,0.227,02/23/2016,2016.0
66,Marist (MAAC),1,0-1,4,16,20,0.200,02/23/2016,2016.0
67,Dartmouth (Ivy League),1,0-1,4,18,22,0.182,02/23/2016,2016.0
-,UMass Lowell (America East),2,0-2,15,30,45,0.333,02/23/2016,2016.0
1,Saint Joseph's (NEC),1,1-0,18,5,23,0.783,02/21/2016,2016.0
2,Notre Dame (ACC),1,1-0,17,5,22,0.773,02/21/2016,2016.0
3,Syracuse (ACC),2,2-0,40,14,54,0.741,02/21/2016,2016.0
4,Cornell (Ivy League),1,0-1,14,5,19,0.737,02/21/2016,2016.0
5,Villanova (Big East),1,0-1,21,8,29,0.724,02/21/2016,2016.0
6,Army West Point (Patriot),3,2-1,52,21,73,0.712,02/21/2016,2016.0
7,Brown (Ivy League),1,1-0,19,9,28,0.679,02/21/2016,2016.0
8,Ohio St. (Big Ten),3,2-1,46,23,69,0.667,02/21/2016,2016.0
8,Bellarmine (SoCon),2,1-1,28,14,42,0.667,02/21/2016,2016.0
8,Richmond (SoCon),2,2-0,26,13,39,0.667,02/21/2016,2016.0
11,Bucknell (Patriot),3,3-0,47,24,71,0.662,02/21/2016,2016.0
12,Bryant (NEC),3,2-1,48,25,73,0.658,02/21/2016,2016.0
13,Yale (Ivy League),1,1-0,18,10,28,0.643,02/21/2016,2016.0
14,Denver (Big East),2,2-0,34,19,53,0.642,02/21/2016,2016.0
15,Binghamton (America East),1,0-1,12,7,19,0.632,02/21/2016,2016.0
16,Virginia (ACC),2,1-1,26,16,42,0.619,02/21/2016,2016.0
17,Boston U. (Patriot),4,3-1,56,35,91,0.615,02/21/2016,2016.0
18,Marquette (Big East),1,1-0,11,7,18,0.611,02/21/2016,2016.0
19,Johns Hopkins (Big Ten),2,1-1,27,18,45,0.600,02/21/2016,2016.0
20,Hobart (NEC),2,1-1,34,23,57,0.596,02/21/2016,2016.0
21,North Carolina (ACC),3,2-1,43,30,73,0.589,02/21/2016,2016.0
22,Towson (CAA),2,2-0,18,13,31,0.581,02/21/2016,2016.0
23,Stony Brook (America East),2,2-0,28,22,50,0.560,02/21/2016,2016.0
24,Lafayette (Patriot),2,1-1,25,20,45,0.556,02/21/2016,2016.0
24,Maryland (Big Ten),1,1-0,15,12,27,0.556,02/21/2016,2016.0
26,Jacksonville (SoCon),3,2-1,41,33,74,0.554,02/21/2016,2016.0
27,Princeton (Ivy League),1,1-0,16,13,29,0.552,02/21/2016,2016.0
28,Duke (ACC),3,2-1,45,37,82,0.549,02/21/2016,2016.0
29,Vermont (America East),3,2-1,47,39,86,0.547,02/21/2016,2016.0
30,Holy Cross (Patriot),2,0-2,25,23,48,0.521,02/21/2016,2016.0
31,Navy (Patriot),3,2-1,28,26,54,0.519,02/21/2016,2016.0
32,Sacred Heart (NEC),3,2-1,38,36,74,0.514,02/21/2016,2016.0
33,Michigan (Big Ten),3,1-2,40,38,78,0.513,02/21/2016,2016.0
34,Rutgers (Big Ten),2,2-0,31,31,62,0.500,02/21/2016,2016.0
34,Hartford (America East),1,1-0,15,15,30,0.500,02/21/2016,2016.0
34,Hofstra (CAA),1,1-0,8,8,16,0.500,02/21/2016,2016.0
37,Mercer (SoCon),2,1-1,17,18,35,0.486,02/21/2016,2016.0
38,Wagner (NEC),2,1-1,22,24,46,0.478,02/21/2016,2016.0
39,Air Force (SoCon),3,1-2,30,33,63,0.476,02/21/2016,2016.0
40,Robert Morris (NEC),3,1-2,39,43,82,0.476,02/21/2016,2016.0
41,Penn St. (Big Ten),3,3-0,38,43,81,0.469,02/21/2016,2016.0
42,Delaware (CAA),3,0-3,27,32,59,0.458,02/21/2016,2016.0
43,Monmouth (MAAC),1,1-0,9,11,20,0.450,02/21/2016,2016.0
44,High Point (SoCon),3,0-3,35,43,78,0.449,02/21/2016,2016.0
45,Furman (SoCon),3,0-3,30,37,67,0.448,02/21/2016,2016.0
46,Penn (Ivy League),1,1-0,11,14,25,0.440,02/21/2016,2016.0
47,Mount St. Mary's (NEC),2,1-1,18,24,42,0.429,02/21/2016,2016.0
48,NJIT (Independent),3,0-3,34,48,82,0.415,02/21/2016,2016.0
49,Massachusetts (CAA),2,1-1,17,26,43,0.395,02/21/2016,2016.0
50,Loyola Maryland (Patriot),2,2-0,15,23,38,0.395,02/21/2016,2016.0
51,St. John's (NY) (Big East),3,0-3,29,46,75,0.387,02/21/2016,2016.0
52,UMBC (America East),1,0-1,6,10,16,0.375,02/21/2016,2016.0
53,Lehigh (Patriot),3,2-1,29,49,78,0.372,02/21/2016,2016.0
54,Colgate (Patriot),2,1-1,14,24,38,0.368,02/21/2016,2016.0
55,Providence (Big East),3,1-2,25,43,68,0.368,02/21/2016,2016.0
56,Drexel (CAA),1,0-1,9,16,25,0.360,02/21/2016,2016.0
57,Detroit Mercy (MAAC),2,0-2,15,29,44,0.341,02/21/2016,2016.0
58,Quinnipiac (MAAC),1,0-1,9,19,28,0.321,02/21/2016,2016.0
59,Manhattan (MAAC),3,0-3,22,55,77,0.286,02/21/2016,2016.0
60,Harvard (Ivy League),1,1-0,8,21,29,0.276,02/21/2016,2016.0
61,Siena (MAAC),2,0-2,14,37,51,0.275,02/21/2016,2016.0
62,Fairfield (CAA),2,0-2,13,35,48,0.271,02/21/2016,2016.0
63,UAlbany (America East),1,0-1,7,20,27,0.259,02/21/2016,2016.0
64,VMI (SoCon),2,0-2,12,38,50,0.240,02/21/2016,2016.0
65,Georgetown (Big East),1,0-1,5,17,22,0.227,02/21/2016,2016.0
66,Marist (MAAC),1,0-1,4,16,20,0.200,02/21/2016,2016.0
67,Dartmouth (Ivy League),1,0-1,4,18,22,0.182,02/21/2016,2016.0
-,UMass Lowell (America East),2,0-2,15,30,45,0.333,02/21/2016,2016.0
1,Bellarmine (SoCon),1,1-0,21,3,24,0.875,02/18/2016,2016.0
2,Ohio St. (Big Ten),2,2-0,33,11,44,0.750,02/18/2016,2016.0
3,Syracuse (ACC),1,1-0,20,7,27,0.741,02/18/2016,2016.0
4,Army West Point (Patriot),1,1-0,13,5,18,0.722,02/18/2016,2016.0
5,Richmond (SoCon),1,1-0,16,7,23,0.696,02/18/2016,2016.0
5,Denver (Big East),1,1-0,16,7,23,0.696,02/18/2016,2016.0
7,Boston U. (Patriot),3,3-0,41,20,61,0.672,02/18/2016,2016.0
8,Bryant (NEC),2,1-1,31,16,47,0.660,02/18/2016,2016.0
9,Rutgers (Big Ten),1,1-0,22,12,34,0.647,02/18/2016,2016.0
10,Duke (ACC),2,2-0,33,19,52,0.635,02/18/2016,2016.0
11,Lafayette (Patriot),1,0-1,15,9,24,0.625,02/18/2016,2016.0
12,North Carolina (ACC),2,2-0,35,22,57,0.614,02/18/2016,2016.0
13,Vermont (America East),2,1-1,38,24,62,0.613,02/18/2016,2016.0
14,Bucknell (Patriot),2,2-0,28,18,46,0.609,02/18/2016,2016.0
15,Stony Brook (America East),1,1-0,17,11,28,0.607,02/18/2016,2016.0
16,Virginia (ACC),1,0-1,10,7,17,0.588,02/18/2016,2016.0
17,Johns Hopkins (Big Ten),1,1-0,14,10,24,0.583,02/18/2016,2016.0
18,Towson (CAA),1,1-0,9,7,16,0.563,02/18/2016,2016.0
19,Jacksonville (SoCon),3,2-1,41,33,74,0.554,02/18/2016,2016.0
20,Penn St. (Big Ten),2,2-0,33,29,62,0.532,02/18/2016,2016.0
21,Navy (Patriot),2,1-1,23,21,44,0.523,02/18/2016,2016.0
22,Hobart (NEC),1,0-1,17,16,33,0.515,02/18/2016,2016.0
23,Michigan (Big Ten),2,1-1,26,27,53,0.491,02/18/2016,2016.0
24,High Point (SoCon),2,0-2,23,28,51,0.451,02/18/2016,2016.0
25,Monmouth (MAAC),1,1-0,9,11,20,0.450,02/18/2016,2016.0
26,Delaware (CAA),2,0-2,22,27,49,0.449,02/18/2016,2016.0
27,Mount St. Mary's (NEC),1,1-0,12,15,27,0.444,02/18/2016,2016.0
28,Wagner (NEC),1,1-0,11,14,25,0.440,02/18/2016,2016.0
29,Mercer (SoCon),1,0-1,7,9,16,0.438,02/18/2016,2016.0
30,Holy Cross (Patriot),1,0-1,10,14,24,0.417,02/18/2016,2016.0
31,Loyola Maryland (Patriot),1,1-0,7,10,17,0.412,02/18/2016,2016.0
32,Lehigh (Patriot),2,1-1,21,32,53,0.396,02/18/2016,2016.0
32,NJIT (Independent),2,0-2,21,32,53,0.396,02/18/2016,2016.0
34,Sacred Heart (NEC),2,1-1,20,32,52,0.385,02/18/2016,2016.0
35,Providence (Big East),2,1-1,16,26,42,0.381,02/18/2016,2016.0
36,Colgate (Patriot),1,0-1,7,12,19,0.368,02/18/2016,2016.0
37,Manhattan (MAAC),2,0-2,17,31,48,0.354,02/18/2016,2016.0
38,St. John's (NY) (Big East),2,0-2,18,35,53,0.340,02/18/2016,2016.0
39,Air Force (SoCon),2,0-2,14,29,43,0.326,02/18/2016,2016.0
40,Furman (SoCon),2,0-2,13,29,42,0.310,02/18/2016,2016.0
41,Fairfield (CAA),1,0-1,7,16,23,0.304,02/18/2016,2016.0
42,Robert Morris (NEC),2,0-2,15,38,53,0.283,02/18/2016,2016.0
43,Massachusetts (CAA),1,0-1,5,13,18,0.278,02/18/2016,2016.0
44,Siena (MAAC),1,0-1,7,20,27,0.259,02/18/2016,2016.0
45,Detroit Mercy (MAAC),1,0-1,6,19,25,0.240,02/18/2016,2016.0
-,UMass Lowell (America East),1,0-1,5,12,17,0.294,02/18/2016,2016.0
1,Bellarmine (SoCon),1,1-0,21,3,24,0.875,02/01/2016 - 02/15/2016,2016.0
2,Boston U. (Patriot),2,2-0,28,7,35,0.800,02/01/2016 - 02/15/2016,2016.0
3,Ohio St. (Big Ten),2,2-0,33,11,44,0.750,02/01/2016 - 02/15/2016,2016.0
4,Syracuse (ACC),1,1-0,20,7,27,0.741,02/01/2016 - 02/15/2016,2016.0
5,Army West Point (Patriot),1,1-0,13,5,18,0.722,02/01/2016 - 02/15/2016,2016.0
6,Richmond (SoCon),1,1-0,16,7,23,0.696,02/01/2016 - 02/15/2016,2016.0
6,Denver (Big East),1,1-0,16,7,23,0.696,02/01/2016 - 02/15/2016,2016.0
8,Bryant (NEC),2,1-1,31,16,47,0.660,02/01/2016 - 02/15/2016,2016.0
9,Rutgers (Big Ten),1,1-0,22,12,34,0.647,02/01/2016 - 02/15/2016,2016.0
10,Duke (ACC),2,2-0,33,19,52,0.635,02/01/2016 - 02/15/2016,2016.0
11,Lafayette (Patriot),1,0-1,15,9,24,0.625,02/01/2016 - 02/15/2016,2016.0
12,North Carolina (ACC),2,2-0,35,22,57,0.614,02/01/2016 - 02/15/2016,2016.0
13,Bucknell (Patriot),2,2-0,28,18,46,0.609,02/01/2016 - 02/15/2016,2016.0
14,Virginia (ACC),1,0-1,10,7,17,0.588,02/01/2016 - 02/15/2016,2016.0
15,Johns Hopkins (Big Ten),1,1-0,14,10,24,0.583,02/01/2016 - 02/15/2016,2016.0
16,Towson (CAA),1,1-0,9,7,16,0.563,02/01/2016 - 02/15/2016,2016.0
17,NJIT (Independent),1,0-1,14,12,26,0.538,02/01/2016 - 02/15/2016,2016.0
18,Penn St. (Big Ten),2,2-0,33,29,62,0.532,02/01/2016 - 02/15/2016,2016.0
19,Navy (Patriot),2,1-1,23,21,44,0.523,02/01/2016 - 02/15/2016,2016.0
20,Hobart (NEC),1,0-1,17,16,33,0.515,02/01/2016 - 02/15/2016,2016.0
21,Vermont (America East),1,0-1,18,17,35,0.514,02/01/2016 - 02/15/2016,2016.0
22,Jacksonville (SoCon),2,1-1,28,27,55,0.509,02/01/2016 - 02/15/2016,2016.0
23,Michigan (Big Ten),2,1-1,26,27,53,0.491,02/01/2016 - 02/15/2016,2016.0
24,Monmouth (MAAC),1,1-0,9,11,20,0.450,02/01/2016 - 02/15/2016,2016.0
25,Delaware (CAA),2,0-2,22,27,49,0.449,02/01/2016 - 02/15/2016,2016.0
26,Mount St. Mary's (NEC),1,1-0,12,15,27,0.444,02/01/2016 - 02/15/2016,2016.0
27,Wagner (NEC),1,1-0,11,14,25,0.440,02/01/2016 - 02/15/2016,2016.0
28,Mercer (SoCon),1,0-1,7,9,16,0.438,02/01/2016 - 02/15/2016,2016.0
29,Holy Cross (Patriot),1,0-1,10,14,24,0.417,02/01/2016 - 02/15/2016,2016.0
30,Loyola Maryland (Patriot),1,1-0,7,10,17,0.412,02/01/2016 - 02/15/2016,2016.0
31,High Point (SoCon),1,0-1,10,15,25,0.400,02/01/2016 - 02/15/2016,2016.0
32,Lehigh (Patriot),2,1-1,21,32,53,0.396,02/01/2016 - 02/15/2016,2016.0
33,Providence (Big East),2,1-1,16,26,42,0.381,02/01/2016 - 02/15/2016,2016.0
34,Sacred Heart (NEC),1,1-0,9,15,24,0.375,02/01/2016 - 02/15/2016,2016.0
35,Colgate (Patriot),1,0-1,7,12,19,0.368,02/01/2016 - 02/15/2016,2016.0
36,Manhattan (MAAC),2,0-2,17,31,48,0.354,02/01/2016 - 02/15/2016,2016.0
37,St. John's (NY) (Big East),1,0-1,12,22,34,0.353,02/01/2016 - 02/15/2016,2016.0
38,Air Force (SoCon),2,0-2,14,29,43,0.326,02/01/2016 - 02/15/2016,2016.0
39,Furman (SoCon),2,0-2,13,29,42,0.310,02/01/2016 - 02/15/2016,2016.0
40,Fairfield (CAA),1,0-1,7,16,23,0.304,02/01/2016 - 02/15/2016,2016.0
41,Robert Morris (NEC),2,0-2,15,38,53,0.283,02/01/2016 - 02/15/2016,2016.0
42,Massachusetts (CAA),1,0-1,5,13,18,0.278,02/01/2016 - 02/15/2016,2016.0
43,Siena (MAAC),1,0-1,7,20,27,0.259,02/01/2016 - 02/15/2016,2016.0
44,Detroit Mercy (MAAC),1,0-1,6,19,25,0.240,02/01/2016 - 02/15/2016,2016.0
-,UMass Lowell (America East),1,0-1,5,12,17,0.294,02/01/2016 - 02/15/2016,2016.0
1,Bellarmine (SoCon),1,1-0,21,3,24,0.875,02/01/2016 - 02/14/2016,2016.0
2,Boston U. (Patriot),2,2-0,28,7,35,0.800,02/01/2016 - 02/14/2016,2016.0
3,Ohio St. (Big Ten),2,2-0,33,11,44,0.750,02/01/2016 - 02/14/2016,2016.0
4,Syracuse (ACC),1,1-0,20,7,27,0.741,02/01/2016 - 02/14/2016,2016.0
5,Army West Point (Patriot),1,1-0,13,5,18,0.722,02/01/2016 - 02/14/2016,2016.0
6,Denver (Big East),1,1-0,16,7,23,0.696,02/01/2016 - 02/14/2016,2016.0
7,Bryant (NEC),2,1-1,31,16,47,0.660,02/01/2016 - 02/14/2016,2016.0
8,Rutgers (Big Ten),1,1-0,22,12,34,0.647,02/01/2016 - 02/14/2016,2016.0
9,Duke (ACC),2,2-0,33,19,52,0.635,02/01/2016 - 02/14/2016,2016.0
10,Lafayette (Patriot),1,0-1,15,9,24,0.625,02/01/2016 - 02/14/2016,2016.0
11,North Carolina (ACC),2,2-0,35,22,57,0.614,02/01/2016 - 02/14/2016,2016.0
12,Bucknell (Patriot),2,2-0,28,18,46,0.609,02/01/2016 - 02/14/2016,2016.0
13,Virginia (ACC),1,0-1,10,7,17,0.588,02/01/2016 - 02/14/2016,2016.0
14,Johns Hopkins (Big Ten),1,1-0,14,10,24,0.583,02/01/2016 - 02/14/2016,2016.0
15,Towson (CAA),1,1-0,9,7,16,0.563,02/01/2016 - 02/14/2016,2016.0
16,NJIT (Independent),1,0-1,14,12,26,0.538,02/01/2016 - 02/14/2016,2016.0
17,Penn St. (Big Ten),2,2-0,33,29,62,0.532,02/01/2016 - 02/14/2016,2016.0
18,Navy (Patriot),2,1-1,23,21,44,0.523,02/01/2016 - 02/14/2016,2016.0
19,Hobart (NEC),1,0-1,17,16,33,0.515,02/01/2016 - 02/14/2016,2016.0
20,Vermont (America East),1,0-1,18,17,35,0.514,02/01/2016 - 02/14/2016,2016.0
21,Jacksonville (SoCon),2,1-1,28,27,55,0.509,02/01/2016 - 02/14/2016,2016.0
22,Michigan (Big Ten),2,1-1,26,27,53,0.491,02/01/2016 - 02/14/2016,2016.0
23,Monmouth (MAAC),1,1-0,9,11,20,0.450,02/01/2016 - 02/14/2016,2016.0
24,Delaware (CAA),2,0-2,22,27,49,0.449,02/01/2016 - 02/14/2016,2016.0
25,Mount St. Mary's (NEC),1,1-0,12,15,27,0.444,02/01/2016 - 02/14/2016,2016.0
26,Wagner (NEC),1,1-0,11,14,25,0.440,02/01/2016 - 02/14/2016,2016.0
27,Mercer (SoCon),1,0-1,7,9,16,0.438,02/01/2016 - 02/14/2016,2016.0
28,Holy Cross (Patriot),1,0-1,10,14,24,0.417,02/01/2016 - 02/14/2016,2016.0
29,Loyola Maryland (Patriot),1,1-0,7,10,17,0.412,02/01/2016 - 02/14/2016,2016.0
30,High Point (SoCon),1,0-1,10,15,25,0.400,02/01/2016 - 02/14/2016,2016.0
31,Lehigh (Patriot),2,1-1,21,32,53,0.396,02/01/2016 - 02/14/2016,2016.0
32,Providence (Big East),2,1-1,16,26,42,0.381,02/01/2016 - 02/14/2016,2016.0
33,Sacred Heart (NEC),1,1-0,9,15,24,0.375,02/01/2016 - 02/14/2016,2016.0
34,Colgate (Patriot),1,0-1,7,12,19,0.368,02/01/2016 - 02/14/2016,2016.0
35,Manhattan (MAAC),2,0-2,17,31,48,0.354,02/01/2016 - 02/14/2016,2016.0
36,St. John's (NY) (Big East),1,0-1,12,22,34,0.353,02/01/2016 - 02/14/2016,2016.0
37,Air Force (SoCon),2,0-2,14,29,43,0.326,02/01/2016 - 02/14/2016,2016.0
38,Furman (SoCon),2,0-2,13,29,42,0.310,02/01/2016 - 02/14/2016,2016.0
39,Robert Morris (NEC),2,0-2,15,38,53,0.283,02/01/2016 - 02/14/2016,2016.0
40,Massachusetts (CAA),1,0-1,5,13,18,0.278,02/01/2016 - 02/14/2016,2016.0
41,Siena (MAAC),1,0-1,7,20,27,0.259,02/01/2016 - 02/14/2016,2016.0
42,Detroit Mercy (MAAC),1,0-1,6,19,25,0.240,02/01/2016 - 02/14/2016,2016.0
-,UMass Lowell (America East),1,0-1,5,12,17,0.294,02/01/2016 - 02/14/2016,2016.0
1,Bryant (NEC),1,1-0,20,3,23,0.870,02/01/2016 - 02/12/2016,2016.0
2,Boston U. (Patriot),2,2-0,28,7,35,0.800,02/01/2016 - 02/12/2016,2016.0
3,Bucknell (Patriot),1,1-0,15,7,22,0.682,02/01/2016 - 02/12/2016,2016.0
1,Boston U. (Patriot),1,1-0,16,2,18,0.889,02/01/2016 - 02/09/2016,2016.0
2,Bryant (NEC),1,1-0,20,3,23,0.870,02/01/2016 - 02/09/2016,2016.0
3,Ohio St. (Big Ten),1,1-0,14,5,19,0.737,02/01/2016 - 02/09/2016,2016.0
4,Bucknell (Patriot),1,1-0,15,7,22,0.682,02/01/2016 - 02/09/2016,2016.0
5,North Carolina (ACC),1,1-0,20,14,34,0.588,02/01/2016 - 02/09/2016,2016.0
6,Penn St. (Big Ten),1,1-0,17,12,29,0.586,02/01/2016 - 02/09/2016,2016.0
7,Johns Hopkins (Big Ten),1,1-0,14,10,24,0.583,02/01/2016 - 02/09/2016,2016.0
8,NJIT (Independent),1,0-1,14,12,26,0.538,02/01/2016 - 02/09/2016,2016.0
9,Navy (Patriot),2,1-1,23,21,44,0.523,02/01/2016 - 02/09/2016,2016.0
10,Vermont (America East),1,0-1,18,17,35,0.514,02/01/2016 - 02/09/2016,2016.0
11,Jacksonville (SoCon),1,1-0,17,18,35,0.486,02/01/2016 - 02/09/2016,2016.0
12,Lehigh (Patriot),1,1-0,12,14,26,0.462,02/01/2016 - 02/09/2016,2016.0
13,Robert Morris (NEC),1,0-1,12,17,29,0.414,02/01/2016 - 02/09/2016,2016.0
14,Michigan (Big Ten),1,0-1,14,20,34,0.412,02/01/2016 - 02/09/2016,2016.0
15,Air Force (SoCon),1,0-1,7,13,20,0.350,02/01/2016 - 02/09/2016,2016.0
16,Delaware (CAA),1,0-1,7,15,22,0.318,02/01/2016 - 02/09/2016,2016.0
17,Furman (SoCon),1,0-1,5,14,19,0.263,02/01/2016 - 02/09/2016,2016.0
18,Manhattan (MAAC),1,0-1,3,20,23,0.130,02/01/2016 - 02/09/2016,2016.0
19,Providence (Big East),1,0-1,2,16,18,0.111,02/01/2016 - 02/09/2016,2016.0
1,Boston U. (Patriot),1,1-0,16,2,18,0.889,02/01/2016 - 02/07/2016,2016.0
2,Bryant (NEC),1,1-0,20,3,23,0.870,02/01/2016 - 02/07/2016,2016.0
3,Ohio St. (Big Ten),1,1-0,14,5,19,0.737,02/01/2016 - 02/07/2016,2016.0
4,Bucknell (Patriot),1,1-0,15,7,22,0.682,02/01/2016 - 02/07/2016,2016.0
5,Navy (Patriot),1,1-0,13,7,20,0.650,02/01/2016 - 02/07/2016,2016.0
6,North Carolina (ACC),1,1-0,20,14,34,0.588,02/01/2016 - 02/07/2016,2016.0
7,Penn St. (Big Ten),1,1-0,17,12,29,0.586,02/01/2016 - 02/07/2016,2016.0
8,NJIT (Independent),1,0-1,14,12,26,0.538,02/01/2016 - 02/07/2016,2016.0
9,Vermont (America East),1,0-1,18,17,35,0.514,02/01/2016 - 02/07/2016,2016.0
10,Jacksonville (SoCon),1,1-0,17,18,35,0.486,02/01/2016 - 02/07/2016,2016.0
11,Lehigh (Patriot),1,1-0,12,14,26,0.462,02/01/2016 - 02/07/2016,2016.0
12,Robert Morris (NEC),1,0-1,12,17,29,0.414,02/01/2016 - 02/07/2016,2016.0
13,Michigan (Big Ten),1,0-1,14,20,34,0.412,02/01/2016 - 02/07/2016,2016.0
14,Air Force (SoCon),1,0-1,7,13,20,0.350,02/01/2016 - 02/07/2016,2016.0
15,Delaware (CAA),1,0-1,7,15,22,0.318,02/01/2016 - 02/07/2016,2016.0
16,Furman (SoCon),1,0-1,5,14,19,0.263,02/01/2016 - 02/07/2016,2016.0
17,Manhattan (MAAC),1,0-1,3,20,23,0.130,02/01/2016 - 02/07/2016,2016.0
18,Providence (Big East),1,0-1,2,16,18,0.111,02/01/2016 - 02/07/2016,2016.0
1,Denver (Big East),17,13-4,313,120,433,0.723,05/29/2017-Final Statistics,2017.0
2,UAlbany (America East),18,15-3,349,160,509,0.686,05/29/2017-Final Statistics,2017.0
3,Navy (Patriot),14,6-8,199,111,310,0.642,05/29/2017-Final Statistics,2017.0
4,Ohio St. (Big Ten),21,16-5,302,184,486,0.621,05/29/2017-Final Statistics,2017.0
5,Army West Point (Patriot),16,12-4,216,136,352,0.614,05/29/2017-Final Statistics,2017.0
6,Yale (Ivy League),16,10-6,262,171,433,0.605,05/29/2017-Final Statistics,2017.0
7,Brown (Ivy League),16,10-6,288,200,488,0.590,05/29/2017-Final Statistics,2017.0
8,Richmond (SoCon),16,12-4,188,131,319,0.589,05/29/2017-Final Statistics,2017.0
9,Penn St. (Big Ten),16,12-4,258,184,442,0.584,05/29/2017-Final Statistics,2017.0
10,Towson (CAA),17,12-5,199,148,347,0.573,05/29/2017-Final Statistics,2017.0
11,Bryant (NEC),19,11-8,228,176,404,0.564,05/29/2017-Final Statistics,2017.0
12,Loyola Maryland (Patriot),16,10-6,217,168,385,0.564,05/29/2017-Final Statistics,2017.0
13,Massachusetts (CAA),15,7-8,187,148,335,0.558,05/29/2017-Final Statistics,2017.0
14,Mercer (SoCon),13,5-8,165,132,297,0.556,05/29/2017-Final Statistics,2017.0
15,Duke (ACC),18,13-5,247,203,450,0.549,05/29/2017-Final Statistics,2017.0
16,Jacksonville (SoCon),14,3-11,191,158,349,0.547,05/29/2017-Final Statistics,2017.0
17,Air Force (SoCon),18,12-6,221,185,406,0.544,05/29/2017-Final Statistics,2017.0
18,Saint Joseph's (NEC),14,5-9,168,143,311,0.540,05/29/2017-Final Statistics,2017.0
19,Rutgers (Big Ten),14,10-4,184,158,342,0.538,05/29/2017-Final Statistics,2017.0
20,Hartford (America East),14,6-8,189,163,352,0.537,05/29/2017-Final Statistics,2017.0
21,Providence (Big East),17,10-7,196,170,366,0.536,05/29/2017-Final Statistics,2017.0
22,Quinnipiac (MAAC),11,2-9,143,125,268,0.534,05/29/2017-Final Statistics,2017.0
23,Lehigh (Patriot),14,7-7,171,151,322,0.531,05/29/2017-Final Statistics,2017.0
24,Syracuse (ACC),16,13-3,211,189,400,0.528,05/29/2017-Final Statistics,2017.0
25,Virginia (ACC),15,8-7,247,222,469,0.527,05/29/2017-Final Statistics,2017.0
26,Hobart (NEC),16,9-7,217,197,414,0.524,05/29/2017-Final Statistics,2017.0
27,Marist (MAAC),16,10-6,156,143,299,0.522,05/29/2017-Final Statistics,2017.0
28,North Carolina (ACC),16,8-8,209,192,401,0.521,05/29/2017-Final Statistics,2017.0
29,Colgate (Patriot),14,5-9,170,159,329,0.517,05/29/2017-Final Statistics,2017.0
30,Bucknell (Patriot),13,5-8,155,146,301,0.515,05/29/2017-Final Statistics,2017.0
31,Fairfield (CAA),14,5-9,160,153,313,0.511,05/29/2017-Final Statistics,2017.0
32,Vermont (America East),13,5-8,158,156,314,0.503,05/29/2017-Final Statistics,2017.0
33,Detroit Mercy (MAAC),16,5-11,182,181,363,0.501,05/29/2017-Final Statistics,2017.0
34,Maryland (Big Ten),19,16-3,236,236,472,0.500,05/29/2017-Final Statistics,2017.0
35,Marquette (Big East),16,8-8,179,181,360,0.497,05/29/2017-Final Statistics,2017.0
36,Delaware (CAA),15,7-8,178,181,359,0.496,05/29/2017-Final Statistics,2017.0
37,Manhattan (MAAC),14,3-11,176,179,355,0.496,05/29/2017-Final Statistics,2017.0
38,Sacred Heart (NEC),15,9-6,180,187,367,0.490,05/29/2017-Final Statistics,2017.0
39,Princeton (Ivy League),15,9-6,214,223,437,0.490,05/29/2017-Final Statistics,2017.0
40,Penn (Ivy League),13,7-6,164,171,335,0.490,05/29/2017-Final Statistics,2017.0
41,Boston U. (Patriot),17,12-5,192,201,393,0.489,05/29/2017-Final Statistics,2017.0
42,Furman (SoCon),15,7-8,162,172,334,0.485,05/29/2017-Final Statistics,2017.0
43,Binghamton (America East),16,11-5,162,176,338,0.479,05/29/2017-Final Statistics,2017.0
44,Michigan (Big Ten),14,8-6,171,186,357,0.479,05/29/2017-Final Statistics,2017.0
45,Villanova (Big East),15,9-6,200,219,419,0.477,05/29/2017-Final Statistics,2017.0
46,Monmouth (MAAC),18,14-4,175,192,367,0.477,05/29/2017-Final Statistics,2017.0
47,Lafayette (Patriot),14,2-12,153,170,323,0.474,05/29/2017-Final Statistics,2017.0
48,UMBC (America East),14,6-8,132,150,282,0.468,05/29/2017-Final Statistics,2017.0
49,Johns Hopkins (Big Ten),15,8-7,184,212,396,0.465,05/29/2017-Final Statistics,2017.0
50,Georgetown (Big East),14,4-10,159,186,345,0.461,05/29/2017-Final Statistics,2017.0
51,Hofstra (CAA),14,11-3,150,178,328,0.457,05/29/2017-Final Statistics,2017.0
52,VMI (SoCon),14,2-12,148,188,336,0.440,05/29/2017-Final Statistics,2017.0
53,Notre Dame (ACC),15,9-6,155,200,355,0.437,05/29/2017-Final Statistics,2017.0
54,Canisius (MAAC),15,6-9,158,204,362,0.436,05/29/2017-Final Statistics,2017.0
55,Siena (MAAC),14,3-11,163,215,378,0.431,05/29/2017-Final Statistics,2017.0
56,St. John's (NY) (Big East),14,1-13,147,194,341,0.431,05/29/2017-Final Statistics,2017.0
57,Cleveland St. (Independent),14,5-9,153,202,355,0.431,05/29/2017-Final Statistics,2017.0
58,Robert Morris (NEC),16,9-7,167,230,397,0.421,05/29/2017-Final Statistics,2017.0
59,Wagner (NEC),15,6-9,129,187,316,0.408,05/29/2017-Final Statistics,2017.0
60,Stony Brook (America East),14,7-7,147,216,363,0.405,05/29/2017-Final Statistics,2017.0
61,Bellarmine (SoCon),13,4-9,126,203,329,0.383,05/29/2017-Final Statistics,2017.0
62,Holy Cross (Patriot),15,5-10,130,211,341,0.381,05/29/2017-Final Statistics,2017.0
63,Cornell (Ivy League),13,5-8,142,231,373,0.381,05/29/2017-Final Statistics,2017.0
64,Drexel (CAA),14,6-8,128,210,338,0.379,05/29/2017-Final Statistics,2017.0
65,Mount St. Mary's (NEC),14,4-10,123,202,325,0.378,05/29/2017-Final Statistics,2017.0
66,Harvard (Ivy League),13,6-7,123,204,327,0.376,05/29/2017-Final Statistics,2017.0
67,Hampton (Independent),8,1-7,66,117,183,0.361,05/29/2017-Final Statistics,2017.0
68,Dartmouth (Ivy League),13,2-11,106,191,297,0.357,05/29/2017-Final Statistics,2017.0
69,High Point (SoCon),14,4-10,111,216,327,0.339,05/29/2017-Final Statistics,2017.0
-,UMass Lowell (America East),16,4-12,171,220,391,0.437,05/29/2017-Final Statistics,2017.0
1,Yale (Ivy League),1,0-1,18,4,22,0.818,05/10/2017 - 05/29/2017-DI Men's Lacrosse Championship,2017.0
2,Denver (Big East),3,2-1,55,20,75,0.733,05/10/2017 - 05/29/2017-DI Men's Lacrosse Championship,2017.0
3,Marquette (Big East),1,0-1,19,9,28,0.679,05/10/2017 - 05/29/2017-DI Men's Lacrosse Championship,2017.0
4,UAlbany (America East),2,1-1,37,23,60,0.617,05/10/2017 - 05/29/2017-DI Men's Lacrosse Championship,2017.0
5,Bryant (NEC),2,1-1,26,18,44,0.591,05/10/2017 - 05/29/2017-DI Men's Lacrosse Championship,2017.0
6,Ohio St. (Big Ten),4,3-1,49,40,89,0.551,05/10/2017 - 05/29/2017-DI Men's Lacrosse Championship,2017.0
7,Duke (ACC),2,1-1,31,27,58,0.534,05/10/2017 - 05/29/2017-DI Men's Lacrosse Championship,2017.0
8,Maryland (Big Ten),4,4-0,50,45,95,0.526,05/10/2017 - 05/29/2017-DI Men's Lacrosse Championship,2017.0
9,Towson (CAA),3,2-1,33,36,69,0.478,05/10/2017 - 05/29/2017-DI Men's Lacrosse Championship,2017.0
10,Loyola Maryland (Patriot),1,0-1,7,8,15,0.467,05/10/2017 - 05/29/2017-DI Men's Lacrosse Championship,2017.0
11,Penn St. (Big Ten),1,0-1,11,13,24,0.458,05/10/2017 - 05/29/2017-DI Men's Lacrosse Championship,2017.0
12,Syracuse (ACC),2,1-1,14,28,42,0.333,05/10/2017 - 05/29/2017-DI Men's Lacrosse Championship,2017.0
13,Johns Hopkins (Big Ten),1,0-1,9,19,28,0.321,05/10/2017 - 05/29/2017-DI Men's Lacrosse Championship,2017.0
14,Monmouth (MAAC),1,0-1,5,14,19,0.263,05/10/2017 - 05/29/2017-DI Men's Lacrosse Championship,2017.0
15,Air Force (SoCon),1,0-1,8,23,31,0.258,05/10/2017 - 05/29/2017-DI Men's Lacrosse Championship,2017.0
16,North Carolina (ACC),1,0-1,7,23,30,0.233,05/10/2017 - 05/29/2017-DI Men's Lacrosse Championship,2017.0
17,Notre Dame (ACC),2,1-1,11,40,51,0.216,05/10/2017 - 05/29/2017-DI Men's Lacrosse Championship,2017.0
1,Denver (Big East),17,13-4,313,120,433,0.723,05/27/2017,2017.0
2,UAlbany (America East),18,15-3,349,160,509,0.686,05/27/2017,2017.0
3,Navy (Patriot),14,6-8,199,111,310,0.642,05/27/2017,2017.0
4,Ohio St. (Big Ten),20,16-4,294,173,467,0.630,05/27/2017,2017.0
5,Army West Point (Patriot),16,12-4,216,136,352,0.614,05/27/2017,2017.0
6,Yale (Ivy League),16,10-6,262,171,433,0.605,05/27/2017,2017.0
7,Brown (Ivy League),16,10-6,288,200,488,0.590,05/27/2017,2017.0
8,Richmond (SoCon),16,12-4,188,131,319,0.589,05/27/2017,2017.0
9,Penn St. (Big Ten),16,12-4,258,184,442,0.584,05/27/2017,2017.0
10,Towson (CAA),17,12-5,199,148,347,0.573,05/27/2017,2017.0
11,Bryant (NEC),19,11-8,228,176,404,0.564,05/27/2017,2017.0
12,Loyola Maryland (Patriot),16,10-6,217,168,385,0.564,05/27/2017,2017.0
13,Massachusetts (CAA),15,7-8,187,148,335,0.558,05/27/2017,2017.0
14,Mercer (SoCon),13,5-8,165,132,297,0.556,05/27/2017,2017.0
15,Duke (ACC),18,13-5,247,203,450,0.549,05/27/2017,2017.0
16,Jacksonville (SoCon),14,3-11,191,158,349,0.547,05/27/2017,2017.0
17,Air Force (SoCon),18,12-6,221,185,406,0.544,05/27/2017,2017.0
18,Saint Joseph's (NEC),14,5-9,168,143,311,0.540,05/27/2017,2017.0
19,Rutgers (Big Ten),14,10-4,184,158,342,0.538,05/27/2017,2017.0
20,Hartford (America East),14,6-8,189,163,352,0.537,05/27/2017,2017.0
21,Providence (Big East),17,10-7,196,170,366,0.536,05/27/2017,2017.0
22,Quinnipiac (MAAC),11,2-9,143,125,268,0.534,05/27/2017,2017.0
23,Lehigh (Patriot),14,7-7,171,151,322,0.531,05/27/2017,2017.0
24,Syracuse (ACC),16,13-3,211,189,400,0.528,05/27/2017,2017.0
25,Virginia (ACC),15,8-7,247,222,469,0.527,05/27/2017,2017.0
26,Hobart (NEC),16,9-7,217,197,414,0.524,05/27/2017,2017.0
27,Marist (MAAC),16,10-6,156,143,299,0.522,05/27/2017,2017.0
28,North Carolina (ACC),16,8-8,209,192,401,0.521,05/27/2017,2017.0
29,Colgate (Patriot),14,5-9,170,159,329,0.517,05/27/2017,2017.0
30,Bucknell (Patriot),13,5-8,155,146,301,0.515,05/27/2017,2017.0
31,Fairfield (CAA),14,5-9,160,153,313,0.511,05/27/2017,2017.0
32,Vermont (America East),13,5-8,158,156,314,0.503,05/27/2017,2017.0
33,Detroit Mercy (MAAC),16,5-11,182,181,363,0.501,05/27/2017,2017.0
34,Marquette (Big East),16,8-8,179,181,360,0.497,05/27/2017,2017.0
35,Maryland (Big Ten),18,15-3,225,228,453,0.497,05/27/2017,2017.0
36,Delaware (CAA),15,7-8,178,181,359,0.496,05/27/2017,2017.0
37,Manhattan (MAAC),14,3-11,176,179,355,0.496,05/27/2017,2017.0
38,Sacred Heart (NEC),15,9-6,180,187,367,0.490,05/27/2017,2017.0
39,Princeton (Ivy League),15,9-6,214,223,437,0.490,05/27/2017,2017.0
40,Penn (Ivy League),13,7-6,164,171,335,0.490,05/27/2017,2017.0
41,Boston U. (Patriot),17,12-5,192,201,393,0.489,05/27/2017,2017.0
42,Furman (SoCon),15,7-8,162,172,334,0.485,05/27/2017,2017.0
43,Binghamton (America East),16,11-5,162,176,338,0.479,05/27/2017,2017.0
44,Michigan (Big Ten),14,8-6,171,186,357,0.479,05/27/2017,2017.0
45,Villanova (Big East),15,9-6,200,219,419,0.477,05/27/2017,2017.0
46,Monmouth (MAAC),18,14-4,175,192,367,0.477,05/27/2017,2017.0
47,Lafayette (Patriot),14,2-12,153,170,323,0.474,05/27/2017,2017.0
48,UMBC (America East),14,6-8,132,150,282,0.468,05/27/2017,2017.0
49,Johns Hopkins (Big Ten),15,8-7,184,212,396,0.465,05/27/2017,2017.0
50,Georgetown (Big East),14,4-10,159,186,345,0.461,05/27/2017,2017.0
51,Hofstra (CAA),14,11-3,150,178,328,0.457,05/27/2017,2017.0
52,VMI (SoCon),14,2-12,148,188,336,0.440,05/27/2017,2017.0
53,Notre Dame (ACC),15,9-6,155,200,355,0.437,05/27/2017,2017.0
54,Canisius (MAAC),15,6-9,158,204,362,0.436,05/27/2017,2017.0
55,Siena (MAAC),14,3-11,163,215,378,0.431,05/27/2017,2017.0
56,St. John's (NY) (Big East),14,1-13,147,194,341,0.431,05/27/2017,2017.0
57,Cleveland St. (Independent),14,5-9,153,202,355,0.431,05/27/2017,2017.0
58,Robert Morris (NEC),16,9-7,167,230,397,0.421,05/27/2017,2017.0
59,Wagner (NEC),15,6-9,129,187,316,0.408,05/27/2017,2017.0
60,Stony Brook (America East),14,7-7,147,216,363,0.405,05/27/2017,2017.0
61,Bellarmine (SoCon),13,4-9,126,203,329,0.383,05/27/2017,2017.0
62,Holy Cross (Patriot),15,5-10,130,211,341,0.381,05/27/2017,2017.0
63,Cornell (Ivy League),13,5-8,142,231,373,0.381,05/27/2017,2017.0
64,Drexel (CAA),14,6-8,128,210,338,0.379,05/27/2017,2017.0
65,Mount St. Mary's (NEC),14,4-10,123,202,325,0.378,05/27/2017,2017.0
66,Harvard (Ivy League),13,6-7,123,204,327,0.376,05/27/2017,2017.0
67,Hampton (DI Independent),8,1-7,66,117,183,0.361,05/27/2017,2017.0
68,Dartmouth (Ivy League),13,2-11,106,191,297,0.357,05/27/2017,2017.0
69,High Point (SoCon),14,4-10,111,216,327,0.339,05/27/2017,2017.0
-,UMass Lowell (America East),16,4-12,171,220,391,0.437,05/27/2017,2017.0
1,Denver (Big East),16,13-3,302,110,412,0.733,05/21/2017,2017.0
2,UAlbany (America East),18,15-3,349,160,509,0.686,05/21/2017,2017.0
3,Navy (Patriot),14,6-8,199,111,310,0.642,05/21/2017,2017.0
4,Ohio St. (Big Ten),19,15-4,279,163,442,0.631,05/21/2017,2017.0
5,Army West Point (Patriot),16,12-4,216,136,352,0.614,05/21/2017,2017.0
6,Yale (Ivy League),16,10-6,262,171,433,0.605,05/21/2017,2017.0
7,Brown (Ivy League),16,10-6,288,200,488,0.590,05/21/2017,2017.0
8,Richmond (SoCon),16,12-4,188,131,319,0.589,05/21/2017,2017.0
9,Towson (CAA),16,12-4,189,133,322,0.587,05/21/2017,2017.0
10,Penn St. (Big Ten),16,12-4,258,184,442,0.584,05/21/2017,2017.0
11,Bryant (NEC),19,11-8,228,176,404,0.564,05/21/2017,2017.0
12,Loyola Maryland (Patriot),16,10-6,217,168,385,0.564,05/21/2017,2017.0
13,Massachusetts (CAA),15,7-8,187,148,335,0.558,05/21/2017,2017.0
14,Mercer (SoCon),13,5-8,165,132,297,0.556,05/21/2017,2017.0
15,Duke (ACC),18,13-5,247,203,450,0.549,05/21/2017,2017.0
16,Jacksonville (SoCon),14,3-11,191,158,349,0.547,05/21/2017,2017.0
17,Air Force (SoCon),18,12-6,221,185,406,0.544,05/21/2017,2017.0
18,Saint Joseph's (NEC),14,5-9,168,143,311,0.540,05/21/2017,2017.0
19,Rutgers (Big Ten),14,10-4,184,158,342,0.538,05/21/2017,2017.0
20,Hartford (America East),14,6-8,189,163,352,0.537,05/21/2017,2017.0
21,Providence (Big East),17,10-7,196,170,366,0.536,05/21/2017,2017.0
22,Quinnipiac (MAAC),11,2-9,143,125,268,0.534,05/21/2017,2017.0
23,Lehigh (Patriot),14,7-7,171,151,322,0.531,05/21/2017,2017.0
24,Syracuse (ACC),16,13-3,211,189,400,0.528,05/21/2017,2017.0
25,Virginia (ACC),15,8-7,247,222,469,0.527,05/21/2017,2017.0
26,Hobart (NEC),16,9-7,217,197,414,0.524,05/21/2017,2017.0
27,Marist (MAAC),16,10-6,156,143,299,0.522,05/21/2017,2017.0
28,North Carolina (ACC),16,8-8,209,192,401,0.521,05/21/2017,2017.0
29,Colgate (Patriot),14,5-9,170,159,329,0.517,05/21/2017,2017.0
30,Bucknell (Patriot),13,5-8,155,146,301,0.515,05/21/2017,2017.0
31,Fairfield (CAA),14,5-9,160,153,313,0.511,05/21/2017,2017.0
32,Vermont (America East),13,5-8,158,156,314,0.503,05/21/2017,2017.0
33,Detroit Mercy (MAAC),16,5-11,182,181,363,0.501,05/21/2017,2017.0
34,Maryland (Big Ten),17,14-3,215,217,432,0.498,05/21/2017,2017.0
35,Marquette (Big East),16,8-8,179,181,360,0.497,05/21/2017,2017.0
36,Delaware (CAA),15,7-8,178,181,359,0.496,05/21/2017,2017.0
37,Manhattan (MAAC),14,3-11,176,179,355,0.496,05/21/2017,2017.0
38,Sacred Heart (NEC),15,9-6,180,187,367,0.490,05/21/2017,2017.0
39,Princeton (Ivy League),15,9-6,214,223,437,0.490,05/21/2017,2017.0
40,Penn (Ivy League),13,7-6,164,171,335,0.490,05/21/2017,2017.0
41,Boston U. (Patriot),17,12-5,192,201,393,0.489,05/21/2017,2017.0
42,Furman (SoCon),15,7-8,162,172,334,0.485,05/21/2017,2017.0
43,Binghamton (America East),16,11-5,162,176,338,0.479,05/21/2017,2017.0
44,Michigan (Big Ten),14,8-6,171,186,357,0.479,05/21/2017,2017.0
45,Villanova (Big East),15,9-6,200,219,419,0.477,05/21/2017,2017.0
46,Monmouth (MAAC),18,14-4,175,192,367,0.477,05/21/2017,2017.0
47,Lafayette (Patriot),14,2-12,153,170,323,0.474,05/21/2017,2017.0
48,UMBC (America East),14,6-8,132,150,282,0.468,05/21/2017,2017.0
49,Johns Hopkins (Big Ten),15,8-7,184,212,396,0.465,05/21/2017,2017.0
50,Georgetown (Big East),14,4-10,159,186,345,0.461,05/21/2017,2017.0
51,Hofstra (CAA),14,11-3,150,178,328,0.457,05/21/2017,2017.0
52,VMI (SoCon),14,2-12,148,188,336,0.440,05/21/2017,2017.0
53,Notre Dame (ACC),15,9-6,155,200,355,0.437,05/21/2017,2017.0
54,Canisius (MAAC),15,6-9,158,204,362,0.436,05/21/2017,2017.0
55,Siena (MAAC),14,3-11,163,215,378,0.431,05/21/2017,2017.0
56,St. John's (NY) (Big East),14,1-13,147,194,341,0.431,05/21/2017,2017.0
57,Cleveland St. (Independent),14,5-9,153,202,355,0.431,05/21/2017,2017.0
58,Robert Morris (NEC),16,9-7,167,230,397,0.421,05/21/2017,2017.0
59,Wagner (NEC),15,6-9,129,187,316,0.408,05/21/2017,2017.0
60,Stony Brook (America East),14,7-7,147,216,363,0.405,05/21/2017,2017.0
61,Bellarmine (SoCon),13,4-9,126,203,329,0.383,05/21/2017,2017.0
62,Holy Cross (Patriot),15,5-10,130,211,341,0.381,05/21/2017,2017.0
63,Cornell (Ivy League),13,5-8,142,231,373,0.381,05/21/2017,2017.0
64,Drexel (CAA),14,6-8,128,210,338,0.379,05/21/2017,2017.0
65,Mount St. Mary's (NEC),14,4-10,123,202,325,0.378,05/21/2017,2017.0
66,Harvard (Ivy League),13,6-7,123,204,327,0.376,05/21/2017,2017.0
67,Hampton (DI Independent),8,1-7,66,117,183,0.361,05/21/2017,2017.0
68,Dartmouth (Ivy League),13,2-11,106,191,297,0.357,05/21/2017,2017.0
69,High Point (SoCon),14,4-10,111,216,327,0.339,05/21/2017,2017.0
-,UMass Lowell (America East),16,4-12,171,220,391,0.437,05/21/2017,2017.0
1,Denver (Big East),16,13-3,302,110,412,0.733,05/20/2017,2017.0
2,UAlbany (America East),17,15-2,335,144,479,0.699,05/20/2017,2017.0
3,Navy (Patriot),14,6-8,199,111,310,0.642,05/20/2017,2017.0
4,Ohio St. (Big Ten),19,15-4,279,163,442,0.631,05/20/2017,2017.0
5,Army West Point (Patriot),16,12-4,216,136,352,0.614,05/20/2017,2017.0
6,Yale (Ivy League),16,10-6,262,171,433,0.605,05/20/2017,2017.0
7,Towson (CAA),15,11-4,179,123,302,0.593,05/20/2017,2017.0
8,Brown (Ivy League),16,10-6,288,200,488,0.590,05/20/2017,2017.0
9,Richmond (SoCon),16,12-4,188,131,319,0.589,05/20/2017,2017.0
10,Penn St. (Big Ten),16,12-4,258,184,442,0.584,05/20/2017,2017.0
11,Bryant (NEC),19,11-8,228,176,404,0.564,05/20/2017,2017.0
12,Loyola Maryland (Patriot),16,10-6,217,168,385,0.564,05/20/2017,2017.0
13,Massachusetts (CAA),15,7-8,187,148,335,0.558,05/20/2017,2017.0
14,Mercer (SoCon),13,5-8,165,132,297,0.556,05/20/2017,2017.0
15,Duke (ACC),18,13-5,247,203,450,0.549,05/20/2017,2017.0
16,Jacksonville (SoCon),14,3-11,191,158,349,0.547,05/20/2017,2017.0
17,Air Force (SoCon),18,12-6,221,185,406,0.544,05/20/2017,2017.0
18,Saint Joseph's (NEC),14,5-9,168,143,311,0.540,05/20/2017,2017.0
19,Rutgers (Big Ten),14,10-4,184,158,342,0.538,05/20/2017,2017.0
20,Hartford (America East),14,6-8,189,163,352,0.537,05/20/2017,2017.0
21,Providence (Big East),17,10-7,196,170,366,0.536,05/20/2017,2017.0
22,Quinnipiac (MAAC),11,2-9,143,125,268,0.534,05/20/2017,2017.0
23,Lehigh (Patriot),14,7-7,171,151,322,0.531,05/20/2017,2017.0
24,Syracuse (ACC),15,13-2,201,179,380,0.529,05/20/2017,2017.0
25,Virginia (ACC),15,8-7,247,222,469,0.527,05/20/2017,2017.0
26,Hobart (NEC),16,9-7,217,197,414,0.524,05/20/2017,2017.0
27,Marist (MAAC),16,10-6,156,143,299,0.522,05/20/2017,2017.0
28,North Carolina (ACC),16,8-8,209,192,401,0.521,05/20/2017,2017.0
29,Colgate (Patriot),14,5-9,170,159,329,0.517,05/20/2017,2017.0
30,Bucknell (Patriot),13,5-8,155,146,301,0.515,05/20/2017,2017.0
31,Fairfield (CAA),14,5-9,160,153,313,0.511,05/20/2017,2017.0
32,Vermont (America East),13,5-8,158,156,314,0.503,05/20/2017,2017.0
33,Detroit Mercy (MAAC),16,5-11,182,181,363,0.501,05/20/2017,2017.0
34,Marquette (Big East),16,8-8,179,181,360,0.497,05/20/2017,2017.0
35,Delaware (CAA),15,7-8,178,181,359,0.496,05/20/2017,2017.0
36,Manhattan (MAAC),14,3-11,176,179,355,0.496,05/20/2017,2017.0
37,Maryland (Big Ten),16,13-3,199,203,402,0.495,05/20/2017,2017.0
38,Sacred Heart (NEC),15,9-6,180,187,367,0.490,05/20/2017,2017.0
39,Princeton (Ivy League),15,9-6,214,223,437,0.490,05/20/2017,2017.0
40,Penn (Ivy League),13,7-6,164,171,335,0.490,05/20/2017,2017.0
41,Boston U. (Patriot),17,12-5,192,201,393,0.489,05/20/2017,2017.0
42,Furman (SoCon),15,7-8,162,172,334,0.485,05/20/2017,2017.0
43,Binghamton (America East),16,11-5,162,176,338,0.479,05/20/2017,2017.0
44,Michigan (Big Ten),14,8-6,171,186,357,0.479,05/20/2017,2017.0
45,Villanova (Big East),15,9-6,200,219,419,0.477,05/20/2017,2017.0
46,Monmouth (MAAC),18,14-4,175,192,367,0.477,05/20/2017,2017.0
47,Lafayette (Patriot),14,2-12,153,170,323,0.474,05/20/2017,2017.0
48,UMBC (America East),14,6-8,132,150,282,0.468,05/20/2017,2017.0
49,Johns Hopkins (Big Ten),15,8-7,184,212,396,0.465,05/20/2017,2017.0
50,Georgetown (Big East),14,4-10,159,186,345,0.461,05/20/2017,2017.0
51,Hofstra (CAA),14,11-3,150,178,328,0.457,05/20/2017,2017.0
52,VMI (SoCon),14,2-12,148,188,336,0.440,05/20/2017,2017.0
53,Notre Dame (ACC),15,9-6,155,200,355,0.437,05/20/2017,2017.0
54,Canisius (MAAC),15,6-9,158,204,362,0.436,05/20/2017,2017.0
55,Siena (MAAC),14,3-11,163,215,378,0.431,05/20/2017,2017.0
56,St. John's (NY) (Big East),14,1-13,147,194,341,0.431,05/20/2017,2017.0
57,Cleveland St. (Independent),14,5-9,153,202,355,0.431,05/20/2017,2017.0
58,Robert Morris (NEC),16,9-7,167,230,397,0.421,05/20/2017,2017.0
59,Wagner (NEC),15,6-9,129,187,316,0.408,05/20/2017,2017.0
60,Stony Brook (America East),14,7-7,147,216,363,0.405,05/20/2017,2017.0
61,Bellarmine (SoCon),13,4-9,126,203,329,0.383,05/20/2017,2017.0
62,Holy Cross (Patriot),15,5-10,130,211,341,0.381,05/20/2017,2017.0
63,Cornell (Ivy League),13,5-8,142,231,373,0.381,05/20/2017,2017.0
64,Drexel (CAA),14,6-8,128,210,338,0.379,05/20/2017,2017.0
65,Mount St. Mary's (NEC),14,4-10,123,202,325,0.378,05/20/2017,2017.0
66,Harvard (Ivy League),13,6-7,123,204,327,0.376,05/20/2017,2017.0
67,Hampton (DI Independent),8,1-7,66,117,183,0.361,05/20/2017,2017.0
68,Dartmouth (Ivy League),13,2-11,106,191,297,0.357,05/20/2017,2017.0
69,High Point (SoCon),14,4-10,111,216,327,0.339,05/20/2017,2017.0
-,UMass Lowell (America East),16,4-12,171,220,391,0.437,05/20/2017,2017.0
1,Denver (Big East),15,12-3,281,108,389,0.722,05/14/2017,2017.0
2,UAlbany (America East),17,15-2,335,144,479,0.699,05/14/2017,2017.0
3,Navy (Patriot),14,6-8,199,111,310,0.642,05/14/2017,2017.0
4,Ohio St. (Big Ten),18,14-4,261,151,412,0.633,05/14/2017,2017.0
5,Army West Point (Patriot),16,12-4,216,136,352,0.614,05/14/2017,2017.0
6,Yale (Ivy League),16,10-6,262,171,433,0.605,05/14/2017,2017.0
7,Towson (CAA),15,11-4,179,123,302,0.593,05/14/2017,2017.0
8,Brown (Ivy League),16,10-6,288,200,488,0.590,05/14/2017,2017.0
9,Richmond (SoCon),16,12-4,188,131,319,0.589,05/14/2017,2017.0
10,Penn St. (Big Ten),16,12-4,258,184,442,0.584,05/14/2017,2017.0
11,Bryant (NEC),19,11-8,228,176,404,0.564,05/14/2017,2017.0
12,Loyola Maryland (Patriot),16,10-6,217,168,385,0.564,05/14/2017,2017.0
13,Duke (ACC),17,13-4,235,185,420,0.560,05/14/2017,2017.0
14,Massachusetts (CAA),15,7-8,187,148,335,0.558,05/14/2017,2017.0
15,Mercer (SoCon),13,5-8,165,132,297,0.556,05/14/2017,2017.0
16,Jacksonville (SoCon),14,3-11,191,158,349,0.547,05/14/2017,2017.0
17,Air Force (SoCon),18,12-6,221,185,406,0.544,05/14/2017,2017.0
18,Saint Joseph's (NEC),14,5-9,168,143,311,0.540,05/14/2017,2017.0
19,Rutgers (Big Ten),14,10-4,184,158,342,0.538,05/14/2017,2017.0
20,Hartford (America East),14,6-8,189,163,352,0.537,05/14/2017,2017.0
21,Providence (Big East),17,10-7,196,170,366,0.536,05/14/2017,2017.0
22,Quinnipiac (MAAC),11,2-9,143,125,268,0.534,05/14/2017,2017.0
23,Lehigh (Patriot),14,7-7,171,151,322,0.531,05/14/2017,2017.0
24,Syracuse (ACC),15,13-2,201,179,380,0.529,05/14/2017,2017.0
25,Virginia (ACC),15,8-7,247,222,469,0.527,05/14/2017,2017.0
26,Hobart (NEC),16,9-7,217,197,414,0.524,05/14/2017,2017.0
27,Marist (MAAC),16,10-6,156,143,299,0.522,05/14/2017,2017.0
28,North Carolina (ACC),16,8-8,209,192,401,0.521,05/14/2017,2017.0
29,Colgate (Patriot),14,5-9,170,159,329,0.517,05/14/2017,2017.0
30,Bucknell (Patriot),13,5-8,155,146,301,0.515,05/14/2017,2017.0
31,Fairfield (CAA),14,5-9,160,153,313,0.511,05/14/2017,2017.0
32,Vermont (America East),13,5-8,158,156,314,0.503,05/14/2017,2017.0
33,Detroit Mercy (MAAC),16,5-11,182,181,363,0.501,05/14/2017,2017.0
34,Marquette (Big East),16,8-8,179,181,360,0.497,05/14/2017,2017.0
35,Delaware (CAA),15,7-8,178,181,359,0.496,05/14/2017,2017.0
36,Manhattan (MAAC),14,3-11,176,179,355,0.496,05/14/2017,2017.0
37,Maryland (Big Ten),16,13-3,199,203,402,0.495,05/14/2017,2017.0
38,Sacred Heart (NEC),15,9-6,180,187,367,0.490,05/14/2017,2017.0
39,Princeton (Ivy League),15,9-6,214,223,437,0.490,05/14/2017,2017.0
40,Penn (Ivy League),13,7-6,164,171,335,0.490,05/14/2017,2017.0
41,Boston U. (Patriot),17,12-5,192,201,393,0.489,05/14/2017,2017.0
42,Furman (SoCon),15,7-8,162,172,334,0.485,05/14/2017,2017.0
43,Binghamton (America East),16,11-5,162,176,338,0.479,05/14/2017,2017.0
44,Michigan (Big Ten),14,8-6,171,186,357,0.479,05/14/2017,2017.0
45,Villanova (Big East),15,9-6,200,219,419,0.477,05/14/2017,2017.0
46,Monmouth (MAAC),18,14-4,175,192,367,0.477,05/14/2017,2017.0
47,Lafayette (Patriot),14,2-12,153,170,323,0.474,05/14/2017,2017.0
48,UMBC (America East),14,6-8,132,150,282,0.468,05/14/2017,2017.0
49,Johns Hopkins (Big Ten),15,8-7,184,212,396,0.465,05/14/2017,2017.0
50,Georgetown (Big East),14,4-10,159,186,345,0.461,05/14/2017,2017.0
51,Notre Dame (ACC),14,9-5,153,179,332,0.461,05/14/2017,2017.0
52,Hofstra (CAA),14,11-3,150,178,328,0.457,05/14/2017,2017.0
53,VMI (SoCon),14,2-12,148,188,336,0.440,05/14/2017,2017.0
54,Canisius (MAAC),15,6-9,158,204,362,0.436,05/14/2017,2017.0
55,Siena (MAAC),14,3-11,163,215,378,0.431,05/14/2017,2017.0
56,St. John's (NY) (Big East),14,1-13,147,194,341,0.431,05/14/2017,2017.0
57,Cleveland St. (Independent),14,5-9,153,202,355,0.431,05/14/2017,2017.0
58,Robert Morris (NEC),16,9-7,167,230,397,0.421,05/14/2017,2017.0
59,Wagner (NEC),15,6-9,129,187,316,0.408,05/14/2017,2017.0
60,Stony Brook (America East),14,7-7,147,216,363,0.405,05/14/2017,2017.0
61,Bellarmine (SoCon),13,4-9,126,203,329,0.383,05/14/2017,2017.0
62,Holy Cross (Patriot),15,5-10,130,211,341,0.381,05/14/2017,2017.0
63,Cornell (Ivy League),13,5-8,142,231,373,0.381,05/14/2017,2017.0
64,Drexel (CAA),14,6-8,128,210,338,0.379,05/14/2017,2017.0
65,Mount St. Mary's (NEC),14,4-10,123,202,325,0.378,05/14/2017,2017.0
66,Harvard (Ivy League),13,6-7,123,204,327,0.376,05/14/2017,2017.0
67,Hampton (DI Independent),8,1-7,66,117,183,0.361,05/14/2017,2017.0
68,Dartmouth (Ivy League),13,2-11,106,191,297,0.357,05/14/2017,2017.0
69,High Point (SoCon),14,4-10,111,216,327,0.339,05/14/2017,2017.0
-,UMass Lowell (America East),16,4-12,171,220,391,0.437,05/14/2017,2017.0
1,Denver (Big East),15,12-3,281,108,389,0.722,05/13/2017,2017.0
2,UAlbany (America East),17,15-2,335,144,479,0.699,05/13/2017,2017.0
3,Navy (Patriot),14,6-8,199,111,310,0.642,05/13/2017,2017.0
4,Ohio St. (Big Ten),17,13-4,253,144,397,0.637,05/13/2017,2017.0
5,Army West Point (Patriot),16,12-4,216,136,352,0.614,05/13/2017,2017.0
6,Yale (Ivy League),15,10-5,244,167,411,0.594,05/13/2017,2017.0
7,Towson (CAA),15,11-4,179,123,302,0.593,05/13/2017,2017.0
8,Brown (Ivy League),16,10-6,288,200,488,0.590,05/13/2017,2017.0
9,Richmond (SoCon),16,12-4,188,131,319,0.589,05/13/2017,2017.0
10,Penn St. (Big Ten),16,12-4,258,184,442,0.584,05/13/2017,2017.0
11,Bryant (NEC),18,11-7,216,163,379,0.570,05/13/2017,2017.0
12,Loyola Maryland (Patriot),15,10-5,210,160,370,0.568,05/13/2017,2017.0
13,Duke (ACC),17,13-4,235,185,420,0.560,05/13/2017,2017.0
14,Massachusetts (CAA),15,7-8,187,148,335,0.558,05/13/2017,2017.0
15,Mercer (SoCon),13,5-8,165,132,297,0.556,05/13/2017,2017.0
16,Syracuse (ACC),14,12-2,197,161,358,0.550,05/13/2017,2017.0
17,Jacksonville (SoCon),14,3-11,191,158,349,0.547,05/13/2017,2017.0
18,Air Force (SoCon),18,12-6,221,185,406,0.544,05/13/2017,2017.0
19,Saint Joseph's (NEC),14,5-9,168,143,311,0.540,05/13/2017,2017.0
20,Rutgers (Big Ten),14,10-4,184,158,342,0.538,05/13/2017,2017.0
21,Hartford (America East),14,6-8,189,163,352,0.537,05/13/2017,2017.0
22,Providence (Big East),17,10-7,196,170,366,0.536,05/13/2017,2017.0
23,Quinnipiac (MAAC),11,2-9,143,125,268,0.534,05/13/2017,2017.0
24,Lehigh (Patriot),14,7-7,171,151,322,0.531,05/13/2017,2017.0
25,Virginia (ACC),15,8-7,247,222,469,0.527,05/13/2017,2017.0
26,Hobart (NEC),16,9-7,217,197,414,0.524,05/13/2017,2017.0
27,Marist (MAAC),16,10-6,156,143,299,0.522,05/13/2017,2017.0
28,North Carolina (ACC),16,8-8,209,192,401,0.521,05/13/2017,2017.0
29,Colgate (Patriot),14,5-9,170,159,329,0.517,05/13/2017,2017.0
30,Bucknell (Patriot),13,5-8,155,146,301,0.515,05/13/2017,2017.0
31,Fairfield (CAA),14,5-9,160,153,313,0.511,05/13/2017,2017.0
32,Vermont (America East),13,5-8,158,156,314,0.503,05/13/2017,2017.0
33,Detroit Mercy (MAAC),16,5-11,182,181,363,0.501,05/13/2017,2017.0
34,Delaware (CAA),15,7-8,178,181,359,0.496,05/13/2017,2017.0
35,Manhattan (MAAC),14,3-11,176,179,355,0.496,05/13/2017,2017.0
36,Maryland (Big Ten),15,12-3,186,191,377,0.493,05/13/2017,2017.0
37,Sacred Heart (NEC),15,9-6,180,187,367,0.490,05/13/2017,2017.0
38,Princeton (Ivy League),15,9-6,214,223,437,0.490,05/13/2017,2017.0
39,Penn (Ivy League),13,7-6,164,171,335,0.490,05/13/2017,2017.0
40,Boston U. (Patriot),17,12-5,192,201,393,0.489,05/13/2017,2017.0
41,Furman (SoCon),15,7-8,162,172,334,0.485,05/13/2017,2017.0
42,Marquette (Big East),15,8-7,160,172,332,0.482,05/13/2017,2017.0
43,Binghamton (America East),16,11-5,162,176,338,0.479,05/13/2017,2017.0
44,Michigan (Big Ten),14,8-6,171,186,357,0.479,05/13/2017,2017.0
45,Villanova (Big East),15,9-6,200,219,419,0.477,05/13/2017,2017.0
46,Monmouth (MAAC),18,14-4,175,192,367,0.477,05/13/2017,2017.0
47,Lafayette (Patriot),14,2-12,153,170,323,0.474,05/13/2017,2017.0
47,Notre Dame (ACC),13,8-5,144,160,304,0.474,05/13/2017,2017.0
49,UMBC (America East),14,6-8,132,150,282,0.468,05/13/2017,2017.0
50,Johns Hopkins (Big Ten),15,8-7,184,212,396,0.465,05/13/2017,2017.0
51,Georgetown (Big East),14,4-10,159,186,345,0.461,05/13/2017,2017.0
52,Hofstra (CAA),14,11-3,150,178,328,0.457,05/13/2017,2017.0
53,VMI (SoCon),14,2-12,148,188,336,0.440,05/13/2017,2017.0
54,Canisius (MAAC),15,6-9,158,204,362,0.436,05/13/2017,2017.0
55,Siena (MAAC),14,3-11,163,215,378,0.431,05/13/2017,2017.0
56,St. John's (NY) (Big East),14,1-13,147,194,341,0.431,05/13/2017,2017.0
57,Cleveland St. (Independent),14,5-9,153,202,355,0.431,05/13/2017,2017.0
58,Robert Morris (NEC),16,9-7,167,230,397,0.421,05/13/2017,2017.0
59,Wagner (NEC),15,6-9,129,187,316,0.408,05/13/2017,2017.0
60,Stony Brook (America East),14,7-7,147,216,363,0.405,05/13/2017,2017.0
61,Bellarmine (SoCon),13,4-9,126,203,329,0.383,05/13/2017,2017.0
62,Holy Cross (Patriot),15,5-10,130,211,341,0.381,05/13/2017,2017.0
63,Cornell (Ivy League),13,5-8,142,231,373,0.381,05/13/2017,2017.0
64,Drexel (CAA),14,6-8,128,210,338,0.379,05/13/2017,2017.0
65,Mount St. Mary's (NEC),14,4-10,123,202,325,0.378,05/13/2017,2017.0
66,Harvard (Ivy League),13,6-7,123,204,327,0.376,05/13/2017,2017.0
67,Hampton (DI Independent),8,1-7,66,117,183,0.361,05/13/2017,2017.0
68,Dartmouth (Ivy League),13,2-11,106,191,297,0.357,05/13/2017,2017.0
69,High Point (SoCon),14,4-10,111,216,327,0.339,05/13/2017,2017.0
-,UMass Lowell (America East),16,4-12,171,220,391,0.437,05/13/2017,2017.0
1,Denver (Big East),14,11-3,258,100,358,0.721,05/10/2017,2017.0
2,UAlbany (America East),16,14-2,312,137,449,0.695,05/10/2017,2017.0
3,Navy (Patriot),14,6-8,199,111,310,0.642,05/10/2017,2017.0
4,Ohio St. (Big Ten),17,13-4,253,144,397,0.637,05/10/2017,2017.0
5,Army West Point (Patriot),16,12-4,216,136,352,0.614,05/10/2017,2017.0
6,Towson (CAA),14,10-4,166,112,278,0.597,05/10/2017,2017.0
7,Yale (Ivy League),15,10-5,244,167,411,0.594,05/10/2017,2017.0
8,Penn St. (Big Ten),15,12-3,247,171,418,0.591,05/10/2017,2017.0
9,Brown (Ivy League),16,10-6,288,200,488,0.590,05/10/2017,2017.0
10,Richmond (SoCon),16,12-4,188,131,319,0.589,05/10/2017,2017.0
11,Bryant (NEC),18,11-7,216,163,379,0.570,05/10/2017,2017.0
12,Air Force (SoCon),17,12-5,213,162,375,0.568,05/10/2017,2017.0
13,Loyola Maryland (Patriot),15,10-5,210,160,370,0.568,05/10/2017,2017.0
14,Massachusetts (CAA),15,7-8,187,148,335,0.558,05/10/2017,2017.0
15,Mercer (SoCon),13,5-8,165,132,297,0.556,05/10/2017,2017.0
16,Duke (ACC),16,12-4,216,176,392,0.551,05/10/2017,2017.0
17,Syracuse (ACC),14,12-2,197,161,358,0.550,05/10/2017,2017.0
18,Jacksonville (SoCon),14,3-11,191,158,349,0.547,05/10/2017,2017.0
19,North Carolina (ACC),15,8-7,202,169,371,0.544,05/10/2017,2017.0
20,Saint Joseph's (NEC),14,5-9,168,143,311,0.540,05/10/2017,2017.0
21,Rutgers (Big Ten),14,10-4,184,158,342,0.538,05/10/2017,2017.0
22,Hartford (America East),14,6-8,189,163,352,0.537,05/10/2017,2017.0
23,Providence (Big East),17,10-7,196,170,366,0.536,05/10/2017,2017.0
24,Quinnipiac (MAAC),11,2-9,143,125,268,0.534,05/10/2017,2017.0
25,Lehigh (Patriot),14,7-7,171,151,322,0.531,05/10/2017,2017.0
26,Virginia (ACC),15,8-7,247,222,469,0.527,05/10/2017,2017.0
27,Hobart (NEC),16,9-7,217,197,414,0.524,05/10/2017,2017.0
28,Marist (MAAC),16,10-6,156,143,299,0.522,05/10/2017,2017.0
29,Colgate (Patriot),14,5-9,170,159,329,0.517,05/10/2017,2017.0
30,Bucknell (Patriot),13,5-8,155,146,301,0.515,05/10/2017,2017.0
31,Fairfield (CAA),14,5-9,160,153,313,0.511,05/10/2017,2017.0
32,Vermont (America East),13,5-8,158,156,314,0.503,05/10/2017,2017.0
33,Detroit Mercy (MAAC),16,5-11,182,181,363,0.501,05/10/2017,2017.0
34,Delaware (CAA),15,7-8,178,181,359,0.496,05/10/2017,2017.0
35,Manhattan (MAAC),14,3-11,176,179,355,0.496,05/10/2017,2017.0
36,Maryland (Big Ten),15,12-3,186,191,377,0.493,05/10/2017,2017.0
37,Sacred Heart (NEC),15,9-6,180,187,367,0.490,05/10/2017,2017.0
38,Princeton (Ivy League),15,9-6,214,223,437,0.490,05/10/2017,2017.0
39,Penn (Ivy League),13,7-6,164,171,335,0.490,05/10/2017,2017.0
40,Boston U. (Patriot),17,12-5,192,201,393,0.489,05/10/2017,2017.0
41,Furman (SoCon),15,7-8,162,172,334,0.485,05/10/2017,2017.0
42,Marquette (Big East),15,8-7,160,172,332,0.482,05/10/2017,2017.0
43,Binghamton (America East),16,11-5,162,176,338,0.479,05/10/2017,2017.0
44,Michigan (Big Ten),14,8-6,171,186,357,0.479,05/10/2017,2017.0
45,Villanova (Big East),15,9-6,200,219,419,0.477,05/10/2017,2017.0
46,Monmouth (MAAC),18,14-4,175,192,367,0.477,05/10/2017,2017.0
47,Johns Hopkins (Big Ten),14,8-6,175,193,368,0.476,05/10/2017,2017.0
48,Lafayette (Patriot),14,2-12,153,170,323,0.474,05/10/2017,2017.0
48,Notre Dame (ACC),13,8-5,144,160,304,0.474,05/10/2017,2017.0
50,UMBC (America East),14,6-8,132,150,282,0.468,05/10/2017,2017.0
51,Georgetown (Big East),14,4-10,159,186,345,0.461,05/10/2017,2017.0
52,Hofstra (CAA),14,11-3,150,178,328,0.457,05/10/2017,2017.0
53,VMI (SoCon),14,2-12,148,188,336,0.440,05/10/2017,2017.0
54,Canisius (MAAC),15,6-9,158,204,362,0.436,05/10/2017,2017.0
55,Siena (MAAC),14,3-11,163,215,378,0.431,05/10/2017,2017.0
56,St. John's (NY) (Big East),14,1-13,147,194,341,0.431,05/10/2017,2017.0
57,Cleveland St. (Independent),14,5-9,153,202,355,0.431,05/10/2017,2017.0
58,Robert Morris (NEC),16,9-7,167,230,397,0.421,05/10/2017,2017.0
59,Wagner (NEC),15,6-9,129,187,316,0.408,05/10/2017,2017.0
60,Stony Brook (America East),14,7-7,147,216,363,0.405,05/10/2017,2017.0
61,Bellarmine (SoCon),13,4-9,126,203,329,0.383,05/10/2017,2017.0
62,Holy Cross (Patriot),15,5-10,130,211,341,0.381,05/10/2017,2017.0
63,Cornell (Ivy League),13,5-8,142,231,373,0.381,05/10/2017,2017.0
64,Drexel (CAA),14,6-8,128,210,338,0.379,05/10/2017,2017.0
65,Mount St. Mary's (NEC),14,4-10,123,202,325,0.378,05/10/2017,2017.0
66,Harvard (Ivy League),13,6-7,123,204,327,0.376,05/10/2017,2017.0
67,Hampton (DI Independent),8,1-7,66,117,183,0.361,05/10/2017,2017.0
68,Dartmouth (Ivy League),13,2-11,106,191,297,0.357,05/10/2017,2017.0
69,High Point (SoCon),14,4-10,111,216,327,0.339,05/10/2017,2017.0
-,UMass Lowell (America East),16,4-12,171,220,391,0.437,05/10/2017,2017.0
1,Denver (Big East),14,11-3,258,100,358,0.721,05/07/2017,2017.0
2,UAlbany (America East),16,14-2,312,137,449,0.695,05/07/2017,2017.0
3,Navy (Patriot),14,6-8,199,111,310,0.642,05/07/2017,2017.0
4,Ohio St. (Big Ten),17,13-4,253,144,397,0.637,05/07/2017,2017.0
5,Army West Point (Patriot),16,12-4,216,136,352,0.614,05/07/2017,2017.0
6,Towson (CAA),14,10-4,166,112,278,0.597,05/07/2017,2017.0
7,Yale (Ivy League),15,10-5,244,167,411,0.594,05/07/2017,2017.0
8,Penn St. (Big Ten),15,12-3,247,171,418,0.591,05/07/2017,2017.0
9,Brown (Ivy League),16,10-6,288,200,488,0.590,05/07/2017,2017.0
10,Richmond (SoCon),16,12-4,188,131,319,0.589,05/07/2017,2017.0
11,Air Force (SoCon),17,12-5,213,162,375,0.568,05/07/2017,2017.0
12,Loyola Maryland (Patriot),15,10-5,210,160,370,0.568,05/07/2017,2017.0
13,Bryant (NEC),17,10-7,202,158,360,0.561,05/07/2017,2017.0
14,Massachusetts (CAA),15,7-8,187,148,335,0.558,05/07/2017,2017.0
15,Mercer (SoCon),13,5-8,165,132,297,0.556,05/07/2017,2017.0
16,Duke (ACC),16,12-4,216,176,392,0.551,05/07/2017,2017.0
17,Syracuse (ACC),14,12-2,197,161,358,0.550,05/07/2017,2017.0
18,Jacksonville (SoCon),14,3-11,191,158,349,0.547,05/07/2017,2017.0
19,North Carolina (ACC),15,8-7,202,169,371,0.544,05/07/2017,2017.0
20,Saint Joseph's (NEC),14,5-9,168,143,311,0.540,05/07/2017,2017.0
21,Rutgers (Big Ten),14,10-4,184,158,342,0.538,05/07/2017,2017.0
22,Hartford (America East),14,6-8,189,163,352,0.537,05/07/2017,2017.0
23,Providence (Big East),17,10-7,196,170,366,0.536,05/07/2017,2017.0
24,Quinnipiac (MAAC),11,2-9,143,125,268,0.534,05/07/2017,2017.0
25,Lehigh (Patriot),14,7-7,171,151,322,0.531,05/07/2017,2017.0
26,Virginia (ACC),15,8-7,247,222,469,0.527,05/07/2017,2017.0
27,Hobart (NEC),16,9-7,217,197,414,0.524,05/07/2017,2017.0
28,Marist (MAAC),16,10-6,156,143,299,0.522,05/07/2017,2017.0
29,Colgate (Patriot),14,5-9,170,159,329,0.517,05/07/2017,2017.0
30,Bucknell (Patriot),13,5-8,155,146,301,0.515,05/07/2017,2017.0
31,Fairfield (CAA),14,5-9,160,153,313,0.511,05/07/2017,2017.0
32,Vermont (America East),13,5-8,158,156,314,0.503,05/07/2017,2017.0
33,Detroit Mercy (MAAC),16,5-11,182,181,363,0.501,05/07/2017,2017.0
34,Delaware (CAA),15,7-8,178,181,359,0.496,05/07/2017,2017.0
35,Manhattan (MAAC),14,3-11,176,179,355,0.496,05/07/2017,2017.0
36,Maryland (Big Ten),15,12-3,186,191,377,0.493,05/07/2017,2017.0
37,Sacred Heart (NEC),15,9-6,180,187,367,0.490,05/07/2017,2017.0
38,Princeton (Ivy League),15,9-6,214,223,437,0.490,05/07/2017,2017.0
39,Penn (Ivy League),13,7-6,164,171,335,0.490,05/07/2017,2017.0
40,Boston U. (Patriot),17,12-5,192,201,393,0.489,05/07/2017,2017.0
41,Monmouth (MAAC),17,14-3,170,178,348,0.489,05/07/2017,2017.0
42,Furman (SoCon),15,7-8,162,172,334,0.485,05/07/2017,2017.0
43,Marquette (Big East),15,8-7,160,172,332,0.482,05/07/2017,2017.0
44,Binghamton (America East),16,11-5,162,176,338,0.479,05/07/2017,2017.0
45,Michigan (Big Ten),14,8-6,171,186,357,0.479,05/07/2017,2017.0
46,Villanova (Big East),15,9-6,200,219,419,0.477,05/07/2017,2017.0
47,Johns Hopkins (Big Ten),14,8-6,175,193,368,0.476,05/07/2017,2017.0
48,Lafayette (Patriot),14,2-12,153,170,323,0.474,05/07/2017,2017.0
48,Notre Dame (ACC),13,8-5,144,160,304,0.474,05/07/2017,2017.0
50,UMBC (America East),14,6-8,132,150,282,0.468,05/07/2017,2017.0
51,Georgetown (Big East),14,4-10,159,186,345,0.461,05/07/2017,2017.0
52,Hofstra (CAA),14,11-3,150,178,328,0.457,05/07/2017,2017.0
53,VMI (SoCon),14,2-12,148,188,336,0.440,05/07/2017,2017.0
54,Canisius (MAAC),15,6-9,158,204,362,0.436,05/07/2017,2017.0
55,Siena (MAAC),14,3-11,163,215,378,0.431,05/07/2017,2017.0
56,St. John's (NY) (Big East),14,1-13,147,194,341,0.431,05/07/2017,2017.0
57,Cleveland St. (Independent),14,5-9,153,202,355,0.431,05/07/2017,2017.0
58,Robert Morris (NEC),16,9-7,167,230,397,0.421,05/07/2017,2017.0
59,Wagner (NEC),15,6-9,129,187,316,0.408,05/07/2017,2017.0
60,Stony Brook (America East),14,7-7,147,216,363,0.405,05/07/2017,2017.0
61,Bellarmine (SoCon),13,4-9,126,203,329,0.383,05/07/2017,2017.0
62,Holy Cross (Patriot),15,5-10,130,211,341,0.381,05/07/2017,2017.0
63,Cornell (Ivy League),13,5-8,142,231,373,0.381,05/07/2017,2017.0
64,Drexel (CAA),14,6-8,128,210,338,0.379,05/07/2017,2017.0
65,Mount St. Mary's (NEC),14,4-10,123,202,325,0.378,05/07/2017,2017.0
66,Harvard (Ivy League),13,6-7,123,204,327,0.376,05/07/2017,2017.0
67,Hampton (DI Independent),8,1-7,66,117,183,0.361,05/07/2017,2017.0
68,Dartmouth (Ivy League),13,2-11,106,191,297,0.357,05/07/2017,2017.0
69,High Point (SoCon),14,4-10,111,216,327,0.339,05/07/2017,2017.0
-,UMass Lowell (America East),16,4-12,171,220,391,0.437,05/07/2017,2017.0
1,Denver (Big East),14,11-3,258,100,358,0.721,05/06/2017,2017.0
2,UAlbany (America East),16,14-2,312,137,449,0.695,05/06/2017,2017.0
3,Navy (Patriot),14,6-8,199,111,310,0.642,05/06/2017,2017.0
4,Ohio St. (Big Ten),17,13-4,253,144,397,0.637,05/06/2017,2017.0
5,Army West Point (Patriot),16,12-4,216,136,352,0.614,05/06/2017,2017.0
6,Yale (Ivy League),14,9-5,234,154,388,0.603,05/06/2017,2017.0
7,Towson (CAA),14,10-4,166,112,278,0.597,05/06/2017,2017.0
8,Brown (Ivy League),15,10-5,275,190,465,0.591,05/06/2017,2017.0
9,Penn St. (Big Ten),15,12-3,247,171,418,0.591,05/06/2017,2017.0
10,Richmond (SoCon),16,12-4,188,131,319,0.589,05/06/2017,2017.0
11,Air Force (SoCon),17,12-5,213,162,375,0.568,05/06/2017,2017.0
12,Loyola Maryland (Patriot),15,10-5,210,160,370,0.568,05/06/2017,2017.0
13,Bryant (NEC),17,10-7,202,158,360,0.561,05/06/2017,2017.0
14,Massachusetts (CAA),15,7-8,187,148,335,0.558,05/06/2017,2017.0
15,Mercer (SoCon),13,5-8,165,132,297,0.556,05/06/2017,2017.0
16,Syracuse (ACC),14,12-2,197,161,358,0.550,05/06/2017,2017.0
17,Jacksonville (SoCon),14,3-11,191,158,349,0.547,05/06/2017,2017.0
18,North Carolina (ACC),15,8-7,202,169,371,0.544,05/06/2017,2017.0
19,Saint Joseph's (NEC),14,5-9,168,143,311,0.540,05/06/2017,2017.0
20,Rutgers (Big Ten),14,10-4,184,158,342,0.538,05/06/2017,2017.0
21,Hartford (America East),14,6-8,189,163,352,0.537,05/06/2017,2017.0
22,Providence (Big East),17,10-7,196,170,366,0.536,05/06/2017,2017.0
23,Quinnipiac (MAAC),11,2-9,143,125,268,0.534,05/06/2017,2017.0
24,Duke (ACC),15,11-4,193,170,363,0.532,05/06/2017,2017.0
25,Lehigh (Patriot),14,7-7,171,151,322,0.531,05/06/2017,2017.0
26,Virginia (ACC),15,8-7,247,222,469,0.527,05/06/2017,2017.0
27,Marist (MAAC),15,10-5,146,132,278,0.525,05/06/2017,2017.0
28,Hobart (NEC),16,9-7,217,197,414,0.524,05/06/2017,2017.0
29,Colgate (Patriot),14,5-9,170,159,329,0.517,05/06/2017,2017.0
30,Bucknell (Patriot),13,5-8,155,146,301,0.515,05/06/2017,2017.0
31,Fairfield (CAA),14,5-9,160,153,313,0.511,05/06/2017,2017.0
32,Boston U. (Patriot),16,12-4,186,178,364,0.511,05/06/2017,2017.0
33,Vermont (America East),13,5-8,158,156,314,0.503,05/06/2017,2017.0
34,Detroit Mercy (MAAC),16,5-11,182,181,363,0.501,05/06/2017,2017.0
35,Delaware (CAA),15,7-8,178,181,359,0.496,05/06/2017,2017.0
36,Manhattan (MAAC),14,3-11,176,179,355,0.496,05/06/2017,2017.0
37,Maryland (Big Ten),15,12-3,186,191,377,0.493,05/06/2017,2017.0
38,Sacred Heart (NEC),15,9-6,180,187,367,0.490,05/06/2017,2017.0
39,Princeton (Ivy League),15,9-6,214,223,437,0.490,05/06/2017,2017.0
40,Penn (Ivy League),13,7-6,164,171,335,0.490,05/06/2017,2017.0
41,Monmouth (MAAC),16,13-3,159,168,327,0.486,05/06/2017,2017.0
42,Furman (SoCon),15,7-8,162,172,334,0.485,05/06/2017,2017.0
43,Marquette (Big East),15,8-7,160,172,332,0.482,05/06/2017,2017.0
44,Binghamton (America East),16,11-5,162,176,338,0.479,05/06/2017,2017.0
45,Michigan (Big Ten),14,8-6,171,186,357,0.479,05/06/2017,2017.0
46,Villanova (Big East),15,9-6,200,219,419,0.477,05/06/2017,2017.0
47,Johns Hopkins (Big Ten),14,8-6,175,193,368,0.476,05/06/2017,2017.0
48,Lafayette (Patriot),14,2-12,153,170,323,0.474,05/06/2017,2017.0
48,Notre Dame (ACC),13,8-5,144,160,304,0.474,05/06/2017,2017.0
50,UMBC (America East),14,6-8,132,150,282,0.468,05/06/2017,2017.0
51,Georgetown (Big East),14,4-10,159,186,345,0.461,05/06/2017,2017.0
52,Hofstra (CAA),14,11-3,150,178,328,0.457,05/06/2017,2017.0
53,VMI (SoCon),14,2-12,148,188,336,0.440,05/06/2017,2017.0
54,Canisius (MAAC),15,6-9,158,204,362,0.436,05/06/2017,2017.0
55,Siena (MAAC),14,3-11,163,215,378,0.431,05/06/2017,2017.0
56,St. John's (NY) (Big East),14,1-13,147,194,341,0.431,05/06/2017,2017.0
57,Cleveland St. (Independent),14,5-9,153,202,355,0.431,05/06/2017,2017.0
58,Robert Morris (NEC),16,9-7,167,230,397,0.421,05/06/2017,2017.0
59,Wagner (NEC),15,6-9,129,187,316,0.408,05/06/2017,2017.0
60,Stony Brook (America East),14,7-7,147,216,363,0.405,05/06/2017,2017.0
61,Bellarmine (SoCon),13,4-9,126,203,329,0.383,05/06/2017,2017.0
62,Holy Cross (Patriot),15,5-10,130,211,341,0.381,05/06/2017,2017.0
63,Cornell (Ivy League),13,5-8,142,231,373,0.381,05/06/2017,2017.0
64,Drexel (CAA),14,6-8,128,210,338,0.379,05/06/2017,2017.0
65,Mount St. Mary's (NEC),14,4-10,123,202,325,0.378,05/06/2017,2017.0
66,Harvard (Ivy League),13,6-7,123,204,327,0.376,05/06/2017,2017.0
67,Hampton (DI Independent),8,1-7,66,117,183,0.361,05/06/2017,2017.0
68,Dartmouth (Ivy League),13,2-11,106,191,297,0.357,05/06/2017,2017.0
69,High Point (SoCon),14,4-10,111,216,327,0.339,05/06/2017,2017.0
-,UMass Lowell (America East),16,4-12,171,220,391,0.437,05/06/2017,2017.0
1,Denver (Big East),14,11-3,258,100,358,0.721,05/05/2017,2017.0
2,UAlbany (America East),15,13-2,291,128,419,0.695,05/05/2017,2017.0
3,Navy (Patriot),14,6-8,199,111,310,0.642,05/05/2017,2017.0
4,Ohio St. (Big Ten),16,13-3,240,134,374,0.642,05/05/2017,2017.0
5,Army West Point (Patriot),15,11-4,204,127,331,0.616,05/05/2017,2017.0
6,Yale (Ivy League),14,9-5,234,154,388,0.603,05/05/2017,2017.0
7,Towson (CAA),13,9-4,158,104,262,0.603,05/05/2017,2017.0
8,Richmond (SoCon),15,12-3,178,122,300,0.593,05/05/2017,2017.0
9,Brown (Ivy League),15,10-5,275,190,465,0.591,05/05/2017,2017.0
10,Penn St. (Big Ten),15,12-3,247,171,418,0.591,05/05/2017,2017.0
11,Air Force (SoCon),16,11-5,204,152,356,0.573,05/05/2017,2017.0
12,Bryant (NEC),16,9-7,198,149,347,0.571,05/05/2017,2017.0
13,Loyola Maryland (Patriot),15,10-5,210,160,370,0.568,05/05/2017,2017.0
14,Massachusetts (CAA),14,7-7,179,140,319,0.561,05/05/2017,2017.0
15,Mercer (SoCon),13,5-8,165,132,297,0.556,05/05/2017,2017.0
16,Jacksonville (SoCon),14,3-11,191,158,349,0.547,05/05/2017,2017.0
17,North Carolina (ACC),15,8-7,202,169,371,0.544,05/05/2017,2017.0
18,Syracuse (ACC),13,11-2,181,154,335,0.540,05/05/2017,2017.0
19,Saint Joseph's (NEC),14,5-9,168,143,311,0.540,05/05/2017,2017.0
20,Rutgers (Big Ten),14,10-4,184,158,342,0.538,05/05/2017,2017.0
21,Hartford (America East),14,6-8,189,163,352,0.537,05/05/2017,2017.0
22,Quinnipiac (MAAC),11,2-9,143,125,268,0.534,05/05/2017,2017.0
23,Colgate (Patriot),13,5-8,163,143,306,0.533,05/05/2017,2017.0
24,Duke (ACC),15,11-4,193,170,363,0.532,05/05/2017,2017.0
25,Lehigh (Patriot),14,7-7,171,151,322,0.531,05/05/2017,2017.0
26,Virginia (ACC),15,8-7,247,222,469,0.527,05/05/2017,2017.0
27,Marist (MAAC),15,10-5,146,132,278,0.525,05/05/2017,2017.0
28,Hobart (NEC),15,9-6,208,193,401,0.519,05/05/2017,2017.0
29,Providence (Big East),16,10-6,177,166,343,0.516,05/05/2017,2017.0
30,Bucknell (Patriot),13,5-8,155,146,301,0.515,05/05/2017,2017.0
31,Fairfield (CAA),14,5-9,160,153,313,0.511,05/05/2017,2017.0
32,Boston U. (Patriot),16,12-4,186,178,364,0.511,05/05/2017,2017.0
33,Marquette (Big East),14,7-7,156,153,309,0.505,05/05/2017,2017.0
34,Vermont (America East),13,5-8,158,156,314,0.503,05/05/2017,2017.0
35,Detroit Mercy (MAAC),16,5-11,182,181,363,0.501,05/05/2017,2017.0
36,Maryland (Big Ten),14,11-3,176,178,354,0.497,05/05/2017,2017.0
37,Binghamton (America East),15,11-4,153,155,308,0.497,05/05/2017,2017.0
38,Delaware (CAA),15,7-8,178,181,359,0.496,05/05/2017,2017.0
39,Manhattan (MAAC),14,3-11,176,179,355,0.496,05/05/2017,2017.0
40,Sacred Heart (NEC),15,9-6,180,187,367,0.490,05/05/2017,2017.0
41,Princeton (Ivy League),15,9-6,214,223,437,0.490,05/05/2017,2017.0
42,Penn (Ivy League),13,7-6,164,171,335,0.490,05/05/2017,2017.0
43,Monmouth (MAAC),16,13-3,159,168,327,0.486,05/05/2017,2017.0
44,Furman (SoCon),15,7-8,162,172,334,0.485,05/05/2017,2017.0
45,Michigan (Big Ten),14,8-6,171,186,357,0.479,05/05/2017,2017.0
46,Villanova (Big East),15,9-6,200,219,419,0.477,05/05/2017,2017.0
47,Notre Dame (ACC),12,8-4,135,148,283,0.477,05/05/2017,2017.0
48,Johns Hopkins (Big Ten),14,8-6,175,193,368,0.476,05/05/2017,2017.0
49,Lafayette (Patriot),14,2-12,153,170,323,0.474,05/05/2017,2017.0
50,UMBC (America East),14,6-8,132,150,282,0.468,05/05/2017,2017.0
51,Georgetown (Big East),14,4-10,159,186,345,0.461,05/05/2017,2017.0
52,Hofstra (CAA),14,11-3,150,178,328,0.457,05/05/2017,2017.0
53,VMI (SoCon),14,2-12,148,188,336,0.440,05/05/2017,2017.0
54,Canisius (MAAC),15,6-9,158,204,362,0.436,05/05/2017,2017.0
55,Siena (MAAC),14,3-11,163,215,378,0.431,05/05/2017,2017.0
56,St. John's (NY) (Big East),14,1-13,147,194,341,0.431,05/05/2017,2017.0
57,Cleveland St. (Independent),14,5-9,153,202,355,0.431,05/05/2017,2017.0
58,Robert Morris (NEC),16,9-7,167,230,397,0.421,05/05/2017,2017.0
59,Wagner (NEC),15,6-9,129,187,316,0.408,05/05/2017,2017.0
60,Stony Brook (America East),14,7-7,147,216,363,0.405,05/05/2017,2017.0
61,Bellarmine (SoCon),13,4-9,126,203,329,0.383,05/05/2017,2017.0
62,Holy Cross (Patriot),15,5-10,130,211,341,0.381,05/05/2017,2017.0
63,Cornell (Ivy League),13,5-8,142,231,373,0.381,05/05/2017,2017.0
64,Drexel (CAA),14,6-8,128,210,338,0.379,05/05/2017,2017.0
65,Mount St. Mary's (NEC),14,4-10,123,202,325,0.378,05/05/2017,2017.0
66,Harvard (Ivy League),13,6-7,123,204,327,0.376,05/05/2017,2017.0
67,Hampton (DI Independent),8,1-7,66,117,183,0.361,05/05/2017,2017.0
68,Dartmouth (Ivy League),13,2-11,106,191,297,0.357,05/05/2017,2017.0
69,High Point (SoCon),14,4-10,111,216,327,0.339,05/05/2017,2017.0
-,UMass Lowell (America East),16,4-12,171,220,391,0.437,05/05/2017,2017.0
1,Denver (Big East),14,11-3,258,100,358,0.721,05/04/2017,2017.0
2,UAlbany (America East),15,13-2,291,128,419,0.695,05/04/2017,2017.0
3,Navy (Patriot),14,6-8,199,111,310,0.642,05/04/2017,2017.0
4,Ohio St. (Big Ten),16,13-3,240,134,374,0.642,05/04/2017,2017.0
5,Army West Point (Patriot),15,11-4,204,127,331,0.616,05/04/2017,2017.0
6,Brown (Ivy League),14,9-5,262,168,430,0.609,05/04/2017,2017.0
7,Yale (Ivy League),13,8-5,217,140,357,0.608,05/04/2017,2017.0
8,Towson (CAA),13,9-4,158,104,262,0.603,05/04/2017,2017.0
9,Richmond (SoCon),15,12-3,178,122,300,0.593,05/04/2017,2017.0
10,Penn St. (Big Ten),15,12-3,247,171,418,0.591,05/04/2017,2017.0
11,Air Force (SoCon),16,11-5,204,152,356,0.573,05/04/2017,2017.0
12,Bryant (NEC),16,9-7,198,149,347,0.571,05/04/2017,2017.0
13,Loyola Maryland (Patriot),15,10-5,210,160,370,0.568,05/04/2017,2017.0
14,Massachusetts (CAA),14,7-7,179,140,319,0.561,05/04/2017,2017.0
15,Mercer (SoCon),13,5-8,165,132,297,0.556,05/04/2017,2017.0
16,Jacksonville (SoCon),14,3-11,191,158,349,0.547,05/04/2017,2017.0
17,North Carolina (ACC),15,8-7,202,169,371,0.544,05/04/2017,2017.0
18,Syracuse (ACC),13,11-2,181,154,335,0.540,05/04/2017,2017.0
19,Saint Joseph's (NEC),14,5-9,168,143,311,0.540,05/04/2017,2017.0
20,Rutgers (Big Ten),14,10-4,184,158,342,0.538,05/04/2017,2017.0
21,Hartford (America East),14,6-8,189,163,352,0.537,05/04/2017,2017.0
22,Quinnipiac (MAAC),11,2-9,143,125,268,0.534,05/04/2017,2017.0
23,Colgate (Patriot),13,5-8,163,143,306,0.533,05/04/2017,2017.0
24,Duke (ACC),15,11-4,193,170,363,0.532,05/04/2017,2017.0
25,Lehigh (Patriot),14,7-7,171,151,322,0.531,05/04/2017,2017.0
26,Virginia (ACC),15,8-7,247,222,469,0.527,05/04/2017,2017.0
27,Hobart (NEC),15,9-6,208,193,401,0.519,05/04/2017,2017.0
28,Marist (MAAC),14,9-5,135,126,261,0.517,05/04/2017,2017.0
29,Providence (Big East),16,10-6,177,166,343,0.516,05/04/2017,2017.0
30,Bucknell (Patriot),13,5-8,155,146,301,0.515,05/04/2017,2017.0
31,Fairfield (CAA),14,5-9,160,153,313,0.511,05/04/2017,2017.0
32,Boston U. (Patriot),16,12-4,186,178,364,0.511,05/04/2017,2017.0
33,Marquette (Big East),14,7-7,156,153,309,0.505,05/04/2017,2017.0
34,Vermont (America East),13,5-8,158,156,314,0.503,05/04/2017,2017.0
35,Detroit Mercy (MAAC),15,5-10,172,170,342,0.503,05/04/2017,2017.0
36,Maryland (Big Ten),14,11-3,176,178,354,0.497,05/04/2017,2017.0
37,Binghamton (America East),15,11-4,153,155,308,0.497,05/04/2017,2017.0
38,Delaware (CAA),15,7-8,178,181,359,0.496,05/04/2017,2017.0
39,Manhattan (MAAC),14,3-11,176,179,355,0.496,05/04/2017,2017.0
40,Penn (Ivy League),12,7-5,150,154,304,0.493,05/04/2017,2017.0
41,Sacred Heart (NEC),15,9-6,180,187,367,0.490,05/04/2017,2017.0
42,Furman (SoCon),15,7-8,162,172,334,0.485,05/04/2017,2017.0
43,Monmouth (MAAC),15,12-3,148,158,306,0.484,05/04/2017,2017.0
44,Michigan (Big Ten),14,8-6,171,186,357,0.479,05/04/2017,2017.0
45,Princeton (Ivy League),14,9-5,192,210,402,0.478,05/04/2017,2017.0
46,Villanova (Big East),15,9-6,200,219,419,0.477,05/04/2017,2017.0
47,Notre Dame (ACC),12,8-4,135,148,283,0.477,05/04/2017,2017.0
48,Johns Hopkins (Big Ten),14,8-6,175,193,368,0.476,05/04/2017,2017.0
49,Lafayette (Patriot),14,2-12,153,170,323,0.474,05/04/2017,2017.0
50,UMBC (America East),14,6-8,132,150,282,0.468,05/04/2017,2017.0
51,Georgetown (Big East),14,4-10,159,186,345,0.461,05/04/2017,2017.0
52,Hofstra (CAA),14,11-3,150,178,328,0.457,05/04/2017,2017.0
53,Canisius (MAAC),14,6-8,152,193,345,0.441,05/04/2017,2017.0
54,VMI (SoCon),14,2-12,148,188,336,0.440,05/04/2017,2017.0
55,Siena (MAAC),14,3-11,163,215,378,0.431,05/04/2017,2017.0
56,St. John's (NY) (Big East),14,1-13,147,194,341,0.431,05/04/2017,2017.0
57,Cleveland St. (Independent),14,5-9,153,202,355,0.431,05/04/2017,2017.0
58,Robert Morris (NEC),16,9-7,167,230,397,0.421,05/04/2017,2017.0
59,Wagner (NEC),15,6-9,129,187,316,0.408,05/04/2017,2017.0
60,Stony Brook (America East),14,7-7,147,216,363,0.405,05/04/2017,2017.0
61,Bellarmine (SoCon),13,4-9,126,203,329,0.383,05/04/2017,2017.0
62,Holy Cross (Patriot),15,5-10,130,211,341,0.381,05/04/2017,2017.0
63,Cornell (Ivy League),13,5-8,142,231,373,0.381,05/04/2017,2017.0
64,Drexel (CAA),14,6-8,128,210,338,0.379,05/04/2017,2017.0
65,Mount St. Mary's (NEC),14,4-10,123,202,325,0.378,05/04/2017,2017.0
66,Harvard (Ivy League),13,6-7,123,204,327,0.376,05/04/2017,2017.0
67,Hampton (DI Independent),8,1-7,66,117,183,0.361,05/04/2017,2017.0
68,Dartmouth (Ivy League),13,2-11,106,191,297,0.357,05/04/2017,2017.0
69,High Point (SoCon),14,4-10,111,216,327,0.339,05/04/2017,2017.0
-,UMass Lowell (America East),16,4-12,171,220,391,0.437,05/04/2017,2017.0
1,Denver (Big East),13,11-2,244,92,336,0.726,04/30/2017,2017.0
2,UAlbany (America East),14,12-2,266,124,390,0.682,04/30/2017,2017.0
3,Navy (Patriot),14,6-8,199,111,310,0.642,04/30/2017,2017.0
4,Ohio St. (Big Ten),15,12-3,220,123,343,0.641,04/30/2017,2017.0
5,Army West Point (Patriot),15,11-4,204,127,331,0.616,04/30/2017,2017.0
6,Brown (Ivy League),14,9-5,262,168,430,0.609,04/30/2017,2017.0
7,Yale (Ivy League),13,8-5,217,140,357,0.608,04/30/2017,2017.0
8,Penn St. (Big Ten),14,12-2,238,162,400,0.595,04/30/2017,2017.0
9,Towson (CAA),12,8-4,144,102,246,0.585,04/30/2017,2017.0
10,Richmond (SoCon),14,11-3,162,118,280,0.579,04/30/2017,2017.0
11,Air Force (SoCon),15,10-5,192,141,333,0.577,04/30/2017,2017.0
12,Loyola Maryland (Patriot),15,10-5,210,160,370,0.568,04/30/2017,2017.0
13,Bryant (NEC),15,8-7,184,145,329,0.559,04/30/2017,2017.0
14,Mercer (SoCon),13,5-8,165,132,297,0.556,04/30/2017,2017.0
15,Massachusetts (CAA),13,6-7,162,131,293,0.553,04/30/2017,2017.0
16,Jacksonville (SoCon),13,3-10,180,146,326,0.552,04/30/2017,2017.0
17,North Carolina (ACC),15,8-7,202,169,371,0.544,04/30/2017,2017.0
18,Syracuse (ACC),13,11-2,181,154,335,0.540,04/30/2017,2017.0
19,Saint Joseph's (NEC),14,5-9,168,143,311,0.540,04/30/2017,2017.0
20,Rutgers (Big Ten),14,10-4,184,158,342,0.538,04/30/2017,2017.0
21,Hartford (America East),14,6-8,189,163,352,0.537,04/30/2017,2017.0
22,Quinnipiac (MAAC),11,2-9,143,125,268,0.534,04/30/2017,2017.0
23,Colgate (Patriot),13,5-8,163,143,306,0.533,04/30/2017,2017.0
24,Duke (ACC),15,11-4,193,170,363,0.532,04/30/2017,2017.0
25,Lehigh (Patriot),14,7-7,171,151,322,0.531,04/30/2017,2017.0
26,Virginia (ACC),15,8-7,247,222,469,0.527,04/30/2017,2017.0
27,Hobart (NEC),14,8-6,195,179,374,0.521,04/30/2017,2017.0
28,Marist (MAAC),14,9-5,135,126,261,0.517,04/30/2017,2017.0
29,Marquette (Big East),13,6-7,148,139,287,0.516,04/30/2017,2017.0
30,Providence (Big East),15,9-6,167,157,324,0.515,04/30/2017,2017.0
31,Bucknell (Patriot),13,5-8,155,146,301,0.515,04/30/2017,2017.0
32,Fairfield (CAA),14,5-9,160,153,313,0.511,04/30/2017,2017.0
33,Boston U. (Patriot),16,12-4,186,178,364,0.511,04/30/2017,2017.0
34,Binghamton (America East),14,10-4,147,145,292,0.503,04/30/2017,2017.0
35,Vermont (America East),13,5-8,158,156,314,0.503,04/30/2017,2017.0
35,Furman (SoCon),14,7-7,158,156,314,0.503,04/30/2017,2017.0
37,Detroit Mercy (MAAC),15,5-10,172,170,342,0.503,04/30/2017,2017.0
38,Maryland (Big Ten),13,10-3,167,169,336,0.497,04/30/2017,2017.0
39,Delaware (CAA),15,7-8,178,181,359,0.496,04/30/2017,2017.0
40,Manhattan (MAAC),14,3-11,176,179,355,0.496,04/30/2017,2017.0
41,Penn (Ivy League),12,7-5,150,154,304,0.493,04/30/2017,2017.0
42,Sacred Heart (NEC),14,9-5,166,174,340,0.488,04/30/2017,2017.0
43,Johns Hopkins (Big Ten),13,8-5,164,173,337,0.487,04/30/2017,2017.0
44,Monmouth (MAAC),15,12-3,148,158,306,0.484,04/30/2017,2017.0
45,Michigan (Big Ten),14,8-6,171,186,357,0.479,04/30/2017,2017.0
46,Princeton (Ivy League),14,9-5,192,210,402,0.478,04/30/2017,2017.0
47,Villanova (Big East),14,9-5,191,209,400,0.478,04/30/2017,2017.0
48,Notre Dame (ACC),12,8-4,135,148,283,0.477,04/30/2017,2017.0
49,Lafayette (Patriot),14,2-12,153,170,323,0.474,04/30/2017,2017.0
50,Hofstra (CAA),13,11-2,141,161,302,0.467,04/30/2017,2017.0
51,Georgetown (Big East),14,4-10,159,186,345,0.461,04/30/2017,2017.0
52,UMBC (America East),13,6-7,122,144,266,0.459,04/30/2017,2017.0
53,Canisius (MAAC),14,6-8,152,193,345,0.441,04/30/2017,2017.0
54,VMI (SoCon),14,2-12,148,188,336,0.440,04/30/2017,2017.0
55,Siena (MAAC),14,3-11,163,215,378,0.431,04/30/2017,2017.0
56,St. John's (NY) (Big East),14,1-13,147,194,341,0.431,04/30/2017,2017.0
57,Cleveland St. (Independent),14,5-9,153,202,355,0.431,04/30/2017,2017.0
58,Robert Morris (NEC),15,9-6,163,216,379,0.430,04/30/2017,2017.0
59,Stony Brook (America East),13,7-6,143,191,334,0.428,04/30/2017,2017.0
60,Wagner (NEC),15,6-9,129,187,316,0.408,04/30/2017,2017.0
61,Drexel (CAA),13,6-7,126,196,322,0.391,04/30/2017,2017.0
62,Bellarmine (SoCon),13,4-9,126,203,329,0.383,04/30/2017,2017.0
63,Holy Cross (Patriot),15,5-10,130,211,341,0.381,04/30/2017,2017.0
64,Cornell (Ivy League),13,5-8,142,231,373,0.381,04/30/2017,2017.0
65,Mount St. Mary's (NEC),14,4-10,123,202,325,0.378,04/30/2017,2017.0
66,Harvard (Ivy League),13,6-7,123,204,327,0.376,04/30/2017,2017.0
67,Hampton (DI Independent),8,1-7,66,117,183,0.361,04/30/2017,2017.0
68,Dartmouth (Ivy League),13,2-11,106,191,297,0.357,04/30/2017,2017.0
69,High Point (SoCon),14,4-10,111,216,327,0.339,04/30/2017,2017.0
-,UMass Lowell (America East),16,4-12,171,220,391,0.437,04/30/2017,2017.0
1,Denver (Big East),13,11-2,244,92,336,0.726,04/29/2017,2017.0
2,UAlbany (America East),14,12-2,266,124,390,0.682,04/29/2017,2017.0
3,Navy (Patriot),14,6-8,199,111,310,0.642,04/29/2017,2017.0
4,Ohio St. (Big Ten),15,12-3,220,123,343,0.641,04/29/2017,2017.0
5,Army West Point (Patriot),14,11-3,193,118,311,0.621,04/29/2017,2017.0
6,Penn St. (Big Ten),13,11-2,225,140,365,0.616,04/29/2017,2017.0
7,Yale (Ivy League),13,8-5,217,140,357,0.608,04/29/2017,2017.0
8,Brown (Ivy League),13,8-5,241,161,402,0.600,04/29/2017,2017.0
9,Towson (CAA),12,8-4,144,102,246,0.585,04/29/2017,2017.0
10,Richmond (SoCon),14,11-3,162,118,280,0.579,04/29/2017,2017.0
11,Air Force (SoCon),15,10-5,192,141,333,0.577,04/29/2017,2017.0
12,Loyola Maryland (Patriot),14,9-5,201,149,350,0.574,04/29/2017,2017.0
13,Bryant (NEC),15,8-7,184,145,329,0.559,04/29/2017,2017.0
14,Mercer (SoCon),13,5-8,165,132,297,0.556,04/29/2017,2017.0
15,Massachusetts (CAA),13,6-7,162,131,293,0.553,04/29/2017,2017.0
16,Jacksonville (SoCon),13,3-10,180,146,326,0.552,04/29/2017,2017.0
17,North Carolina (ACC),14,7-7,188,155,343,0.548,04/29/2017,2017.0
18,Syracuse (ACC),13,11-2,181,154,335,0.540,04/29/2017,2017.0
19,Saint Joseph's (NEC),14,5-9,168,143,311,0.540,04/29/2017,2017.0
20,Rutgers (Big Ten),14,10-4,184,158,342,0.538,04/29/2017,2017.0
21,Hartford (America East),14,6-8,189,163,352,0.537,04/29/2017,2017.0
22,Quinnipiac (MAAC),11,2-9,143,125,268,0.534,04/29/2017,2017.0
23,Colgate (Patriot),13,5-8,163,143,306,0.533,04/29/2017,2017.0
24,Duke (ACC),15,11-4,193,170,363,0.532,04/29/2017,2017.0
25,Lehigh (Patriot),14,7-7,171,151,322,0.531,04/29/2017,2017.0
26,Virginia (ACC),15,8-7,247,222,469,0.527,04/29/2017,2017.0
27,Hobart (NEC),14,8-6,195,179,374,0.521,04/29/2017,2017.0
28,Marist (MAAC),14,9-5,135,126,261,0.517,04/29/2017,2017.0
29,Marquette (Big East),13,6-7,148,139,287,0.516,04/29/2017,2017.0
30,Providence (Big East),15,9-6,167,157,324,0.515,04/29/2017,2017.0
31,Bucknell (Patriot),13,5-8,155,146,301,0.515,04/29/2017,2017.0
32,Fairfield (CAA),14,5-9,160,153,313,0.511,04/29/2017,2017.0
33,Boston U. (Patriot),16,12-4,186,178,364,0.511,04/29/2017,2017.0
34,Binghamton (America East),14,10-4,147,145,292,0.503,04/29/2017,2017.0
35,Furman (SoCon),14,7-7,158,156,314,0.503,04/29/2017,2017.0
35,Vermont (America East),13,5-8,158,156,314,0.503,04/29/2017,2017.0
37,Detroit Mercy (MAAC),15,5-10,172,170,342,0.503,04/29/2017,2017.0
38,Maryland (Big Ten),13,10-3,167,169,336,0.497,04/29/2017,2017.0
39,Delaware (CAA),15,7-8,178,181,359,0.496,04/29/2017,2017.0
40,Manhattan (MAAC),14,3-11,176,179,355,0.496,04/29/2017,2017.0
41,Penn (Ivy League),12,7-5,150,154,304,0.493,04/29/2017,2017.0
42,Sacred Heart (NEC),14,9-5,166,174,340,0.488,04/29/2017,2017.0
43,Johns Hopkins (Big Ten),13,8-5,164,173,337,0.487,04/29/2017,2017.0
44,Monmouth (MAAC),15,12-3,148,158,306,0.484,04/29/2017,2017.0
45,Princeton (Ivy League),14,9-5,192,210,402,0.478,04/29/2017,2017.0
46,Villanova (Big East),14,9-5,191,209,400,0.478,04/29/2017,2017.0
47,Notre Dame (ACC),11,8-3,121,134,255,0.475,04/29/2017,2017.0
48,Lafayette (Patriot),14,2-12,153,170,323,0.474,04/29/2017,2017.0
49,Hofstra (CAA),13,11-2,141,161,302,0.467,04/29/2017,2017.0
50,Michigan (Big Ten),13,8-5,149,173,322,0.463,04/29/2017,2017.0
51,Georgetown (Big East),14,4-10,159,186,345,0.461,04/29/2017,2017.0
52,UMBC (America East),13,6-7,122,144,266,0.459,04/29/2017,2017.0
53,Canisius (MAAC),14,6-8,152,193,345,0.441,04/29/2017,2017.0
54,VMI (SoCon),14,2-12,148,188,336,0.440,04/29/2017,2017.0
55,Siena (MAAC),14,3-11,163,215,378,0.431,04/29/2017,2017.0
56,St. John's (NY) (Big East),14,1-13,147,194,341,0.431,04/29/2017,2017.0
57,Cleveland St. (Independent),14,5-9,153,202,355,0.431,04/29/2017,2017.0
58,Robert Morris (NEC),15,9-6,163,216,379,0.430,04/29/2017,2017.0
59,Stony Brook (America East),13,7-6,143,191,334,0.428,04/29/2017,2017.0
60,Wagner (NEC),15,6-9,129,187,316,0.408,04/29/2017,2017.0
61,Drexel (CAA),13,6-7,126,196,322,0.391,04/29/2017,2017.0
62,Bellarmine (SoCon),13,4-9,126,203,329,0.383,04/29/2017,2017.0
63,Holy Cross (Patriot),15,5-10,130,211,341,0.381,04/29/2017,2017.0
64,Cornell (Ivy League),13,5-8,142,231,373,0.381,04/29/2017,2017.0
65,Mount St. Mary's (NEC),14,4-10,123,202,325,0.378,04/29/2017,2017.0
66,Harvard (Ivy League),13,6-7,123,204,327,0.376,04/29/2017,2017.0
67,Dartmouth (Ivy League),12,2-10,99,170,269,0.368,04/29/2017,2017.0
68,Hampton (DI Independent),8,1-7,66,117,183,0.361,04/29/2017,2017.0
69,High Point (SoCon),14,4-10,111,216,327,0.339,04/29/2017,2017.0
-,UMass Lowell (America East),16,4-12,171,220,391,0.437,04/29/2017,2017.0
1,Denver (Big East),12,10-2,226,82,308,0.734,04/28/2017,2017.0
2,UAlbany (America East),13,11-2,241,121,362,0.666,04/28/2017,2017.0
3,Ohio St. (Big Ten),14,12-2,206,111,317,0.650,04/28/2017,2017.0
4,Navy (Patriot),14,6-8,199,111,310,0.642,04/28/2017,2017.0
5,Army West Point (Patriot),14,11-3,193,118,311,0.621,04/28/2017,2017.0
6,Penn St. (Big Ten),13,11-2,225,140,365,0.616,04/28/2017,2017.0
7,Yale (Ivy League),12,8-4,203,134,337,0.602,04/28/2017,2017.0
8,Brown (Ivy League),13,8-5,241,161,402,0.600,04/28/2017,2017.0
9,Towson (CAA),11,7-4,130,94,224,0.580,04/28/2017,2017.0
10,Richmond (SoCon),13,10-3,150,110,260,0.577,04/28/2017,2017.0
11,Loyola Maryland (Patriot),14,9-5,201,149,350,0.574,04/28/2017,2017.0
12,Hartford (America East),13,6-7,186,138,324,0.574,04/28/2017,2017.0
13,Air Force (SoCon),14,9-5,171,133,304,0.563,04/28/2017,2017.0
14,Bryant (NEC),15,8-7,184,145,329,0.559,04/28/2017,2017.0
15,Massachusetts (CAA),13,6-7,162,131,293,0.553,04/28/2017,2017.0
16,Mercer (SoCon),12,4-8,151,123,274,0.551,04/28/2017,2017.0
17,North Carolina (ACC),14,7-7,188,155,343,0.548,04/28/2017,2017.0
18,Rutgers (Big Ten),13,9-4,172,144,316,0.544,04/28/2017,2017.0
19,Jacksonville (SoCon),12,2-10,159,135,294,0.541,04/28/2017,2017.0
20,Syracuse (ACC),13,11-2,181,154,335,0.540,04/28/2017,2017.0
21,Virginia (ACC),14,8-6,235,202,437,0.538,04/28/2017,2017.0
22,Saint Joseph's (NEC),13,4-9,150,131,281,0.534,04/28/2017,2017.0
23,Quinnipiac (MAAC),11,2-9,143,125,268,0.534,04/28/2017,2017.0
24,Marquette (Big East),12,6-6,138,121,259,0.533,04/28/2017,2017.0
25,Colgate (Patriot),13,5-8,163,143,306,0.533,04/28/2017,2017.0
26,Duke (ACC),15,11-4,193,170,363,0.532,04/28/2017,2017.0
27,Lehigh (Patriot),14,7-7,171,151,322,0.531,04/28/2017,2017.0
28,Hobart (NEC),13,7-6,177,160,337,0.525,04/28/2017,2017.0
29,Bucknell (Patriot),13,5-8,155,146,301,0.515,04/28/2017,2017.0
30,Marist (MAAC),13,8-5,127,120,247,0.514,04/28/2017,2017.0
31,Detroit Mercy (MAAC),14,5-9,164,156,320,0.513,04/28/2017,2017.0
32,Vermont (America East),12,5-7,150,143,293,0.512,04/28/2017,2017.0
33,Fairfield (CAA),14,5-9,160,153,313,0.511,04/28/2017,2017.0
34,Boston U. (Patriot),16,12-4,186,178,364,0.511,04/28/2017,2017.0
35,Furman (SoCon),13,7-6,150,144,294,0.510,04/28/2017,2017.0
36,Providence (Big East),14,9-5,151,147,298,0.507,04/28/2017,2017.0
37,Maryland (Big Ten),12,9-3,161,157,318,0.506,04/28/2017,2017.0
38,Binghamton (America East),14,10-4,147,145,292,0.503,04/28/2017,2017.0
39,Delaware (CAA),15,7-8,178,181,359,0.496,04/28/2017,2017.0
40,Manhattan (MAAC),14,3-11,176,179,355,0.496,04/28/2017,2017.0
41,Sacred Heart (NEC),14,9-5,166,174,340,0.488,04/28/2017,2017.0
42,Villanova (Big East),13,8-5,181,193,374,0.484,04/28/2017,2017.0
43,Monmouth (MAAC),15,12-3,148,158,306,0.484,04/28/2017,2017.0
44,Princeton (Ivy League),13,9-4,174,190,364,0.478,04/28/2017,2017.0
45,Penn (Ivy League),11,6-5,130,142,272,0.478,04/28/2017,2017.0
46,Johns Hopkins (Big Ten),12,8-4,152,167,319,0.476,04/28/2017,2017.0
47,Hofstra (CAA),12,11-1,133,147,280,0.475,04/28/2017,2017.0
48,Notre Dame (ACC),11,8-3,121,134,255,0.475,04/28/2017,2017.0
49,Lafayette (Patriot),14,2-12,153,170,323,0.474,04/28/2017,2017.0
50,Michigan (Big Ten),13,8-5,149,173,322,0.463,04/28/2017,2017.0
51,Georgetown (Big East),13,3-10,146,177,323,0.452,04/28/2017,2017.0
52,UMBC (America East),12,5-7,109,136,245,0.445,04/28/2017,2017.0
53,VMI (SoCon),13,2-11,139,174,313,0.444,04/28/2017,2017.0
54,Canisius (MAAC),14,6-8,152,193,345,0.441,04/28/2017,2017.0
55,St. John's (NY) (Big East),13,1-12,138,181,319,0.433,04/28/2017,2017.0
56,Siena (MAAC),13,3-10,157,207,364,0.431,04/28/2017,2017.0
57,Stony Brook (America East),13,7-6,143,191,334,0.428,04/28/2017,2017.0
58,Robert Morris (NEC),14,9-5,144,198,342,0.421,04/28/2017,2017.0
59,Cleveland St. (Independent),13,4-9,139,194,333,0.417,04/28/2017,2017.0
60,Wagner (NEC),15,6-9,129,187,316,0.408,04/28/2017,2017.0
61,Drexel (CAA),13,6-7,126,196,322,0.391,04/28/2017,2017.0
62,Bellarmine (SoCon),12,4-8,115,182,297,0.387,04/28/2017,2017.0
63,Holy Cross (Patriot),15,5-10,130,211,341,0.381,04/28/2017,2017.0
64,Harvard (Ivy League),12,5-7,117,190,307,0.381,04/28/2017,2017.0
65,Mount St. Mary's (NEC),13,4-9,111,184,295,0.376,04/28/2017,2017.0
66,Dartmouth (Ivy League),12,2-10,99,170,269,0.368,04/28/2017,2017.0
67,Cornell (Ivy League),12,4-8,122,213,335,0.364,04/28/2017,2017.0
68,Hampton (DI Independent),8,1-7,66,117,183,0.361,04/28/2017,2017.0
69,High Point (SoCon),13,4-9,103,195,298,0.346,04/28/2017,2017.0
-,UMass Lowell (America East),15,3-12,159,212,371,0.429,04/28/2017,2017.0
1,Denver (Big East),12,10-2,226,82,308,0.734,04/25/2017,2017.0
2,UAlbany (America East),13,11-2,241,121,362,0.666,04/25/2017,2017.0
3,Ohio St. (Big Ten),14,12-2,206,111,317,0.650,04/25/2017,2017.0
4,Navy (Patriot),14,6-8,199,111,310,0.642,04/25/2017,2017.0
5,Army West Point (Patriot),13,10-3,179,111,290,0.617,04/25/2017,2017.0
6,Penn St. (Big Ten),13,11-2,225,140,365,0.616,04/25/2017,2017.0
7,Yale (Ivy League),12,8-4,203,134,337,0.602,04/25/2017,2017.0
8,Brown (Ivy League),13,8-5,241,161,402,0.600,04/25/2017,2017.0
9,Towson (CAA),11,7-4,130,94,224,0.580,04/25/2017,2017.0
10,Richmond (SoCon),13,10-3,150,110,260,0.577,04/25/2017,2017.0
11,Hartford (America East),13,6-7,186,138,324,0.574,04/25/2017,2017.0
12,Loyola Maryland (Patriot),13,8-5,189,141,330,0.573,04/25/2017,2017.0
13,Air Force (SoCon),14,9-5,171,133,304,0.563,04/25/2017,2017.0
14,Bryant (NEC),15,8-7,184,145,329,0.559,04/25/2017,2017.0
15,Massachusetts (CAA),12,5-7,148,119,267,0.554,04/25/2017,2017.0
16,Mercer (SoCon),12,4-8,151,123,274,0.551,04/25/2017,2017.0
17,North Carolina (ACC),13,6-7,170,139,309,0.550,04/25/2017,2017.0
18,Syracuse (ACC),12,11-1,165,136,301,0.548,04/25/2017,2017.0
19,Rutgers (Big Ten),13,9-4,172,144,316,0.544,04/25/2017,2017.0
20,Jacksonville (SoCon),12,2-10,159,135,294,0.541,04/25/2017,2017.0
21,Virginia (ACC),14,8-6,235,202,437,0.538,04/25/2017,2017.0
22,Duke (ACC),14,11-3,185,161,346,0.535,04/25/2017,2017.0
23,Saint Joseph's (NEC),13,4-9,150,131,281,0.534,04/25/2017,2017.0
24,Marquette (Big East),12,6-6,138,121,259,0.533,04/25/2017,2017.0
25,Colgate (Patriot),13,5-8,163,143,306,0.533,04/25/2017,2017.0
26,Lehigh (Patriot),14,7-7,171,151,322,0.531,04/25/2017,2017.0
27,Hobart (NEC),13,7-6,177,160,337,0.525,04/25/2017,2017.0
28,Boston U. (Patriot),15,12-3,179,164,343,0.522,04/25/2017,2017.0
29,Quinnipiac (MAAC),10,2-8,129,119,248,0.520,04/25/2017,2017.0
30,Bucknell (Patriot),13,5-8,155,146,301,0.515,04/25/2017,2017.0
31,Marist (MAAC),13,8-5,127,120,247,0.514,04/25/2017,2017.0
32,Detroit Mercy (MAAC),14,5-9,164,156,320,0.513,04/25/2017,2017.0
33,Vermont (America East),12,5-7,150,143,293,0.512,04/25/2017,2017.0
34,Binghamton (America East),13,9-4,142,136,278,0.511,04/25/2017,2017.0
35,Furman (SoCon),13,7-6,150,144,294,0.510,04/25/2017,2017.0
36,Providence (Big East),14,9-5,151,147,298,0.507,04/25/2017,2017.0
37,Maryland (Big Ten),12,9-3,161,157,318,0.506,04/25/2017,2017.0
38,Fairfield (CAA),13,4-9,147,145,292,0.503,04/25/2017,2017.0
39,Delaware (CAA),14,7-7,170,168,338,0.503,04/25/2017,2017.0
40,Manhattan (MAAC),13,3-10,170,171,341,0.499,04/25/2017,2017.0
41,Villanova (Big East),13,8-5,181,193,374,0.484,04/25/2017,2017.0
42,Monmouth (MAAC),14,11-3,140,152,292,0.479,04/25/2017,2017.0
43,Princeton (Ivy League),13,9-4,174,190,364,0.478,04/25/2017,2017.0
44,Penn (Ivy League),11,6-5,130,142,272,0.478,04/25/2017,2017.0
45,Johns Hopkins (Big Ten),12,8-4,152,167,319,0.476,04/25/2017,2017.0
46,Hofstra (CAA),12,11-1,133,147,280,0.475,04/25/2017,2017.0
47,Lafayette (Patriot),14,2-12,153,170,323,0.474,04/25/2017,2017.0
48,Notre Dame (ACC),10,7-3,112,126,238,0.471,04/25/2017,2017.0
49,Michigan (Big Ten),13,8-5,149,173,322,0.463,04/25/2017,2017.0
50,Sacred Heart (NEC),13,8-5,144,168,312,0.462,04/25/2017,2017.0
51,Georgetown (Big East),13,3-10,146,177,323,0.452,04/25/2017,2017.0
52,Canisius (MAAC),13,5-8,146,179,325,0.449,04/25/2017,2017.0
53,UMBC (America East),12,5-7,109,136,245,0.445,04/25/2017,2017.0
54,VMI (SoCon),13,2-11,139,174,313,0.444,04/25/2017,2017.0
55,St. John's (NY) (Big East),13,1-12,138,181,319,0.433,04/25/2017,2017.0
56,Siena (MAAC),13,3-10,157,207,364,0.431,04/25/2017,2017.0
57,Wagner (NEC),14,6-8,123,165,288,0.427,04/25/2017,2017.0
58,Robert Morris (NEC),14,9-5,144,198,342,0.421,04/25/2017,2017.0
59,Stony Brook (America East),12,7-5,134,186,320,0.419,04/25/2017,2017.0
60,Cleveland St. (Independent),13,4-9,139,194,333,0.417,04/25/2017,2017.0
61,Bellarmine (SoCon),12,4-8,115,182,297,0.387,04/25/2017,2017.0
62,Drexel (CAA),12,6-6,114,182,296,0.385,04/25/2017,2017.0
63,Harvard (Ivy League),12,5-7,117,190,307,0.381,04/25/2017,2017.0
64,Holy Cross (Patriot),14,5-9,122,199,321,0.380,04/25/2017,2017.0
65,Mount St. Mary's (NEC),13,4-9,111,184,295,0.376,04/25/2017,2017.0
66,Dartmouth (Ivy League),12,2-10,99,170,269,0.368,04/25/2017,2017.0
67,Cornell (Ivy League),12,4-8,122,213,335,0.364,04/25/2017,2017.0
68,Hampton (DI Independent),8,1-7,66,117,183,0.361,04/25/2017,2017.0
69,High Point (SoCon),13,4-9,103,195,298,0.346,04/25/2017,2017.0
-,UMass Lowell (America East),15,3-12,159,212,371,0.429,04/25/2017,2017.0
1,Denver (Big East),12,10-2,226,82,308,0.734,04/23/2017,2017.0
2,UAlbany (America East),13,11-2,241,121,362,0.666,04/23/2017,2017.0
3,Ohio St. (Big Ten),14,12-2,206,111,317,0.650,04/23/2017,2017.0
4,Navy (Patriot),13,6-7,186,103,289,0.644,04/23/2017,2017.0
5,Army West Point (Patriot),13,10-3,179,111,290,0.617,04/23/2017,2017.0
6,Penn St. (Big Ten),13,11-2,225,140,365,0.616,04/23/2017,2017.0
7,Brown (Ivy League),12,7-5,226,148,374,0.604,04/23/2017,2017.0
8,Yale (Ivy League),12,8-4,203,134,337,0.602,04/23/2017,2017.0
9,Towson (CAA),11,7-4,130,94,224,0.580,04/23/2017,2017.0
10,Richmond (SoCon),13,10-3,150,110,260,0.577,04/23/2017,2017.0
11,Hartford (America East),13,6-7,186,138,324,0.574,04/23/2017,2017.0
12,Loyola Maryland (Patriot),13,8-5,189,141,330,0.573,04/23/2017,2017.0
13,Bryant (NEC),14,8-6,171,130,301,0.568,04/23/2017,2017.0
14,Air Force (SoCon),14,9-5,171,133,304,0.563,04/23/2017,2017.0
15,Massachusetts (CAA),12,5-7,148,119,267,0.554,04/23/2017,2017.0
16,Mercer (SoCon),12,4-8,151,123,274,0.551,04/23/2017,2017.0
17,North Carolina (ACC),13,6-7,170,139,309,0.550,04/23/2017,2017.0
18,Syracuse (ACC),12,11-1,165,136,301,0.548,04/23/2017,2017.0
19,Rutgers (Big Ten),13,9-4,172,144,316,0.544,04/23/2017,2017.0
20,Jacksonville (SoCon),12,2-10,159,135,294,0.541,04/23/2017,2017.0
21,Virginia (ACC),14,8-6,235,202,437,0.538,04/23/2017,2017.0
22,Duke (ACC),14,11-3,185,161,346,0.535,04/23/2017,2017.0
23,Saint Joseph's (NEC),13,4-9,150,131,281,0.534,04/23/2017,2017.0
24,Marquette (Big East),12,6-6,138,121,259,0.533,04/23/2017,2017.0
25,Colgate (Patriot),13,5-8,163,143,306,0.533,04/23/2017,2017.0
26,Boston U. (Patriot),14,11-3,173,152,325,0.532,04/23/2017,2017.0
27,Hobart (NEC),13,7-6,177,160,337,0.525,04/23/2017,2017.0
28,Lehigh (Patriot),13,7-6,159,145,304,0.523,04/23/2017,2017.0
29,Quinnipiac (MAAC),10,2-8,129,119,248,0.520,04/23/2017,2017.0
30,Bucknell (Patriot),13,5-8,155,146,301,0.515,04/23/2017,2017.0
31,Marist (MAAC),13,8-5,127,120,247,0.514,04/23/2017,2017.0
32,Detroit Mercy (MAAC),14,5-9,164,156,320,0.513,04/23/2017,2017.0
33,Vermont (America East),12,5-7,150,143,293,0.512,04/23/2017,2017.0
34,Binghamton (America East),13,9-4,142,136,278,0.511,04/23/2017,2017.0
35,Furman (SoCon),13,7-6,150,144,294,0.510,04/23/2017,2017.0
36,Providence (Big East),14,9-5,151,147,298,0.507,04/23/2017,2017.0
37,Maryland (Big Ten),12,9-3,161,157,318,0.506,04/23/2017,2017.0
38,Fairfield (CAA),13,4-9,147,145,292,0.503,04/23/2017,2017.0
39,Delaware (CAA),14,7-7,170,168,338,0.503,04/23/2017,2017.0
40,Manhattan (MAAC),13,3-10,170,171,341,0.499,04/23/2017,2017.0
41,Villanova (Big East),13,8-5,181,193,374,0.484,04/23/2017,2017.0
42,Monmouth (MAAC),14,11-3,140,152,292,0.479,04/23/2017,2017.0
43,Princeton (Ivy League),13,9-4,174,190,364,0.478,04/23/2017,2017.0
44,Penn (Ivy League),11,6-5,130,142,272,0.478,04/23/2017,2017.0
45,Johns Hopkins (Big Ten),12,8-4,152,167,319,0.476,04/23/2017,2017.0
46,Hofstra (CAA),12,11-1,133,147,280,0.475,04/23/2017,2017.0
47,Lafayette (Patriot),14,2-12,153,170,323,0.474,04/23/2017,2017.0
48,Notre Dame (ACC),10,7-3,112,126,238,0.471,04/23/2017,2017.0
49,Michigan (Big Ten),13,8-5,149,173,322,0.463,04/23/2017,2017.0
50,Sacred Heart (NEC),13,8-5,144,168,312,0.462,04/23/2017,2017.0
51,Georgetown (Big East),13,3-10,146,177,323,0.452,04/23/2017,2017.0
52,Canisius (MAAC),13,5-8,146,179,325,0.449,04/23/2017,2017.0
53,UMBC (America East),12,5-7,109,136,245,0.445,04/23/2017,2017.0
54,VMI (SoCon),13,2-11,139,174,313,0.444,04/23/2017,2017.0
55,St. John's (NY) (Big East),13,1-12,138,181,319,0.433,04/23/2017,2017.0
56,Siena (MAAC),13,3-10,157,207,364,0.431,04/23/2017,2017.0
57,Wagner (NEC),14,6-8,123,165,288,0.427,04/23/2017,2017.0
58,Robert Morris (NEC),14,9-5,144,198,342,0.421,04/23/2017,2017.0
59,Stony Brook (America East),12,7-5,134,186,320,0.419,04/23/2017,2017.0
60,Cleveland St. (Independent),13,4-9,139,194,333,0.417,04/23/2017,2017.0
61,Bellarmine (SoCon),12,4-8,115,182,297,0.387,04/23/2017,2017.0
62,Drexel (CAA),12,6-6,114,182,296,0.385,04/23/2017,2017.0
63,Harvard (Ivy League),12,5-7,117,190,307,0.381,04/23/2017,2017.0
64,Holy Cross (Patriot),13,4-9,114,186,300,0.380,04/23/2017,2017.0
65,Mount St. Mary's (NEC),13,4-9,111,184,295,0.376,04/23/2017,2017.0
66,Dartmouth (Ivy League),12,2-10,99,170,269,0.368,04/23/2017,2017.0
67,Cornell (Ivy League),12,4-8,122,213,335,0.364,04/23/2017,2017.0
68,Hampton (DI Independent),8,1-7,66,117,183,0.361,04/23/2017,2017.0
69,High Point (SoCon),13,4-9,103,195,298,0.346,04/23/2017,2017.0
-,UMass Lowell (America East),15,3-12,159,212,371,0.429,04/23/2017,2017.0
1,Denver (Big East),11,9-2,215,75,290,0.741,04/21/2017,2017.0
2,UAlbany (America East),12,10-2,228,105,333,0.685,04/21/2017,2017.0
3,Ohio St. (Big Ten),13,11-2,188,104,292,0.644,04/21/2017,2017.0
4,Navy (Patriot),13,6-7,186,103,289,0.644,04/21/2017,2017.0
5,Army West Point (Patriot),13,10-3,179,111,290,0.617,04/21/2017,2017.0
6,Penn St. (Big Ten),12,10-2,209,134,343,0.609,04/21/2017,2017.0
7,Yale (Ivy League),11,8-3,187,121,308,0.607,04/21/2017,2017.0
8,Brown (Ivy League),11,6-5,204,143,347,0.588,04/21/2017,2017.0
9,Hartford (America East),12,5-7,174,126,300,0.580,04/21/2017,2017.0
10,Richmond (SoCon),12,10-2,138,102,240,0.575,04/21/2017,2017.0
11,Air Force (SoCon),13,8-5,163,121,284,0.574,04/21/2017,2017.0
12,Loyola Maryland (Patriot),13,8-5,189,141,330,0.573,04/21/2017,2017.0
13,Towson (CAA),10,7-3,117,88,205,0.571,04/21/2017,2017.0
14,North Carolina (ACC),12,6-6,159,120,279,0.570,04/21/2017,2017.0
15,Rutgers (Big Ten),12,9-3,166,128,294,0.565,04/21/2017,2017.0
16,Bryant (NEC),13,7-6,158,122,280,0.564,04/21/2017,2017.0
17,Syracuse (ACC),11,10-1,157,124,281,0.559,04/21/2017,2017.0
18,Mercer (SoCon),11,4-7,136,114,250,0.544,04/21/2017,2017.0
19,Saint Joseph's (NEC),12,3-9,140,118,258,0.543,04/21/2017,2017.0
20,Marquette (Big East),11,6-5,128,109,237,0.540,04/21/2017,2017.0
21,Virginia (ACC),14,8-6,235,202,437,0.538,04/21/2017,2017.0
22,Massachusetts (CAA),11,5-6,129,111,240,0.538,04/21/2017,2017.0
23,Jacksonville (SoCon),11,2-9,144,124,268,0.537,04/21/2017,2017.0
24,Duke (ACC),13,10-3,173,151,324,0.534,04/21/2017,2017.0
25,Colgate (Patriot),13,5-8,163,143,306,0.533,04/21/2017,2017.0
26,Boston U. (Patriot),14,11-3,173,152,325,0.532,04/21/2017,2017.0
27,Maryland (Big Ten),11,9-2,154,139,293,0.526,04/21/2017,2017.0
28,Lehigh (Patriot),13,7-6,159,145,304,0.523,04/21/2017,2017.0
29,Quinnipiac (MAAC),10,2-8,129,119,248,0.520,04/21/2017,2017.0
30,Fairfield (CAA),12,3-9,141,132,273,0.516,04/21/2017,2017.0
31,Marist (MAAC),12,7-5,119,112,231,0.515,04/21/2017,2017.0
32,Bucknell (Patriot),13,5-8,155,146,301,0.515,04/21/2017,2017.0
33,Providence (Big East),13,9-4,144,136,280,0.514,04/21/2017,2017.0
34,Detroit Mercy (MAAC),13,5-8,156,148,304,0.513,04/21/2017,2017.0
35,Vermont (America East),12,5-7,150,143,293,0.512,04/21/2017,2017.0
36,Binghamton (America East),12,9-3,130,128,258,0.504,04/21/2017,2017.0
37,Furman (SoCon),12,6-6,135,134,269,0.502,04/21/2017,2017.0
38,Hobart (NEC),12,6-6,155,155,310,0.500,04/21/2017,2017.0
39,Hofstra (CAA),11,10-1,125,128,253,0.494,04/21/2017,2017.0
40,Delaware (CAA),13,7-6,153,158,311,0.492,04/21/2017,2017.0
41,Manhattan (MAAC),12,2-10,159,166,325,0.489,04/21/2017,2017.0
42,Princeton (Ivy League),12,8-4,166,177,343,0.484,04/21/2017,2017.0
43,Villanova (Big East),12,7-5,168,181,349,0.481,04/21/2017,2017.0
44,Monmouth (MAAC),14,11-3,140,152,292,0.479,04/21/2017,2017.0
45,Michigan (Big Ten),12,8-4,139,152,291,0.478,04/21/2017,2017.0
46,Lafayette (Patriot),14,2-12,153,170,323,0.474,04/21/2017,2017.0
47,Sacred Heart (NEC),12,7-5,128,153,281,0.456,04/21/2017,2017.0
48,Penn (Ivy League),10,5-5,117,140,257,0.455,04/21/2017,2017.0
49,Johns Hopkins (Big Ten),11,7-4,131,157,288,0.455,04/21/2017,2017.0
50,Georgetown (Big East),13,3-10,146,177,323,0.452,04/21/2017,2017.0
51,Canisius (MAAC),13,5-8,146,179,325,0.449,04/21/2017,2017.0
52,VMI (SoCon),12,2-10,129,159,288,0.448,04/21/2017,2017.0
53,Notre Dame (ACC),9,6-3,93,115,208,0.447,04/21/2017,2017.0
54,UMBC (America East),11,5-6,97,124,221,0.439,04/21/2017,2017.0
55,Siena (MAAC),13,3-10,157,207,364,0.431,04/21/2017,2017.0
56,St. John's (NY) (Big East),12,1-11,126,168,294,0.429,04/21/2017,2017.0
57,Robert Morris (NEC),13,9-4,136,185,321,0.424,04/21/2017,2017.0
58,Stony Brook (America East),12,7-5,134,186,320,0.419,04/21/2017,2017.0
59,Wagner (NEC),13,6-7,110,155,265,0.415,04/21/2017,2017.0
60,Cleveland St. (Independent),12,4-8,124,178,302,0.411,04/21/2017,2017.0
61,Mount St. Mary's (NEC),12,4-8,106,162,268,0.396,04/21/2017,2017.0
62,Bellarmine (SoCon),11,3-8,106,167,273,0.388,04/21/2017,2017.0
63,Drexel (CAA),11,5-6,104,165,269,0.387,04/21/2017,2017.0
64,Dartmouth (Ivy League),11,2-9,97,157,254,0.382,04/21/2017,2017.0
65,Holy Cross (Patriot),13,4-9,114,186,300,0.380,04/21/2017,2017.0
66,Cornell (Ivy League),11,4-7,117,191,308,0.380,04/21/2017,2017.0
67,Harvard (Ivy League),11,5-6,104,182,286,0.364,04/21/2017,2017.0
68,Hampton (DI Independent),8,1-7,66,117,183,0.361,04/21/2017,2017.0
69,High Point (SoCon),12,3-9,92,180,272,0.338,04/21/2017,2017.0
-,UMass Lowell (America East),15,3-12,159,212,371,0.429,04/21/2017,2017.0
1,Denver (Big East),11,9-2,215,75,290,0.741,04/19/2017,2017.0
2,UAlbany (America East),12,10-2,228,105,333,0.685,04/19/2017,2017.0
3,Ohio St. (Big Ten),13,11-2,188,104,292,0.644,04/19/2017,2017.0
4,Navy (Patriot),13,6-7,186,103,289,0.644,04/19/2017,2017.0
5,Army West Point (Patriot),12,10-2,167,100,267,0.625,04/19/2017,2017.0
6,Penn St. (Big Ten),12,10-2,209,134,343,0.609,04/19/2017,2017.0
7,Yale (Ivy League),11,8-3,187,121,308,0.607,04/19/2017,2017.0
8,Brown (Ivy League),11,6-5,204,143,347,0.588,04/19/2017,2017.0
9,Hartford (America East),12,5-7,174,126,300,0.580,04/19/2017,2017.0
10,Loyola Maryland (Patriot),12,7-5,178,129,307,0.580,04/19/2017,2017.0
11,Richmond (SoCon),12,10-2,138,102,240,0.575,04/19/2017,2017.0
12,Air Force (SoCon),13,8-5,163,121,284,0.574,04/19/2017,2017.0
13,Towson (CAA),10,7-3,117,88,205,0.571,04/19/2017,2017.0
14,North Carolina (ACC),12,6-6,159,120,279,0.570,04/19/2017,2017.0
15,Rutgers (Big Ten),12,9-3,166,128,294,0.565,04/19/2017,2017.0
16,Bryant (NEC),13,7-6,158,122,280,0.564,04/19/2017,2017.0
17,Syracuse (ACC),11,10-1,157,124,281,0.559,04/19/2017,2017.0
18,Mercer (SoCon),11,4-7,136,114,250,0.544,04/19/2017,2017.0
19,Saint Joseph's (NEC),12,3-9,140,118,258,0.543,04/19/2017,2017.0
20,Colgate (Patriot),12,4-8,155,131,286,0.542,04/19/2017,2017.0
21,Marquette (Big East),11,6-5,128,109,237,0.540,04/19/2017,2017.0
22,Virginia (ACC),14,8-6,235,202,437,0.538,04/19/2017,2017.0
23,Massachusetts (CAA),11,5-6,129,111,240,0.538,04/19/2017,2017.0
24,Jacksonville (SoCon),11,2-9,144,124,268,0.537,04/19/2017,2017.0
25,Quinnipiac (MAAC),9,2-7,121,105,226,0.535,04/19/2017,2017.0
26,Duke (ACC),13,10-3,173,151,324,0.534,04/19/2017,2017.0
27,Boston U. (Patriot),13,10-3,159,139,298,0.534,04/19/2017,2017.0
28,Lehigh (Patriot),12,6-6,150,135,285,0.526,04/19/2017,2017.0
29,Maryland (Big Ten),11,9-2,154,139,293,0.526,04/19/2017,2017.0
30,Fairfield (CAA),12,3-9,141,132,273,0.516,04/19/2017,2017.0
31,Marist (MAAC),12,7-5,119,112,231,0.515,04/19/2017,2017.0
32,Providence (Big East),13,9-4,144,136,280,0.514,04/19/2017,2017.0
33,Bucknell (Patriot),12,5-7,145,137,282,0.514,04/19/2017,2017.0
34,Detroit Mercy (MAAC),13,5-8,156,148,304,0.513,04/19/2017,2017.0
35,Vermont (America East),12,5-7,150,143,293,0.512,04/19/2017,2017.0
36,Binghamton (America East),12,9-3,130,128,258,0.504,04/19/2017,2017.0
37,Furman (SoCon),12,6-6,135,134,269,0.502,04/19/2017,2017.0
38,Hobart (NEC),12,6-6,155,155,310,0.500,04/19/2017,2017.0
39,Hofstra (CAA),11,10-1,125,128,253,0.494,04/19/2017,2017.0
40,Delaware (CAA),13,7-6,153,158,311,0.492,04/19/2017,2017.0
41,Manhattan (MAAC),12,2-10,159,166,325,0.489,04/19/2017,2017.0
42,Princeton (Ivy League),12,8-4,166,177,343,0.484,04/19/2017,2017.0
43,Villanova (Big East),12,7-5,168,181,349,0.481,04/19/2017,2017.0
44,Michigan (Big Ten),12,8-4,139,152,291,0.478,04/19/2017,2017.0
45,Monmouth (MAAC),13,10-3,127,144,271,0.469,04/19/2017,2017.0
46,Lafayette (Patriot),13,2-11,141,162,303,0.465,04/19/2017,2017.0
47,Sacred Heart (NEC),12,7-5,128,153,281,0.456,04/19/2017,2017.0
48,Penn (Ivy League),10,5-5,117,140,257,0.455,04/19/2017,2017.0
49,Johns Hopkins (Big Ten),11,7-4,131,157,288,0.455,04/19/2017,2017.0
50,Canisius (MAAC),12,5-7,138,166,304,0.454,04/19/2017,2017.0
51,Georgetown (Big East),13,3-10,146,177,323,0.452,04/19/2017,2017.0
52,VMI (SoCon),12,2-10,129,159,288,0.448,04/19/2017,2017.0
53,Notre Dame (ACC),9,6-3,93,115,208,0.447,04/19/2017,2017.0
54,UMBC (America East),11,5-6,97,124,221,0.439,04/19/2017,2017.0
55,St. John's (NY) (Big East),12,1-11,126,168,294,0.429,04/19/2017,2017.0
56,Robert Morris (NEC),13,9-4,136,185,321,0.424,04/19/2017,2017.0
57,Siena (MAAC),12,2-10,143,199,342,0.418,04/19/2017,2017.0
58,Wagner (NEC),13,6-7,110,155,265,0.415,04/19/2017,2017.0
59,Stony Brook (America East),11,6-5,121,173,294,0.412,04/19/2017,2017.0
60,Cleveland St. (Independent),12,4-8,124,178,302,0.411,04/19/2017,2017.0
61,Mount St. Mary's (NEC),12,4-8,106,162,268,0.396,04/19/2017,2017.0
62,Bellarmine (SoCon),11,3-8,106,167,273,0.388,04/19/2017,2017.0
63,Drexel (CAA),11,5-6,104,165,269,0.387,04/19/2017,2017.0
64,Dartmouth (Ivy League),11,2-9,97,157,254,0.382,04/19/2017,2017.0
65,Cornell (Ivy League),11,4-7,117,191,308,0.380,04/19/2017,2017.0
66,Holy Cross (Patriot),12,4-8,101,172,273,0.370,04/19/2017,2017.0
67,Harvard (Ivy League),11,5-6,104,182,286,0.364,04/19/2017,2017.0
68,Hampton (DI Independent),8,1-7,66,117,183,0.361,04/19/2017,2017.0
69,High Point (SoCon),12,3-9,92,180,272,0.338,04/19/2017,2017.0
-,UMass Lowell (America East),14,3-11,146,199,345,0.423,04/19/2017,2017.0
1,Denver (Big East),11,9-2,215,75,290,0.741,04/18/2017,2017.0
2,UAlbany (America East),11,9-2,215,100,315,0.683,04/18/2017,2017.0
3,Ohio St. (Big Ten),13,11-2,188,104,292,0.644,04/18/2017,2017.0
4,Navy (Patriot),13,6-7,186,103,289,0.644,04/18/2017,2017.0
5,Army West Point (Patriot),12,10-2,167,100,267,0.625,04/18/2017,2017.0
6,Penn St. (Big Ten),12,10-2,209,134,343,0.609,04/18/2017,2017.0
7,Yale (Ivy League),11,8-3,187,121,308,0.607,04/18/2017,2017.0
8,Brown (Ivy League),11,6-5,204,143,347,0.588,04/18/2017,2017.0
9,Hartford (America East),12,5-7,174,126,300,0.580,04/18/2017,2017.0
10,Loyola Maryland (Patriot),12,7-5,178,129,307,0.580,04/18/2017,2017.0
11,Richmond (SoCon),12,10-2,138,102,240,0.575,04/18/2017,2017.0
12,Air Force (SoCon),13,8-5,163,121,284,0.574,04/18/2017,2017.0
13,Towson (CAA),10,7-3,117,88,205,0.571,04/18/2017,2017.0
14,North Carolina (ACC),12,6-6,159,120,279,0.570,04/18/2017,2017.0
15,Rutgers (Big Ten),12,9-3,166,128,294,0.565,04/18/2017,2017.0
16,Bryant (NEC),13,7-6,158,122,280,0.564,04/18/2017,2017.0
17,Syracuse (ACC),11,10-1,157,124,281,0.559,04/18/2017,2017.0
18,Mercer (SoCon),11,4-7,136,114,250,0.544,04/18/2017,2017.0
19,Saint Joseph's (NEC),12,3-9,140,118,258,0.543,04/18/2017,2017.0
20,Colgate (Patriot),12,4-8,155,131,286,0.542,04/18/2017,2017.0
21,Marquette (Big East),11,6-5,128,109,237,0.540,04/18/2017,2017.0
22,Virginia (ACC),14,8-6,235,202,437,0.538,04/18/2017,2017.0
23,Massachusetts (CAA),11,5-6,129,111,240,0.538,04/18/2017,2017.0
24,Jacksonville (SoCon),11,2-9,144,124,268,0.537,04/18/2017,2017.0
25,Quinnipiac (MAAC),9,2-7,121,105,226,0.535,04/18/2017,2017.0
26,Duke (ACC),13,10-3,173,151,324,0.534,04/18/2017,2017.0
27,Boston U. (Patriot),13,10-3,159,139,298,0.534,04/18/2017,2017.0
28,Lehigh (Patriot),12,6-6,150,135,285,0.526,04/18/2017,2017.0
29,Maryland (Big Ten),11,9-2,154,139,293,0.526,04/18/2017,2017.0
30,Binghamton (America East),11,9-2,125,115,240,0.521,04/18/2017,2017.0
31,Fairfield (CAA),12,3-9,141,132,273,0.516,04/18/2017,2017.0
32,Marist (MAAC),12,7-5,119,112,231,0.515,04/18/2017,2017.0
33,Providence (Big East),13,9-4,144,136,280,0.514,04/18/2017,2017.0
34,Bucknell (Patriot),12,5-7,145,137,282,0.514,04/18/2017,2017.0
35,Detroit Mercy (MAAC),13,5-8,156,148,304,0.513,04/18/2017,2017.0
36,Vermont (America East),12,5-7,150,143,293,0.512,04/18/2017,2017.0
37,Furman (SoCon),12,6-6,135,134,269,0.502,04/18/2017,2017.0
38,Hobart (NEC),12,6-6,155,155,310,0.500,04/18/2017,2017.0
39,Hofstra (CAA),11,10-1,125,128,253,0.494,04/18/2017,2017.0
40,Delaware (CAA),13,7-6,153,158,311,0.492,04/18/2017,2017.0
41,Manhattan (MAAC),12,2-10,159,166,325,0.489,04/18/2017,2017.0
42,Princeton (Ivy League),12,8-4,166,177,343,0.484,04/18/2017,2017.0
43,Villanova (Big East),12,7-5,168,181,349,0.481,04/18/2017,2017.0
44,Michigan (Big Ten),12,8-4,139,152,291,0.478,04/18/2017,2017.0
45,Monmouth (MAAC),13,10-3,127,144,271,0.469,04/18/2017,2017.0
46,Lafayette (Patriot),13,2-11,141,162,303,0.465,04/18/2017,2017.0
47,Sacred Heart (NEC),12,7-5,128,153,281,0.456,04/18/2017,2017.0
48,Penn (Ivy League),10,5-5,117,140,257,0.455,04/18/2017,2017.0
49,Johns Hopkins (Big Ten),11,7-4,131,157,288,0.455,04/18/2017,2017.0
50,Canisius (MAAC),12,5-7,138,166,304,0.454,04/18/2017,2017.0
51,Georgetown (Big East),13,3-10,146,177,323,0.452,04/18/2017,2017.0
52,VMI (SoCon),12,2-10,129,159,288,0.448,04/18/2017,2017.0
53,Notre Dame (ACC),9,6-3,93,115,208,0.447,04/18/2017,2017.0
54,UMBC (America East),11,5-6,97,124,221,0.439,04/18/2017,2017.0
55,St. John's (NY) (Big East),12,1-11,126,168,294,0.429,04/18/2017,2017.0
56,Robert Morris (NEC),13,9-4,136,185,321,0.424,04/18/2017,2017.0
57,Siena (MAAC),12,2-10,143,199,342,0.418,04/18/2017,2017.0
58,Wagner (NEC),13,6-7,110,155,265,0.415,04/18/2017,2017.0
59,Stony Brook (America East),11,6-5,121,173,294,0.412,04/18/2017,2017.0
60,Cleveland St. (Independent),12,4-8,124,178,302,0.411,04/18/2017,2017.0
61,Mount St. Mary's (NEC),12,4-8,106,162,268,0.396,04/18/2017,2017.0
62,Bellarmine (SoCon),11,3-8,106,167,273,0.388,04/18/2017,2017.0
63,Drexel (CAA),11,5-6,104,165,269,0.387,04/18/2017,2017.0
64,Dartmouth (Ivy League),11,2-9,97,157,254,0.382,04/18/2017,2017.0
65,Cornell (Ivy League),11,4-7,117,191,308,0.380,04/18/2017,2017.0
66,Holy Cross (Patriot),12,4-8,101,172,273,0.370,04/18/2017,2017.0
67,Harvard (Ivy League),11,5-6,104,182,286,0.364,04/18/2017,2017.0
68,Hampton (DI Independent),8,1-7,66,117,183,0.361,04/18/2017,2017.0
69,High Point (SoCon),12,3-9,92,180,272,0.338,04/18/2017,2017.0
-,UMass Lowell (America East),14,3-11,146,199,345,0.423,04/18/2017,2017.0
1,Denver (Big East),11,9-2,215,75,290,0.741,04/16/2017,2017.0
2,UAlbany (America East),11,9-2,215,100,315,0.683,04/16/2017,2017.0
3,Ohio St. (Big Ten),13,11-2,188,104,292,0.644,04/16/2017,2017.0
4,Navy (Patriot),13,6-7,186,103,289,0.644,04/16/2017,2017.0
5,Army West Point (Patriot),12,10-2,167,100,267,0.625,04/16/2017,2017.0
6,Penn St. (Big Ten),12,10-2,209,134,343,0.609,04/16/2017,2017.0
7,Yale (Ivy League),11,8-3,187,121,308,0.607,04/16/2017,2017.0
8,Hartford (America East),11,4-7,162,109,271,0.598,04/16/2017,2017.0
9,Loyola Maryland (Patriot),12,7-5,178,129,307,0.580,04/16/2017,2017.0
10,Brown (Ivy League),10,5-5,183,135,318,0.575,04/16/2017,2017.0
11,Richmond (SoCon),12,10-2,138,102,240,0.575,04/16/2017,2017.0
12,Air Force (SoCon),13,8-5,163,121,284,0.574,04/16/2017,2017.0
13,Towson (CAA),10,7-3,117,88,205,0.571,04/16/2017,2017.0
14,North Carolina (ACC),12,6-6,159,120,279,0.570,04/16/2017,2017.0
15,Rutgers (Big Ten),12,9-3,166,128,294,0.565,04/16/2017,2017.0
16,Bryant (NEC),13,7-6,158,122,280,0.564,04/16/2017,2017.0
17,Syracuse (ACC),11,10-1,157,124,281,0.559,04/16/2017,2017.0
18,Mercer (SoCon),11,4-7,136,114,250,0.544,04/16/2017,2017.0
19,Saint Joseph's (NEC),12,3-9,140,118,258,0.543,04/16/2017,2017.0
20,Colgate (Patriot),12,4-8,155,131,286,0.542,04/16/2017,2017.0
21,Providence (Big East),12,9-3,136,115,251,0.542,04/16/2017,2017.0
22,Marquette (Big East),11,6-5,128,109,237,0.540,04/16/2017,2017.0
23,Virginia (ACC),14,8-6,235,202,437,0.538,04/16/2017,2017.0
24,Massachusetts (CAA),11,5-6,129,111,240,0.538,04/16/2017,2017.0
25,Jacksonville (SoCon),11,2-9,144,124,268,0.537,04/16/2017,2017.0
26,Quinnipiac (MAAC),9,2-7,121,105,226,0.535,04/16/2017,2017.0
27,Duke (ACC),13,10-3,173,151,324,0.534,04/16/2017,2017.0
28,Boston U. (Patriot),13,10-3,159,139,298,0.534,04/16/2017,2017.0
29,Lehigh (Patriot),12,6-6,150,135,285,0.526,04/16/2017,2017.0
30,Maryland (Big Ten),11,9-2,154,139,293,0.526,04/16/2017,2017.0
31,Binghamton (America East),11,9-2,125,115,240,0.521,04/16/2017,2017.0
32,Fairfield (CAA),12,3-9,141,132,273,0.516,04/16/2017,2017.0
33,Marist (MAAC),12,7-5,119,112,231,0.515,04/16/2017,2017.0
34,Bucknell (Patriot),12,5-7,145,137,282,0.514,04/16/2017,2017.0
35,Detroit Mercy (MAAC),13,5-8,156,148,304,0.513,04/16/2017,2017.0
36,Vermont (America East),12,5-7,150,143,293,0.512,04/16/2017,2017.0
37,Furman (SoCon),12,6-6,135,134,269,0.502,04/16/2017,2017.0
38,Hobart (NEC),12,6-6,155,155,310,0.500,04/16/2017,2017.0
39,Hofstra (CAA),11,10-1,125,128,253,0.494,04/16/2017,2017.0
40,Delaware (CAA),13,7-6,153,158,311,0.492,04/16/2017,2017.0
41,Manhattan (MAAC),12,2-10,159,166,325,0.489,04/16/2017,2017.0
42,Princeton (Ivy League),12,8-4,166,177,343,0.484,04/16/2017,2017.0
43,Villanova (Big East),12,7-5,168,181,349,0.481,04/16/2017,2017.0
44,Michigan (Big Ten),12,8-4,139,152,291,0.478,04/16/2017,2017.0
45,Monmouth (MAAC),13,10-3,127,144,271,0.469,04/16/2017,2017.0
46,Lafayette (Patriot),13,2-11,141,162,303,0.465,04/16/2017,2017.0
47,Penn (Ivy League),10,5-5,117,140,257,0.455,04/16/2017,2017.0
48,Johns Hopkins (Big Ten),11,7-4,131,157,288,0.455,04/16/2017,2017.0
49,VMI (SoCon),12,2-10,129,159,288,0.448,04/16/2017,2017.0
50,Notre Dame (ACC),9,6-3,93,115,208,0.447,04/16/2017,2017.0
51,Georgetown (Big East),12,2-10,134,166,300,0.447,04/16/2017,2017.0
52,Canisius (MAAC),11,5-6,125,156,281,0.445,04/16/2017,2017.0
53,Sacred Heart (NEC),11,7-4,111,141,252,0.440,04/16/2017,2017.0
54,UMBC (America East),11,5-6,97,124,221,0.439,04/16/2017,2017.0
55,St. John's (NY) (Big East),12,1-11,126,168,294,0.429,04/16/2017,2017.0
56,Robert Morris (NEC),12,8-4,126,172,298,0.423,04/16/2017,2017.0
57,Siena (MAAC),12,2-10,143,199,342,0.418,04/16/2017,2017.0
58,Wagner (NEC),13,6-7,110,155,265,0.415,04/16/2017,2017.0
59,Stony Brook (America East),11,6-5,121,173,294,0.412,04/16/2017,2017.0
60,Cleveland St. (Independent),12,4-8,124,178,302,0.411,04/16/2017,2017.0
61,Bellarmine (SoCon),11,3-8,106,167,273,0.388,04/16/2017,2017.0
62,Mount St. Mary's (NEC),11,4-7,95,150,245,0.388,04/16/2017,2017.0
63,Drexel (CAA),11,5-6,104,165,269,0.387,04/16/2017,2017.0
64,Dartmouth (Ivy League),11,2-9,97,157,254,0.382,04/16/2017,2017.0
65,Cornell (Ivy League),11,4-7,117,191,308,0.380,04/16/2017,2017.0
66,Holy Cross (Patriot),12,4-8,101,172,273,0.370,04/16/2017,2017.0
67,Harvard (Ivy League),11,5-6,104,182,286,0.364,04/16/2017,2017.0
68,Hampton (DI Independent),8,1-7,66,117,183,0.361,04/16/2017,2017.0
69,High Point (SoCon),12,3-9,92,180,272,0.338,04/16/2017,2017.0
-,UMass Lowell (America East),14,3-11,146,199,345,0.423,04/16/2017,2017.0
1,Denver (Big East),10,8-2,191,67,258,0.740,04/12/2017,2017.0
2,UAlbany (America East),11,9-2,215,100,315,0.683,04/12/2017,2017.0
3,Navy (Patriot),12,5-7,175,95,270,0.648,04/12/2017,2017.0
4,Army West Point (Patriot),11,10-1,159,89,248,0.641,04/12/2017,2017.0
5,Penn St. (Big Ten),11,10-1,200,115,315,0.635,04/12/2017,2017.0
6,Ohio St. (Big Ten),12,10-2,166,97,263,0.631,04/12/2017,2017.0
7,Yale (Ivy League),10,7-3,170,105,275,0.618,04/12/2017,2017.0
8,Loyola Maryland (Patriot),11,7-4,168,112,280,0.600,04/12/2017,2017.0
9,North Carolina (ACC),11,6-5,149,105,254,0.587,04/12/2017,2017.0
10,Brown (Ivy League),9,5-4,167,118,285,0.586,04/12/2017,2017.0
11,Richmond (SoCon),11,9-2,126,91,217,0.581,04/12/2017,2017.0
12,Bryant (NEC),12,7-5,150,109,259,0.579,04/12/2017,2017.0
13,Hartford (America East),10,4-6,140,104,244,0.574,04/12/2017,2017.0
14,Mercer (SoCon),10,4-6,129,97,226,0.571,04/12/2017,2017.0
15,Towson (CAA),9,6-3,105,81,186,0.565,04/12/2017,2017.0
16,Rutgers (Big Ten),11,9-2,146,117,263,0.555,04/12/2017,2017.0
17,Syracuse (ACC),10,9-1,142,114,256,0.555,04/12/2017,2017.0
18,Air Force (SoCon),12,7-5,145,118,263,0.551,04/12/2017,2017.0
19,Marquette (Big East),10,6-4,120,98,218,0.550,04/12/2017,2017.0
20,Colgate (Patriot),11,4-7,142,117,259,0.548,04/12/2017,2017.0
21,Maryland (Big Ten),10,8-2,143,119,262,0.546,04/12/2017,2017.0
22,Saint Joseph's (NEC),11,3-8,126,106,232,0.543,04/12/2017,2017.0
23,Virginia (ACC),13,8-5,218,184,402,0.542,04/12/2017,2017.0
24,Providence (Big East),11,8-3,125,107,232,0.539,04/12/2017,2017.0
25,Massachusetts (CAA),10,4-6,116,100,216,0.537,04/12/2017,2017.0
26,Duke (ACC),12,9-3,155,134,289,0.536,04/12/2017,2017.0
27,Quinnipiac (MAAC),9,2-7,121,105,226,0.535,04/12/2017,2017.0
28,Marist (MAAC),11,6-5,108,97,205,0.527,04/12/2017,2017.0
29,Binghamton (America East),10,9-1,117,106,223,0.525,04/12/2017,2017.0
30,Boston U. (Patriot),12,9-3,142,129,271,0.524,04/12/2017,2017.0
31,Fairfield (CAA),11,3-8,130,119,249,0.522,04/12/2017,2017.0
32,Jacksonville (SoCon),10,1-9,127,117,244,0.520,04/12/2017,2017.0
33,Vermont (America East),11,5-6,137,134,271,0.506,04/12/2017,2017.0
34,Detroit Mercy (MAAC),12,5-7,143,140,283,0.505,04/12/2017,2017.0
35,Michigan (Big Ten),11,8-3,132,130,262,0.504,04/12/2017,2017.0
36,Delaware (CAA),12,7-5,146,146,292,0.500,04/12/2017,2017.0
37,Furman (SoCon),11,5-6,122,124,246,0.496,04/12/2017,2017.0
38,Lehigh (Patriot),11,6-5,126,129,255,0.494,04/12/2017,2017.0
39,Hofstra (CAA),10,10-0,111,114,225,0.493,04/12/2017,2017.0
40,Hobart (NEC),11,5-6,142,147,289,0.491,04/12/2017,2017.0
41,Bucknell (Patriot),11,4-7,128,133,261,0.490,04/12/2017,2017.0
42,Lafayette (Patriot),12,2-10,137,145,282,0.486,04/12/2017,2017.0
43,Manhattan (MAAC),11,2-9,144,155,299,0.482,04/12/2017,2017.0
44,Monmouth (MAAC),12,9-3,119,131,250,0.476,04/12/2017,2017.0
45,VMI (SoCon),11,2-9,126,141,267,0.472,04/12/2017,2017.0
46,Villanova (Big East),11,6-5,149,169,318,0.469,04/12/2017,2017.0
47,Princeton (Ivy League),11,7-4,149,170,319,0.467,04/12/2017,2017.0
48,Canisius (MAAC),10,5-5,117,139,256,0.457,04/12/2017,2017.0
49,Georgetown (Big East),11,2-9,122,147,269,0.454,04/12/2017,2017.0
50,St. John's (NY) (Big East),11,1-10,118,144,262,0.450,04/12/2017,2017.0
51,Notre Dame (ACC),9,6-3,93,115,208,0.447,04/12/2017,2017.0
52,Sacred Heart (NEC),10,6-4,99,127,226,0.438,04/12/2017,2017.0
53,UMBC (America East),10,4-6,88,116,204,0.431,04/12/2017,2017.0
54,Johns Hopkins (Big Ten),10,6-4,112,148,260,0.431,04/12/2017,2017.0
55,Robert Morris (NEC),12,8-4,126,172,298,0.423,04/12/2017,2017.0
56,Wagner (NEC),12,5-7,103,144,247,0.417,04/12/2017,2017.0
57,Penn (Ivy League),9,4-5,95,134,229,0.415,04/12/2017,2017.0
58,Stony Brook (America East),10,5-5,112,160,272,0.412,04/12/2017,2017.0
59,Cleveland St. (Independent),11,3-8,113,166,279,0.405,04/12/2017,2017.0
60,Cornell (Ivy League),10,3-7,111,167,278,0.399,04/12/2017,2017.0
61,Siena (MAAC),11,1-10,126,191,317,0.397,04/12/2017,2017.0
62,Dartmouth (Ivy League),10,2-8,90,140,230,0.391,04/12/2017,2017.0
63,Hampton (DI Independent),7,1-6,62,98,160,0.388,04/12/2017,2017.0
64,Bellarmine (SoCon),10,3-7,95,155,250,0.380,04/12/2017,2017.0
65,Harvard (Ivy League),10,5-5,98,160,258,0.380,04/12/2017,2017.0
66,Drexel (CAA),10,4-6,90,151,241,0.373,04/12/2017,2017.0
67,Mount St. Mary's (NEC),10,4-6,84,143,227,0.370,04/12/2017,2017.0
68,Holy Cross (Patriot),11,3-8,87,159,246,0.354,04/12/2017,2017.0
69,High Point (SoCon),11,3-8,82,167,249,0.329,04/12/2017,2017.0
-,UMass Lowell (America East),13,2-11,141,177,318,0.443,04/12/2017,2017.0
1,Denver (Big East),10,8-2,191,67,258,0.740,04/11/2017,2017.0
2,UAlbany (America East),10,9-1,199,89,288,0.691,04/11/2017,2017.0
3,Navy (Patriot),12,5-7,175,95,270,0.648,04/11/2017,2017.0
4,Army West Point (Patriot),11,10-1,159,89,248,0.641,04/11/2017,2017.0
5,Penn St. (Big Ten),11,10-1,200,115,315,0.635,04/11/2017,2017.0
6,Ohio St. (Big Ten),12,10-2,166,97,263,0.631,04/11/2017,2017.0
7,Yale (Ivy League),10,7-3,170,105,275,0.618,04/11/2017,2017.0
8,Loyola Maryland (Patriot),11,7-4,168,112,280,0.600,04/11/2017,2017.0
9,North Carolina (ACC),11,6-5,149,105,254,0.587,04/11/2017,2017.0
10,Brown (Ivy League),9,5-4,167,118,285,0.586,04/11/2017,2017.0
11,Richmond (SoCon),11,9-2,126,91,217,0.581,04/11/2017,2017.0
12,Bryant (NEC),12,7-5,150,109,259,0.579,04/11/2017,2017.0
13,Hartford (America East),10,4-6,140,104,244,0.574,04/11/2017,2017.0
14,Mercer (SoCon),10,4-6,129,97,226,0.571,04/11/2017,2017.0
15,Towson (CAA),9,6-3,105,81,186,0.565,04/11/2017,2017.0
16,Maryland (Big Ten),9,7-2,132,103,235,0.562,04/11/2017,2017.0
17,Rutgers (Big Ten),11,9-2,146,117,263,0.555,04/11/2017,2017.0
18,Syracuse (ACC),10,9-1,142,114,256,0.555,04/11/2017,2017.0
19,Air Force (SoCon),12,7-5,145,118,263,0.551,04/11/2017,2017.0
20,Marquette (Big East),10,6-4,120,98,218,0.550,04/11/2017,2017.0
21,Colgate (Patriot),11,4-7,142,117,259,0.548,04/11/2017,2017.0
22,Saint Joseph's (NEC),11,3-8,126,106,232,0.543,04/11/2017,2017.0
23,Virginia (ACC),13,8-5,218,184,402,0.542,04/11/2017,2017.0
24,Providence (Big East),11,8-3,125,107,232,0.539,04/11/2017,2017.0
25,Massachusetts (CAA),10,4-6,116,100,216,0.537,04/11/2017,2017.0
26,Duke (ACC),12,9-3,155,134,289,0.536,04/11/2017,2017.0
27,Quinnipiac (MAAC),9,2-7,121,105,226,0.535,04/11/2017,2017.0
28,Marist (MAAC),11,6-5,108,97,205,0.527,04/11/2017,2017.0
29,Binghamton (America East),10,9-1,117,106,223,0.525,04/11/2017,2017.0
30,Boston U. (Patriot),12,9-3,142,129,271,0.524,04/11/2017,2017.0
31,Fairfield (CAA),11,3-8,130,119,249,0.522,04/11/2017,2017.0
32,Jacksonville (SoCon),10,1-9,127,117,244,0.520,04/11/2017,2017.0
33,Vermont (America East),11,5-6,137,134,271,0.506,04/11/2017,2017.0
34,Detroit Mercy (MAAC),12,5-7,143,140,283,0.505,04/11/2017,2017.0
35,Michigan (Big Ten),11,8-3,132,130,262,0.504,04/11/2017,2017.0
36,Delaware (CAA),12,7-5,146,146,292,0.500,04/11/2017,2017.0
37,Lehigh (Patriot),11,6-5,127,129,256,0.496,04/11/2017,2017.0
38,Furman (SoCon),11,5-6,122,124,246,0.496,04/11/2017,2017.0
39,Hofstra (CAA),10,10-0,111,114,225,0.493,04/11/2017,2017.0
40,Hobart (NEC),11,5-6,142,147,289,0.491,04/11/2017,2017.0
41,Bucknell (Patriot),11,4-7,128,133,261,0.490,04/11/2017,2017.0
42,Lafayette (Patriot),12,2-10,137,145,282,0.486,04/11/2017,2017.0
43,Manhattan (MAAC),11,2-9,144,155,299,0.482,04/11/2017,2017.0
44,Monmouth (MAAC),12,9-3,119,131,250,0.476,04/11/2017,2017.0
45,VMI (SoCon),11,2-9,126,141,267,0.472,04/11/2017,2017.0
46,Villanova (Big East),11,6-5,149,169,318,0.469,04/11/2017,2017.0
47,Princeton (Ivy League),11,7-4,149,171,320,0.466,04/11/2017,2017.0
48,Canisius (MAAC),10,5-5,117,139,256,0.457,04/11/2017,2017.0
49,Georgetown (Big East),11,2-9,122,147,269,0.454,04/11/2017,2017.0
50,St. John's (NY) (Big East),11,1-10,118,144,262,0.450,04/11/2017,2017.0
51,Notre Dame (ACC),9,6-3,93,115,208,0.447,04/11/2017,2017.0
52,Sacred Heart (NEC),10,6-4,99,127,226,0.438,04/11/2017,2017.0
53,UMBC (America East),10,4-6,88,116,204,0.431,04/11/2017,2017.0
54,Johns Hopkins (Big Ten),10,6-4,112,148,260,0.431,04/11/2017,2017.0
55,Robert Morris (NEC),12,8-4,126,172,298,0.423,04/11/2017,2017.0
56,Wagner (NEC),12,5-7,103,144,247,0.417,04/11/2017,2017.0
57,Penn (Ivy League),9,4-5,95,134,229,0.415,04/11/2017,2017.0
58,Stony Brook (America East),10,5-5,112,160,272,0.412,04/11/2017,2017.0
59,Cleveland St. (Independent),11,3-8,113,166,279,0.405,04/11/2017,2017.0
60,Cornell (Ivy League),10,3-7,111,167,278,0.399,04/11/2017,2017.0
61,Siena (MAAC),11,1-10,126,191,317,0.397,04/11/2017,2017.0
62,Dartmouth (Ivy League),10,2-8,90,140,230,0.391,04/11/2017,2017.0
63,Hampton (DI Independent),7,1-6,62,98,160,0.388,04/11/2017,2017.0
64,Bellarmine (SoCon),10,3-7,95,155,250,0.380,04/11/2017,2017.0
65,Harvard (Ivy League),10,5-5,98,160,258,0.380,04/11/2017,2017.0
66,Drexel (CAA),10,4-6,90,151,241,0.373,04/11/2017,2017.0
67,Mount St. Mary's (NEC),10,4-6,84,143,227,0.370,04/11/2017,2017.0
68,Holy Cross (Patriot),11,3-8,87,159,246,0.354,04/11/2017,2017.0
69,High Point (SoCon),11,3-8,82,167,249,0.329,04/11/2017,2017.0
-,UMass Lowell (America East),13,2-11,141,177,318,0.443,04/11/2017,2017.0
1,Denver (Big East),10,8-2,191,67,258,0.740,04/10/2017,2017.0
2,UAlbany (America East),10,9-1,199,89,288,0.691,04/10/2017,2017.0
3,Navy (Patriot),12,5-7,174,96,270,0.644,04/10/2017,2017.0
4,Army West Point (Patriot),11,10-1,159,89,248,0.641,04/10/2017,2017.0
5,Penn St. (Big Ten),11,10-1,200,115,315,0.635,04/10/2017,2017.0
6,Ohio St. (Big Ten),12,10-2,166,97,263,0.631,04/10/2017,2017.0
7,Yale (Ivy League),10,7-3,170,105,275,0.618,04/10/2017,2017.0
8,Loyola Maryland (Patriot),11,7-4,168,112,280,0.600,04/10/2017,2017.0
9,North Carolina (ACC),11,6-5,149,105,254,0.587,04/10/2017,2017.0
10,Brown (Ivy League),9,5-4,167,118,285,0.586,04/10/2017,2017.0
11,Richmond (SoCon),11,9-2,126,91,217,0.581,04/10/2017,2017.0
12,Bryant (NEC),12,7-5,150,109,259,0.579,04/10/2017,2017.0
13,Hartford (America East),10,4-6,140,104,244,0.574,04/10/2017,2017.0
14,Mercer (SoCon),10,4-6,129,97,226,0.571,04/10/2017,2017.0
15,Towson (CAA),9,6-3,105,81,186,0.565,04/10/2017,2017.0
16,Maryland (Big Ten),9,7-2,132,103,235,0.562,04/10/2017,2017.0
17,Rutgers (Big Ten),11,9-2,146,117,263,0.555,04/10/2017,2017.0
18,Colgate (Patriot),11,4-7,143,116,259,0.552,04/10/2017,2017.0
19,Air Force (SoCon),12,7-5,145,118,263,0.551,04/10/2017,2017.0
20,Saint Joseph's (NEC),11,3-8,126,106,232,0.543,04/10/2017,2017.0
21,Providence (Big East),11,8-3,125,107,232,0.539,04/10/2017,2017.0
22,Massachusetts (CAA),10,4-6,116,100,216,0.537,04/10/2017,2017.0
23,Duke (ACC),12,9-3,155,134,289,0.536,04/10/2017,2017.0
24,Quinnipiac (MAAC),9,2-7,121,105,226,0.535,04/10/2017,2017.0
25,Virginia (ACC),12,7-5,201,177,378,0.532,04/10/2017,2017.0
26,Syracuse (ACC),9,8-1,122,108,230,0.530,04/10/2017,2017.0
27,Marquette (Big East),9,6-3,102,91,193,0.528,04/10/2017,2017.0
28,Marist (MAAC),11,6-5,108,97,205,0.527,04/10/2017,2017.0
29,Binghamton (America East),10,9-1,117,106,223,0.525,04/10/2017,2017.0
30,Boston U. (Patriot),12,9-3,142,129,271,0.524,04/10/2017,2017.0
31,Fairfield (CAA),11,3-8,130,119,249,0.522,04/10/2017,2017.0
32,Jacksonville (SoCon),10,1-9,127,117,244,0.520,04/10/2017,2017.0
33,Lehigh (Patriot),10,5-5,115,111,226,0.509,04/10/2017,2017.0
34,Vermont (America East),11,5-6,137,134,271,0.506,04/10/2017,2017.0
35,Detroit Mercy (MAAC),12,5-7,143,140,283,0.505,04/10/2017,2017.0
36,Michigan (Big Ten),11,8-3,132,130,262,0.504,04/10/2017,2017.0
37,Delaware (CAA),12,7-5,146,146,292,0.500,04/10/2017,2017.0
38,Furman (SoCon),11,5-6,122,124,246,0.496,04/10/2017,2017.0
39,Hofstra (CAA),10,10-0,111,114,225,0.493,04/10/2017,2017.0
40,Hobart (NEC),11,5-6,142,147,289,0.491,04/10/2017,2017.0
41,Bucknell (Patriot),11,4-7,128,133,261,0.490,04/10/2017,2017.0
42,Manhattan (MAAC),11,2-9,144,155,299,0.482,04/10/2017,2017.0
43,Lafayette (Patriot),11,1-10,122,134,256,0.477,04/10/2017,2017.0
44,Monmouth (MAAC),12,9-3,119,131,250,0.476,04/10/2017,2017.0
45,VMI (SoCon),11,2-9,126,141,267,0.472,04/10/2017,2017.0
46,Notre Dame (ACC),8,5-3,86,97,183,0.470,04/10/2017,2017.0
47,Villanova (Big East),11,6-5,149,169,318,0.469,04/10/2017,2017.0
48,Canisius (MAAC),10,5-5,117,139,256,0.457,04/10/2017,2017.0
49,Georgetown (Big East),11,2-9,122,147,269,0.454,04/10/2017,2017.0
50,Princeton (Ivy League),10,7-3,131,159,290,0.452,04/10/2017,2017.0
51,St. John's (NY) (Big East),11,1-10,118,144,262,0.450,04/10/2017,2017.0
52,Sacred Heart (NEC),10,6-4,99,127,226,0.438,04/10/2017,2017.0
53,Robert Morris (NEC),11,8-3,119,155,274,0.434,04/10/2017,2017.0
54,UMBC (America East),10,4-6,88,116,204,0.431,04/10/2017,2017.0
55,Johns Hopkins (Big Ten),10,6-4,112,148,260,0.431,04/10/2017,2017.0
56,Wagner (NEC),12,5-7,103,144,247,0.417,04/10/2017,2017.0
57,Cornell (Ivy League),9,3-6,105,147,252,0.417,04/10/2017,2017.0
58,Penn (Ivy League),9,4-5,95,134,229,0.415,04/10/2017,2017.0
59,Stony Brook (America East),10,5-5,112,160,272,0.412,04/10/2017,2017.0
60,Cleveland St. (Independent),11,3-8,113,166,279,0.405,04/10/2017,2017.0
61,Siena (MAAC),11,1-10,126,191,317,0.397,04/10/2017,2017.0
62,Dartmouth (Ivy League),9,1-8,80,126,206,0.388,04/10/2017,2017.0
63,Hampton (DI Independent),7,1-6,62,98,160,0.388,04/10/2017,2017.0
64,Bellarmine (SoCon),10,3-7,95,155,250,0.380,04/10/2017,2017.0
65,Harvard (Ivy League),10,5-5,98,160,258,0.380,04/10/2017,2017.0
66,Drexel (CAA),10,4-6,90,151,241,0.373,04/10/2017,2017.0
67,Mount St. Mary's (NEC),10,4-6,84,143,227,0.370,04/10/2017,2017.0
68,Holy Cross (Patriot),11,3-8,87,159,246,0.354,04/10/2017,2017.0
69,High Point (SoCon),11,3-8,82,167,249,0.329,04/10/2017,2017.0
-,UMass Lowell (America East),12,2-10,127,167,294,0.432,04/10/2017,2017.0
1,Denver (Big East),10,8-2,191,67,258,0.740,04/09/2017,2017.0
2,UAlbany (America East),10,9-1,199,89,288,0.691,04/09/2017,2017.0
3,Navy (Patriot),12,5-7,174,96,270,0.644,04/09/2017,2017.0
4,Army West Point (Patriot),11,10-1,159,89,248,0.641,04/09/2017,2017.0
5,Penn St. (Big Ten),11,10-1,200,115,315,0.635,04/09/2017,2017.0
6,Ohio St. (Big Ten),12,10-2,166,97,263,0.631,04/09/2017,2017.0
7,Yale (Ivy League),10,7-3,170,105,275,0.618,04/09/2017,2017.0
8,Loyola Maryland (Patriot),11,7-4,168,112,280,0.600,04/09/2017,2017.0
9,North Carolina (ACC),11,6-5,149,105,254,0.587,04/09/2017,2017.0
10,Brown (Ivy League),9,5-4,167,118,285,0.586,04/09/2017,2017.0
11,Richmond (SoCon),11,9-2,126,91,217,0.581,04/09/2017,2017.0
12,Bryant (NEC),12,7-5,150,109,259,0.579,04/09/2017,2017.0
13,Hartford (America East),10,4-6,140,104,244,0.574,04/09/2017,2017.0
14,Mercer (SoCon),10,4-6,129,97,226,0.571,04/09/2017,2017.0
15,Towson (CAA),9,6-3,105,81,186,0.565,04/09/2017,2017.0
16,Maryland (Big Ten),9,7-2,132,103,235,0.562,04/09/2017,2017.0
17,Rutgers (Big Ten),11,9-2,146,117,263,0.555,04/09/2017,2017.0
18,Colgate (Patriot),11,4-7,143,116,259,0.552,04/09/2017,2017.0
19,Air Force (SoCon),12,7-5,145,118,263,0.551,04/09/2017,2017.0
20,Saint Joseph's (NEC),11,3-8,126,106,232,0.543,04/09/2017,2017.0
21,Providence (Big East),11,8-3,125,107,232,0.539,04/09/2017,2017.0
22,Massachusetts (CAA),10,4-6,116,100,216,0.537,04/09/2017,2017.0
23,Duke (ACC),12,9-3,155,134,289,0.536,04/09/2017,2017.0
24,Quinnipiac (MAAC),9,2-7,121,105,226,0.535,04/09/2017,2017.0
25,Virginia (ACC),12,7-5,201,177,378,0.532,04/09/2017,2017.0
26,Syracuse (ACC),9,8-1,122,108,230,0.530,04/09/2017,2017.0
27,Marquette (Big East),9,6-3,102,91,193,0.528,04/09/2017,2017.0
28,Marist (MAAC),11,6-5,108,97,205,0.527,04/09/2017,2017.0
29,Binghamton (America East),10,9-1,117,106,223,0.525,04/09/2017,2017.0
30,Boston U. (Patriot),12,9-3,142,129,271,0.524,04/09/2017,2017.0
31,Fairfield (CAA),11,3-8,130,119,249,0.522,04/09/2017,2017.0
32,Jacksonville (SoCon),10,1-9,127,117,244,0.520,04/09/2017,2017.0
33,Lehigh (Patriot),10,5-5,115,111,226,0.509,04/09/2017,2017.0
34,Vermont (America East),11,5-6,137,134,271,0.506,04/09/2017,2017.0
35,Detroit Mercy (MAAC),12,5-7,143,140,283,0.505,04/09/2017,2017.0
36,Michigan (Big Ten),11,8-3,132,130,262,0.504,04/09/2017,2017.0
37,Delaware (CAA),12,7-5,146,146,292,0.500,04/09/2017,2017.0
38,Furman (SoCon),11,5-6,122,124,246,0.496,04/09/2017,2017.0
39,Hofstra (CAA),10,10-0,111,114,225,0.493,04/09/2017,2017.0
40,Hobart (NEC),11,5-6,142,147,289,0.491,04/09/2017,2017.0
41,Bucknell (Patriot),11,4-7,128,133,261,0.490,04/09/2017,2017.0
42,Monmouth (MAAC),11,8-3,109,114,223,0.489,04/09/2017,2017.0
43,Manhattan (MAAC),11,2-9,144,155,299,0.482,04/09/2017,2017.0
44,Lafayette (Patriot),11,1-10,122,134,256,0.477,04/09/2017,2017.0
45,Notre Dame (ACC),8,5-3,86,97,183,0.470,04/09/2017,2017.0
46,Villanova (Big East),11,6-5,149,169,318,0.469,04/09/2017,2017.0
47,Canisius (MAAC),10,5-5,117,139,256,0.457,04/09/2017,2017.0
48,VMI (SoCon),10,2-8,109,131,240,0.454,04/09/2017,2017.0
49,Georgetown (Big East),11,2-9,122,147,269,0.454,04/09/2017,2017.0
50,Princeton (Ivy League),10,7-3,131,159,290,0.452,04/09/2017,2017.0
51,St. John's (NY) (Big East),11,1-10,118,144,262,0.450,04/09/2017,2017.0
52,Sacred Heart (NEC),10,6-4,99,127,226,0.438,04/09/2017,2017.0
53,Robert Morris (NEC),11,8-3,119,155,274,0.434,04/09/2017,2017.0
54,UMBC (America East),10,4-6,88,116,204,0.431,04/09/2017,2017.0
55,Johns Hopkins (Big Ten),10,6-4,112,148,260,0.431,04/09/2017,2017.0
56,Wagner (NEC),12,5-7,103,144,247,0.417,04/09/2017,2017.0
57,Cornell (Ivy League),9,3-6,105,147,252,0.417,04/09/2017,2017.0
58,Penn (Ivy League),9,4-5,95,134,229,0.415,04/09/2017,2017.0
59,Stony Brook (America East),10,5-5,112,160,272,0.412,04/09/2017,2017.0
60,Cleveland St. (Independent),11,3-8,113,166,279,0.405,04/09/2017,2017.0
61,Siena (MAAC),11,1-10,126,191,317,0.397,04/09/2017,2017.0
62,Dartmouth (Ivy League),9,1-8,80,126,206,0.388,04/09/2017,2017.0
63,Hampton (DI Independent),7,1-6,62,98,160,0.388,04/09/2017,2017.0
64,Bellarmine (SoCon),10,3-7,95,155,250,0.380,04/09/2017,2017.0
65,Harvard (Ivy League),10,5-5,98,160,258,0.380,04/09/2017,2017.0
66,Drexel (CAA),10,4-6,90,151,241,0.373,04/09/2017,2017.0
67,Mount St. Mary's (NEC),10,4-6,84,143,227,0.370,04/09/2017,2017.0
68,Holy Cross (Patriot),11,3-8,87,159,246,0.354,04/09/2017,2017.0
69,High Point (SoCon),11,3-8,82,167,249,0.329,04/09/2017,2017.0
-,UMass Lowell (America East),12,2-10,127,167,294,0.432,04/09/2017,2017.0
1,Denver (Big East),9,7-2,166,61,227,0.731,04/05/2017,2017.0
2,UAlbany (America East),9,8-1,183,86,269,0.680,04/05/2017,2017.0
3,Penn St. (Big Ten),10,10-0,190,95,285,0.667,04/05/2017,2017.0
4,Army West Point (Patriot),10,9-1,148,76,224,0.661,04/05/2017,2017.0
5,Navy (Patriot),11,5-6,165,88,253,0.652,04/05/2017,2017.0
6,Ohio St. (Big Ten),11,9-2,147,90,237,0.620,04/05/2017,2017.0
7,Yale (Ivy League),9,6-3,153,100,253,0.605,04/05/2017,2017.0
8,Mercer (SoCon),9,4-5,119,82,201,0.592,04/05/2017,2017.0
9,Loyola Maryland (Patriot),10,6-4,152,106,258,0.589,04/05/2017,2017.0
10,Hartford (America East),9,4-5,130,91,221,0.588,04/05/2017,2017.0
11,Richmond (SoCon),10,8-2,111,81,192,0.578,04/05/2017,2017.0
12,Brown (Ivy League),8,4-4,151,111,262,0.576,04/05/2017,2017.0
13,Towson (CAA),8,5-3,93,71,164,0.567,04/05/2017,2017.0
14,North Carolina (ACC),10,5-5,126,98,224,0.563,04/05/2017,2017.0
15,Bryant (NEC),11,6-5,133,104,237,0.561,04/05/2017,2017.0
16,Colgate (Patriot),10,3-7,135,107,242,0.558,04/05/2017,2017.0
17,Virginia (ACC),11,7-4,194,154,348,0.557,04/05/2017,2017.0
18,Massachusetts (CAA),9,4-5,106,88,194,0.546,04/05/2017,2017.0
19,Maryland (Big Ten),8,6-2,112,93,205,0.546,04/05/2017,2017.0
20,Providence (Big East),10,7-3,114,95,209,0.545,04/05/2017,2017.0
21,Duke (ACC),11,8-3,144,122,266,0.541,04/05/2017,2017.0
22,Quinnipiac (MAAC),8,2-6,112,95,207,0.541,04/05/2017,2017.0
23,Michigan (Big Ten),10,8-2,128,110,238,0.538,04/05/2017,2017.0
24,Air Force (SoCon),11,7-4,131,113,244,0.537,04/05/2017,2017.0
25,Lehigh (Patriot),9,5-4,109,95,204,0.534,04/05/2017,2017.0
26,Saint Joseph's (NEC),10,3-7,114,100,214,0.533,04/05/2017,2017.0
27,Syracuse (ACC),9,8-1,122,108,230,0.530,04/05/2017,2017.0
28,Rutgers (Big Ten),10,8-2,126,113,239,0.527,04/05/2017,2017.0
29,Marist (MAAC),10,5-5,98,88,186,0.527,04/05/2017,2017.0
30,Fairfield (CAA),10,3-7,115,105,220,0.523,04/05/2017,2017.0
31,Boston U. (Patriot),11,9-2,129,118,247,0.522,04/05/2017,2017.0
32,Binghamton (America East),9,8-1,104,96,200,0.520,04/05/2017,2017.0
33,Furman (SoCon),10,4-6,117,110,227,0.515,04/05/2017,2017.0
34,Hofstra (CAA),9,9-0,103,99,202,0.510,04/05/2017,2017.0
35,Detroit Mercy (MAAC),11,5-6,133,130,263,0.506,04/05/2017,2017.0
36,Hobart (NEC),10,4-6,136,135,271,0.502,04/05/2017,2017.0
37,Jacksonville (SoCon),9,0-9,108,108,216,0.500,04/05/2017,2017.0
38,Villanova (Big East),10,6-4,143,144,287,0.498,04/05/2017,2017.0
39,Marquette (Big East),8,5-3,81,82,163,0.497,04/05/2017,2017.0
40,Vermont (America East),10,4-6,120,124,244,0.492,04/05/2017,2017.0
41,Delaware (CAA),11,7-4,131,138,269,0.487,04/05/2017,2017.0
42,Manhattan (MAAC),10,2-8,133,141,274,0.485,04/05/2017,2017.0
43,Lafayette (Patriot),10,1-9,114,125,239,0.477,04/05/2017,2017.0
44,Bucknell (Patriot),10,4-6,112,123,235,0.477,04/05/2017,2017.0
45,VMI (SoCon),9,2-7,100,112,212,0.472,04/05/2017,2017.0
46,Monmouth (MAAC),10,7-3,96,108,204,0.471,04/05/2017,2017.0
47,St. John's (NY) (Big East),10,1-9,109,123,232,0.470,04/05/2017,2017.0
48,Notre Dame (ACC),7,5-2,74,86,160,0.463,04/05/2017,2017.0
49,Sacred Heart (NEC),9,6-3,94,110,204,0.461,04/05/2017,2017.0
50,UMBC (America East),9,4-5,85,100,185,0.459,04/05/2017,2017.0
51,Canisius (MAAC),9,4-5,107,129,236,0.453,04/05/2017,2017.0
52,Johns Hopkins (Big Ten),9,6-3,105,129,234,0.449,04/05/2017,2017.0
53,Georgetown (Big East),10,2-8,110,136,246,0.447,04/05/2017,2017.0
54,Princeton (Ivy League),9,6-3,117,145,262,0.447,04/05/2017,2017.0
55,Robert Morris (NEC),10,7-3,108,139,247,0.437,04/05/2017,2017.0
56,Penn (Ivy League),8,4-4,88,118,206,0.427,04/05/2017,2017.0
57,Dartmouth (Ivy League),8,1-7,75,109,184,0.408,04/05/2017,2017.0
58,Cleveland St. (Independent),11,3-8,113,166,279,0.405,04/05/2017,2017.0
59,Stony Brook (America East),9,5-4,98,146,244,0.402,04/05/2017,2017.0
60,Cornell (Ivy League),8,2-6,91,136,227,0.401,04/05/2017,2017.0
61,Wagner (NEC),11,5-6,87,133,220,0.395,04/05/2017,2017.0
62,Siena (MAAC),10,0-10,112,180,292,0.384,04/05/2017,2017.0
63,Harvard (Ivy League),9,5-4,87,146,233,0.373,04/05/2017,2017.0
64,Mount St. Mary's (NEC),9,3-6,74,127,201,0.368,04/05/2017,2017.0
65,Hampton (DI Independent),6,1-5,50,86,136,0.368,04/05/2017,2017.0
66,Bellarmine (SoCon),9,2-7,85,150,235,0.362,04/05/2017,2017.0
67,Drexel (CAA),9,3-6,76,136,212,0.358,04/05/2017,2017.0
68,Holy Cross (Patriot),10,2-8,78,151,229,0.341,04/05/2017,2017.0
69,High Point (SoCon),10,3-7,77,157,234,0.329,04/05/2017,2017.0
-,UMass Lowell (America East),11,2-9,117,150,267,0.438,04/05/2017,2017.0
1,Denver (Big East),9,7-2,166,61,227,0.731,04/04/2017,2017.0
2,UAlbany (America East),9,8-1,183,86,269,0.680,04/04/2017,2017.0
3,Penn St. (Big Ten),10,10-0,190,95,285,0.667,04/04/2017,2017.0
4,Army West Point (Patriot),10,9-1,148,76,224,0.661,04/04/2017,2017.0
5,Navy (Patriot),11,5-6,165,88,253,0.652,04/04/2017,2017.0
6,Ohio St. (Big Ten),11,9-2,147,90,237,0.620,04/04/2017,2017.0
7,Yale (Ivy League),9,6-3,153,100,253,0.605,04/04/2017,2017.0
8,Mercer (SoCon),9,4-5,119,82,201,0.592,04/04/2017,2017.0
9,Loyola Maryland (Patriot),10,6-4,152,106,258,0.589,04/04/2017,2017.0
10,Hartford (America East),9,4-5,130,91,221,0.588,04/04/2017,2017.0
11,Richmond (SoCon),10,8-2,111,81,192,0.578,04/04/2017,2017.0
12,Brown (Ivy League),8,4-4,151,111,262,0.576,04/04/2017,2017.0
13,Towson (CAA),8,5-3,93,71,164,0.567,04/04/2017,2017.0
14,North Carolina (ACC),10,5-5,126,98,224,0.563,04/04/2017,2017.0
15,Bryant (NEC),11,6-5,133,104,237,0.561,04/04/2017,2017.0
16,Colgate (Patriot),10,3-7,135,107,242,0.558,04/04/2017,2017.0
17,Virginia (ACC),11,7-4,194,154,348,0.557,04/04/2017,2017.0
18,Massachusetts (CAA),9,4-5,106,88,194,0.546,04/04/2017,2017.0
19,Maryland (Big Ten),8,6-2,112,93,205,0.546,04/04/2017,2017.0
20,Providence (Big East),10,7-3,114,95,209,0.545,04/04/2017,2017.0
21,Duke (ACC),11,8-3,144,122,266,0.541,04/04/2017,2017.0
22,Quinnipiac (MAAC),8,2-6,112,95,207,0.541,04/04/2017,2017.0
23,Michigan (Big Ten),10,8-2,128,110,238,0.538,04/04/2017,2017.0
24,Air Force (SoCon),11,7-4,131,113,244,0.537,04/04/2017,2017.0
25,Lehigh (Patriot),9,5-4,109,95,204,0.534,04/04/2017,2017.0
26,Saint Joseph's (NEC),10,3-7,114,100,214,0.533,04/04/2017,2017.0
27,Syracuse (ACC),8,7-1,105,94,199,0.528,04/04/2017,2017.0
28,Rutgers (Big Ten),10,8-2,126,113,239,0.527,04/04/2017,2017.0
29,Marist (MAAC),10,5-5,98,88,186,0.527,04/04/2017,2017.0
30,Fairfield (CAA),10,3-7,115,105,220,0.523,04/04/2017,2017.0
31,Boston U. (Patriot),11,9-2,129,118,247,0.522,04/04/2017,2017.0
32,Binghamton (America East),9,8-1,104,96,200,0.520,04/04/2017,2017.0
33,Furman (SoCon),10,4-6,117,110,227,0.515,04/04/2017,2017.0
34,Hofstra (CAA),9,9-0,103,99,202,0.510,04/04/2017,2017.0
35,Hobart (NEC),9,4-5,122,118,240,0.508,04/04/2017,2017.0
36,Detroit Mercy (MAAC),11,5-6,133,130,263,0.506,04/04/2017,2017.0
37,Jacksonville (SoCon),9,0-9,108,108,216,0.500,04/04/2017,2017.0
38,Villanova (Big East),10,6-4,143,144,287,0.498,04/04/2017,2017.0
39,Marquette (Big East),8,5-3,81,82,163,0.497,04/04/2017,2017.0
40,Vermont (America East),10,4-6,120,124,244,0.492,04/04/2017,2017.0
41,Delaware (CAA),11,7-4,131,138,269,0.487,04/04/2017,2017.0
42,Manhattan (MAAC),10,2-8,133,141,274,0.485,04/04/2017,2017.0
43,Lafayette (Patriot),10,1-9,114,125,239,0.477,04/04/2017,2017.0
44,Bucknell (Patriot),10,4-6,112,123,235,0.477,04/04/2017,2017.0
45,VMI (SoCon),9,2-7,100,112,212,0.472,04/04/2017,2017.0
46,Monmouth (MAAC),10,7-3,96,108,204,0.471,04/04/2017,2017.0
47,St. John's (NY) (Big East),10,1-9,109,123,232,0.470,04/04/2017,2017.0
48,Notre Dame (ACC),7,5-2,74,86,160,0.463,04/04/2017,2017.0
49,Sacred Heart (NEC),9,6-3,94,110,204,0.461,04/04/2017,2017.0
50,UMBC (America East),9,4-5,85,100,185,0.459,04/04/2017,2017.0
51,Canisius (MAAC),9,4-5,107,129,236,0.453,04/04/2017,2017.0
52,Johns Hopkins (Big Ten),9,6-3,105,129,234,0.449,04/04/2017,2017.0
53,Georgetown (Big East),10,2-8,110,136,246,0.447,04/04/2017,2017.0
54,Princeton (Ivy League),9,6-3,117,145,262,0.447,04/04/2017,2017.0
55,Robert Morris (NEC),10,7-3,108,139,247,0.437,04/04/2017,2017.0
56,Penn (Ivy League),8,4-4,88,118,206,0.427,04/04/2017,2017.0
57,Dartmouth (Ivy League),8,1-7,75,109,184,0.408,04/04/2017,2017.0
58,Cleveland St. (Independent),11,3-8,113,166,279,0.405,04/04/2017,2017.0
59,Stony Brook (America East),9,5-4,98,146,244,0.402,04/04/2017,2017.0
60,Cornell (Ivy League),8,2-6,91,136,227,0.401,04/04/2017,2017.0
61,Wagner (NEC),11,5-6,87,133,220,0.395,04/04/2017,2017.0
62,Siena (MAAC),10,0-10,112,180,292,0.384,04/04/2017,2017.0
63,Harvard (Ivy League),9,5-4,87,146,233,0.373,04/04/2017,2017.0
64,Mount St. Mary's (NEC),9,3-6,74,127,201,0.368,04/04/2017,2017.0
65,Hampton (DI Independent),6,1-5,50,86,136,0.368,04/04/2017,2017.0
66,Bellarmine (SoCon),9,2-7,85,150,235,0.362,04/04/2017,2017.0
67,Drexel (CAA),9,3-6,76,136,212,0.358,04/04/2017,2017.0
68,Holy Cross (Patriot),10,2-8,78,151,229,0.341,04/04/2017,2017.0
69,High Point (SoCon),10,3-7,77,157,234,0.329,04/04/2017,2017.0
-,UMass Lowell (America East),11,2-9,117,150,267,0.438,04/04/2017,2017.0
1,Denver (Big East),9,7-2,166,61,227,0.731,04/03/2017,2017.0
2,UAlbany (America East),9,8-1,183,86,269,0.680,04/03/2017,2017.0
3,Penn St. (Big Ten),10,10-0,190,95,285,0.667,04/03/2017,2017.0
4,Army West Point (Patriot),10,9-1,148,76,224,0.661,04/03/2017,2017.0
5,Navy (Patriot),11,5-6,165,88,253,0.652,04/03/2017,2017.0
6,Ohio St. (Big Ten),11,9-2,147,90,237,0.620,04/03/2017,2017.0
7,Mercer (SoCon),9,4-5,119,82,201,0.592,04/03/2017,2017.0
8,Loyola Maryland (Patriot),10,6-4,152,106,258,0.589,04/03/2017,2017.0
9,Hartford (America East),9,4-5,130,91,221,0.588,04/03/2017,2017.0
10,Yale (Ivy League),8,5-3,128,92,220,0.582,04/03/2017,2017.0
11,Richmond (SoCon),10,8-2,111,81,192,0.578,04/03/2017,2017.0
12,Brown (Ivy League),8,4-4,151,111,262,0.576,04/03/2017,2017.0
13,Towson (CAA),8,5-3,93,71,164,0.567,04/03/2017,2017.0
14,North Carolina (ACC),10,5-5,126,98,224,0.563,04/03/2017,2017.0
15,Bryant (NEC),11,6-5,133,104,237,0.561,04/03/2017,2017.0
16,Colgate (Patriot),10,3-7,135,107,242,0.558,04/03/2017,2017.0
17,Massachusetts (CAA),9,4-5,106,88,194,0.546,04/03/2017,2017.0
18,Maryland (Big Ten),8,6-2,112,93,205,0.546,04/03/2017,2017.0
19,Providence (Big East),10,7-3,114,95,209,0.545,04/03/2017,2017.0
20,Virginia (ACC),10,6-4,173,145,318,0.544,04/03/2017,2017.0
21,Duke (ACC),11,8-3,144,122,266,0.541,04/03/2017,2017.0
22,Quinnipiac (MAAC),8,2-6,112,95,207,0.541,04/03/2017,2017.0
23,Michigan (Big Ten),10,8-2,128,110,238,0.538,04/03/2017,2017.0
24,Air Force (SoCon),11,7-4,131,113,244,0.537,04/03/2017,2017.0
25,Lehigh (Patriot),9,5-4,109,95,204,0.534,04/03/2017,2017.0
26,Saint Joseph's (NEC),10,3-7,114,100,214,0.533,04/03/2017,2017.0
27,Syracuse (ACC),8,7-1,105,94,199,0.528,04/03/2017,2017.0
28,Rutgers (Big Ten),10,8-2,126,113,239,0.527,04/03/2017,2017.0
29,Marist (MAAC),10,5-5,98,88,186,0.527,04/03/2017,2017.0
30,Fairfield (CAA),10,3-7,115,105,220,0.523,04/03/2017,2017.0
31,Boston U. (Patriot),11,9-2,129,118,247,0.522,04/03/2017,2017.0
32,Binghamton (America East),9,8-1,104,96,200,0.520,04/03/2017,2017.0
33,Furman (SoCon),10,4-6,117,110,227,0.515,04/03/2017,2017.0
34,Hofstra (CAA),9,9-0,103,99,202,0.510,04/03/2017,2017.0
35,Hobart (NEC),9,4-5,122,118,240,0.508,04/03/2017,2017.0
36,St. John's (NY) (Big East),9,1-8,101,98,199,0.508,04/03/2017,2017.0
37,Detroit Mercy (MAAC),11,5-6,133,130,263,0.506,04/03/2017,2017.0
38,Jacksonville (SoCon),9,0-9,108,108,216,0.500,04/03/2017,2017.0
39,Villanova (Big East),10,6-4,143,144,287,0.498,04/03/2017,2017.0
40,Marquette (Big East),8,5-3,81,82,163,0.497,04/03/2017,2017.0
41,Vermont (America East),10,4-6,120,124,244,0.492,04/03/2017,2017.0
42,Delaware (CAA),11,7-4,131,138,269,0.487,04/03/2017,2017.0
43,Manhattan (MAAC),10,2-8,133,141,274,0.485,04/03/2017,2017.0
44,Monmouth (MAAC),9,6-3,89,95,184,0.484,04/03/2017,2017.0
45,Bucknell (Patriot),10,4-6,112,123,235,0.477,04/03/2017,2017.0
46,VMI (SoCon),9,2-7,100,112,212,0.472,04/03/2017,2017.0
47,Notre Dame (ACC),7,5-2,74,86,160,0.463,04/03/2017,2017.0
48,Lafayette (Patriot),9,1-8,101,118,219,0.461,04/03/2017,2017.0
49,Sacred Heart (NEC),9,6-3,94,110,204,0.461,04/03/2017,2017.0
50,UMBC (America East),9,4-5,85,100,185,0.459,04/03/2017,2017.0
51,Canisius (MAAC),9,4-5,107,129,236,0.453,04/03/2017,2017.0
52,Johns Hopkins (Big Ten),9,6-3,105,129,234,0.449,04/03/2017,2017.0
53,Georgetown (Big East),10,2-8,110,136,246,0.447,04/03/2017,2017.0
54,Princeton (Ivy League),9,6-3,117,145,262,0.447,04/03/2017,2017.0
55,Robert Morris (NEC),10,7-3,108,139,247,0.437,04/03/2017,2017.0
56,Penn (Ivy League),8,4-4,88,118,206,0.427,04/03/2017,2017.0
57,Cleveland St. (Independent),10,3-7,104,145,249,0.418,04/03/2017,2017.0
58,Dartmouth (Ivy League),8,1-7,75,109,184,0.408,04/03/2017,2017.0
59,Stony Brook (America East),9,5-4,98,146,244,0.402,04/03/2017,2017.0
60,Cornell (Ivy League),8,2-6,91,136,227,0.401,04/03/2017,2017.0
61,Wagner (NEC),11,5-6,87,133,220,0.395,04/03/2017,2017.0
62,Siena (MAAC),10,0-10,112,180,292,0.384,04/03/2017,2017.0
63,Harvard (Ivy League),9,5-4,87,146,233,0.373,04/03/2017,2017.0
64,Mount St. Mary's (NEC),9,3-6,74,127,201,0.368,04/03/2017,2017.0
65,Hampton (DI Independent),6,1-5,50,86,136,0.368,04/03/2017,2017.0
66,Bellarmine (SoCon),9,2-7,85,150,235,0.362,04/03/2017,2017.0
67,Drexel (CAA),9,3-6,76,136,212,0.358,04/03/2017,2017.0
68,Holy Cross (Patriot),10,2-8,78,151,229,0.341,04/03/2017,2017.0
69,High Point (SoCon),10,3-7,77,157,234,0.329,04/03/2017,2017.0
-,UMass Lowell (America East),11,2-9,117,150,267,0.438,04/03/2017,2017.0
1,Denver (Big East),9,7-2,166,61,227,0.731,04/02/2017,2017.0
2,UAlbany (America East),9,8-1,183,86,269,0.680,04/02/2017,2017.0
3,Penn St. (Big Ten),10,10-0,190,95,285,0.667,04/02/2017,2017.0
4,Army West Point (Patriot),10,9-1,148,76,224,0.661,04/02/2017,2017.0
5,Navy (Patriot),11,5-6,165,88,253,0.652,04/02/2017,2017.0
6,Ohio St. (Big Ten),11,9-2,147,90,237,0.620,04/02/2017,2017.0
7,Mercer (SoCon),9,4-5,119,82,201,0.592,04/02/2017,2017.0
8,Loyola Maryland (Patriot),10,6-4,152,106,258,0.589,04/02/2017,2017.0
9,Hartford (America East),9,4-5,130,91,221,0.588,04/02/2017,2017.0
10,Yale (Ivy League),8,5-3,128,92,220,0.582,04/02/2017,2017.0
11,Richmond (SoCon),10,8-2,111,81,192,0.578,04/02/2017,2017.0
12,Brown (Ivy League),8,4-4,151,111,262,0.576,04/02/2017,2017.0
13,Towson (CAA),8,5-3,93,71,164,0.567,04/02/2017,2017.0
14,North Carolina (ACC),10,5-5,126,98,224,0.563,04/02/2017,2017.0
15,Bryant (NEC),11,6-5,133,104,237,0.561,04/02/2017,2017.0
16,Colgate (Patriot),10,3-7,135,107,242,0.558,04/02/2017,2017.0
17,Massachusetts (CAA),9,4-5,106,88,194,0.546,04/02/2017,2017.0
18,Maryland (Big Ten),8,6-2,112,93,205,0.546,04/02/2017,2017.0
19,Providence (Big East),10,7-3,114,95,209,0.545,04/02/2017,2017.0
20,Virginia (ACC),10,6-4,173,145,318,0.544,04/02/2017,2017.0
21,Duke (ACC),11,8-3,144,122,266,0.541,04/02/2017,2017.0
22,Quinnipiac (MAAC),8,2-6,112,95,207,0.541,04/02/2017,2017.0
23,Michigan (Big Ten),10,8-2,128,110,238,0.538,04/02/2017,2017.0
24,Air Force (SoCon),11,7-4,131,113,244,0.537,04/02/2017,2017.0
25,Lehigh (Patriot),9,5-4,109,95,204,0.534,04/02/2017,2017.0
26,Saint Joseph's (NEC),10,3-7,114,100,214,0.533,04/02/2017,2017.0
27,Syracuse (ACC),8,7-1,105,94,199,0.528,04/02/2017,2017.0
28,Rutgers (Big Ten),10,8-2,126,113,239,0.527,04/02/2017,2017.0
29,Marist (MAAC),10,5-5,98,88,186,0.527,04/02/2017,2017.0
30,Fairfield (CAA),10,3-7,115,105,220,0.523,04/02/2017,2017.0
31,Boston U. (Patriot),11,9-2,129,118,247,0.522,04/02/2017,2017.0
32,Binghamton (America East),9,8-1,104,96,200,0.520,04/02/2017,2017.0
33,Furman (SoCon),10,4-6,117,110,227,0.515,04/02/2017,2017.0
34,Hofstra (CAA),9,9-0,103,99,202,0.510,04/02/2017,2017.0
35,Hobart (NEC),9,4-5,122,118,240,0.508,04/02/2017,2017.0
36,St. John's (NY) (Big East),9,1-8,101,98,199,0.508,04/02/2017,2017.0
37,Detroit Mercy (MAAC),11,5-6,133,130,263,0.506,04/02/2017,2017.0
38,Jacksonville (SoCon),9,0-9,108,108,216,0.500,04/02/2017,2017.0
39,Villanova (Big East),10,6-4,143,144,287,0.498,04/02/2017,2017.0
40,Marquette (Big East),8,5-3,81,82,163,0.497,04/02/2017,2017.0
41,Vermont (America East),10,4-6,120,124,244,0.492,04/02/2017,2017.0
42,Delaware (CAA),11,7-4,131,138,269,0.487,04/02/2017,2017.0
43,Manhattan (MAAC),10,2-8,133,141,274,0.485,04/02/2017,2017.0
44,Monmouth (MAAC),9,6-3,89,95,184,0.484,04/02/2017,2017.0
45,Bucknell (Patriot),10,4-6,112,123,235,0.477,04/02/2017,2017.0
46,VMI (SoCon),9,2-7,100,112,212,0.472,04/02/2017,2017.0
47,Notre Dame (ACC),7,5-2,74,86,160,0.463,04/02/2017,2017.0
48,Lafayette (Patriot),9,1-8,101,118,219,0.461,04/02/2017,2017.0
49,Sacred Heart (NEC),9,6-3,94,110,204,0.461,04/02/2017,2017.0
50,UMBC (America East),9,4-5,85,100,185,0.459,04/02/2017,2017.0
51,Canisius (MAAC),9,4-5,107,129,236,0.453,04/02/2017,2017.0
52,Johns Hopkins (Big Ten),9,6-3,105,129,234,0.449,04/02/2017,2017.0
53,Georgetown (Big East),10,2-8,110,136,246,0.447,04/02/2017,2017.0
54,Princeton (Ivy League),9,6-3,117,145,262,0.447,04/02/2017,2017.0
55,Robert Morris (NEC),10,7-3,108,139,247,0.437,04/02/2017,2017.0
56,Penn (Ivy League),8,4-4,88,118,206,0.427,04/02/2017,2017.0
57,Cleveland St. (Independent),10,3-7,104,145,249,0.418,04/02/2017,2017.0
58,Dartmouth (Ivy League),8,1-7,75,109,184,0.408,04/02/2017,2017.0
59,Stony Brook (America East),9,5-4,98,146,244,0.402,04/02/2017,2017.0
60,Cornell (Ivy League),8,2-6,91,136,227,0.401,04/02/2017,2017.0
61,Wagner (NEC),11,5-6,87,133,220,0.395,04/02/2017,2017.0
62,Siena (MAAC),10,0-10,112,180,292,0.384,04/02/2017,2017.0
63,Harvard (Ivy League),9,5-4,87,146,233,0.373,04/02/2017,2017.0
64,Mount St. Mary's (NEC),9,3-6,74,127,201,0.368,04/02/2017,2017.0
65,Hampton (DI Independent),6,1-5,50,86,136,0.368,04/02/2017,2017.0
66,Bellarmine (SoCon),9,2-7,85,150,235,0.362,04/02/2017,2017.0
67,Drexel (CAA),9,3-6,76,136,212,0.358,04/02/2017,2017.0
68,Holy Cross (Patriot),10,2-8,78,151,229,0.341,04/02/2017,2017.0
69,High Point (SoCon),10,3-7,77,157,234,0.329,04/02/2017,2017.0
-,UMass Lowell (America East),11,2-9,117,150,267,0.438,04/02/2017,2017.0
1,Denver (Big East),8,6-2,138,55,193,0.715,03/29/2017,2017.0
2,Penn St. (Big Ten),9,9-0,186,82,268,0.694,03/29/2017,2017.0
3,UAlbany (America East),8,7-1,157,79,236,0.665,03/29/2017,2017.0
4,Army West Point (Patriot),9,8-1,133,69,202,0.658,03/29/2017,2017.0
5,Navy (Patriot),10,4-6,149,85,234,0.637,03/29/2017,2017.0
6,Ohio St. (Big Ten),10,9-1,134,86,220,0.609,03/29/2017,2017.0
7,North Carolina (ACC),9,5-4,119,81,200,0.595,03/29/2017,2017.0
8,Loyola Maryland (Patriot),9,5-4,140,99,239,0.586,03/29/2017,2017.0
9,Yale (Ivy League),7,4-3,111,79,190,0.584,03/29/2017,2017.0
10,Mercer (SoCon),8,3-5,99,73,172,0.576,03/29/2017,2017.0
11,Brown (Ivy League),7,4-3,130,96,226,0.575,03/29/2017,2017.0
12,Hartford (America East),8,3-5,111,82,193,0.575,03/29/2017,2017.0
13,Colgate (Patriot),9,3-6,128,95,223,0.574,03/29/2017,2017.0
14,Richmond (SoCon),9,8-1,99,74,173,0.572,03/29/2017,2017.0
15,Lehigh (Patriot),8,4-4,103,82,185,0.557,03/29/2017,2017.0
16,Virginia (ACC),9,5-4,166,133,299,0.555,03/29/2017,2017.0
17,Towson (CAA),7,4-3,81,65,146,0.555,03/29/2017,2017.0
18,Michigan (Big Ten),9,8-1,117,94,211,0.555,03/29/2017,2017.0
19,Providence (Big East),9,6-3,102,82,184,0.554,03/29/2017,2017.0
20,Bryant (NEC),10,5-5,121,103,224,0.540,03/29/2017,2017.0
21,Maryland (Big Ten),7,5-2,96,82,178,0.539,03/29/2017,2017.0
22,Rutgers (Big Ten),9,8-1,117,100,217,0.539,03/29/2017,2017.0
23,Syracuse (ACC),7,6-1,94,81,175,0.537,03/29/2017,2017.0
24,Hofstra (CAA),8,8-0,97,85,182,0.533,03/29/2017,2017.0
25,Marist (MAAC),9,5-4,92,81,173,0.532,03/29/2017,2017.0
26,Saint Joseph's (NEC),9,3-6,101,89,190,0.532,03/29/2017,2017.0
27,Duke (ACC),10,7-3,127,115,242,0.525,03/29/2017,2017.0
28,Furman (SoCon),9,3-6,103,96,199,0.518,03/29/2017,2017.0
29,Massachusetts (CAA),8,3-5,91,85,176,0.517,03/29/2017,2017.0
30,Binghamton (America East),8,7-1,89,84,173,0.514,03/29/2017,2017.0
31,Vermont (America East),9,4-5,111,105,216,0.514,03/29/2017,2017.0
32,Air Force (SoCon),10,6-4,112,106,218,0.514,03/29/2017,2017.0
33,Quinnipiac (MAAC),7,1-6,95,90,185,0.514,03/29/2017,2017.0
34,Delaware (CAA),10,7-3,128,123,251,0.510,03/29/2017,2017.0
35,Boston U. (Patriot),10,9-1,116,112,228,0.509,03/29/2017,2017.0
36,Hobart (NEC),9,4-5,122,118,240,0.508,03/29/2017,2017.0
37,Manhattan (MAAC),9,2-7,128,124,252,0.508,03/29/2017,2017.0
38,St. John's (NY) (Big East),8,1-7,88,86,174,0.506,03/29/2017,2017.0
39,Fairfield (CAA),9,3-6,101,99,200,0.505,03/29/2017,2017.0
40,Villanova (Big East),9,5-4,134,132,266,0.504,03/29/2017,2017.0
41,Jacksonville (SoCon),8,0-8,94,94,188,0.500,03/29/2017,2017.0
42,Detroit Mercy (MAAC),10,4-6,120,123,243,0.494,03/29/2017,2017.0
43,Bucknell (Patriot),9,4-5,105,108,213,0.493,03/29/2017,2017.0
44,Georgetown (Big East),9,2-7,104,108,212,0.491,03/29/2017,2017.0
45,Marquette (Big East),7,5-2,69,73,142,0.486,03/29/2017,2017.0
46,Monmouth (MAAC),8,5-3,82,89,171,0.480,03/29/2017,2017.0
47,Lafayette (Patriot),8,1-7,89,103,192,0.464,03/29/2017,2017.0
48,UMBC (America East),8,3-5,77,90,167,0.461,03/29/2017,2017.0
49,Canisius (MAAC),9,4-5,107,129,236,0.453,03/29/2017,2017.0
50,Princeton (Ivy League),8,5-3,102,124,226,0.451,03/29/2017,2017.0
51,Notre Dame (ACC),6,5-1,61,75,136,0.449,03/29/2017,2017.0
52,VMI (SoCon),8,1-7,86,107,193,0.446,03/29/2017,2017.0
53,Sacred Heart (NEC),8,5-3,81,102,183,0.443,03/29/2017,2017.0
54,Robert Morris (NEC),9,6-3,97,126,223,0.435,03/29/2017,2017.0
55,Johns Hopkins (Big Ten),8,5-3,92,120,212,0.434,03/29/2017,2017.0
56,Stony Brook (America East),8,5-3,91,120,211,0.431,03/29/2017,2017.0
57,Penn (Ivy League),7,4-3,75,101,176,0.426,03/29/2017,2017.0
58,Cleveland St. (Independent),10,3-7,104,145,249,0.418,03/29/2017,2017.0
59,Dartmouth (Ivy League),7,1-6,67,94,161,0.416,03/29/2017,2017.0
60,Wagner (NEC),10,5-5,86,121,207,0.415,03/29/2017,2017.0
61,Siena (MAAC),9,0-9,105,167,272,0.386,03/29/2017,2017.0
62,Hampton (DI Independent),5,1-4,45,72,117,0.385,03/29/2017,2017.0
63,Harvard (Ivy League),9,5-4,87,146,233,0.373,03/29/2017,2017.0
64,Bellarmine (SoCon),8,2-6,78,131,209,0.373,03/29/2017,2017.0
65,Cornell (Ivy League),7,1-6,76,128,204,0.373,03/29/2017,2017.0
66,Mount St. Mary's (NEC),8,3-5,66,114,180,0.367,03/29/2017,2017.0
67,Drexel (CAA),8,3-5,70,124,194,0.361,03/29/2017,2017.0
68,Holy Cross (Patriot),9,2-7,75,135,210,0.357,03/29/2017,2017.0
69,High Point (SoCon),9,3-6,68,137,205,0.332,03/29/2017,2017.0
-,UMass Lowell (America East),10,2-8,107,142,249,0.430,03/29/2017,2017.0
1,Denver (Big East),8,6-2,138,55,193,0.715,03/28/2017,2017.0
2,Penn St. (Big Ten),9,9-0,186,82,268,0.694,03/28/2017,2017.0
3,Army West Point (Patriot),9,8-1,133,69,202,0.658,03/28/2017,2017.0
4,UAlbany (America East),7,6-1,131,73,204,0.642,03/28/2017,2017.0
5,Navy (Patriot),10,4-6,149,85,234,0.637,03/28/2017,2017.0
6,Ohio St. (Big Ten),10,9-1,134,86,220,0.609,03/28/2017,2017.0
7,North Carolina (ACC),9,5-4,119,81,200,0.595,03/28/2017,2017.0
8,Loyola Maryland (Patriot),9,5-4,140,99,239,0.586,03/28/2017,2017.0
9,Yale (Ivy League),7,4-3,111,79,190,0.584,03/28/2017,2017.0
10,Mercer (SoCon),8,3-5,99,73,172,0.576,03/28/2017,2017.0
11,Brown (Ivy League),7,4-3,130,96,226,0.575,03/28/2017,2017.0
12,Hartford (America East),8,3-5,111,82,193,0.575,03/28/2017,2017.0
13,Colgate (Patriot),9,3-6,128,95,223,0.574,03/28/2017,2017.0
14,Richmond (SoCon),9,8-1,99,74,173,0.572,03/28/2017,2017.0
15,Lehigh (Patriot),8,4-4,103,82,185,0.557,03/28/2017,2017.0
16,Virginia (ACC),9,5-4,166,133,299,0.555,03/28/2017,2017.0
17,Towson (CAA),7,4-3,81,65,146,0.555,03/28/2017,2017.0
18,Michigan (Big Ten),9,8-1,117,94,211,0.555,03/28/2017,2017.0
19,Providence (Big East),9,6-3,102,82,184,0.554,03/28/2017,2017.0
20,Bryant (NEC),10,5-5,121,103,224,0.540,03/28/2017,2017.0
21,Maryland (Big Ten),7,5-2,96,82,178,0.539,03/28/2017,2017.0
22,Rutgers (Big Ten),9,8-1,117,100,217,0.539,03/28/2017,2017.0
23,Syracuse (ACC),7,6-1,94,81,175,0.537,03/28/2017,2017.0
24,Hofstra (CAA),8,8-0,97,85,182,0.533,03/28/2017,2017.0
25,Marist (MAAC),9,5-4,92,81,173,0.532,03/28/2017,2017.0
26,Saint Joseph's (NEC),9,3-6,101,89,190,0.532,03/28/2017,2017.0
27,Duke (ACC),10,7-3,127,115,242,0.525,03/28/2017,2017.0
28,Furman (SoCon),9,3-6,103,96,199,0.518,03/28/2017,2017.0
29,Massachusetts (CAA),8,3-5,91,85,176,0.517,03/28/2017,2017.0
30,Binghamton (America East),8,7-1,89,84,173,0.514,03/28/2017,2017.0
31,Vermont (America East),9,4-5,111,105,216,0.514,03/28/2017,2017.0
32,Air Force (SoCon),10,6-4,112,106,218,0.514,03/28/2017,2017.0
33,Quinnipiac (MAAC),7,1-6,95,90,185,0.514,03/28/2017,2017.0
34,Delaware (CAA),10,7-3,128,123,251,0.510,03/28/2017,2017.0
35,Boston U. (Patriot),10,9-1,116,112,228,0.509,03/28/2017,2017.0
36,Hobart (NEC),9,4-5,122,118,240,0.508,03/28/2017,2017.0
37,Manhattan (MAAC),9,2-7,128,124,252,0.508,03/28/2017,2017.0
38,St. John's (NY) (Big East),8,1-7,88,86,174,0.506,03/28/2017,2017.0
39,Fairfield (CAA),9,3-6,101,99,200,0.505,03/28/2017,2017.0
40,Villanova (Big East),9,5-4,134,132,266,0.504,03/28/2017,2017.0
41,Jacksonville (SoCon),8,0-8,94,94,188,0.500,03/28/2017,2017.0
42,Detroit Mercy (MAAC),10,4-6,120,123,243,0.494,03/28/2017,2017.0
43,Bucknell (Patriot),9,4-5,105,108,213,0.493,03/28/2017,2017.0
44,Georgetown (Big East),9,2-7,104,108,212,0.491,03/28/2017,2017.0
45,Marquette (Big East),7,5-2,69,73,142,0.486,03/28/2017,2017.0
46,Monmouth (MAAC),8,5-3,82,89,171,0.480,03/28/2017,2017.0
47,Lafayette (Patriot),8,1-7,89,103,192,0.464,03/28/2017,2017.0
48,UMBC (America East),8,3-5,77,90,167,0.461,03/28/2017,2017.0
49,Canisius (MAAC),9,4-5,107,129,236,0.453,03/28/2017,2017.0
50,Princeton (Ivy League),8,5-3,102,124,226,0.451,03/28/2017,2017.0
51,Notre Dame (ACC),6,5-1,61,75,136,0.449,03/28/2017,2017.0
52,VMI (SoCon),8,1-7,86,107,193,0.446,03/28/2017,2017.0
53,Sacred Heart (NEC),8,5-3,81,102,183,0.443,03/28/2017,2017.0
54,Robert Morris (NEC),9,6-3,97,126,223,0.435,03/28/2017,2017.0
55,Johns Hopkins (Big Ten),8,5-3,92,120,212,0.434,03/28/2017,2017.0
56,Stony Brook (America East),8,5-3,91,120,211,0.431,03/28/2017,2017.0
57,Penn (Ivy League),7,4-3,75,101,176,0.426,03/28/2017,2017.0
58,Cleveland St. (Independent),10,3-7,104,145,249,0.418,03/28/2017,2017.0
59,Dartmouth (Ivy League),7,1-6,67,94,161,0.416,03/28/2017,2017.0
60,Wagner (NEC),10,5-5,86,121,207,0.415,03/28/2017,2017.0
61,Harvard (Ivy League),8,5-3,81,120,201,0.403,03/28/2017,2017.0
62,Siena (MAAC),9,0-9,105,167,272,0.386,03/28/2017,2017.0
63,Hampton (DI Independent),5,1-4,45,72,117,0.385,03/28/2017,2017.0
64,Bellarmine (SoCon),8,2-6,78,131,209,0.373,03/28/2017,2017.0
65,Cornell (Ivy League),7,1-6,76,128,204,0.373,03/28/2017,2017.0
66,Mount St. Mary's (NEC),8,3-5,66,114,180,0.367,03/28/2017,2017.0
67,Drexel (CAA),8,3-5,70,124,194,0.361,03/28/2017,2017.0
68,Holy Cross (Patriot),9,2-7,75,135,210,0.357,03/28/2017,2017.0
69,High Point (SoCon),9,3-6,68,137,205,0.332,03/28/2017,2017.0
-,UMass Lowell (America East),10,2-8,107,142,249,0.430,03/28/2017,2017.0
1,Denver (Big East),8,6-2,138,55,193,0.715,03/26/2017,2017.0
2,Penn St. (Big Ten),9,9-0,187,81,268,0.698,03/26/2017,2017.0
3,Army West Point (Patriot),9,8-1,133,70,203,0.655,03/26/2017,2017.0
4,UAlbany (America East),7,6-1,131,73,204,0.642,03/26/2017,2017.0
5,Navy (Patriot),10,4-6,149,85,234,0.637,03/26/2017,2017.0
6,Ohio St. (Big Ten),10,9-1,134,86,220,0.609,03/26/2017,2017.0
7,North Carolina (ACC),9,5-4,119,81,200,0.595,03/26/2017,2017.0
8,Loyola Maryland (Patriot),9,5-4,140,99,239,0.586,03/26/2017,2017.0
9,Yale (Ivy League),7,4-3,111,79,190,0.584,03/26/2017,2017.0
10,Colgate (Patriot),9,3-6,129,95,224,0.576,03/26/2017,2017.0
11,Brown (Ivy League),7,4-3,130,96,226,0.575,03/26/2017,2017.0
12,Hartford (America East),8,3-5,111,82,193,0.575,03/26/2017,2017.0
13,Richmond (SoCon),9,8-1,99,74,173,0.572,03/26/2017,2017.0
14,Mercer (SoCon),8,3-5,99,75,174,0.569,03/26/2017,2017.0
15,Lehigh (Patriot),8,4-4,103,82,185,0.557,03/26/2017,2017.0
16,Virginia (ACC),9,5-4,166,133,299,0.555,03/26/2017,2017.0
17,Towson (CAA),7,4-3,81,65,146,0.555,03/26/2017,2017.0
18,Michigan (Big Ten),9,8-1,117,94,211,0.555,03/26/2017,2017.0
19,Providence (Big East),9,6-3,102,82,184,0.554,03/26/2017,2017.0
20,Bryant (NEC),10,5-5,121,103,224,0.540,03/26/2017,2017.0
21,Maryland (Big Ten),7,5-2,96,82,178,0.539,03/26/2017,2017.0
22,Rutgers (Big Ten),9,8-1,117,100,217,0.539,03/26/2017,2017.0
23,Syracuse (ACC),7,6-1,94,81,175,0.537,03/26/2017,2017.0
24,Hofstra (CAA),8,8-0,97,85,182,0.533,03/26/2017,2017.0
25,Marist (MAAC),9,5-4,92,81,173,0.532,03/26/2017,2017.0
26,Saint Joseph's (NEC),9,3-6,101,89,190,0.532,03/26/2017,2017.0
27,Duke (ACC),10,7-3,127,115,242,0.525,03/26/2017,2017.0
28,Furman (SoCon),9,3-6,105,96,201,0.522,03/26/2017,2017.0
29,Massachusetts (CAA),8,3-5,91,85,176,0.517,03/26/2017,2017.0
30,Vermont (America East),9,4-5,111,105,216,0.514,03/26/2017,2017.0
31,Quinnipiac (MAAC),7,1-6,95,90,185,0.514,03/26/2017,2017.0
32,Air Force (SoCon),9,6-3,103,98,201,0.512,03/26/2017,2017.0
33,Delaware (CAA),10,7-3,128,123,251,0.510,03/26/2017,2017.0
34,Boston U. (Patriot),10,9-1,116,112,228,0.509,03/26/2017,2017.0
35,Hobart (NEC),9,4-5,122,118,240,0.508,03/26/2017,2017.0
36,Manhattan (MAAC),9,2-7,128,124,252,0.508,03/26/2017,2017.0
37,Binghamton (America East),7,6-1,77,75,152,0.507,03/26/2017,2017.0
38,St. John's (NY) (Big East),8,1-7,88,86,174,0.506,03/26/2017,2017.0
39,Fairfield (CAA),9,3-6,101,99,200,0.505,03/26/2017,2017.0
40,Villanova (Big East),9,5-4,134,132,266,0.504,03/26/2017,2017.0
41,Jacksonville (SoCon),8,0-8,94,94,188,0.500,03/26/2017,2017.0
42,Detroit Mercy (MAAC),10,4-6,120,123,243,0.494,03/26/2017,2017.0
43,Bucknell (Patriot),9,4-5,105,108,213,0.493,03/26/2017,2017.0
44,Georgetown (Big East),9,2-7,104,108,212,0.491,03/26/2017,2017.0
45,Marquette (Big East),6,4-2,61,64,125,0.488,03/26/2017,2017.0
46,Monmouth (MAAC),8,5-3,82,89,171,0.480,03/26/2017,2017.0
47,Lafayette (Patriot),8,1-7,89,103,192,0.464,03/26/2017,2017.0
48,UMBC (America East),8,3-5,77,90,167,0.461,03/26/2017,2017.0
49,Canisius (MAAC),8,4-4,98,117,215,0.456,03/26/2017,2017.0
50,Princeton (Ivy League),8,5-3,102,124,226,0.451,03/26/2017,2017.0
51,Notre Dame (ACC),6,5-1,61,75,136,0.449,03/26/2017,2017.0
52,Sacred Heart (NEC),8,5-3,81,102,183,0.443,03/26/2017,2017.0
53,Robert Morris (NEC),9,6-3,97,126,223,0.435,03/26/2017,2017.0
54,VMI (SoCon),7,1-6,73,95,168,0.435,03/26/2017,2017.0
55,Johns Hopkins (Big Ten),8,5-3,92,120,212,0.434,03/26/2017,2017.0
56,Stony Brook (America East),8,5-3,91,120,211,0.431,03/26/2017,2017.0
57,Penn (Ivy League),7,4-3,75,101,176,0.426,03/26/2017,2017.0
58,Dartmouth (Ivy League),7,1-6,67,94,161,0.416,03/26/2017,2017.0
59,Wagner (NEC),10,5-5,86,121,207,0.415,03/26/2017,2017.0
60,Cleveland St. (Independent),10,3-7,103,146,249,0.414,03/26/2017,2017.0
61,Harvard (Ivy League),8,5-3,81,120,201,0.403,03/26/2017,2017.0
62,Siena (MAAC),9,0-9,105,167,272,0.386,03/26/2017,2017.0
63,Hampton (DI Independent),5,1-4,45,72,117,0.385,03/26/2017,2017.0
64,Bellarmine (SoCon),8,2-6,78,131,209,0.373,03/26/2017,2017.0
65,Cornell (Ivy League),7,1-6,76,128,204,0.373,03/26/2017,2017.0
66,Drexel (CAA),8,3-5,70,124,194,0.361,03/26/2017,2017.0
67,Holy Cross (Patriot),9,2-7,75,135,210,0.357,03/26/2017,2017.0
68,Mount St. Mary's (NEC),7,2-5,54,101,155,0.348,03/26/2017,2017.0
69,High Point (SoCon),9,3-6,68,137,205,0.332,03/26/2017,2017.0
-,UMass Lowell (America East),10,2-8,107,142,249,0.430,03/26/2017,2017.0
1,Denver (Big East),7,5-2,118,48,166,0.711,03/22/2017,2017.0
2,Penn St. (Big Ten),8,8-0,167,75,242,0.690,03/22/2017,2017.0
3,Army West Point (Patriot),8,7-1,119,62,181,0.657,03/22/2017,2017.0
4,UAlbany (America East),6,5-1,106,63,169,0.627,03/22/2017,2017.0
5,Towson (CAA),6,4-2,74,45,119,0.622,03/22/2017,2017.0
6,Lehigh (Patriot),7,4-3,98,61,159,0.616,03/22/2017,2017.0
7,Navy (Patriot),9,3-6,128,80,208,0.615,03/22/2017,2017.0
8,North Carolina (ACC),8,5-3,107,69,176,0.608,03/22/2017,2017.0
9,Ohio St. (Big Ten),9,9-0,120,79,199,0.603,03/22/2017,2017.0
10,Colgate (Patriot),8,3-5,121,81,202,0.599,03/22/2017,2017.0
11,Mercer (SoCon),7,3-4,88,62,150,0.587,03/22/2017,2017.0
12,Brown (Ivy League),6,3-3,119,84,203,0.586,03/22/2017,2017.0
13,Hartford (America East),7,3-4,98,70,168,0.583,03/22/2017,2017.0
14,Loyola Maryland (Patriot),8,5-3,127,92,219,0.580,03/22/2017,2017.0
15,Virginia (ACC),8,5-3,148,112,260,0.569,03/22/2017,2017.0
16,Richmond (SoCon),8,7-1,87,67,154,0.565,03/22/2017,2017.0
17,Syracuse (ACC),6,5-1,84,65,149,0.564,03/22/2017,2017.0
18,Michigan (Big Ten),8,7-1,106,84,190,0.558,03/22/2017,2017.0
19,Rutgers (Big Ten),8,8-0,106,85,191,0.555,03/22/2017,2017.0
20,Maryland (Big Ten),6,4-2,84,70,154,0.545,03/22/2017,2017.0
21,Bryant (NEC),9,4-5,111,94,205,0.541,03/22/2017,2017.0
22,Yale (Ivy League),6,3-3,85,72,157,0.541,03/22/2017,2017.0
23,Providence (Big East),8,5-3,89,76,165,0.539,03/22/2017,2017.0
24,Saint Joseph's (NEC),8,3-5,92,79,171,0.538,03/22/2017,2017.0
25,Marist (MAAC),8,4-4,83,73,156,0.532,03/22/2017,2017.0
25,St. John's (NY) (Big East),7,1-6,83,73,156,0.532,03/22/2017,2017.0
27,Quinnipiac (MAAC),6,1-5,87,80,167,0.521,03/22/2017,2017.0
28,Vermont (America East),8,4-4,104,96,200,0.520,03/22/2017,2017.0
29,Manhattan (MAAC),8,2-6,118,109,227,0.520,03/22/2017,2017.0
30,Furman (SoCon),8,2-6,92,85,177,0.520,03/22/2017,2017.0
31,Villanova (Big East),8,4-4,122,113,235,0.519,03/22/2017,2017.0
32,Massachusetts (CAA),7,3-4,79,74,153,0.516,03/22/2017,2017.0
33,Jacksonville (SoCon),7,0-7,86,81,167,0.515,03/22/2017,2017.0
34,Duke (ACC),9,7-2,111,105,216,0.514,03/22/2017,2017.0
35,Hofstra (CAA),7,7-0,84,80,164,0.512,03/22/2017,2017.0
36,Bucknell (Patriot),8,3-5,98,95,193,0.508,03/22/2017,2017.0
37,Boston U. (Patriot),9,8-1,102,101,203,0.502,03/22/2017,2017.0
38,Delaware (CAA),9,6-3,113,112,225,0.502,03/22/2017,2017.0
39,Air Force (SoCon),8,5-3,90,90,180,0.500,03/22/2017,2017.0
39,Binghamton (America East),6,5-1,68,68,136,0.500,03/22/2017,2017.0
41,Princeton (Ivy League),7,5-2,95,98,193,0.492,03/22/2017,2017.0
42,Hobart (NEC),8,4-4,110,114,224,0.491,03/22/2017,2017.0
43,Marquette (Big East),5,3-2,49,51,100,0.490,03/22/2017,2017.0
44,Detroit Mercy (MAAC),9,3-6,110,115,225,0.489,03/22/2017,2017.0
45,Georgetown (Big East),8,2-6,91,96,187,0.487,03/22/2017,2017.0
46,Fairfield (CAA),8,3-5,82,87,169,0.485,03/22/2017,2017.0
47,Notre Dame (ACC),5,4-1,54,61,115,0.470,03/22/2017,2017.0
48,Lafayette (Patriot),7,1-6,78,89,167,0.467,03/22/2017,2017.0
49,Sacred Heart (NEC),7,4-3,77,90,167,0.461,03/22/2017,2017.0
50,UMBC (America East),7,3-4,67,79,146,0.459,03/22/2017,2017.0
51,Monmouth (MAAC),7,4-3,66,78,144,0.458,03/22/2017,2017.0
52,Canisius (MAAC),7,3-4,83,107,190,0.437,03/22/2017,2017.0
53,Cleveland St. (Independent),9,3-6,97,126,223,0.435,03/22/2017,2017.0
54,Stony Brook (America East),7,4-3,79,107,186,0.425,03/22/2017,2017.0
55,VMI (SoCon),6,1-5,60,83,143,0.420,03/22/2017,2017.0
56,Penn (Ivy League),6,3-3,64,89,153,0.418,03/22/2017,2017.0
57,Johns Hopkins (Big Ten),7,4-3,71,102,173,0.410,03/22/2017,2017.0
58,Robert Morris (NEC),8,5-3,80,118,198,0.404,03/22/2017,2017.0
59,Wagner (NEC),9,4-5,75,113,188,0.399,03/22/2017,2017.0
60,Harvard (Ivy League),7,4-3,71,107,178,0.399,03/22/2017,2017.0
61,Dartmouth (Ivy League),6,1-5,54,84,138,0.391,03/22/2017,2017.0
62,Siena (MAAC),8,0-8,94,151,245,0.384,03/22/2017,2017.0
63,Drexel (CAA),7,3-4,64,111,175,0.366,03/22/2017,2017.0
64,Bellarmine (SoCon),7,1-6,66,118,184,0.359,03/22/2017,2017.0
65,Hampton (DI Independent),4,1-3,35,63,98,0.357,03/22/2017,2017.0
66,Mount St. Mary's (NEC),6,2-4,46,84,130,0.354,03/22/2017,2017.0
67,Cornell (Ivy League),6,1-5,64,117,181,0.354,03/22/2017,2017.0
68,Holy Cross (Patriot),8,2-6,67,126,193,0.347,03/22/2017,2017.0
69,High Point (SoCon),8,3-5,61,125,186,0.328,03/22/2017,2017.0
-,UMass Lowell (America East),9,2-7,97,117,214,0.453,03/22/2017,2017.0
1,Denver (Big East),7,5-2,118,48,166,0.711,03/21/2017,2017.0
2,Penn St. (Big Ten),8,8-0,167,75,242,0.690,03/21/2017,2017.0
3,Army West Point (Patriot),8,7-1,119,62,181,0.657,03/21/2017,2017.0
4,UAlbany (America East),6,5-1,106,63,169,0.627,03/21/2017,2017.0
5,Towson (CAA),6,4-2,74,45,119,0.622,03/21/2017,2017.0
6,Lehigh (Patriot),7,4-3,98,61,159,0.616,03/21/2017,2017.0
7,Navy (Patriot),9,3-6,128,80,208,0.615,03/21/2017,2017.0
8,North Carolina (ACC),8,5-3,107,69,176,0.608,03/21/2017,2017.0
9,Ohio St. (Big Ten),9,9-0,120,79,199,0.603,03/21/2017,2017.0
10,Colgate (Patriot),8,3-5,121,81,202,0.599,03/21/2017,2017.0
11,Mercer (SoCon),7,3-4,88,62,150,0.587,03/21/2017,2017.0
12,Brown (Ivy League),6,3-3,119,84,203,0.586,03/21/2017,2017.0
13,Hartford (America East),7,3-4,98,70,168,0.583,03/21/2017,2017.0
14,Loyola Maryland (Patriot),7,4-3,113,82,195,0.579,03/21/2017,2017.0
15,Virginia (ACC),8,5-3,148,112,260,0.569,03/21/2017,2017.0
16,Richmond (SoCon),8,7-1,87,67,154,0.565,03/21/2017,2017.0
17,Syracuse (ACC),6,5-1,84,65,149,0.564,03/21/2017,2017.0
18,Michigan (Big Ten),8,7-1,106,84,190,0.558,03/21/2017,2017.0
19,Rutgers (Big Ten),8,8-0,106,85,191,0.555,03/21/2017,2017.0
20,Maryland (Big Ten),6,4-2,84,70,154,0.545,03/21/2017,2017.0
21,Bryant (NEC),9,4-5,111,94,205,0.541,03/21/2017,2017.0
22,Yale (Ivy League),6,3-3,85,72,157,0.541,03/21/2017,2017.0
23,Providence (Big East),8,5-3,89,76,165,0.539,03/21/2017,2017.0
24,Saint Joseph's (NEC),8,3-5,92,79,171,0.538,03/21/2017,2017.0
25,Marist (MAAC),8,4-4,83,73,156,0.532,03/21/2017,2017.0
25,St. John's (NY) (Big East),7,1-6,83,73,156,0.532,03/21/2017,2017.0
27,Quinnipiac (MAAC),6,1-5,87,80,167,0.521,03/21/2017,2017.0
28,Vermont (America East),8,4-4,104,96,200,0.520,03/21/2017,2017.0
29,Manhattan (MAAC),8,2-6,118,109,227,0.520,03/21/2017,2017.0
30,Furman (SoCon),8,2-6,92,85,177,0.520,03/21/2017,2017.0
31,Villanova (Big East),8,4-4,122,113,235,0.519,03/21/2017,2017.0
32,Massachusetts (CAA),7,3-4,79,74,153,0.516,03/21/2017,2017.0
33,Jacksonville (SoCon),7,0-7,86,81,167,0.515,03/21/2017,2017.0
34,Duke (ACC),9,7-2,111,105,216,0.514,03/21/2017,2017.0
35,Hofstra (CAA),7,7-0,84,80,164,0.512,03/21/2017,2017.0
36,Bucknell (Patriot),8,3-5,98,95,193,0.508,03/21/2017,2017.0
37,Boston U. (Patriot),9,8-1,102,101,203,0.502,03/21/2017,2017.0
38,Delaware (CAA),9,6-3,113,112,225,0.502,03/21/2017,2017.0
39,Air Force (SoCon),8,5-3,90,90,180,0.500,03/21/2017,2017.0
39,Binghamton (America East),6,5-1,68,68,136,0.500,03/21/2017,2017.0
41,Georgetown (Big East),7,2-5,81,82,163,0.497,03/21/2017,2017.0
42,Princeton (Ivy League),7,5-2,95,98,193,0.492,03/21/2017,2017.0
43,Hobart (NEC),8,4-4,110,114,224,0.491,03/21/2017,2017.0
44,Marquette (Big East),5,3-2,49,51,100,0.490,03/21/2017,2017.0
45,Detroit Mercy (MAAC),9,3-6,110,115,225,0.489,03/21/2017,2017.0
46,Fairfield (CAA),8,3-5,82,87,169,0.485,03/21/2017,2017.0
47,Notre Dame (ACC),5,4-1,54,61,115,0.470,03/21/2017,2017.0
48,Lafayette (Patriot),7,1-6,78,89,167,0.467,03/21/2017,2017.0
49,Sacred Heart (NEC),7,4-3,77,90,167,0.461,03/21/2017,2017.0
50,UMBC (America East),7,3-4,67,79,146,0.459,03/21/2017,2017.0
51,Monmouth (MAAC),7,4-3,66,78,144,0.458,03/21/2017,2017.0
52,Canisius (MAAC),7,3-4,83,107,190,0.437,03/21/2017,2017.0
53,Cleveland St. (Independent),9,3-6,97,126,223,0.435,03/21/2017,2017.0
54,Stony Brook (America East),7,4-3,79,107,186,0.425,03/21/2017,2017.0
55,VMI (SoCon),6,1-5,60,83,143,0.420,03/21/2017,2017.0
56,Penn (Ivy League),6,3-3,64,89,153,0.418,03/21/2017,2017.0
57,Johns Hopkins (Big Ten),7,4-3,71,102,173,0.410,03/21/2017,2017.0
58,Robert Morris (NEC),8,5-3,80,118,198,0.404,03/21/2017,2017.0
59,Wagner (NEC),9,4-5,75,113,188,0.399,03/21/2017,2017.0
60,Harvard (Ivy League),7,4-3,71,107,178,0.399,03/21/2017,2017.0
61,Dartmouth (Ivy League),6,1-5,54,84,138,0.391,03/21/2017,2017.0
62,Siena (MAAC),8,0-8,94,151,245,0.384,03/21/2017,2017.0
63,Drexel (CAA),7,3-4,64,111,175,0.366,03/21/2017,2017.0
64,Bellarmine (SoCon),7,1-6,66,118,184,0.359,03/21/2017,2017.0
65,Hampton (DI Independent),4,1-3,35,63,98,0.357,03/21/2017,2017.0
66,Mount St. Mary's (NEC),6,2-4,46,84,130,0.354,03/21/2017,2017.0
67,Cornell (Ivy League),6,1-5,64,117,181,0.354,03/21/2017,2017.0
68,Holy Cross (Patriot),8,2-6,67,126,193,0.347,03/21/2017,2017.0
69,High Point (SoCon),8,3-5,61,125,186,0.328,03/21/2017,2017.0
-,UMass Lowell (America East),9,2-7,97,117,214,0.453,03/21/2017,2017.0
1,Denver (Big East),7,5-2,118,48,166,0.711,03/19/2017,2017.0
2,Penn St. (Big Ten),8,8-0,167,75,242,0.690,03/19/2017,2017.0
3,Army West Point (Patriot),8,7-1,119,62,181,0.657,03/19/2017,2017.0
4,Towson (CAA),6,4-2,74,45,119,0.622,03/19/2017,2017.0
5,Lehigh (Patriot),7,4-3,98,61,159,0.616,03/19/2017,2017.0
6,Navy (Patriot),8,2-6,114,73,187,0.610,03/19/2017,2017.0
7,North Carolina (ACC),8,5-3,107,69,176,0.608,03/19/2017,2017.0
8,Ohio St. (Big Ten),9,9-0,120,79,199,0.603,03/19/2017,2017.0
9,UAlbany (America East),5,4-1,80,54,134,0.597,03/19/2017,2017.0
10,Mercer (SoCon),7,3-4,88,62,150,0.587,03/19/2017,2017.0
11,Loyola Maryland (Patriot),7,4-3,113,82,195,0.579,03/19/2017,2017.0
12,Colgate (Patriot),7,3-4,102,75,177,0.576,03/19/2017,2017.0
13,Hartford (America East),6,2-4,87,65,152,0.572,03/19/2017,2017.0
14,Virginia (ACC),8,5-3,148,112,260,0.569,03/19/2017,2017.0
15,Richmond (SoCon),8,7-1,87,67,154,0.565,03/19/2017,2017.0
16,Syracuse (ACC),6,5-1,84,65,149,0.564,03/19/2017,2017.0
17,Providence (Big East),7,4-3,82,64,146,0.562,03/19/2017,2017.0
18,Brown (Ivy League),5,2-3,95,75,170,0.559,03/19/2017,2017.0
19,Michigan (Big Ten),8,7-1,106,84,190,0.558,03/19/2017,2017.0
20,Marist (MAAC),7,4-3,78,62,140,0.557,03/19/2017,2017.0
21,Rutgers (Big Ten),8,8-0,106,85,191,0.555,03/19/2017,2017.0
22,Maryland (Big Ten),6,4-2,84,70,154,0.545,03/19/2017,2017.0
23,Bryant (NEC),9,4-5,111,94,205,0.541,03/19/2017,2017.0
24,Yale (Ivy League),6,3-3,85,72,157,0.541,03/19/2017,2017.0
25,Saint Joseph's (NEC),8,3-5,92,79,171,0.538,03/19/2017,2017.0
26,St. John's (NY) (Big East),7,1-6,83,73,156,0.532,03/19/2017,2017.0
27,Quinnipiac (MAAC),6,1-5,87,80,167,0.521,03/19/2017,2017.0
28,Vermont (America East),8,4-4,104,96,200,0.520,03/19/2017,2017.0
29,Manhattan (MAAC),8,2-6,118,109,227,0.520,03/19/2017,2017.0
30,Furman (SoCon),8,2-6,92,85,177,0.520,03/19/2017,2017.0
31,Villanova (Big East),7,3-4,109,102,211,0.517,03/19/2017,2017.0
32,Massachusetts (CAA),7,3-4,79,74,153,0.516,03/19/2017,2017.0
33,Jacksonville (SoCon),7,0-7,86,81,167,0.515,03/19/2017,2017.0
34,Bucknell (Patriot),7,3-4,87,82,169,0.515,03/19/2017,2017.0
35,Duke (ACC),9,7-2,111,105,216,0.514,03/19/2017,2017.0
36,Delaware (CAA),9,6-3,113,112,225,0.502,03/19/2017,2017.0
37,Air Force (SoCon),8,5-3,90,90,180,0.500,03/19/2017,2017.0
37,Binghamton (America East),6,5-1,68,68,136,0.500,03/19/2017,2017.0
39,Georgetown (Big East),7,2-5,81,82,163,0.497,03/19/2017,2017.0
40,Princeton (Ivy League),7,5-2,95,98,193,0.492,03/19/2017,2017.0
41,Hobart (NEC),8,4-4,110,114,224,0.491,03/19/2017,2017.0
42,Marquette (Big East),5,3-2,49,51,100,0.490,03/19/2017,2017.0
43,Detroit Mercy (MAAC),9,3-6,110,115,225,0.489,03/19/2017,2017.0
44,Hofstra (CAA),6,6-0,68,72,140,0.486,03/19/2017,2017.0
45,Canisius (MAAC),6,3-3,74,81,155,0.477,03/19/2017,2017.0
46,Boston U. (Patriot),8,7-1,84,94,178,0.472,03/19/2017,2017.0
47,Notre Dame (ACC),5,4-1,54,61,115,0.470,03/19/2017,2017.0
48,Lafayette (Patriot),7,1-6,78,89,167,0.467,03/19/2017,2017.0
49,Sacred Heart (NEC),7,4-3,77,90,167,0.461,03/19/2017,2017.0
50,UMBC (America East),7,3-4,67,79,146,0.459,03/19/2017,2017.0
51,Monmouth (MAAC),7,4-3,66,78,144,0.458,03/19/2017,2017.0
52,Fairfield (CAA),7,2-5,66,81,147,0.449,03/19/2017,2017.0
53,Stony Brook (America East),6,4-2,71,91,162,0.438,03/19/2017,2017.0
54,Cleveland St. (Independent),9,3-6,97,126,223,0.435,03/19/2017,2017.0
55,VMI (SoCon),6,1-5,60,83,143,0.420,03/19/2017,2017.0
56,Harvard (Ivy League),6,4-2,64,89,153,0.418,03/19/2017,2017.0
56,Penn (Ivy League),6,3-3,64,89,153,0.418,03/19/2017,2017.0
58,Johns Hopkins (Big Ten),7,4-3,71,102,173,0.410,03/19/2017,2017.0
59,Robert Morris (NEC),8,5-3,80,118,198,0.404,03/19/2017,2017.0
60,Dartmouth (Ivy League),5,1-4,47,70,117,0.402,03/19/2017,2017.0
61,Wagner (NEC),9,4-5,75,113,188,0.399,03/19/2017,2017.0
62,Siena (MAAC),8,0-8,94,151,245,0.384,03/19/2017,2017.0
63,Cornell (Ivy League),5,0-5,58,98,156,0.372,03/19/2017,2017.0
64,Drexel (CAA),7,3-4,64,111,175,0.366,03/19/2017,2017.0
65,Holy Cross (Patriot),7,2-5,58,102,160,0.363,03/19/2017,2017.0
66,Bellarmine (SoCon),7,1-6,66,118,184,0.359,03/19/2017,2017.0
67,Hampton (DI Independent),4,1-3,35,63,98,0.357,03/19/2017,2017.0
68,Mount St. Mary's (NEC),6,2-4,46,84,130,0.354,03/19/2017,2017.0
69,High Point (SoCon),8,3-5,61,125,186,0.328,03/19/2017,2017.0
-,UMass Lowell (America East),8,2-6,85,110,195,0.436,03/19/2017,2017.0
1,Denver (Big East),6,5-1,103,37,140,0.736,03/16/2017,2017.0
2,Penn St. (Big Ten),7,7-0,154,67,221,0.697,03/16/2017,2017.0
3,Army West Point (Patriot),7,6-1,109,55,164,0.665,03/16/2017,2017.0
4,Navy (Patriot),7,2-5,103,57,160,0.644,03/16/2017,2017.0
5,Hartford (America East),5,2-3,81,47,128,0.633,03/16/2017,2017.0
6,Ohio St. (Big Ten),8,8-0,109,64,173,0.630,03/16/2017,2017.0
7,Lehigh (Patriot),6,3-3,83,50,133,0.624,03/16/2017,2017.0
8,Towson (CAA),6,4-2,74,45,119,0.622,03/16/2017,2017.0
9,Richmond (SoCon),7,6-1,79,53,132,0.598,03/16/2017,2017.0
10,UAlbany (America East),4,3-1,64,43,107,0.598,03/16/2017,2017.0
11,North Carolina (ACC),7,4-3,89,60,149,0.597,03/16/2017,2017.0
12,Mercer (SoCon),6,3-3,73,53,126,0.579,03/16/2017,2017.0
13,Loyola Maryland (Patriot),6,3-3,97,71,168,0.577,03/16/2017,2017.0
14,Syracuse (ACC),5,4-1,75,56,131,0.573,03/16/2017,2017.0
15,Providence (Big East),6,4-2,69,53,122,0.566,03/16/2017,2017.0
16,Brown (Ivy League),4,1-3,83,64,147,0.565,03/16/2017,2017.0
17,Virginia (ACC),7,5-2,133,103,236,0.564,03/16/2017,2017.0
18,Marist (MAAC),6,4-2,64,50,114,0.561,03/16/2017,2017.0
19,Michigan (Big Ten),8,7-1,106,84,190,0.558,03/16/2017,2017.0
20,Colgate (Patriot),6,2-4,80,67,147,0.544,03/16/2017,2017.0
21,Villanova (Big East),6,2-4,99,83,182,0.544,03/16/2017,2017.0
22,Rutgers (Big Ten),7,7-0,93,78,171,0.544,03/16/2017,2017.0
23,Vermont (America East),7,4-3,93,80,173,0.538,03/16/2017,2017.0
24,Saint Joseph's (NEC),7,3-4,80,69,149,0.537,03/16/2017,2017.0
25,Manhattan (MAAC),7,2-5,105,93,198,0.530,03/16/2017,2017.0
26,Bryant (NEC),8,4-4,101,91,192,0.526,03/16/2017,2017.0
27,Quinnipiac (MAAC),5,1-4,77,71,148,0.520,03/16/2017,2017.0
27,Bucknell (Patriot),6,2-4,77,71,148,0.520,03/16/2017,2017.0
29,Maryland (Big Ten),5,4-1,65,60,125,0.520,03/16/2017,2017.0
30,Air Force (SoCon),7,4-3,81,75,156,0.519,03/16/2017,2017.0
31,Duke (ACC),8,6-2,99,94,193,0.513,03/16/2017,2017.0
32,St. John's (NY) (Big East),6,1-5,70,67,137,0.511,03/16/2017,2017.0
33,Yale (Ivy League),5,2-3,64,62,126,0.508,03/16/2017,2017.0
34,Delaware (CAA),8,5-3,103,100,203,0.507,03/16/2017,2017.0
35,Princeton (Ivy League),6,4-2,83,81,164,0.506,03/16/2017,2017.0
36,Furman (SoCon),7,1-6,75,74,149,0.503,03/16/2017,2017.0
37,Georgetown (Big East),6,2-4,70,70,140,0.500,03/16/2017,2017.0
38,Jacksonville (SoCon),6,0-6,72,73,145,0.497,03/16/2017,2017.0
39,Notre Dame (ACC),4,3-1,45,46,91,0.495,03/16/2017,2017.0
40,Hofstra (CAA),5,5-0,57,59,116,0.491,03/16/2017,2017.0
41,Marquette (Big East),5,3-2,49,51,100,0.490,03/16/2017,2017.0
42,Canisius (MAAC),5,2-3,62,67,129,0.481,03/16/2017,2017.0
43,Detroit Mercy (MAAC),8,2-6,94,102,196,0.480,03/16/2017,2017.0
44,Lafayette (Patriot),6,1-5,67,74,141,0.475,03/16/2017,2017.0
45,Massachusetts (CAA),6,2-4,61,68,129,0.473,03/16/2017,2017.0
46,Hobart (NEC),7,3-4,93,107,200,0.465,03/16/2017,2017.0
47,Boston U. (Patriot),7,7-0,73,84,157,0.465,03/16/2017,2017.0
48,Fairfield (CAA),6,2-4,58,68,126,0.460,03/16/2017,2017.0
49,Binghamton (America East),5,4-1,50,59,109,0.459,03/16/2017,2017.0
50,Monmouth (MAAC),6,3-3,57,68,125,0.456,03/16/2017,2017.0
51,UMBC (America East),6,2-4,53,68,121,0.438,03/16/2017,2017.0
52,Stony Brook (America East),5,4-1,60,77,137,0.438,03/16/2017,2017.0
53,Cleveland St. (Independent),9,3-6,97,126,223,0.435,03/16/2017,2017.0
54,Sacred Heart (NEC),6,4-2,61,82,143,0.427,03/16/2017,2017.0
55,Dartmouth (Ivy League),4,1-3,38,52,90,0.422,03/16/2017,2017.0
56,Wagner (NEC),8,4-4,68,96,164,0.415,03/16/2017,2017.0
57,Robert Morris (NEC),7,4-3,72,102,174,0.414,03/16/2017,2017.0
58,Harvard (Ivy League),5,4-1,53,77,130,0.408,03/16/2017,2017.0
59,Siena (MAAC),7,0-7,86,129,215,0.400,03/16/2017,2017.0
59,Johns Hopkins (Big Ten),6,4-2,62,93,155,0.400,03/16/2017,2017.0
61,VMI (SoCon),5,1-4,49,74,123,0.398,03/16/2017,2017.0
62,Cornell (Ivy League),4,0-4,48,77,125,0.384,03/16/2017,2017.0
63,Penn (Ivy League),5,3-2,47,77,124,0.379,03/16/2017,2017.0
64,Drexel (CAA),6,2-4,58,98,156,0.372,03/16/2017,2017.0
65,Mount St. Mary's (NEC),5,1-4,43,74,117,0.368,03/16/2017,2017.0
66,Hampton (DI Independent),4,1-3,35,63,98,0.357,03/16/2017,2017.0
67,Holy Cross (Patriot),6,2-4,51,92,143,0.357,03/16/2017,2017.0
68,Bellarmine (SoCon),6,1-5,55,101,156,0.353,03/16/2017,2017.0
69,High Point (SoCon),7,2-5,52,114,166,0.313,03/16/2017,2017.0
-,UMass Lowell (America East),7,2-5,76,92,168,0.452,03/16/2017,2017.0
1,Denver (Big East),6,5-1,103,37,140,0.736,03/15/2017,2017.0
2,Penn St. (Big Ten),7,7-0,154,67,221,0.697,03/15/2017,2017.0
3,Army West Point (Patriot),7,6-1,109,55,164,0.665,03/15/2017,2017.0
4,Navy (Patriot),7,2-5,103,57,160,0.644,03/15/2017,2017.0
5,Hartford (America East),5,2-3,81,47,128,0.633,03/15/2017,2017.0
6,Ohio St. (Big Ten),8,8-0,109,64,173,0.630,03/15/2017,2017.0
7,Lehigh (Patriot),6,3-3,83,50,133,0.624,03/15/2017,2017.0
8,Towson (CAA),6,4-2,74,45,119,0.622,03/15/2017,2017.0
9,Richmond (SoCon),7,6-1,79,53,132,0.598,03/15/2017,2017.0
10,UAlbany (America East),4,3-1,64,43,107,0.598,03/15/2017,2017.0
11,North Carolina (ACC),7,4-3,89,60,149,0.597,03/15/2017,2017.0
12,Mercer (SoCon),6,3-3,73,53,126,0.579,03/15/2017,2017.0
13,Loyola Maryland (Patriot),6,3-3,97,71,168,0.577,03/15/2017,2017.0
14,Syracuse (ACC),5,4-1,75,56,131,0.573,03/15/2017,2017.0
15,Providence (Big East),6,4-2,69,53,122,0.566,03/15/2017,2017.0
16,Brown (Ivy League),4,1-3,83,64,147,0.565,03/15/2017,2017.0
17,Virginia (ACC),7,5-2,133,103,236,0.564,03/15/2017,2017.0
18,Marist (MAAC),6,4-2,64,50,114,0.561,03/15/2017,2017.0
19,Michigan (Big Ten),8,7-1,106,84,190,0.558,03/15/2017,2017.0
20,Rutgers (Big Ten),7,7-0,94,78,172,0.547,03/15/2017,2017.0
21,Colgate (Patriot),6,2-4,80,67,147,0.544,03/15/2017,2017.0
22,Villanova (Big East),6,2-4,99,83,182,0.544,03/15/2017,2017.0
23,Vermont (America East),7,4-3,93,80,173,0.538,03/15/2017,2017.0
24,Saint Joseph's (NEC),7,3-4,80,69,149,0.537,03/15/2017,2017.0
25,Manhattan (MAAC),7,2-5,105,93,198,0.530,03/15/2017,2017.0
26,Bryant (NEC),8,4-4,101,91,192,0.526,03/15/2017,2017.0
27,Quinnipiac (MAAC),5,1-4,77,71,148,0.520,03/15/2017,2017.0
27,Bucknell (Patriot),6,2-4,77,71,148,0.520,03/15/2017,2017.0
29,Maryland (Big Ten),5,4-1,65,60,125,0.520,03/15/2017,2017.0
30,Air Force (SoCon),7,4-3,81,75,156,0.519,03/15/2017,2017.0
31,Duke (ACC),8,6-2,99,94,193,0.513,03/15/2017,2017.0
32,St. John's (NY) (Big East),6,1-5,70,67,137,0.511,03/15/2017,2017.0
33,Yale (Ivy League),5,2-3,64,62,126,0.508,03/15/2017,2017.0
34,Delaware (CAA),8,5-3,103,100,203,0.507,03/15/2017,2017.0
35,Furman (SoCon),7,1-6,75,74,149,0.503,03/15/2017,2017.0
36,Princeton (Ivy League),6,4-2,83,82,165,0.503,03/15/2017,2017.0
37,Georgetown (Big East),6,2-4,70,70,140,0.500,03/15/2017,2017.0
38,Jacksonville (SoCon),6,0-6,72,73,145,0.497,03/15/2017,2017.0
39,Notre Dame (ACC),4,3-1,45,46,91,0.495,03/15/2017,2017.0
40,Hofstra (CAA),5,5-0,57,59,116,0.491,03/15/2017,2017.0
41,Marquette (Big East),5,3-2,49,51,100,0.490,03/15/2017,2017.0
42,Canisius (MAAC),5,2-3,62,67,129,0.481,03/15/2017,2017.0
43,Detroit Mercy (MAAC),8,2-6,94,102,196,0.480,03/15/2017,2017.0
44,Lafayette (Patriot),6,1-5,67,74,141,0.475,03/15/2017,2017.0
45,Massachusetts (CAA),6,2-4,61,68,129,0.473,03/15/2017,2017.0
46,Hobart (NEC),7,3-4,93,107,200,0.465,03/15/2017,2017.0
47,Boston U. (Patriot),7,7-0,73,84,157,0.465,03/15/2017,2017.0
48,Fairfield (CAA),6,2-4,58,68,126,0.460,03/15/2017,2017.0
49,Binghamton (America East),5,4-1,50,59,109,0.459,03/15/2017,2017.0
50,Monmouth (MAAC),6,3-3,57,68,125,0.456,03/15/2017,2017.0
51,UMBC (America East),6,2-4,53,68,121,0.438,03/15/2017,2017.0
52,Stony Brook (America East),5,4-1,60,77,137,0.438,03/15/2017,2017.0
53,Sacred Heart (NEC),6,4-2,61,82,143,0.427,03/15/2017,2017.0
54,Dartmouth (Ivy League),4,1-3,38,52,90,0.422,03/15/2017,2017.0
55,Wagner (NEC),8,4-4,68,96,164,0.415,03/15/2017,2017.0
56,Robert Morris (NEC),7,4-3,72,102,174,0.414,03/15/2017,2017.0
57,Cleveland St. (Independent),8,2-6,79,113,192,0.411,03/15/2017,2017.0
58,Harvard (Ivy League),5,4-1,53,77,130,0.408,03/15/2017,2017.0
59,Siena (MAAC),7,0-7,86,129,215,0.400,03/15/2017,2017.0
59,Johns Hopkins (Big Ten),6,4-2,62,93,155,0.400,03/15/2017,2017.0
61,VMI (SoCon),5,1-4,49,74,123,0.398,03/15/2017,2017.0
62,Cornell (Ivy League),4,0-4,48,77,125,0.384,03/15/2017,2017.0
63,Penn (Ivy League),5,3-2,47,77,124,0.379,03/15/2017,2017.0
64,Drexel (CAA),6,2-4,58,98,156,0.372,03/15/2017,2017.0
65,Mount St. Mary's (NEC),5,1-4,43,74,117,0.368,03/15/2017,2017.0
66,Hampton (DI Independent),4,1-3,35,63,98,0.357,03/15/2017,2017.0
67,Holy Cross (Patriot),6,2-4,51,92,143,0.357,03/15/2017,2017.0
68,Bellarmine (SoCon),6,1-5,55,101,156,0.353,03/15/2017,2017.0
69,High Point (SoCon),7,2-5,52,114,166,0.313,03/15/2017,2017.0
-,UMass Lowell (America East),7,2-5,76,92,168,0.452,03/15/2017,2017.0
1,Denver (Big East),6,5-1,103,37,140,0.736,03/14/2017,2017.0
2,Penn St. (Big Ten),7,7-0,154,67,221,0.697,03/14/2017,2017.0
3,Towson (CAA),5,4-1,72,34,106,0.679,03/14/2017,2017.0
4,Army West Point (Patriot),7,6-1,109,55,164,0.665,03/14/2017,2017.0
5,Navy (Patriot),7,2-5,103,57,160,0.644,03/14/2017,2017.0
6,Hartford (America East),5,2-3,81,47,128,0.633,03/14/2017,2017.0
7,Lehigh (Patriot),6,3-3,83,50,133,0.624,03/14/2017,2017.0
8,Ohio St. (Big Ten),7,7-0,98,62,160,0.613,03/14/2017,2017.0
9,Richmond (SoCon),7,6-1,79,53,132,0.598,03/14/2017,2017.0
10,UAlbany (America East),4,3-1,64,43,107,0.598,03/14/2017,2017.0
11,North Carolina (ACC),7,4-3,89,60,149,0.597,03/14/2017,2017.0
12,Mercer (SoCon),6,3-3,73,53,126,0.579,03/14/2017,2017.0
13,Loyola Maryland (Patriot),6,3-3,97,71,168,0.577,03/14/2017,2017.0
14,Syracuse (ACC),5,4-1,75,56,131,0.573,03/14/2017,2017.0
15,Providence (Big East),6,4-2,69,53,122,0.566,03/14/2017,2017.0
16,Brown (Ivy League),4,1-3,83,64,147,0.565,03/14/2017,2017.0
17,Virginia (ACC),7,5-2,133,103,236,0.564,03/14/2017,2017.0
18,Marist (MAAC),6,4-2,64,50,114,0.561,03/14/2017,2017.0
19,Michigan (Big Ten),8,7-1,106,84,190,0.558,03/14/2017,2017.0
20,Colgate (Patriot),6,2-4,80,67,147,0.544,03/14/2017,2017.0
21,Villanova (Big East),6,2-4,99,83,182,0.544,03/14/2017,2017.0
22,Rutgers (Big Ten),6,6-0,76,65,141,0.539,03/14/2017,2017.0
23,Vermont (America East),7,4-3,93,80,173,0.538,03/14/2017,2017.0
24,Saint Joseph's (NEC),7,3-4,80,69,149,0.537,03/14/2017,2017.0
25,Manhattan (MAAC),7,2-5,105,93,198,0.530,03/14/2017,2017.0
26,Bryant (NEC),8,4-4,101,91,192,0.526,03/14/2017,2017.0
27,Princeton (Ivy League),5,4-1,70,64,134,0.522,03/14/2017,2017.0
28,Quinnipiac (MAAC),5,1-4,77,71,148,0.520,03/14/2017,2017.0
28,Bucknell (Patriot),6,2-4,77,71,148,0.520,03/14/2017,2017.0
30,Maryland (Big Ten),5,4-1,65,60,125,0.520,03/14/2017,2017.0
31,Air Force (SoCon),7,4-3,81,75,156,0.519,03/14/2017,2017.0
32,Duke (ACC),8,6-2,99,94,193,0.513,03/14/2017,2017.0
33,St. John's (NY) (Big East),6,1-5,70,67,137,0.511,03/14/2017,2017.0
34,Yale (Ivy League),5,2-3,64,62,126,0.508,03/14/2017,2017.0
35,Delaware (CAA),8,5-3,103,100,203,0.507,03/14/2017,2017.0
36,Furman (SoCon),7,1-6,75,74,149,0.503,03/14/2017,2017.0
37,Georgetown (Big East),6,2-4,70,70,140,0.500,03/14/2017,2017.0
38,Jacksonville (SoCon),6,0-6,72,73,145,0.497,03/14/2017,2017.0
39,Notre Dame (ACC),4,3-1,45,46,91,0.495,03/14/2017,2017.0
40,Hofstra (CAA),5,5-0,57,59,116,0.491,03/14/2017,2017.0
41,Marquette (Big East),5,3-2,49,51,100,0.490,03/14/2017,2017.0
42,Canisius (MAAC),5,2-3,62,67,129,0.481,03/14/2017,2017.0
43,Detroit Mercy (MAAC),8,2-6,94,102,196,0.480,03/14/2017,2017.0
44,Lafayette (Patriot),6,1-5,67,74,141,0.475,03/14/2017,2017.0
45,Hobart (NEC),7,3-4,93,107,200,0.465,03/14/2017,2017.0
46,Boston U. (Patriot),7,7-0,73,84,157,0.465,03/14/2017,2017.0
47,Fairfield (CAA),6,2-4,58,68,126,0.460,03/14/2017,2017.0
48,Binghamton (America East),5,4-1,50,59,109,0.459,03/14/2017,2017.0
49,Monmouth (MAAC),6,3-3,57,68,125,0.456,03/14/2017,2017.0
50,Massachusetts (CAA),5,1-4,49,59,108,0.454,03/14/2017,2017.0
51,UMBC (America East),6,2-4,53,68,121,0.438,03/14/2017,2017.0
52,Stony Brook (America East),5,4-1,60,77,137,0.438,03/14/2017,2017.0
53,Sacred Heart (NEC),6,4-2,61,82,143,0.427,03/14/2017,2017.0
54,Dartmouth (Ivy League),4,1-3,38,52,90,0.422,03/14/2017,2017.0
55,Wagner (NEC),8,4-4,68,96,164,0.415,03/14/2017,2017.0
56,Robert Morris (NEC),7,4-3,72,102,174,0.414,03/14/2017,2017.0
57,Cleveland St. (Independent),8,2-6,79,113,192,0.411,03/14/2017,2017.0
58,Harvard (Ivy League),5,4-1,53,77,130,0.408,03/14/2017,2017.0
59,Siena (MAAC),7,0-7,86,129,215,0.400,03/14/2017,2017.0
59,Johns Hopkins (Big Ten),6,4-2,62,93,155,0.400,03/14/2017,2017.0
61,VMI (SoCon),5,1-4,49,74,123,0.398,03/14/2017,2017.0
62,Cornell (Ivy League),4,0-4,48,77,125,0.384,03/14/2017,2017.0
63,Penn (Ivy League),5,3-2,47,77,124,0.379,03/14/2017,2017.0
64,Drexel (CAA),6,2-4,58,98,156,0.372,03/14/2017,2017.0
65,Mount St. Mary's (NEC),5,1-4,43,74,117,0.368,03/14/2017,2017.0
66,Hampton (DI Independent),4,1-3,35,63,98,0.357,03/14/2017,2017.0
67,Holy Cross (Patriot),6,2-4,51,92,143,0.357,03/14/2017,2017.0
68,Bellarmine (SoCon),6,1-5,55,101,156,0.353,03/14/2017,2017.0
69,High Point (SoCon),7,2-5,52,114,166,0.313,03/14/2017,2017.0
-,UMass Lowell (America East),6,2-4,67,80,147,0.456,03/14/2017,2017.0
1,Denver (Big East),6,5-1,103,37,140,0.736,03/13/2017,2017.0
2,Penn St. (Big Ten),7,7-0,154,67,221,0.697,03/13/2017,2017.0
3,Towson (CAA),5,4-1,72,34,106,0.679,03/13/2017,2017.0
4,Army West Point (Patriot),7,6-1,109,55,164,0.665,03/13/2017,2017.0
5,Navy (Patriot),7,2-5,103,57,160,0.644,03/13/2017,2017.0
6,Hartford (America East),5,2-3,81,47,128,0.633,03/13/2017,2017.0
7,Lehigh (Patriot),6,3-3,83,50,133,0.624,03/13/2017,2017.0
8,Ohio St. (Big Ten),7,7-0,98,62,160,0.613,03/13/2017,2017.0
9,Richmond (SoCon),7,6-1,79,53,132,0.598,03/13/2017,2017.0
10,UAlbany (America East),4,3-1,64,43,107,0.598,03/13/2017,2017.0
11,North Carolina (ACC),7,4-3,89,60,149,0.597,03/13/2017,2017.0
12,Mercer (SoCon),6,3-3,73,53,126,0.579,03/13/2017,2017.0
13,Loyola Maryland (Patriot),6,3-3,97,71,168,0.577,03/13/2017,2017.0
14,Syracuse (ACC),5,4-1,75,56,131,0.573,03/13/2017,2017.0
15,Providence (Big East),6,4-2,69,53,122,0.566,03/13/2017,2017.0
16,Brown (Ivy League),4,1-3,83,64,147,0.565,03/13/2017,2017.0
17,Virginia (ACC),7,5-2,133,103,236,0.564,03/13/2017,2017.0
18,Marist (MAAC),6,4-2,64,50,114,0.561,03/13/2017,2017.0
19,Michigan (Big Ten),8,7-1,106,84,190,0.558,03/13/2017,2017.0
20,Colgate (Patriot),6,2-4,80,67,147,0.544,03/13/2017,2017.0
21,Villanova (Big East),6,2-4,99,83,182,0.544,03/13/2017,2017.0
22,Rutgers (Big Ten),6,6-0,76,65,141,0.539,03/13/2017,2017.0
23,Vermont (America East),7,4-3,93,80,173,0.538,03/13/2017,2017.0
24,Saint Joseph's (NEC),7,3-4,80,69,149,0.537,03/13/2017,2017.0
25,Manhattan (MAAC),7,2-5,105,93,198,0.530,03/13/2017,2017.0
26,Bryant (NEC),8,4-4,101,91,192,0.526,03/13/2017,2017.0
27,Princeton (Ivy League),5,4-1,70,64,134,0.522,03/13/2017,2017.0
28,Bucknell (Patriot),6,2-4,77,71,148,0.520,03/13/2017,2017.0
28,Quinnipiac (MAAC),5,1-4,77,71,148,0.520,03/13/2017,2017.0
30,Maryland (Big Ten),5,4-1,65,60,125,0.520,03/13/2017,2017.0
31,Air Force (SoCon),7,4-3,81,75,156,0.519,03/13/2017,2017.0
32,Duke (ACC),8,6-2,99,94,193,0.513,03/13/2017,2017.0
33,St. John's (NY) (Big East),6,1-5,70,67,137,0.511,03/13/2017,2017.0
34,Yale (Ivy League),5,2-3,64,62,126,0.508,03/13/2017,2017.0
35,Delaware (CAA),8,5-3,103,100,203,0.507,03/13/2017,2017.0
36,Furman (SoCon),7,1-6,75,74,149,0.503,03/13/2017,2017.0
37,Georgetown (Big East),6,2-4,70,70,140,0.500,03/13/2017,2017.0
38,Jacksonville (SoCon),6,0-6,72,73,145,0.497,03/13/2017,2017.0
39,Notre Dame (ACC),4,3-1,45,46,91,0.495,03/13/2017,2017.0
40,Hofstra (CAA),5,5-0,57,59,116,0.491,03/13/2017,2017.0
41,Marquette (Big East),5,3-2,49,51,100,0.490,03/13/2017,2017.0
42,Detroit Mercy (MAAC),8,2-6,94,102,196,0.480,03/13/2017,2017.0
43,Lafayette (Patriot),6,1-5,67,74,141,0.475,03/13/2017,2017.0
44,Hobart (NEC),6,2-4,79,89,168,0.470,03/13/2017,2017.0
45,Boston U. (Patriot),7,7-0,73,84,157,0.465,03/13/2017,2017.0
46,Fairfield (CAA),6,2-4,58,68,126,0.460,03/13/2017,2017.0
47,Binghamton (America East),5,4-1,50,59,109,0.459,03/13/2017,2017.0
48,Monmouth (MAAC),6,3-3,57,68,125,0.456,03/13/2017,2017.0
49,Massachusetts (CAA),5,1-4,49,59,108,0.454,03/13/2017,2017.0
50,Canisius (MAAC),4,2-2,44,53,97,0.454,03/13/2017,2017.0
51,UMBC (America East),6,2-4,53,68,121,0.438,03/13/2017,2017.0
52,Stony Brook (America East),5,4-1,60,77,137,0.438,03/13/2017,2017.0
53,Sacred Heart (NEC),6,4-2,61,82,143,0.427,03/13/2017,2017.0
54,Dartmouth (Ivy League),4,1-3,38,52,90,0.422,03/13/2017,2017.0
55,Wagner (NEC),8,4-4,68,96,164,0.415,03/13/2017,2017.0
56,Robert Morris (NEC),7,4-3,72,102,174,0.414,03/13/2017,2017.0
57,Cleveland St. (Independent),8,2-6,79,113,192,0.411,03/13/2017,2017.0
58,Harvard (Ivy League),5,4-1,53,77,130,0.408,03/13/2017,2017.0
59,Siena (MAAC),7,0-7,86,129,215,0.400,03/13/2017,2017.0
59,Johns Hopkins (Big Ten),6,4-2,62,93,155,0.400,03/13/2017,2017.0
61,VMI (SoCon),5,1-4,49,74,123,0.398,03/13/2017,2017.0
62,Cornell (Ivy League),4,0-4,48,77,125,0.384,03/13/2017,2017.0
63,Penn (Ivy League),5,3-2,47,77,124,0.379,03/13/2017,2017.0
64,Drexel (CAA),6,2-4,58,98,156,0.372,03/13/2017,2017.0
65,Mount St. Mary's (NEC),5,1-4,43,74,117,0.368,03/13/2017,2017.0
66,Hampton (DI Independent),4,1-3,35,63,98,0.357,03/13/2017,2017.0
67,Holy Cross (Patriot),6,2-4,51,92,143,0.357,03/13/2017,2017.0
68,Bellarmine (SoCon),6,1-5,55,101,156,0.353,03/13/2017,2017.0
69,High Point (SoCon),7,2-5,52,114,166,0.313,03/13/2017,2017.0
-,UMass Lowell (America East),6,2-4,67,80,147,0.456,03/13/2017,2017.0
1,Denver (Big East),6,5-1,103,37,140,0.736,03/12/2017,2017.0
2,Penn St. (Big Ten),7,7-0,154,67,221,0.697,03/12/2017,2017.0
3,Towson (CAA),5,4-1,72,34,106,0.679,03/12/2017,2017.0
4,Army West Point (Patriot),6,5-1,88,48,136,0.647,03/12/2017,2017.0
5,Navy (Patriot),7,2-5,103,57,160,0.644,03/12/2017,2017.0
6,Hartford (America East),5,2-3,81,47,128,0.633,03/12/2017,2017.0
7,Lehigh (Patriot),6,3-3,83,50,133,0.624,03/12/2017,2017.0
8,North Carolina (ACC),6,4-2,83,51,134,0.619,03/12/2017,2017.0
9,Ohio St. (Big Ten),7,7-0,98,62,160,0.613,03/12/2017,2017.0
10,Richmond (SoCon),6,5-1,70,47,117,0.598,03/12/2017,2017.0
11,UAlbany (America East),4,3-1,64,43,107,0.598,03/12/2017,2017.0
12,Mercer (SoCon),6,3-3,73,53,126,0.579,03/12/2017,2017.0
13,Loyola Maryland (Patriot),6,3-3,97,71,168,0.577,03/12/2017,2017.0
14,Syracuse (ACC),5,4-1,75,56,131,0.573,03/12/2017,2017.0
15,Providence (Big East),6,4-2,69,53,122,0.566,03/12/2017,2017.0
16,Brown (Ivy League),4,1-3,83,64,147,0.565,03/12/2017,2017.0
17,Virginia (ACC),7,5-2,133,103,236,0.564,03/12/2017,2017.0
18,Marist (MAAC),6,4-2,64,50,114,0.561,03/12/2017,2017.0
19,Michigan (Big Ten),8,7-1,106,84,190,0.558,03/12/2017,2017.0
20,Villanova (Big East),6,2-4,99,83,182,0.544,03/12/2017,2017.0
21,Rutgers (Big Ten),6,6-0,76,65,141,0.539,03/12/2017,2017.0
22,Vermont (America East),7,4-3,93,80,173,0.538,03/12/2017,2017.0
23,Saint Joseph's (NEC),7,3-4,80,69,149,0.537,03/12/2017,2017.0
24,Manhattan (MAAC),7,2-5,105,93,198,0.530,03/12/2017,2017.0
25,Duke (ACC),7,5-2,90,80,170,0.529,03/12/2017,2017.0
26,Princeton (Ivy League),5,4-1,70,64,134,0.522,03/12/2017,2017.0
27,Bucknell (Patriot),6,2-4,77,71,148,0.520,03/12/2017,2017.0
27,Quinnipiac (MAAC),5,1-4,77,71,148,0.520,03/12/2017,2017.0
29,Maryland (Big Ten),5,4-1,65,60,125,0.520,03/12/2017,2017.0
30,Air Force (SoCon),7,4-3,81,75,156,0.519,03/12/2017,2017.0
31,Colgate (Patriot),5,2-3,61,57,118,0.517,03/12/2017,2017.0
32,St. John's (NY) (Big East),6,1-5,70,67,137,0.511,03/12/2017,2017.0
33,Yale (Ivy League),5,2-3,64,62,126,0.508,03/12/2017,2017.0
34,Delaware (CAA),8,5-3,103,100,203,0.507,03/12/2017,2017.0
35,Furman (SoCon),7,1-6,75,74,149,0.503,03/12/2017,2017.0
36,Georgetown (Big East),6,2-4,70,70,140,0.500,03/12/2017,2017.0
37,Notre Dame (ACC),4,3-1,45,46,91,0.495,03/12/2017,2017.0
38,Boston U. (Patriot),6,6-0,63,65,128,0.492,03/12/2017,2017.0
39,Hofstra (CAA),5,5-0,57,59,116,0.491,03/12/2017,2017.0
40,Marquette (Big East),5,3-2,49,51,100,0.490,03/12/2017,2017.0
41,Bryant (NEC),7,3-4,76,82,158,0.481,03/12/2017,2017.0
42,Detroit Mercy (MAAC),8,2-6,94,102,196,0.480,03/12/2017,2017.0
43,Jacksonville (SoCon),5,0-5,58,64,122,0.475,03/12/2017,2017.0
44,Lafayette (Patriot),6,1-5,67,74,141,0.475,03/12/2017,2017.0
45,Hobart (NEC),6,2-4,79,89,168,0.470,03/12/2017,2017.0
46,Fairfield (CAA),6,2-4,58,68,126,0.460,03/12/2017,2017.0
47,Binghamton (America East),5,4-1,50,59,109,0.459,03/12/2017,2017.0
48,Monmouth (MAAC),6,3-3,57,68,125,0.456,03/12/2017,2017.0
49,Massachusetts (CAA),5,1-4,49,59,108,0.454,03/12/2017,2017.0
50,Canisius (MAAC),4,2-2,44,53,97,0.454,03/12/2017,2017.0
51,UMBC (America East),6,2-4,53,68,121,0.438,03/12/2017,2017.0
52,Stony Brook (America East),5,4-1,60,77,137,0.438,03/12/2017,2017.0
53,Sacred Heart (NEC),6,4-2,61,82,143,0.427,03/12/2017,2017.0
54,Siena (MAAC),6,0-6,77,104,181,0.425,03/12/2017,2017.0
55,Dartmouth (Ivy League),4,1-3,38,52,90,0.422,03/12/2017,2017.0
56,Wagner (NEC),8,4-4,68,96,164,0.415,03/12/2017,2017.0
57,Robert Morris (NEC),7,4-3,72,102,174,0.414,03/12/2017,2017.0
58,Cleveland St. (Independent),8,2-6,79,113,192,0.411,03/12/2017,2017.0
59,Harvard (Ivy League),5,4-1,53,77,130,0.408,03/12/2017,2017.0
60,Johns Hopkins (Big Ten),6,4-2,62,93,155,0.400,03/12/2017,2017.0
61,VMI (SoCon),5,1-4,49,74,123,0.398,03/12/2017,2017.0
62,Cornell (Ivy League),4,0-4,48,77,125,0.384,03/12/2017,2017.0
63,Penn (Ivy League),5,3-2,47,77,124,0.379,03/12/2017,2017.0
64,Drexel (CAA),6,2-4,58,98,156,0.372,03/12/2017,2017.0
65,Mount St. Mary's (NEC),5,1-4,43,74,117,0.368,03/12/2017,2017.0
66,Hampton (DI Independent),4,1-3,35,63,98,0.357,03/12/2017,2017.0
67,Holy Cross (Patriot),6,2-4,51,92,143,0.357,03/12/2017,2017.0
68,Bellarmine (SoCon),6,1-5,55,101,156,0.353,03/12/2017,2017.0
69,High Point (SoCon),7,2-5,52,114,166,0.313,03/12/2017,2017.0
-,UMass Lowell (America East),6,2-4,67,80,147,0.456,03/12/2017,2017.0
1,Denver (Big East),5,4-1,84,32,116,0.724,03/08/2017,2017.0
2,Towson (CAA),4,3-1,56,25,81,0.691,03/08/2017,2017.0
3,Penn St. (Big Ten),6,6-0,131,59,190,0.689,03/08/2017,2017.0
4,Lehigh (Patriot),5,3-2,79,40,119,0.664,03/08/2017,2017.0
5,Navy (Patriot),6,2-4,90,49,139,0.647,03/08/2017,2017.0
6,Army West Point (Patriot),5,4-1,78,44,122,0.639,03/08/2017,2017.0
7,Ohio St. (Big Ten),6,6-0,90,52,142,0.634,03/08/2017,2017.0
8,Hartford (America East),4,1-3,64,40,104,0.615,03/08/2017,2017.0
9,North Carolina (ACC),5,4-1,68,43,111,0.613,03/08/2017,2017.0
10,UAlbany (America East),4,3-1,64,43,107,0.598,03/08/2017,2017.0
11,Notre Dame (ACC),3,3-0,40,27,67,0.597,03/08/2017,2017.0
12,Michigan (Big Ten),7,6-1,94,67,161,0.584,03/08/2017,2017.0
13,Virginia (ACC),6,4-2,114,83,197,0.579,03/08/2017,2017.0
14,Loyola Maryland (Patriot),5,3-2,82,60,142,0.577,03/08/2017,2017.0
15,Mercer (SoCon),4,1-3,52,40,92,0.565,03/08/2017,2017.0
16,Brown (Ivy League),4,1-3,83,64,147,0.565,03/08/2017,2017.0
17,Quinnipiac (MAAC),4,1-3,70,54,124,0.565,03/08/2017,2017.0
18,Richmond (SoCon),5,4-1,52,41,93,0.559,03/08/2017,2017.0
19,Syracuse (ACC),4,3-1,62,49,111,0.559,03/08/2017,2017.0
20,Marist (MAAC),5,4-1,56,45,101,0.554,03/08/2017,2017.0
21,Duke (ACC),6,4-2,79,65,144,0.549,03/08/2017,2017.0
22,Villanova (Big East),6,2-4,99,83,182,0.544,03/08/2017,2017.0
23,St. John's (NY) (Big East),5,1-4,63,54,117,0.538,03/08/2017,2017.0
24,Manhattan (MAAC),6,2-4,94,81,175,0.537,03/08/2017,2017.0
25,Hofstra (CAA),4,4-0,49,44,93,0.527,03/08/2017,2017.0
26,Fairfield (CAA),5,2-3,53,48,101,0.525,03/08/2017,2017.0
27,Princeton (Ivy League),5,4-1,70,64,134,0.522,03/08/2017,2017.0
28,Georgetown (Big East),5,1-4,60,55,115,0.522,03/08/2017,2017.0
29,Maryland (Big Ten),5,4-1,65,60,125,0.520,03/08/2017,2017.0
30,Colgate (Patriot),5,2-3,61,57,118,0.517,03/08/2017,2017.0
31,Providence (Big East),5,3-2,48,45,93,0.516,03/08/2017,2017.0
32,Air Force (SoCon),6,3-3,67,64,131,0.511,03/08/2017,2017.0
33,Furman (SoCon),7,1-6,75,74,149,0.503,03/08/2017,2017.0
34,Vermont (America East),6,3-3,75,75,150,0.500,03/08/2017,2017.0
34,Rutgers (Big Ten),5,5-0,58,58,116,0.500,03/08/2017,2017.0
34,Monmouth (MAAC),5,3-2,55,55,110,0.500,03/08/2017,2017.0
37,Boston U. (Patriot),6,6-0,63,65,128,0.492,03/08/2017,2017.0
38,Lafayette (Patriot),5,0-5,59,61,120,0.492,03/08/2017,2017.0
39,Delaware (CAA),7,5-2,87,91,178,0.489,03/08/2017,2017.0
40,Bucknell (Patriot),5,2-3,62,65,127,0.488,03/08/2017,2017.0
41,Binghamton (America East),4,3-1,41,43,84,0.488,03/08/2017,2017.0
42,Detroit Mercy (MAAC),7,2-5,83,88,171,0.485,03/08/2017,2017.0
43,Saint Joseph's (NEC),5,2-3,54,58,112,0.482,03/08/2017,2017.0
44,Jacksonville (SoCon),5,0-5,58,64,122,0.475,03/08/2017,2017.0
45,Stony Brook (America East),4,4-0,53,59,112,0.473,03/08/2017,2017.0
46,Sacred Heart (NEC),5,4-1,56,64,120,0.467,03/08/2017,2017.0
46,Marquette (Big East),4,2-2,35,40,75,0.467,03/08/2017,2017.0
48,Harvard (Ivy League),4,4-0,45,54,99,0.455,03/08/2017,2017.0
49,Massachusetts (CAA),5,1-4,49,59,108,0.454,03/08/2017,2017.0
50,Canisius (MAAC),4,2-2,44,53,97,0.454,03/08/2017,2017.0
51,Bryant (NEC),6,3-3,64,78,142,0.451,03/08/2017,2017.0
52,Hobart (NEC),5,2-3,64,79,143,0.448,03/08/2017,2017.0
53,UMBC (America East),5,1-4,48,60,108,0.444,03/08/2017,2017.0
54,Yale (Ivy League),4,1-3,44,57,101,0.436,03/08/2017,2017.0
55,VMI (SoCon),4,1-3,43,56,99,0.434,03/08/2017,2017.0
56,Siena (MAAC),6,0-6,77,104,181,0.425,03/08/2017,2017.0
57,Dartmouth (Ivy League),4,1-3,38,52,90,0.422,03/08/2017,2017.0
58,Robert Morris (NEC),6,4-2,61,88,149,0.409,03/08/2017,2017.0
59,Johns Hopkins (Big Ten),5,4-1,53,77,130,0.408,03/08/2017,2017.0
60,Wagner (NEC),6,3-3,54,80,134,0.403,03/08/2017,2017.0
61,Cleveland St. (Independent),7,2-5,69,105,174,0.397,03/08/2017,2017.0
62,Drexel (CAA),4,0-4,45,73,118,0.381,03/08/2017,2017.0
63,Holy Cross (Patriot),5,1-4,45,77,122,0.369,03/08/2017,2017.0
64,Hampton (DI Independent),3,1-2,29,53,82,0.354,03/08/2017,2017.0
65,Bellarmine (SoCon),5,1-4,45,85,130,0.346,03/08/2017,2017.0
66,Cornell (Ivy League),3,0-3,28,58,86,0.326,03/08/2017,2017.0
67,High Point (SoCon),6,2-4,44,93,137,0.321,03/08/2017,2017.0
68,Penn (Ivy League),4,3-1,30,65,95,0.316,03/08/2017,2017.0
69,Mount St. Mary's (NEC),4,0-4,27,64,91,0.297,03/08/2017,2017.0
-,UMass Lowell (America East),5,1-4,55,69,124,0.444,03/08/2017,2017.0
1,Denver (Big East),5,4-1,84,32,116,0.724,03/07/2017,2017.0
2,Towson (CAA),4,3-1,56,25,81,0.691,03/07/2017,2017.0
3,Penn St. (Big Ten),6,6-0,131,59,190,0.689,03/07/2017,2017.0
4,Lehigh (Patriot),5,3-2,79,40,119,0.664,03/07/2017,2017.0
5,Navy (Patriot),6,2-4,90,49,139,0.647,03/07/2017,2017.0
6,Army West Point (Patriot),5,4-1,78,44,122,0.639,03/07/2017,2017.0
7,Ohio St. (Big Ten),6,6-0,90,52,142,0.634,03/07/2017,2017.0
8,Hartford (America East),4,1-3,64,40,104,0.615,03/07/2017,2017.0
9,North Carolina (ACC),5,4-1,68,43,111,0.613,03/07/2017,2017.0
10,UAlbany (America East),4,3-1,64,43,107,0.598,03/07/2017,2017.0
11,Notre Dame (ACC),3,3-0,40,27,67,0.597,03/07/2017,2017.0
12,Michigan (Big Ten),7,6-1,94,67,161,0.584,03/07/2017,2017.0
13,Virginia (ACC),6,4-2,114,83,197,0.579,03/07/2017,2017.0
14,Loyola Maryland (Patriot),5,3-2,82,60,142,0.577,03/07/2017,2017.0
15,Mercer (SoCon),4,1-3,52,40,92,0.565,03/07/2017,2017.0
16,Brown (Ivy League),4,1-3,83,64,147,0.565,03/07/2017,2017.0
17,Quinnipiac (MAAC),4,1-3,70,54,124,0.565,03/07/2017,2017.0
18,Richmond (SoCon),5,4-1,52,41,93,0.559,03/07/2017,2017.0
19,Syracuse (ACC),4,3-1,62,49,111,0.559,03/07/2017,2017.0
20,Marist (MAAC),5,4-1,56,45,101,0.554,03/07/2017,2017.0
21,Duke (ACC),6,4-2,79,65,144,0.549,03/07/2017,2017.0
22,Villanova (Big East),6,2-4,99,83,182,0.544,03/07/2017,2017.0
23,St. John's (NY) (Big East),5,1-4,63,54,117,0.538,03/07/2017,2017.0
24,Manhattan (MAAC),6,2-4,94,81,175,0.537,03/07/2017,2017.0
25,Hofstra (CAA),4,4-0,49,44,93,0.527,03/07/2017,2017.0
26,Fairfield (CAA),5,2-3,53,48,101,0.525,03/07/2017,2017.0
27,Princeton (Ivy League),5,4-1,70,64,134,0.522,03/07/2017,2017.0
28,Georgetown (Big East),5,1-4,60,55,115,0.522,03/07/2017,2017.0
29,Maryland (Big Ten),5,4-1,65,60,125,0.520,03/07/2017,2017.0
30,Providence (Big East),5,3-2,48,45,93,0.516,03/07/2017,2017.0
31,Colgate (Patriot),4,1-3,49,46,95,0.516,03/07/2017,2017.0
32,Air Force (SoCon),6,3-3,67,64,131,0.511,03/07/2017,2017.0
33,Furman (SoCon),7,1-6,75,74,149,0.503,03/07/2017,2017.0
34,Vermont (America East),6,3-3,75,75,150,0.500,03/07/2017,2017.0
34,Rutgers (Big Ten),5,5-0,58,58,116,0.500,03/07/2017,2017.0
34,Monmouth (MAAC),5,3-2,55,55,110,0.500,03/07/2017,2017.0
37,Boston U. (Patriot),6,6-0,63,65,128,0.492,03/07/2017,2017.0
38,Lafayette (Patriot),5,0-5,59,61,120,0.492,03/07/2017,2017.0
39,Delaware (CAA),7,5-2,87,91,178,0.489,03/07/2017,2017.0
40,Bucknell (Patriot),5,2-3,62,65,127,0.488,03/07/2017,2017.0
41,Binghamton (America East),4,3-1,41,43,84,0.488,03/07/2017,2017.0
42,Detroit Mercy (MAAC),7,2-5,83,88,171,0.485,03/07/2017,2017.0
43,Saint Joseph's (NEC),5,2-3,54,58,112,0.482,03/07/2017,2017.0
44,Jacksonville (SoCon),5,0-5,58,64,122,0.475,03/07/2017,2017.0
45,Stony Brook (America East),4,4-0,53,59,112,0.473,03/07/2017,2017.0
46,Sacred Heart (NEC),5,4-1,56,64,120,0.467,03/07/2017,2017.0
46,Marquette (Big East),4,2-2,35,40,75,0.467,03/07/2017,2017.0
48,Harvard (Ivy League),4,4-0,45,54,99,0.455,03/07/2017,2017.0
49,Massachusetts (CAA),5,1-4,49,59,108,0.454,03/07/2017,2017.0
50,Canisius (MAAC),4,2-2,44,53,97,0.454,03/07/2017,2017.0
51,Bryant (NEC),6,3-3,64,78,142,0.451,03/07/2017,2017.0
52,UMBC (America East),5,1-4,48,60,108,0.444,03/07/2017,2017.0
53,Hobart (NEC),4,2-2,53,67,120,0.442,03/07/2017,2017.0
54,Yale (Ivy League),4,1-3,44,57,101,0.436,03/07/2017,2017.0
55,VMI (SoCon),4,1-3,43,56,99,0.434,03/07/2017,2017.0
56,Siena (MAAC),6,0-6,77,104,181,0.425,03/07/2017,2017.0
57,Dartmouth (Ivy League),4,1-3,38,52,90,0.422,03/07/2017,2017.0
58,Robert Morris (NEC),6,4-2,61,88,149,0.409,03/07/2017,2017.0
59,Johns Hopkins (Big Ten),5,4-1,53,77,130,0.408,03/07/2017,2017.0
60,Wagner (NEC),6,3-3,54,80,134,0.403,03/07/2017,2017.0
61,Cleveland St. (Independent),7,2-5,69,105,174,0.397,03/07/2017,2017.0
62,Drexel (CAA),4,0-4,45,73,118,0.381,03/07/2017,2017.0
63,Holy Cross (Patriot),5,1-4,45,77,122,0.369,03/07/2017,2017.0
64,Hampton (DI Independent),3,1-2,29,53,82,0.354,03/07/2017,2017.0
65,Bellarmine (SoCon),5,1-4,45,85,130,0.346,03/07/2017,2017.0
66,Cornell (Ivy League),3,0-3,28,58,86,0.326,03/07/2017,2017.0
67,High Point (SoCon),6,2-4,44,93,137,0.321,03/07/2017,2017.0
68,Penn (Ivy League),4,3-1,30,65,95,0.316,03/07/2017,2017.0
69,Mount St. Mary's (NEC),4,0-4,27,64,91,0.297,03/07/2017,2017.0
-,UMass Lowell (America East),5,1-4,55,69,124,0.444,03/07/2017,2017.0
1,Denver (Big East),5,4-1,84,32,116,0.724,03/05/2017,2017.0
2,Towson (CAA),4,3-1,56,25,81,0.691,03/05/2017,2017.0
3,Penn St. (Big Ten),5,5-0,114,51,165,0.691,03/05/2017,2017.0
4,Lehigh (Patriot),5,3-2,79,40,119,0.664,03/05/2017,2017.0
5,Army West Point (Patriot),5,4-1,78,44,122,0.639,03/05/2017,2017.0
6,Ohio St. (Big Ten),6,6-0,90,52,142,0.634,03/05/2017,2017.0
7,Navy (Patriot),5,2-3,72,44,116,0.621,03/05/2017,2017.0
8,Hartford (America East),4,1-3,64,40,104,0.615,03/05/2017,2017.0
9,North Carolina (ACC),5,4-1,68,43,111,0.613,03/05/2017,2017.0
10,UAlbany (America East),4,3-1,64,43,107,0.598,03/05/2017,2017.0
11,Notre Dame (ACC),3,3-0,40,27,67,0.597,03/05/2017,2017.0
12,Michigan (Big Ten),7,6-1,94,67,161,0.584,03/05/2017,2017.0
13,Virginia (ACC),6,4-2,114,83,197,0.579,03/05/2017,2017.0
14,Loyola Maryland (Patriot),5,3-2,82,60,142,0.577,03/05/2017,2017.0
15,Brown (Ivy League),3,1-2,64,47,111,0.577,03/05/2017,2017.0
16,Quinnipiac (MAAC),3,1-2,52,39,91,0.571,03/05/2017,2017.0
17,Mercer (SoCon),4,1-3,52,40,92,0.565,03/05/2017,2017.0
18,Villanova (Big East),5,1-4,82,64,146,0.562,03/05/2017,2017.0
19,Richmond (SoCon),5,4-1,52,41,93,0.559,03/05/2017,2017.0
20,Syracuse (ACC),4,3-1,62,49,111,0.559,03/05/2017,2017.0
21,Marist (MAAC),5,4-1,56,45,101,0.554,03/05/2017,2017.0
22,Duke (ACC),6,4-2,79,65,144,0.549,03/05/2017,2017.0
23,Princeton (Ivy League),4,3-1,55,46,101,0.545,03/05/2017,2017.0
24,Furman (SoCon),6,1-5,67,57,124,0.540,03/05/2017,2017.0
25,St. John's (NY) (Big East),5,1-4,63,54,117,0.538,03/05/2017,2017.0
26,Manhattan (MAAC),5,2-3,80,70,150,0.533,03/05/2017,2017.0
27,Hofstra (CAA),4,4-0,49,44,93,0.527,03/05/2017,2017.0
28,Fairfield (CAA),5,2-3,53,48,101,0.525,03/05/2017,2017.0
29,Maryland (Big Ten),5,4-1,65,60,125,0.520,03/05/2017,2017.0
30,Providence (Big East),5,3-2,48,45,93,0.516,03/05/2017,2017.0
31,Colgate (Patriot),4,1-3,49,46,95,0.516,03/05/2017,2017.0
32,Air Force (SoCon),6,3-3,67,64,131,0.511,03/05/2017,2017.0
33,Vermont (America East),6,3-3,75,75,150,0.500,03/05/2017,2017.0
33,Rutgers (Big Ten),5,5-0,58,58,116,0.500,03/05/2017,2017.0
33,Monmouth (MAAC),5,3-2,55,55,110,0.500,03/05/2017,2017.0
36,Delaware (CAA),6,4-2,76,77,153,0.497,03/05/2017,2017.0
37,Binghamton (America East),3,2-1,32,33,65,0.492,03/05/2017,2017.0
38,Boston U. (Patriot),6,6-0,63,65,128,0.492,03/05/2017,2017.0
39,Lafayette (Patriot),5,0-5,59,61,120,0.492,03/05/2017,2017.0
40,Bucknell (Patriot),5,2-3,62,65,127,0.488,03/05/2017,2017.0
41,Detroit Mercy (MAAC),7,2-5,83,88,171,0.485,03/05/2017,2017.0
42,Saint Joseph's (NEC),5,2-3,54,58,112,0.482,03/05/2017,2017.0
43,Georgetown (Big East),4,0-4,44,48,92,0.478,03/05/2017,2017.0
44,Jacksonville (SoCon),5,0-5,58,64,122,0.475,03/05/2017,2017.0
45,Stony Brook (America East),4,4-0,53,59,112,0.473,03/05/2017,2017.0
46,Sacred Heart (NEC),5,4-1,56,64,120,0.467,03/05/2017,2017.0
46,Marquette (Big East),4,2-2,35,40,75,0.467,03/05/2017,2017.0
48,Harvard (Ivy League),4,4-0,45,54,99,0.455,03/05/2017,2017.0
49,Canisius (MAAC),4,2-2,44,53,97,0.454,03/05/2017,2017.0
50,Bryant (NEC),6,3-3,64,78,142,0.451,03/05/2017,2017.0
51,UMBC (America East),5,1-4,48,60,108,0.444,03/05/2017,2017.0
52,Hobart (NEC),4,2-2,53,67,120,0.442,03/05/2017,2017.0
53,Yale (Ivy League),3,1-2,34,43,77,0.442,03/05/2017,2017.0
54,Robert Morris (NEC),5,4-1,54,72,126,0.429,03/05/2017,2017.0
55,Dartmouth (Ivy League),4,1-3,38,52,90,0.422,03/05/2017,2017.0
56,Massachusetts (CAA),4,0-4,35,49,84,0.417,03/05/2017,2017.0
57,VMI (SoCon),3,1-2,32,45,77,0.416,03/05/2017,2017.0
58,Siena (MAAC),5,0-5,67,95,162,0.414,03/05/2017,2017.0
59,Johns Hopkins (Big Ten),5,4-1,53,77,130,0.408,03/05/2017,2017.0
60,Cleveland St. (Independent),7,2-5,69,105,174,0.397,03/05/2017,2017.0
61,Wagner (NEC),5,2-3,43,69,112,0.384,03/05/2017,2017.0
62,Drexel (CAA),4,0-4,45,73,118,0.381,03/05/2017,2017.0
63,Holy Cross (Patriot),5,1-4,45,77,122,0.369,03/05/2017,2017.0
64,Hampton (DI Independent),3,1-2,29,53,82,0.354,03/05/2017,2017.0
65,Penn (Ivy League),3,2-1,25,47,72,0.347,03/05/2017,2017.0
66,Bellarmine (SoCon),5,1-4,45,85,130,0.346,03/05/2017,2017.0
67,Cornell (Ivy League),3,0-3,28,58,86,0.326,03/05/2017,2017.0
68,High Point (SoCon),6,2-4,44,93,137,0.321,03/05/2017,2017.0
69,Mount St. Mary's (NEC),4,0-4,27,64,91,0.297,03/05/2017,2017.0
-,UMass Lowell (America East),5,1-4,55,69,124,0.444,03/05/2017,2017.0
1,Denver (Big East),4,4-0,70,22,92,0.761,03/02/2017,2017.0
2,Towson (CAA),3,2-1,47,18,65,0.723,03/02/2017,2017.0
3,Penn St. (Big Ten),4,4-0,90,44,134,0.672,03/02/2017,2017.0
4,North Carolina (ACC),4,3-1,58,29,87,0.667,03/02/2017,2017.0
5,Navy (Patriot),4,1-3,60,32,92,0.652,03/02/2017,2017.0
6,Army West Point (Patriot),4,3-1,64,36,100,0.640,03/02/2017,2017.0
7,Lehigh (Patriot),4,2-2,63,36,99,0.636,03/02/2017,2017.0
8,Hartford (America East),3,0-3,51,31,82,0.622,03/02/2017,2017.0
9,Hofstra (CAA),3,3-0,42,27,69,0.609,03/02/2017,2017.0
10,Richmond (SoCon),4,4-0,44,29,73,0.603,03/02/2017,2017.0
11,Brown (Ivy League),2,1-1,50,33,83,0.602,03/02/2017,2017.0
12,Syracuse (ACC),3,2-1,48,32,80,0.600,03/02/2017,2017.0
12,Colgate (Patriot),3,1-2,45,30,75,0.600,03/02/2017,2017.0
14,Michigan (Big Ten),6,5-1,87,60,147,0.592,03/02/2017,2017.0
15,Virginia (ACC),5,4-1,97,69,166,0.584,03/02/2017,2017.0
16,UAlbany (America East),3,2-1,47,34,81,0.580,03/02/2017,2017.0
17,Notre Dame (ACC),2,2-0,31,23,54,0.574,03/02/2017,2017.0
18,Ohio St. (Big Ten),4,4-0,52,40,92,0.565,03/02/2017,2017.0
19,Manhattan (MAAC),4,2-2,69,54,123,0.561,03/02/2017,2017.0
20,Furman (SoCon),5,1-4,61,49,110,0.555,03/02/2017,2017.0
21,Mercer (SoCon),4,1-3,51,41,92,0.554,03/02/2017,2017.0
22,Villanova (Big East),4,1-3,65,54,119,0.546,03/02/2017,2017.0
23,Maryland (Big Ten),4,4-0,61,51,112,0.545,03/02/2017,2017.0
24,Loyola Maryland (Patriot),4,2-2,62,52,114,0.544,03/02/2017,2017.0
25,Marist (MAAC),4,3-1,44,37,81,0.543,03/02/2017,2017.0
26,Marquette (Big East),2,1-1,19,16,35,0.543,03/02/2017,2017.0
27,Fairfield (CAA),4,2-2,45,38,83,0.542,03/02/2017,2017.0
28,Duke (ACC),5,3-2,67,57,124,0.540,03/02/2017,2017.0
29,St. John's (NY) (Big East),4,0-4,48,41,89,0.539,03/02/2017,2017.0
30,Providence (Big East),4,3-1,38,33,71,0.535,03/02/2017,2017.0
31,Delaware (CAA),5,3-2,66,60,126,0.524,03/02/2017,2017.0
32,Princeton (Ivy League),3,2-1,38,35,73,0.521,03/02/2017,2017.0
33,Lafayette (Patriot),4,0-4,51,47,98,0.520,03/02/2017,2017.0
34,Boston U. (Patriot),5,5-0,56,54,110,0.509,03/02/2017,2017.0
35,Rutgers (Big Ten),4,4-0,44,44,88,0.500,03/02/2017,2017.0
36,Air Force (SoCon),5,3-2,56,57,113,0.496,03/02/2017,2017.0
37,Monmouth (MAAC),4,2-2,46,47,93,0.495,03/02/2017,2017.0
38,Jacksonville (SoCon),4,0-4,49,51,100,0.490,03/02/2017,2017.0
39,Harvard (Ivy League),3,3-0,35,37,72,0.486,03/02/2017,2017.0
40,Bucknell (Patriot),4,2-2,50,53,103,0.485,03/02/2017,2017.0
41,Quinnipiac (MAAC),2,0-2,33,36,69,0.478,03/02/2017,2017.0
42,Vermont (America East),5,3-2,58,65,123,0.472,03/02/2017,2017.0
43,Yale (Ivy League),2,1-1,27,31,58,0.466,03/02/2017,2017.0
44,Hobart (NEC),3,2-1,45,53,98,0.459,03/02/2017,2017.0
45,Stony Brook (America East),3,3-0,43,51,94,0.457,03/02/2017,2017.0
46,Detroit Mercy (MAAC),5,1-4,57,69,126,0.452,03/02/2017,2017.0
47,Sacred Heart (NEC),4,3-1,44,54,98,0.449,03/02/2017,2017.0
48,Saint Joseph's (NEC),4,1-3,38,47,85,0.447,03/02/2017,2017.0
49,UMBC (America East),4,1-3,41,51,92,0.446,03/02/2017,2017.0
50,Penn (Ivy League),2,2-0,18,23,41,0.439,03/02/2017,2017.0
51,Bryant (NEC),5,2-3,52,71,123,0.423,03/02/2017,2017.0
52,Binghamton (America East),2,1-1,18,25,43,0.419,03/02/2017,2017.0
53,Massachusetts (CAA),4,0-4,35,49,84,0.417,03/02/2017,2017.0
54,VMI (SoCon),3,1-2,32,45,77,0.416,03/02/2017,2017.0
55,Johns Hopkins (Big Ten),4,4-0,42,60,102,0.412,03/02/2017,2017.0
56,Canisius (MAAC),3,1-2,28,41,69,0.406,03/02/2017,2017.0
57,Dartmouth (Ivy League),3,1-2,30,44,74,0.405,03/02/2017,2017.0
58,Siena (MAAC),4,0-4,54,80,134,0.403,03/02/2017,2017.0
59,Robert Morris (NEC),4,3-1,43,64,107,0.402,03/02/2017,2017.0
60,Bellarmine (SoCon),3,1-2,30,45,75,0.400,03/02/2017,2017.0
61,Georgetown (Big East),3,0-3,27,41,68,0.397,03/02/2017,2017.0
62,Holy Cross (Patriot),4,1-3,37,57,94,0.394,03/02/2017,2017.0
63,Cleveland St. (Independent),6,2-4,57,89,146,0.390,03/02/2017,2017.0
64,Drexel (CAA),3,0-3,37,61,98,0.378,03/02/2017,2017.0
65,Wagner (NEC),4,1-3,35,61,96,0.365,03/02/2017,2017.0
66,Hampton (DI Independent),2,0-2,21,45,66,0.318,03/02/2017,2017.0
67,Cornell (Ivy League),2,0-2,19,41,60,0.317,03/02/2017,2017.0
68,High Point (SoCon),5,2-3,36,82,118,0.305,03/02/2017,2017.0
69,Mount St. Mary's (NEC),4,0-4,27,64,91,0.297,03/02/2017,2017.0
-,UMass Lowell (America East),4,1-3,47,60,107,0.439,03/02/2017,2017.0
1,Denver (Big East),4,4-0,70,22,92,0.761,03/01/2017,2017.0
2,Towson (CAA),3,2-1,47,18,65,0.723,03/01/2017,2017.0
3,Penn St. (Big Ten),4,4-0,90,44,134,0.672,03/01/2017,2017.0
4,North Carolina (ACC),4,3-1,58,29,87,0.667,03/01/2017,2017.0
5,Navy (Patriot),4,1-3,60,32,92,0.652,03/01/2017,2017.0
6,Army West Point (Patriot),4,3-1,64,36,100,0.640,03/01/2017,2017.0
7,Lehigh (Patriot),4,2-2,63,36,99,0.636,03/01/2017,2017.0
8,Hartford (America East),3,0-3,51,31,82,0.622,03/01/2017,2017.0
9,Hofstra (CAA),3,3-0,42,27,69,0.609,03/01/2017,2017.0
10,Richmond (SoCon),4,4-0,44,29,73,0.603,03/01/2017,2017.0
11,Brown (Ivy League),2,1-1,50,33,83,0.602,03/01/2017,2017.0
12,Syracuse (ACC),3,2-1,48,32,80,0.600,03/01/2017,2017.0
12,Colgate (Patriot),3,1-2,45,30,75,0.600,03/01/2017,2017.0
14,Mercer (SoCon),3,1-2,43,29,72,0.597,03/01/2017,2017.0
15,Michigan (Big Ten),5,4-1,75,52,127,0.591,03/01/2017,2017.0
16,Virginia (ACC),5,4-1,97,69,166,0.584,03/01/2017,2017.0
17,UAlbany (America East),3,2-1,47,34,81,0.580,03/01/2017,2017.0
18,Notre Dame (ACC),2,2-0,31,23,54,0.574,03/01/2017,2017.0
19,Ohio St. (Big Ten),4,4-0,52,40,92,0.565,03/01/2017,2017.0
20,Manhattan (MAAC),4,2-2,69,54,123,0.561,03/01/2017,2017.0
21,Furman (SoCon),5,1-4,61,49,110,0.555,03/01/2017,2017.0
22,Villanova (Big East),4,1-3,65,54,119,0.546,03/01/2017,2017.0
23,Maryland (Big Ten),4,4-0,61,51,112,0.545,03/01/2017,2017.0
24,Loyola Maryland (Patriot),4,2-2,62,52,114,0.544,03/01/2017,2017.0
25,Marist (MAAC),4,3-1,44,37,81,0.543,03/01/2017,2017.0
26,Marquette (Big East),2,1-1,19,16,35,0.543,03/01/2017,2017.0
27,Fairfield (CAA),4,2-2,45,38,83,0.542,03/01/2017,2017.0
28,Duke (ACC),5,3-2,67,57,124,0.540,03/01/2017,2017.0
29,St. John's (NY) (Big East),4,0-4,48,41,89,0.539,03/01/2017,2017.0
30,Providence (Big East),4,3-1,38,33,71,0.535,03/01/2017,2017.0
31,Delaware (CAA),5,3-2,66,60,126,0.524,03/01/2017,2017.0
32,Princeton (Ivy League),3,2-1,38,35,73,0.521,03/01/2017,2017.0
33,Lafayette (Patriot),4,0-4,51,47,98,0.520,03/01/2017,2017.0
34,Boston U. (Patriot),5,5-0,56,54,110,0.509,03/01/2017,2017.0
35,Rutgers (Big Ten),4,4-0,44,44,88,0.500,03/01/2017,2017.0
36,Air Force (SoCon),5,3-2,56,57,113,0.496,03/01/2017,2017.0
37,Monmouth (MAAC),4,2-2,46,47,93,0.495,03/01/2017,2017.0
38,Jacksonville (SoCon),4,0-4,49,51,100,0.490,03/01/2017,2017.0
39,Harvard (Ivy League),3,3-0,35,37,72,0.486,03/01/2017,2017.0
40,Bucknell (Patriot),4,2-2,50,53,103,0.485,03/01/2017,2017.0
41,Quinnipiac (MAAC),2,0-2,33,36,69,0.478,03/01/2017,2017.0
42,Vermont (America East),5,3-2,58,65,123,0.472,03/01/2017,2017.0
43,Yale (Ivy League),2,1-1,27,31,58,0.466,03/01/2017,2017.0
44,Hobart (NEC),3,2-1,45,53,98,0.459,03/01/2017,2017.0
45,Stony Brook (America East),3,3-0,43,51,94,0.457,03/01/2017,2017.0
46,Detroit Mercy (MAAC),5,1-4,57,69,126,0.452,03/01/2017,2017.0
47,Sacred Heart (NEC),4,3-1,44,54,98,0.449,03/01/2017,2017.0
48,Saint Joseph's (NEC),4,1-3,38,47,85,0.447,03/01/2017,2017.0
49,UMBC (America East),4,1-3,41,51,92,0.446,03/01/2017,2017.0
50,Penn (Ivy League),2,2-0,18,23,41,0.439,03/01/2017,2017.0
51,Bryant (NEC),5,2-3,52,71,123,0.423,03/01/2017,2017.0
52,Binghamton (America East),2,1-1,18,25,43,0.419,03/01/2017,2017.0
53,Massachusetts (CAA),4,0-4,35,49,84,0.417,03/01/2017,2017.0
54,VMI (SoCon),3,1-2,32,45,77,0.416,03/01/2017,2017.0
55,Johns Hopkins (Big Ten),4,4-0,42,60,102,0.412,03/01/2017,2017.0
56,Canisius (MAAC),3,1-2,28,41,69,0.406,03/01/2017,2017.0
57,Dartmouth (Ivy League),3,1-2,30,44,74,0.405,03/01/2017,2017.0
58,Siena (MAAC),4,0-4,54,80,134,0.403,03/01/2017,2017.0
59,Robert Morris (NEC),4,3-1,43,64,107,0.402,03/01/2017,2017.0
60,Bellarmine (SoCon),3,1-2,30,45,75,0.400,03/01/2017,2017.0
61,Georgetown (Big East),3,0-3,27,41,68,0.397,03/01/2017,2017.0
62,Holy Cross (Patriot),4,1-3,37,57,94,0.394,03/01/2017,2017.0
63,Cleveland St. (Independent),6,2-4,57,89,146,0.390,03/01/2017,2017.0
64,Drexel (CAA),3,0-3,37,61,98,0.378,03/01/2017,2017.0
65,Wagner (NEC),4,1-3,35,61,96,0.365,03/01/2017,2017.0
66,Hampton (DI Independent),2,0-2,21,45,66,0.318,03/01/2017,2017.0
67,Cornell (Ivy League),2,0-2,19,41,60,0.317,03/01/2017,2017.0
68,High Point (SoCon),5,2-3,36,82,118,0.305,03/01/2017,2017.0
69,Mount St. Mary's (NEC),4,0-4,27,64,91,0.297,03/01/2017,2017.0
-,UMass Lowell (America East),4,1-3,47,60,107,0.439,03/01/2017,2017.0
1,Towson (CAA),2,2-0,34,9,43,0.791,02/28/2017,2017.0
2,Denver (Big East),4,4-0,70,22,92,0.761,02/28/2017,2017.0
3,Penn St. (Big Ten),4,4-0,90,44,134,0.672,02/28/2017,2017.0
4,North Carolina (ACC),4,3-1,58,29,87,0.667,02/28/2017,2017.0
5,Navy (Patriot),4,1-3,60,32,92,0.652,02/28/2017,2017.0
6,Army West Point (Patriot),4,3-1,64,36,100,0.640,02/28/2017,2017.0
7,Lehigh (Patriot),4,2-2,63,36,99,0.636,02/28/2017,2017.0
8,Hartford (America East),3,0-3,51,31,82,0.622,02/28/2017,2017.0
9,Hofstra (CAA),3,3-0,42,27,69,0.609,02/28/2017,2017.0
10,Richmond (SoCon),4,4-0,44,29,73,0.603,02/28/2017,2017.0
11,Brown (Ivy League),2,1-1,50,33,83,0.602,02/28/2017,2017.0
12,Syracuse (ACC),3,2-1,48,32,80,0.600,02/28/2017,2017.0
12,Colgate (Patriot),3,1-2,45,30,75,0.600,02/28/2017,2017.0
14,Mercer (SoCon),3,1-2,43,29,72,0.597,02/28/2017,2017.0
15,Michigan (Big Ten),5,4-1,75,52,127,0.591,02/28/2017,2017.0
16,St. John's (NY) (Big East),3,0-3,42,30,72,0.583,02/28/2017,2017.0
17,Loyola Maryland (Patriot),3,1-2,53,39,92,0.576,02/28/2017,2017.0
18,Notre Dame (ACC),2,2-0,31,23,54,0.574,02/28/2017,2017.0
19,Ohio St. (Big Ten),4,4-0,52,40,92,0.565,02/28/2017,2017.0
20,Manhattan (MAAC),4,2-2,69,54,123,0.561,02/28/2017,2017.0
21,Furman (SoCon),5,1-4,61,49,110,0.555,02/28/2017,2017.0
22,Villanova (Big East),4,1-3,65,54,119,0.546,02/28/2017,2017.0
23,Maryland (Big Ten),4,4-0,61,51,112,0.545,02/28/2017,2017.0
24,Marist (MAAC),4,3-1,44,37,81,0.543,02/28/2017,2017.0
25,Marquette (Big East),2,1-1,19,16,35,0.543,02/28/2017,2017.0
26,Fairfield (CAA),4,2-2,45,38,83,0.542,02/28/2017,2017.0
27,Virginia (ACC),4,3-1,72,61,133,0.541,02/28/2017,2017.0
28,Duke (ACC),5,3-2,67,57,124,0.540,02/28/2017,2017.0
29,Providence (Big East),4,3-1,38,33,71,0.535,02/28/2017,2017.0
30,Delaware (CAA),5,3-2,66,60,126,0.524,02/28/2017,2017.0
31,Princeton (Ivy League),3,2-1,38,35,73,0.521,02/28/2017,2017.0
32,Lafayette (Patriot),4,0-4,51,47,98,0.520,02/28/2017,2017.0
33,UAlbany (America East),2,1-1,27,25,52,0.519,02/28/2017,2017.0
34,Boston U. (Patriot),5,5-0,56,54,110,0.509,02/28/2017,2017.0
35,Rutgers (Big Ten),4,4-0,44,44,88,0.500,02/28/2017,2017.0
36,Air Force (SoCon),5,3-2,56,57,113,0.496,02/28/2017,2017.0
37,Monmouth (MAAC),4,2-2,46,47,93,0.495,02/28/2017,2017.0
38,Jacksonville (SoCon),4,0-4,49,51,100,0.490,02/28/2017,2017.0
39,Harvard (Ivy League),3,3-0,35,37,72,0.486,02/28/2017,2017.0
40,Bucknell (Patriot),4,2-2,50,53,103,0.485,02/28/2017,2017.0
41,Quinnipiac (MAAC),2,0-2,33,36,69,0.478,02/28/2017,2017.0
42,Massachusetts (CAA),3,0-3,26,29,55,0.473,02/28/2017,2017.0
43,Vermont (America East),5,3-2,58,65,123,0.472,02/28/2017,2017.0
44,Yale (Ivy League),2,1-1,27,31,58,0.466,02/28/2017,2017.0
45,Hobart (NEC),3,2-1,45,53,98,0.459,02/28/2017,2017.0
46,Stony Brook (America East),3,3-0,43,51,94,0.457,02/28/2017,2017.0
47,Detroit Mercy (MAAC),5,1-4,57,69,126,0.452,02/28/2017,2017.0
48,Sacred Heart (NEC),4,3-1,44,54,98,0.449,02/28/2017,2017.0
49,UMBC (America East),4,1-3,41,51,92,0.446,02/28/2017,2017.0
50,Penn (Ivy League),2,2-0,18,23,41,0.439,02/28/2017,2017.0
51,Bryant (NEC),5,2-3,52,71,123,0.423,02/28/2017,2017.0
52,Binghamton (America East),2,1-1,18,25,43,0.419,02/28/2017,2017.0
53,VMI (SoCon),3,1-2,32,45,77,0.416,02/28/2017,2017.0
54,Johns Hopkins (Big Ten),4,4-0,42,60,102,0.412,02/28/2017,2017.0
55,Canisius (MAAC),3,1-2,28,41,69,0.406,02/28/2017,2017.0
56,Dartmouth (Ivy League),3,1-2,30,44,74,0.405,02/28/2017,2017.0
57,Siena (MAAC),4,0-4,54,80,134,0.403,02/28/2017,2017.0
58,Robert Morris (NEC),4,3-1,43,64,107,0.402,02/28/2017,2017.0
59,Bellarmine (SoCon),3,1-2,30,45,75,0.400,02/28/2017,2017.0
60,Georgetown (Big East),3,0-3,27,41,68,0.397,02/28/2017,2017.0
60,Saint Joseph's (NEC),3,0-3,27,41,68,0.397,02/28/2017,2017.0
62,Holy Cross (Patriot),4,1-3,37,57,94,0.394,02/28/2017,2017.0
63,Cleveland St. (Independent),6,2-4,57,89,146,0.390,02/28/2017,2017.0
64,Drexel (CAA),3,0-3,37,61,98,0.378,02/28/2017,2017.0
65,Wagner (NEC),4,1-3,35,61,96,0.365,02/28/2017,2017.0
66,High Point (SoCon),4,2-2,28,57,85,0.329,02/28/2017,2017.0
67,Hampton (DI Independent),2,0-2,21,45,66,0.318,02/28/2017,2017.0
68,Cornell (Ivy League),2,0-2,19,41,60,0.317,02/28/2017,2017.0
69,Mount St. Mary's (NEC),4,0-4,27,64,91,0.297,02/28/2017,2017.0
-,UMass Lowell (America East),4,1-3,47,60,107,0.439,02/28/2017,2017.0
1,Towson (CAA),2,2-0,34,9,43,0.791,02/26/2017,2017.0
2,Denver (Big East),4,4-0,70,22,92,0.761,02/26/2017,2017.0
3,Penn St. (Big Ten),4,4-0,90,44,134,0.672,02/26/2017,2017.0
4,North Carolina (ACC),4,3-1,58,29,87,0.667,02/26/2017,2017.0
5,Navy (Patriot),4,1-3,60,32,92,0.652,02/26/2017,2017.0
6,Army West Point (Patriot),4,3-1,64,36,100,0.640,02/26/2017,2017.0
7,Lehigh (Patriot),4,2-2,63,36,99,0.636,02/26/2017,2017.0
8,Manhattan (MAAC),3,1-2,58,35,93,0.624,02/26/2017,2017.0
9,Hartford (America East),2,0-2,32,20,52,0.615,02/26/2017,2017.0
10,Richmond (SoCon),4,4-0,44,29,73,0.603,02/26/2017,2017.0
11,Brown (Ivy League),2,1-1,50,33,83,0.602,02/26/2017,2017.0
12,Syracuse (ACC),3,2-1,48,32,80,0.600,02/26/2017,2017.0
12,Colgate (Patriot),3,1-2,45,30,75,0.600,02/26/2017,2017.0
14,Mercer (SoCon),3,1-2,43,29,72,0.597,02/26/2017,2017.0
15,Michigan (Big Ten),5,4-1,75,52,127,0.591,02/26/2017,2017.0
16,St. John's (NY) (Big East),3,0-3,42,30,72,0.583,02/26/2017,2017.0
17,Loyola Maryland (Patriot),3,1-2,53,39,92,0.576,02/26/2017,2017.0
18,Notre Dame (ACC),2,2-0,31,23,54,0.574,02/26/2017,2017.0
19,Ohio St. (Big Ten),4,4-0,52,40,92,0.565,02/26/2017,2017.0
20,Furman (SoCon),5,1-4,61,49,110,0.555,02/26/2017,2017.0
21,Villanova (Big East),3,0-3,48,40,88,0.545,02/26/2017,2017.0
22,Maryland (Big Ten),4,4-0,61,51,112,0.545,02/26/2017,2017.0
23,Marist (MAAC),4,3-1,44,37,81,0.543,02/26/2017,2017.0
24,Marquette (Big East),2,1-1,19,16,35,0.543,02/26/2017,2017.0
25,Virginia (ACC),4,3-1,72,61,133,0.541,02/26/2017,2017.0
26,Duke (ACC),5,3-2,67,57,124,0.540,02/26/2017,2017.0
27,Providence (Big East),4,3-1,38,33,71,0.535,02/26/2017,2017.0
28,Boston U. (Patriot),4,4-0,45,40,85,0.529,02/26/2017,2017.0
29,Princeton (Ivy League),3,2-1,38,35,73,0.521,02/26/2017,2017.0
30,UAlbany (America East),2,1-1,27,25,52,0.519,02/26/2017,2017.0
31,Delaware (CAA),4,2-2,50,49,99,0.505,02/26/2017,2017.0
32,Air Force (SoCon),5,3-2,56,57,113,0.496,02/26/2017,2017.0
33,Monmouth (MAAC),4,2-2,46,47,93,0.495,02/26/2017,2017.0
34,Lafayette (Patriot),3,0-3,36,37,73,0.493,02/26/2017,2017.0
35,Jacksonville (SoCon),4,0-4,49,51,100,0.490,02/26/2017,2017.0
36,Harvard (Ivy League),3,3-0,35,37,72,0.486,02/26/2017,2017.0
37,Bucknell (Patriot),4,2-2,50,53,103,0.485,02/26/2017,2017.0
38,Fairfield (CAA),3,1-2,31,33,64,0.484,02/26/2017,2017.0
39,Quinnipiac (MAAC),2,0-2,33,36,69,0.478,02/26/2017,2017.0
40,Massachusetts (CAA),3,0-3,26,29,55,0.473,02/26/2017,2017.0
41,Sacred Heart (NEC),3,2-1,34,39,73,0.466,02/26/2017,2017.0
42,Yale (Ivy League),2,1-1,27,31,58,0.466,02/26/2017,2017.0
43,Hobart (NEC),3,2-1,45,53,98,0.459,02/26/2017,2017.0
44,Stony Brook (America East),3,3-0,43,51,94,0.457,02/26/2017,2017.0
45,Detroit Mercy (MAAC),5,1-4,57,69,126,0.452,02/26/2017,2017.0
45,Hofstra (CAA),2,2-0,19,23,42,0.452,02/26/2017,2017.0
47,Rutgers (Big Ten),3,3-0,30,37,67,0.448,02/26/2017,2017.0
48,UMBC (America East),4,1-3,41,51,92,0.446,02/26/2017,2017.0
49,Dartmouth (Ivy League),2,0-2,22,28,50,0.440,02/26/2017,2017.0
50,Penn (Ivy League),2,2-0,18,23,41,0.439,02/26/2017,2017.0
51,Vermont (America East),4,3-1,42,57,99,0.424,02/26/2017,2017.0
52,VMI (SoCon),2,1-1,21,29,50,0.420,02/26/2017,2017.0
53,Binghamton (America East),2,1-1,18,25,43,0.419,02/26/2017,2017.0
54,Johns Hopkins (Big Ten),4,4-0,42,60,102,0.412,02/26/2017,2017.0
55,Canisius (MAAC),3,1-2,28,41,69,0.406,02/26/2017,2017.0
56,Siena (MAAC),4,0-4,54,80,134,0.403,02/26/2017,2017.0
57,Robert Morris (NEC),4,3-1,43,64,107,0.402,02/26/2017,2017.0
58,Bellarmine (SoCon),3,1-2,30,45,75,0.400,02/26/2017,2017.0
59,Saint Joseph's (NEC),3,0-3,27,41,68,0.397,02/26/2017,2017.0
59,Georgetown (Big East),3,0-3,27,41,68,0.397,02/26/2017,2017.0
61,Holy Cross (Patriot),4,1-3,37,57,94,0.394,02/26/2017,2017.0
62,Cleveland St. (Independent),6,2-4,57,89,146,0.390,02/26/2017,2017.0
63,Bryant (NEC),4,2-2,38,60,98,0.388,02/26/2017,2017.0
64,Wagner (NEC),3,1-2,28,47,75,0.373,02/26/2017,2017.0
65,Drexel (CAA),2,0-2,23,44,67,0.343,02/26/2017,2017.0
66,High Point (SoCon),4,2-2,28,57,85,0.329,02/26/2017,2017.0
67,Hampton (DI Independent),2,0-2,21,45,66,0.318,02/26/2017,2017.0
68,Cornell (Ivy League),2,0-2,19,41,60,0.317,02/26/2017,2017.0
69,Mount St. Mary's (NEC),4,0-4,27,64,91,0.297,02/26/2017,2017.0
-,UMass Lowell (America East),3,1-2,42,46,88,0.477,02/26/2017,2017.0
1,Towson (CAA),2,2-0,34,9,43,0.791,02/25/2017,2017.0
2,Denver (Big East),3,3-0,58,19,77,0.753,02/25/2017,2017.0
3,Penn St. (Big Ten),4,4-0,90,44,134,0.672,02/25/2017,2017.0
4,North Carolina (ACC),4,3-1,58,29,87,0.667,02/25/2017,2017.0
5,Navy (Patriot),4,1-3,60,32,92,0.652,02/25/2017,2017.0
6,Army West Point (Patriot),4,3-1,64,36,100,0.640,02/25/2017,2017.0
7,Lehigh (Patriot),4,2-2,63,36,99,0.636,02/25/2017,2017.0
8,Michigan (Big Ten),4,4-0,64,38,102,0.627,02/25/2017,2017.0
9,Manhattan (MAAC),3,1-2,58,35,93,0.624,02/25/2017,2017.0
10,Hartford (America East),2,0-2,32,20,52,0.615,02/25/2017,2017.0
11,Richmond (SoCon),4,4-0,44,29,73,0.603,02/25/2017,2017.0
12,Brown (Ivy League),2,1-1,50,33,83,0.602,02/25/2017,2017.0
13,Syracuse (ACC),3,2-1,48,32,80,0.600,02/25/2017,2017.0
13,Colgate (Patriot),3,1-2,45,30,75,0.600,02/25/2017,2017.0
15,Mercer (SoCon),3,1-2,43,29,72,0.597,02/25/2017,2017.0
16,Notre Dame (ACC),1,1-0,17,12,29,0.586,02/25/2017,2017.0
17,St. John's (NY) (Big East),3,0-3,42,30,72,0.583,02/25/2017,2017.0
18,Loyola Maryland (Patriot),3,1-2,53,39,92,0.576,02/25/2017,2017.0
19,Ohio St. (Big Ten),4,4-0,52,40,92,0.565,02/25/2017,2017.0
20,Villanova (Big East),3,0-3,48,40,88,0.545,02/25/2017,2017.0
21,Maryland (Big Ten),4,4-0,61,51,112,0.545,02/25/2017,2017.0
22,Marist (MAAC),4,3-1,44,37,81,0.543,02/25/2017,2017.0
23,Marquette (Big East),2,1-1,19,16,35,0.543,02/25/2017,2017.0
24,Virginia (ACC),4,3-1,72,61,133,0.541,02/25/2017,2017.0
25,Duke (ACC),5,3-2,67,57,124,0.540,02/25/2017,2017.0
26,Providence (Big East),4,3-1,38,33,71,0.535,02/25/2017,2017.0
27,Boston U. (Patriot),4,4-0,45,40,85,0.529,02/25/2017,2017.0
28,Princeton (Ivy League),3,2-1,38,35,73,0.521,02/25/2017,2017.0
29,UAlbany (America East),2,1-1,27,25,52,0.519,02/25/2017,2017.0
30,Furman (SoCon),4,0-4,44,41,85,0.518,02/25/2017,2017.0
31,Delaware (CAA),4,2-2,50,49,99,0.505,02/25/2017,2017.0
32,Monmouth (MAAC),4,2-2,46,47,93,0.495,02/25/2017,2017.0
33,Lafayette (Patriot),3,0-3,36,37,73,0.493,02/25/2017,2017.0
34,Jacksonville (SoCon),4,0-4,49,51,100,0.490,02/25/2017,2017.0
35,Harvard (Ivy League),3,3-0,35,37,72,0.486,02/25/2017,2017.0
36,Bucknell (Patriot),4,2-2,50,53,103,0.485,02/25/2017,2017.0
37,Fairfield (CAA),3,1-2,31,33,64,0.484,02/25/2017,2017.0
38,Quinnipiac (MAAC),2,0-2,33,36,69,0.478,02/25/2017,2017.0
39,Massachusetts (CAA),3,0-3,26,29,55,0.473,02/25/2017,2017.0
40,Sacred Heart (NEC),3,2-1,34,39,73,0.466,02/25/2017,2017.0
41,Yale (Ivy League),2,1-1,27,31,58,0.466,02/25/2017,2017.0
42,Canisius (MAAC),2,1-1,25,29,54,0.463,02/25/2017,2017.0
43,Hobart (NEC),3,2-1,45,53,98,0.459,02/25/2017,2017.0
44,Stony Brook (America East),3,3-0,43,51,94,0.457,02/25/2017,2017.0
45,Detroit Mercy (MAAC),5,1-4,57,69,126,0.452,02/25/2017,2017.0
45,Hofstra (CAA),2,2-0,19,23,42,0.452,02/25/2017,2017.0
47,Rutgers (Big Ten),3,3-0,30,37,67,0.448,02/25/2017,2017.0
48,UMBC (America East),4,1-3,41,51,92,0.446,02/25/2017,2017.0
49,Dartmouth (Ivy League),2,0-2,22,28,50,0.440,02/25/2017,2017.0
50,Penn (Ivy League),2,2-0,18,23,41,0.439,02/25/2017,2017.0
51,Air Force (SoCon),4,2-2,40,52,92,0.435,02/25/2017,2017.0
52,Vermont (America East),4,3-1,42,57,99,0.424,02/25/2017,2017.0
53,VMI (SoCon),2,1-1,21,29,50,0.420,02/25/2017,2017.0
54,Binghamton (America East),2,1-1,18,25,43,0.419,02/25/2017,2017.0
55,Cleveland St. (Independent),5,2-3,52,73,125,0.416,02/25/2017,2017.0
56,Johns Hopkins (Big Ten),4,4-0,42,60,102,0.412,02/25/2017,2017.0
57,Siena (MAAC),4,0-4,54,80,134,0.403,02/25/2017,2017.0
58,Robert Morris (NEC),4,3-1,43,64,107,0.402,02/25/2017,2017.0
59,Bellarmine (SoCon),3,1-2,30,45,75,0.400,02/25/2017,2017.0
60,Saint Joseph's (NEC),3,0-3,27,41,68,0.397,02/25/2017,2017.0
60,Georgetown (Big East),3,0-3,27,41,68,0.397,02/25/2017,2017.0
62,Holy Cross (Patriot),4,1-3,37,57,94,0.394,02/25/2017,2017.0
63,Bryant (NEC),4,2-2,38,60,98,0.388,02/25/2017,2017.0
64,Wagner (NEC),3,1-2,28,47,75,0.373,02/25/2017,2017.0
65,Drexel (CAA),2,0-2,23,44,67,0.343,02/25/2017,2017.0
66,High Point (SoCon),4,2-2,28,57,85,0.329,02/25/2017,2017.0
67,Hampton (DI Independent),2,0-2,21,45,66,0.318,02/25/2017,2017.0
68,Cornell (Ivy League),2,0-2,19,41,60,0.317,02/25/2017,2017.0
69,Mount St. Mary's (NEC),3,0-3,19,47,66,0.288,02/25/2017,2017.0
-,UMass Lowell (America East),3,1-2,42,46,88,0.477,02/25/2017,2017.0
1,Towson (CAA),1,1-0,15,4,19,0.789,02/23/2017,2017.0
2,Penn St. (Big Ten),3,3-0,73,29,102,0.716,02/23/2017,2017.0
3,Syracuse (ACC),2,2-0,35,15,50,0.700,02/23/2017,2017.0
4,Denver (Big East),2,2-0,34,15,49,0.694,02/23/2017,2017.0
5,Army West Point (Patriot),3,2-1,47,23,70,0.671,02/23/2017,2017.0
6,North Carolina (ACC),3,3-0,44,22,66,0.667,02/23/2017,2017.0
7,Navy (Patriot),3,1-2,48,27,75,0.640,02/23/2017,2017.0
8,Richmond (SoCon),3,3-0,38,22,60,0.633,02/23/2017,2017.0
9,Mercer (SoCon),2,1-1,31,18,49,0.633,02/23/2017,2017.0
10,Brown (Ivy League),1,1-0,24,14,38,0.632,02/23/2017,2017.0
11,Michigan (Big Ten),4,4-0,64,38,102,0.627,02/23/2017,2017.0
12,Manhattan (MAAC),3,1-2,58,35,93,0.624,02/23/2017,2017.0
13,Lehigh (Patriot),3,2-1,45,30,75,0.600,02/23/2017,2017.0
14,Providence (Big East),3,2-1,32,22,54,0.593,02/23/2017,2017.0
15,Villanova (Big East),2,0-2,33,23,56,0.589,02/23/2017,2017.0
16,Boston U. (Patriot),3,3-0,40,28,68,0.588,02/23/2017,2017.0
17,Notre Dame (ACC),1,1-0,17,12,29,0.586,02/23/2017,2017.0
18,Colgate (Patriot),2,0-2,28,20,48,0.583,02/23/2017,2017.0
19,Princeton (Ivy League),2,2-0,30,22,52,0.577,02/23/2017,2017.0
20,Loyola Maryland (Patriot),2,0-2,38,28,66,0.576,02/23/2017,2017.0
21,Marist (MAAC),3,2-1,35,26,61,0.574,02/23/2017,2017.0
22,St. John's (NY) (Big East),2,0-2,27,21,48,0.563,02/23/2017,2017.0
23,Canisius (MAAC),1,1-0,14,11,25,0.560,02/23/2017,2017.0
24,Harvard (Ivy League),2,2-0,28,23,51,0.549,02/23/2017,2017.0
25,Marquette (Big East),1,1-0,12,10,22,0.545,02/23/2017,2017.0
26,Maryland (Big Ten),3,3-0,46,39,85,0.541,02/23/2017,2017.0
27,Jacksonville (SoCon),3,0-3,40,34,74,0.541,02/23/2017,2017.0
28,Virginia (ACC),3,3-0,58,51,109,0.532,02/23/2017,2017.0
29,Lafayette (Patriot),2,0-2,25,22,47,0.532,02/23/2017,2017.0
30,Ohio St. (Big Ten),3,3-0,35,31,66,0.530,02/23/2017,2017.0
31,Bucknell (Patriot),3,2-1,40,36,76,0.526,02/23/2017,2017.0
32,Duke (ACC),4,2-2,53,48,101,0.525,02/23/2017,2017.0
33,Furman (SoCon),4,0-4,44,41,85,0.518,02/23/2017,2017.0
34,Monmouth (MAAC),3,2-1,35,33,68,0.515,02/23/2017,2017.0
35,Georgetown (Big East),2,0-2,22,22,44,0.500,02/23/2017,2017.0
36,Cleveland St. (Independent),4,2-2,48,49,97,0.495,02/23/2017,2017.0
37,Stony Brook (America East),2,2-0,24,25,49,0.490,02/23/2017,2017.0
37,Fairfield (CAA),2,1-1,24,25,49,0.490,02/23/2017,2017.0
39,Delaware (CAA),3,1-2,36,38,74,0.486,02/23/2017,2017.0
40,Yale (Ivy League),1,1-0,15,16,31,0.484,02/23/2017,2017.0
41,Penn (Ivy League),1,1-0,8,9,17,0.471,02/23/2017,2017.0
42,Bryant (NEC),3,1-2,30,37,67,0.448,02/23/2017,2017.0
43,Holy Cross (Patriot),3,0-3,31,39,70,0.443,02/23/2017,2017.0
44,Dartmouth (Ivy League),1,0-1,11,14,25,0.440,02/23/2017,2017.0
45,Siena (MAAC),3,0-3,44,57,101,0.436,02/23/2017,2017.0
46,UMBC (America East),3,0-3,30,39,69,0.435,02/23/2017,2017.0
47,Johns Hopkins (Big Ten),3,3-0,35,46,81,0.432,02/23/2017,2017.0
48,Hartford (America East),1,0-1,9,12,21,0.429,02/23/2017,2017.0
49,Detroit Mercy (MAAC),4,1-3,43,58,101,0.426,02/23/2017,2017.0
50,Rutgers (Big Ten),2,2-0,22,30,52,0.423,02/23/2017,2017.0
51,Sacred Heart (NEC),2,1-1,20,28,48,0.417,02/23/2017,2017.0
52,Bellarmine (SoCon),2,0-2,18,26,44,0.409,02/23/2017,2017.0
53,Hobart (NEC),2,1-1,29,43,72,0.403,02/23/2017,2017.0
54,Saint Joseph's (NEC),2,0-2,18,27,45,0.400,02/23/2017,2017.0
55,Robert Morris (NEC),3,2-1,32,50,82,0.390,02/23/2017,2017.0
56,Vermont (America East),3,3-0,31,51,82,0.378,02/23/2017,2017.0
57,Wagner (NEC),3,1-2,28,47,75,0.373,02/23/2017,2017.0
58,Quinnipiac (MAAC),1,0-1,14,24,38,0.368,02/23/2017,2017.0
59,Drexel (CAA),1,0-1,13,23,36,0.361,02/23/2017,2017.0
60,Massachusetts (CAA),2,0-2,12,22,34,0.353,02/23/2017,2017.0
61,Air Force (SoCon),3,1-2,22,41,63,0.349,02/23/2017,2017.0
62,High Point (SoCon),3,1-2,19,42,61,0.311,02/23/2017,2017.0
63,Binghamton (America East),1,1-0,7,16,23,0.304,02/23/2017,2017.0
64,Mount St. Mary's (NEC),3,0-3,19,47,66,0.288,02/23/2017,2017.0
65,UAlbany (America East),1,0-1,6,15,21,0.286,02/23/2017,2017.0
65,Hofstra (CAA),1,1-0,6,15,21,0.286,02/23/2017,2017.0
67,Hampton (DI Independent),1,0-1,8,21,29,0.276,02/23/2017,2017.0
68,Cornell (Ivy League),1,0-1,9,25,34,0.265,02/23/2017,2017.0
69,NJIT (Independent),2,0-2,11,46,57,0.193,02/23/2017,2017.0
-,UMass Lowell (America East),2,0-2,19,36,55,0.345,02/23/2017,2017.0
1,Towson (CAA),1,1-0,15,4,19,0.789,02/21/2017,2017.0
2,Penn St. (Big Ten),3,3-0,73,29,102,0.716,02/21/2017,2017.0
3,Syracuse (ACC),2,2-0,35,15,50,0.700,02/21/2017,2017.0
4,Denver (Big East),2,2-0,34,15,49,0.694,02/21/2017,2017.0
5,Army West Point (Patriot),3,2-1,47,23,70,0.671,02/21/2017,2017.0
6,North Carolina (ACC),3,3-0,44,22,66,0.667,02/21/2017,2017.0
7,Navy (Patriot),3,1-2,48,27,75,0.640,02/21/2017,2017.0
8,Richmond (SoCon),3,3-0,38,22,60,0.633,02/21/2017,2017.0
9,Mercer (SoCon),2,1-1,31,18,49,0.633,02/21/2017,2017.0
10,Brown (Ivy League),1,1-0,24,14,38,0.632,02/21/2017,2017.0
11,Michigan (Big Ten),4,4-0,64,38,102,0.627,02/21/2017,2017.0
12,Manhattan (MAAC),3,1-2,58,35,93,0.624,02/21/2017,2017.0
13,Lehigh (Patriot),3,2-1,45,30,75,0.600,02/21/2017,2017.0
14,Providence (Big East),3,2-1,32,22,54,0.593,02/21/2017,2017.0
15,Villanova (Big East),2,0-2,33,23,56,0.589,02/21/2017,2017.0
16,Boston U. (Patriot),3,3-0,40,28,68,0.588,02/21/2017,2017.0
17,Notre Dame (ACC),1,1-0,17,12,29,0.586,02/21/2017,2017.0
18,Colgate (Patriot),2,0-2,28,20,48,0.583,02/21/2017,2017.0
19,Princeton (Ivy League),2,2-0,30,22,52,0.577,02/21/2017,2017.0
20,Loyola Maryland (Patriot),2,0-2,38,28,66,0.576,02/21/2017,2017.0
21,Marist (MAAC),3,2-1,35,26,61,0.574,02/21/2017,2017.0
22,St. John's (NY) (Big East),2,0-2,27,21,48,0.563,02/21/2017,2017.0
23,Canisius (MAAC),1,1-0,14,11,25,0.560,02/21/2017,2017.0
24,Harvard (Ivy League),2,2-0,28,23,51,0.549,02/21/2017,2017.0
25,Marquette (Big East),1,1-0,12,10,22,0.545,02/21/2017,2017.0
26,Maryland (Big Ten),3,3-0,46,39,85,0.541,02/21/2017,2017.0
27,Virginia (ACC),3,3-0,58,51,109,0.532,02/21/2017,2017.0
28,Lafayette (Patriot),2,0-2,25,22,47,0.532,02/21/2017,2017.0
29,Ohio St. (Big Ten),3,3-0,35,31,66,0.530,02/21/2017,2017.0
30,Bucknell (Patriot),3,2-1,40,36,76,0.526,02/21/2017,2017.0
31,Duke (ACC),4,2-2,53,48,101,0.525,02/21/2017,2017.0
32,Furman (SoCon),4,0-4,44,41,85,0.518,02/21/2017,2017.0
33,Monmouth (MAAC),3,2-1,35,33,68,0.515,02/21/2017,2017.0
34,Georgetown (Big East),2,0-2,22,22,44,0.500,02/21/2017,2017.0
35,Cleveland St. (Independent),4,2-2,48,49,97,0.495,02/21/2017,2017.0
36,Stony Brook (America East),2,2-0,24,25,49,0.490,02/21/2017,2017.0
36,Fairfield (CAA),2,1-1,24,25,49,0.490,02/21/2017,2017.0
38,Delaware (CAA),3,1-2,36,38,74,0.486,02/21/2017,2017.0
39,Yale (Ivy League),1,1-0,15,16,31,0.484,02/21/2017,2017.0
40,Jacksonville (SoCon),2,0-2,23,25,48,0.479,02/21/2017,2017.0
41,Penn (Ivy League),1,1-0,8,9,17,0.471,02/21/2017,2017.0
42,Detroit Mercy (MAAC),3,0-3,34,41,75,0.453,02/21/2017,2017.0
43,Bryant (NEC),3,1-2,30,37,67,0.448,02/21/2017,2017.0
44,Holy Cross (Patriot),3,0-3,31,39,70,0.443,02/21/2017,2017.0
45,Dartmouth (Ivy League),1,0-1,11,14,25,0.440,02/21/2017,2017.0
46,Siena (MAAC),3,0-3,44,57,101,0.436,02/21/2017,2017.0
47,UMBC (America East),3,0-3,30,39,69,0.435,02/21/2017,2017.0
48,Johns Hopkins (Big Ten),3,3-0,35,46,81,0.432,02/21/2017,2017.0
49,Hartford (America East),1,0-1,9,12,21,0.429,02/21/2017,2017.0
50,Rutgers (Big Ten),2,2-0,22,30,52,0.423,02/21/2017,2017.0
51,Sacred Heart (NEC),2,1-1,20,28,48,0.417,02/21/2017,2017.0
52,Bellarmine (SoCon),2,0-2,18,26,44,0.409,02/21/2017,2017.0
53,Hobart (NEC),2,1-1,29,43,72,0.403,02/21/2017,2017.0
54,Saint Joseph's (NEC),2,0-2,18,27,45,0.400,02/21/2017,2017.0
55,Robert Morris (NEC),3,2-1,32,50,82,0.390,02/21/2017,2017.0
56,Vermont (America East),3,3-0,31,51,82,0.378,02/21/2017,2017.0
57,Wagner (NEC),3,1-2,28,47,75,0.373,02/21/2017,2017.0
58,Quinnipiac (MAAC),1,0-1,14,24,38,0.368,02/21/2017,2017.0
59,Drexel (CAA),1,0-1,13,23,36,0.361,02/21/2017,2017.0
60,Massachusetts (CAA),2,0-2,12,22,34,0.353,02/21/2017,2017.0
61,Air Force (SoCon),3,1-2,22,41,63,0.349,02/21/2017,2017.0
62,High Point (SoCon),3,1-2,19,42,61,0.311,02/21/2017,2017.0
63,Binghamton (America East),1,1-0,7,16,23,0.304,02/21/2017,2017.0
64,Mount St. Mary's (NEC),3,0-3,19,47,66,0.288,02/21/2017,2017.0
65,Hofstra (CAA),1,1-0,6,15,21,0.286,02/21/2017,2017.0
65,UAlbany (America East),1,0-1,6,15,21,0.286,02/21/2017,2017.0
67,Hampton (DI Independent),1,0-1,8,21,29,0.276,02/21/2017,2017.0
68,Cornell (Ivy League),1,0-1,9,25,34,0.265,02/21/2017,2017.0
69,NJIT (Independent),2,0-2,11,46,57,0.193,02/21/2017,2017.0
-,UMass Lowell (America East),2,0-2,19,36,55,0.345,02/21/2017,2017.0
1,Towson (CAA),1,1-0,15,4,19,0.789,02/20/2017,2017.0
2,Princeton (Ivy League),1,1-0,25,8,33,0.758,02/20/2017,2017.0
3,Penn St. (Big Ten),3,3-0,73,29,102,0.716,02/20/2017,2017.0
4,Syracuse (ACC),2,2-0,35,15,50,0.700,02/20/2017,2017.0
5,Denver (Big East),2,2-0,34,15,49,0.694,02/20/2017,2017.0
6,North Carolina (ACC),3,3-0,44,22,66,0.667,02/20/2017,2017.0
7,Army West Point (Patriot),3,2-1,47,24,71,0.662,02/20/2017,2017.0
8,Navy (Patriot),3,1-2,48,27,75,0.640,02/20/2017,2017.0
9,Mercer (SoCon),2,1-1,31,18,49,0.633,02/20/2017,2017.0
10,Brown (Ivy League),1,1-0,24,14,38,0.632,02/20/2017,2017.0
11,Michigan (Big Ten),4,4-0,64,38,102,0.627,02/20/2017,2017.0
12,Manhattan (MAAC),3,1-2,58,35,93,0.624,02/20/2017,2017.0
13,Richmond (SoCon),2,2-0,24,15,39,0.615,02/20/2017,2017.0
13,Harvard (Ivy League),1,1-0,16,10,26,0.615,02/20/2017,2017.0
15,Lehigh (Patriot),3,2-1,45,30,75,0.600,02/20/2017,2017.0
16,Providence (Big East),3,2-1,32,22,54,0.593,02/20/2017,2017.0
17,Villanova (Big East),2,0-2,33,23,56,0.589,02/20/2017,2017.0
18,Boston U. (Patriot),3,3-0,40,28,68,0.588,02/20/2017,2017.0
19,Notre Dame (ACC),1,1-0,17,12,29,0.586,02/20/2017,2017.0
20,Colgate (Patriot),2,0-2,28,20,48,0.583,02/20/2017,2017.0
21,Loyola Maryland (Patriot),2,0-2,38,28,66,0.576,02/20/2017,2017.0
22,St. John's (NY) (Big East),2,0-2,27,21,48,0.563,02/20/2017,2017.0
23,Canisius (MAAC),1,1-0,14,11,25,0.560,02/20/2017,2017.0
24,Virginia (ACC),2,2-0,39,32,71,0.549,02/20/2017,2017.0
25,Marquette (Big East),1,1-0,12,10,22,0.545,02/20/2017,2017.0
26,Maryland (Big Ten),3,3-0,46,39,85,0.541,02/20/2017,2017.0
27,Lafayette (Patriot),2,0-2,25,22,47,0.532,02/20/2017,2017.0
28,Ohio St. (Big Ten),3,3-0,35,31,66,0.530,02/20/2017,2017.0
29,Bucknell (Patriot),3,2-1,40,36,76,0.526,02/20/2017,2017.0
30,Duke (ACC),4,2-2,53,48,101,0.525,02/20/2017,2017.0
31,Furman (SoCon),4,0-4,44,41,85,0.518,02/20/2017,2017.0
32,Monmouth (MAAC),2,1-1,23,23,46,0.500,02/20/2017,2017.0
32,Georgetown (Big East),2,0-2,22,22,44,0.500,02/20/2017,2017.0
32,Marist (MAAC),2,2-0,21,21,42,0.500,02/20/2017,2017.0
35,Cleveland St. (Independent),4,2-2,48,49,97,0.495,02/20/2017,2017.0
36,Stony Brook (America East),2,2-0,24,25,49,0.490,02/20/2017,2017.0
36,Fairfield (CAA),2,1-1,24,25,49,0.490,02/20/2017,2017.0
38,Delaware (CAA),3,1-2,36,38,74,0.486,02/20/2017,2017.0
39,Yale (Ivy League),1,1-0,15,16,31,0.484,02/20/2017,2017.0
40,Jacksonville (SoCon),2,0-2,23,25,48,0.479,02/20/2017,2017.0
41,Penn (Ivy League),1,1-0,8,9,17,0.471,02/20/2017,2017.0
42,Detroit Mercy (MAAC),3,0-3,34,41,75,0.453,02/20/2017,2017.0
43,Bryant (NEC),3,1-2,30,37,67,0.448,02/20/2017,2017.0
44,Dartmouth (Ivy League),1,0-1,11,14,25,0.440,02/20/2017,2017.0
45,UMBC (America East),3,0-3,30,39,69,0.435,02/20/2017,2017.0
46,Johns Hopkins (Big Ten),3,3-0,35,46,81,0.432,02/20/2017,2017.0
47,Hartford (America East),1,0-1,9,12,21,0.429,02/20/2017,2017.0
48,Rutgers (Big Ten),2,2-0,22,30,52,0.423,02/20/2017,2017.0
49,Sacred Heart (NEC),2,1-1,20,28,48,0.417,02/20/2017,2017.0
50,Bellarmine (SoCon),2,0-2,18,26,44,0.409,02/20/2017,2017.0
51,Hobart (NEC),2,1-1,29,43,72,0.403,02/20/2017,2017.0
52,Saint Joseph's (NEC),2,0-2,18,27,45,0.400,02/20/2017,2017.0
52,Holy Cross (Patriot),2,0-2,18,27,45,0.400,02/20/2017,2017.0
54,Siena (MAAC),2,0-2,25,38,63,0.397,02/20/2017,2017.0
55,Robert Morris (NEC),3,2-1,32,50,82,0.390,02/20/2017,2017.0
56,Vermont (America East),3,3-0,31,51,82,0.378,02/20/2017,2017.0
57,Quinnipiac (MAAC),1,0-1,14,24,38,0.368,02/20/2017,2017.0
58,Drexel (CAA),1,0-1,13,23,36,0.361,02/20/2017,2017.0
59,Massachusetts (CAA),2,0-2,12,22,34,0.353,02/20/2017,2017.0
60,Air Force (SoCon),3,1-2,22,41,63,0.349,02/20/2017,2017.0
61,Wagner (NEC),2,1-1,18,35,53,0.340,02/20/2017,2017.0
62,High Point (SoCon),3,1-2,19,42,61,0.311,02/20/2017,2017.0
63,Binghamton (America East),1,1-0,7,16,23,0.304,02/20/2017,2017.0
64,UAlbany (America East),1,0-1,6,15,21,0.286,02/20/2017,2017.0
64,Hofstra (CAA),1,1-0,6,15,21,0.286,02/20/2017,2017.0
66,Hampton (DI Independent),1,0-1,8,21,29,0.276,02/20/2017,2017.0
67,Mount St. Mary's (NEC),2,0-2,12,33,45,0.267,02/20/2017,2017.0
68,Cornell (Ivy League),1,0-1,9,25,34,0.265,02/20/2017,2017.0
69,VMI (SoCon),1,0-1,6,24,30,0.200,02/20/2017,2017.0
-,UMass Lowell (America East),2,0-2,19,36,55,0.345,02/20/2017,2017.0
1,Towson (CAA),1,1-0,15,4,19,0.789,02/19/2017,2017.0
2,Princeton (Ivy League),1,1-0,25,8,33,0.758,02/19/2017,2017.0
3,Penn St. (Big Ten),3,3-0,73,29,102,0.716,02/19/2017,2017.0
4,Syracuse (ACC),2,2-0,35,15,50,0.700,02/19/2017,2017.0
5,Denver (Big East),2,2-0,34,15,49,0.694,02/19/2017,2017.0
6,North Carolina (ACC),3,3-0,44,22,66,0.667,02/19/2017,2017.0
7,Navy (Patriot),3,1-2,48,27,75,0.640,02/19/2017,2017.0
8,Mercer (SoCon),2,1-1,31,18,49,0.633,02/19/2017,2017.0
9,Brown (Ivy League),1,1-0,24,14,38,0.632,02/19/2017,2017.0
10,Michigan (Big Ten),4,4-0,64,38,102,0.627,02/19/2017,2017.0
11,Manhattan (MAAC),3,1-2,58,35,93,0.624,02/19/2017,2017.0
12,Richmond (SoCon),2,2-0,24,15,39,0.615,02/19/2017,2017.0
12,Harvard (Ivy League),1,1-0,16,10,26,0.615,02/19/2017,2017.0
14,Lehigh (Patriot),3,2-1,45,30,75,0.600,02/19/2017,2017.0
15,Providence (Big East),3,2-1,32,22,54,0.593,02/19/2017,2017.0
16,Villanova (Big East),2,0-2,33,23,56,0.589,02/19/2017,2017.0
17,Boston U. (Patriot),3,3-0,40,28,68,0.588,02/19/2017,2017.0
18,Notre Dame (ACC),1,1-0,17,12,29,0.586,02/19/2017,2017.0
19,Colgate (Patriot),2,0-2,28,20,48,0.583,02/19/2017,2017.0
20,Loyola Maryland (Patriot),2,0-2,38,28,66,0.576,02/19/2017,2017.0
21,St. John's (NY) (Big East),2,0-2,27,21,48,0.563,02/19/2017,2017.0
22,Army West Point (Patriot),2,1-1,23,18,41,0.561,02/19/2017,2017.0
23,Canisius (MAAC),1,1-0,14,11,25,0.560,02/19/2017,2017.0
24,Virginia (ACC),2,2-0,39,32,71,0.549,02/19/2017,2017.0
25,Marquette (Big East),1,1-0,12,10,22,0.545,02/19/2017,2017.0
26,Maryland (Big Ten),3,3-0,46,39,85,0.541,02/19/2017,2017.0
27,Lafayette (Patriot),2,0-2,25,22,47,0.532,02/19/2017,2017.0
28,Ohio St. (Big Ten),3,3-0,35,31,66,0.530,02/19/2017,2017.0
29,Bucknell (Patriot),3,2-1,40,36,76,0.526,02/19/2017,2017.0
30,Duke (ACC),4,2-2,53,48,101,0.525,02/19/2017,2017.0
31,Furman (SoCon),4,0-4,44,41,85,0.518,02/19/2017,2017.0
32,Monmouth (MAAC),2,1-1,23,23,46,0.500,02/19/2017,2017.0
32,Georgetown (Big East),2,0-2,22,22,44,0.500,02/19/2017,2017.0
32,Marist (MAAC),2,2-0,21,21,42,0.500,02/19/2017,2017.0
35,Cleveland St. (Independent),4,2-2,48,49,97,0.495,02/19/2017,2017.0
36,Stony Brook (America East),2,2-0,24,25,49,0.490,02/19/2017,2017.0
36,Fairfield (CAA),2,1-1,24,25,49,0.490,02/19/2017,2017.0
38,Delaware (CAA),3,1-2,36,38,74,0.486,02/19/2017,2017.0
39,Yale (Ivy League),1,1-0,15,16,31,0.484,02/19/2017,2017.0
40,Jacksonville (SoCon),2,0-2,23,25,48,0.479,02/19/2017,2017.0
41,Penn (Ivy League),1,1-0,8,9,17,0.471,02/19/2017,2017.0
42,Detroit Mercy (MAAC),3,0-3,34,41,75,0.453,02/19/2017,2017.0
43,Bryant (NEC),3,1-2,30,37,67,0.448,02/19/2017,2017.0
44,Dartmouth (Ivy League),1,0-1,11,14,25,0.440,02/19/2017,2017.0
45,UMBC (America East),3,0-3,30,39,69,0.435,02/19/2017,2017.0
46,Johns Hopkins (Big Ten),3,3-0,35,46,81,0.432,02/19/2017,2017.0
47,Hartford (America East),1,0-1,9,12,21,0.429,02/19/2017,2017.0
48,Rutgers (Big Ten),2,2-0,22,30,52,0.423,02/19/2017,2017.0
49,Sacred Heart (NEC),2,1-1,20,28,48,0.417,02/19/2017,2017.0
50,Bellarmine (SoCon),2,0-2,18,26,44,0.409,02/19/2017,2017.0
51,Hobart (NEC),2,1-1,29,43,72,0.403,02/19/2017,2017.0
52,Saint Joseph's (NEC),2,0-2,18,27,45,0.400,02/19/2017,2017.0
52,Holy Cross (Patriot),2,0-2,18,27,45,0.400,02/19/2017,2017.0
54,Siena (MAAC),2,0-2,25,38,63,0.397,02/19/2017,2017.0
55,Robert Morris (NEC),3,2-1,32,50,82,0.390,02/19/2017,2017.0
56,Vermont (America East),3,3-0,31,51,82,0.378,02/19/2017,2017.0
57,Quinnipiac (MAAC),1,0-1,14,24,38,0.368,02/19/2017,2017.0
58,Drexel (CAA),1,0-1,13,23,36,0.361,02/19/2017,2017.0
59,Massachusetts (CAA),2,0-2,12,22,34,0.353,02/19/2017,2017.0
60,Air Force (SoCon),3,1-2,22,41,63,0.349,02/19/2017,2017.0
61,Wagner (NEC),2,1-1,18,35,53,0.340,02/19/2017,2017.0
62,High Point (SoCon),3,1-2,19,42,61,0.311,02/19/2017,2017.0
63,Binghamton (America East),1,1-0,7,16,23,0.304,02/19/2017,2017.0
64,Hofstra (CAA),1,1-0,6,15,21,0.286,02/19/2017,2017.0
64,UAlbany (America East),1,0-1,6,15,21,0.286,02/19/2017,2017.0
66,Hampton (DI Independent),1,0-1,8,21,29,0.276,02/19/2017,2017.0
67,Mount St. Mary's (NEC),2,0-2,12,33,45,0.267,02/19/2017,2017.0
68,Cornell (Ivy League),1,0-1,9,25,34,0.265,02/19/2017,2017.0
69,NJIT (Independent),2,0-2,11,46,57,0.193,02/19/2017,2017.0
-,UMass Lowell (America East),2,0-2,19,36,55,0.345,02/19/2017,2017.0
1,North Carolina (ACC),2,2-0,30,11,41,0.732,02/15/2017,2017.0
2,Denver (Big East),1,1-0,16,6,22,0.727,02/15/2017,2017.0
3,Mercer (SoCon),1,0-1,20,8,28,0.714,02/15/2017,2017.0
3,Richmond (SoCon),1,1-0,15,6,21,0.714,02/15/2017,2017.0
5,Penn St. (Big Ten),2,2-0,48,20,68,0.706,02/15/2017,2017.0
6,Providence (Big East),2,1-1,26,11,37,0.703,02/15/2017,2017.0
7,Syracuse (ACC),1,1-0,20,9,29,0.690,02/15/2017,2017.0
8,Lehigh (Patriot),2,2-0,34,16,50,0.680,02/15/2017,2017.0
8,Villanova (Big East),1,0-1,17,8,25,0.680,02/15/2017,2017.0
10,Georgetown (Big East),1,0-1,10,5,15,0.667,02/15/2017,2017.0
10,Army West Point (Patriot),1,1-0,10,5,15,0.667,02/15/2017,2017.0
12,St. John's (NY) (Big East),1,0-1,17,9,26,0.654,02/15/2017,2017.0
13,Michigan (Big Ten),3,3-0,50,30,80,0.625,02/15/2017,2017.0
13,Navy (Patriot),2,0-2,35,21,56,0.625,02/15/2017,2017.0
13,Bucknell (Patriot),2,2-0,30,18,48,0.625,02/15/2017,2017.0
16,Manhattan (MAAC),2,1-1,39,24,63,0.619,02/15/2017,2017.0
17,Boston U. (Patriot),2,2-0,28,19,47,0.596,02/15/2017,2017.0
18,Duke (ACC),3,2-1,44,30,74,0.595,02/15/2017,2017.0
19,Sacred Heart (NEC),1,0-1,15,12,27,0.556,02/15/2017,2017.0
20,Delaware (CAA),2,1-1,30,25,55,0.545,02/15/2017,2017.0
21,Loyola Maryland (Patriot),1,0-1,19,16,35,0.543,02/15/2017,2017.0
22,Marist (MAAC),1,1-0,13,12,25,0.520,02/15/2017,2017.0
23,Cleveland St. (Independent),2,0-2,28,28,56,0.500,02/15/2017,2017.0
23,Jacksonville (SoCon),1,0-1,13,13,26,0.500,02/15/2017,2017.0
25,Ohio St. (Big Ten),2,2-0,23,24,47,0.489,02/15/2017,2017.0
26,Maryland (Big Ten),2,2-0,28,30,58,0.483,02/15/2017,2017.0
27,Colgate (Patriot),1,0-1,12,13,25,0.480,02/15/2017,2017.0
28,Johns Hopkins (Big Ten),2,2-0,23,27,50,0.460,02/15/2017,2017.0
29,Virginia (ACC),1,1-0,16,19,35,0.457,02/15/2017,2017.0
30,Bellarmine (SoCon),1,0-1,10,12,22,0.455,02/15/2017,2017.0
31,Detroit Mercy (MAAC),2,0-2,24,30,54,0.444,02/15/2017,2017.0
31,Stony Brook (America East),1,1-0,12,15,27,0.444,02/15/2017,2017.0
33,Furman (SoCon),3,0-3,28,36,64,0.438,02/15/2017,2017.0
34,Lafayette (Patriot),1,0-1,11,15,26,0.423,02/15/2017,2017.0
35,UMBC (America East),2,0-2,21,30,51,0.412,02/15/2017,2017.0
36,Robert Morris (NEC),2,1-1,21,31,52,0.404,02/15/2017,2017.0
37,Bryant (NEC),2,1-1,19,31,50,0.380,02/15/2017,2017.0
38,Vermont (America East),2,2-0,20,36,56,0.357,02/15/2017,2017.0
39,Rutgers (Big Ten),1,1-0,9,17,26,0.346,02/15/2017,2017.0
40,Wagner (NEC),1,0-1,11,21,32,0.344,02/15/2017,2017.0
41,Massachusetts (CAA),1,0-1,5,10,15,0.333,02/15/2017,2017.0
42,Saint Joseph's (NEC),1,0-1,9,19,28,0.321,02/15/2017,2017.0
43,Monmouth (MAAC),1,1-0,8,17,25,0.320,02/15/2017,2017.0
44,Siena (MAAC),1,0-1,9,20,29,0.310,02/15/2017,2017.0
45,Mount St. Mary's (NEC),1,0-1,8,18,26,0.308,02/15/2017,2017.0
46,High Point (SoCon),2,1-1,10,24,34,0.294,02/15/2017,2017.0
47,Hobart (NEC),1,0-1,11,27,38,0.289,02/15/2017,2017.0
48,Fairfield (CAA),1,0-1,6,15,21,0.286,02/15/2017,2017.0
49,Air Force (SoCon),2,1-1,13,33,46,0.283,02/15/2017,2017.0
50,Holy Cross (Patriot),1,0-1,3,16,19,0.158,02/15/2017,2017.0
51,NJIT (Independent),1,0-1,3,21,24,0.125,02/15/2017,2017.0
-,UMass Lowell (America East),1,0-1,9,20,29,0.310,02/15/2017,2017.0
1,North Carolina (ACC),2,2-0,30,11,41,0.732,02/14/2017,2017.0
2,Denver (Big East),1,1-0,16,6,22,0.727,02/14/2017,2017.0
3,Mercer (SoCon),1,0-1,20,8,28,0.714,02/14/2017,2017.0
3,Richmond (SoCon),1,1-0,15,6,21,0.714,02/14/2017,2017.0
5,Penn St. (Big Ten),2,2-0,48,20,68,0.706,02/14/2017,2017.0
6,Providence (Big East),2,1-1,26,11,37,0.703,02/14/2017,2017.0
7,Syracuse (ACC),1,1-0,20,9,29,0.690,02/14/2017,2017.0
8,Lehigh (Patriot),2,2-0,34,16,50,0.680,02/14/2017,2017.0
8,Villanova (Big East),1,0-1,17,8,25,0.680,02/14/2017,2017.0
10,Georgetown (Big East),1,0-1,10,5,15,0.667,02/14/2017,2017.0
10,Army West Point (Patriot),1,1-0,10,5,15,0.667,02/14/2017,2017.0
12,St. John's (NY) (Big East),1,0-1,17,9,26,0.654,02/14/2017,2017.0
13,Navy (Patriot),2,0-2,35,21,56,0.625,02/14/2017,2017.0
13,Bucknell (Patriot),2,2-0,30,18,48,0.625,02/14/2017,2017.0
15,Manhattan (MAAC),2,1-1,39,24,63,0.619,02/14/2017,2017.0
16,Detroit Mercy (MAAC),1,0-1,15,10,25,0.600,02/14/2017,2017.0
17,Boston U. (Patriot),2,2-0,28,19,47,0.596,02/14/2017,2017.0
18,Duke (ACC),3,2-1,44,30,74,0.595,02/14/2017,2017.0
19,Michigan (Big Ten),2,2-0,30,21,51,0.588,02/14/2017,2017.0
20,Sacred Heart (NEC),1,0-1,15,12,27,0.556,02/14/2017,2017.0
21,Delaware (CAA),2,1-1,30,25,55,0.545,02/14/2017,2017.0
22,Loyola Maryland (Patriot),1,0-1,19,16,35,0.543,02/14/2017,2017.0
23,Marist (MAAC),1,1-0,13,12,25,0.520,02/14/2017,2017.0
24,Cleveland St. (Independent),2,0-2,28,28,56,0.500,02/14/2017,2017.0
24,Jacksonville (SoCon),1,0-1,13,13,26,0.500,02/14/2017,2017.0
26,Ohio St. (Big Ten),2,2-0,23,24,47,0.489,02/14/2017,2017.0
27,Maryland (Big Ten),2,2-0,28,30,58,0.483,02/14/2017,2017.0
28,Colgate (Patriot),1,0-1,12,13,25,0.480,02/14/2017,2017.0
29,Johns Hopkins (Big Ten),2,2-0,23,27,50,0.460,02/14/2017,2017.0
30,Virginia (ACC),1,1-0,16,19,35,0.457,02/14/2017,2017.0
31,Bellarmine (SoCon),1,0-1,10,12,22,0.455,02/14/2017,2017.0
32,Stony Brook (America East),1,1-0,12,15,27,0.444,02/14/2017,2017.0
33,Furman (SoCon),3,0-3,28,36,64,0.438,02/14/2017,2017.0
34,Lafayette (Patriot),1,0-1,11,15,26,0.423,02/14/2017,2017.0
35,UMBC (America East),2,0-2,21,30,51,0.412,02/14/2017,2017.0
36,Robert Morris (NEC),2,1-1,21,31,52,0.404,02/14/2017,2017.0
37,Bryant (NEC),2,1-1,19,31,50,0.380,02/14/2017,2017.0
38,Vermont (America East),2,2-0,20,36,56,0.357,02/14/2017,2017.0
39,Rutgers (Big Ten),1,1-0,9,17,26,0.346,02/14/2017,2017.0
40,Wagner (NEC),1,0-1,11,21,32,0.344,02/14/2017,2017.0
41,Massachusetts (CAA),1,0-1,5,10,15,0.333,02/14/2017,2017.0
42,Saint Joseph's (NEC),1,0-1,9,19,28,0.321,02/14/2017,2017.0
43,Monmouth (MAAC),1,1-0,8,17,25,0.320,02/14/2017,2017.0
44,Siena (MAAC),1,0-1,9,20,29,0.310,02/14/2017,2017.0
45,Mount St. Mary's (NEC),1,0-1,8,18,26,0.308,02/14/2017,2017.0
46,High Point (SoCon),2,1-1,10,24,34,0.294,02/14/2017,2017.0
47,Hobart (NEC),1,0-1,11,27,38,0.289,02/14/2017,2017.0
48,Fairfield (CAA),1,0-1,6,15,21,0.286,02/14/2017,2017.0
49,Air Force (SoCon),2,1-1,13,33,46,0.283,02/14/2017,2017.0
50,Holy Cross (Patriot),1,0-1,3,16,19,0.158,02/14/2017,2017.0
51,NJIT (Independent),1,0-1,3,21,24,0.125,02/14/2017,2017.0
-,UMass Lowell (America East),1,0-1,9,20,29,0.310,02/14/2017,2017.0
1,North Carolina (ACC),2,2-0,30,11,41,0.732,02/12/2017,2017.0
2,Denver (Big East),1,1-0,16,6,22,0.727,02/12/2017,2017.0
3,Mercer (SoCon),1,0-1,20,8,28,0.714,02/12/2017,2017.0
3,Richmond (SoCon),1,1-0,15,6,21,0.714,02/12/2017,2017.0
5,Penn St. (Big Ten),2,2-0,48,20,68,0.706,02/12/2017,2017.0
6,Providence (Big East),2,1-1,26,11,37,0.703,02/12/2017,2017.0
7,Syracuse (ACC),1,1-0,20,9,29,0.690,02/12/2017,2017.0
8,Lehigh (Patriot),2,2-0,34,16,50,0.680,02/12/2017,2017.0
8,Villanova (Big East),1,0-1,17,8,25,0.680,02/12/2017,2017.0
10,Army West Point (Patriot),1,1-0,10,5,15,0.667,02/12/2017,2017.0
11,St. John's (NY) (Big East),1,0-1,17,9,26,0.654,02/12/2017,2017.0
12,Navy (Patriot),2,0-2,35,21,56,0.625,02/12/2017,2017.0
12,Bucknell (Patriot),2,2-0,30,18,48,0.625,02/12/2017,2017.0
14,Manhattan (MAAC),2,1-1,39,24,63,0.619,02/12/2017,2017.0
15,Detroit Mercy (MAAC),1,0-1,15,10,25,0.600,02/12/2017,2017.0
16,Boston U. (Patriot),2,2-0,28,19,47,0.596,02/12/2017,2017.0
17,Duke (ACC),3,2-1,44,30,74,0.595,02/12/2017,2017.0
18,Michigan (Big Ten),2,2-0,30,21,51,0.588,02/12/2017,2017.0
19,Delaware (CAA),2,1-1,30,25,55,0.545,02/12/2017,2017.0
20,Loyola Maryland (Patriot),1,0-1,19,16,35,0.543,02/12/2017,2017.0
21,Marist (MAAC),1,1-0,13,12,25,0.520,02/12/2017,2017.0
22,Cleveland St. (Independent),2,0-2,28,28,56,0.500,02/12/2017,2017.0
22,Jacksonville (SoCon),1,0-1,13,13,26,0.500,02/12/2017,2017.0
24,Ohio St. (Big Ten),2,2-0,23,24,47,0.489,02/12/2017,2017.0
25,Colgate (Patriot),1,0-1,12,13,25,0.480,02/12/2017,2017.0
26,Johns Hopkins (Big Ten),2,2-0,23,27,50,0.460,02/12/2017,2017.0
27,Virginia (ACC),1,1-0,16,19,35,0.457,02/12/2017,2017.0
28,Bellarmine (SoCon),1,0-1,10,12,22,0.455,02/12/2017,2017.0
29,Furman (SoCon),3,0-3,28,36,64,0.438,02/12/2017,2017.0
30,Lafayette (Patriot),1,0-1,11,15,26,0.423,02/12/2017,2017.0
31,UMBC (America East),2,0-2,21,30,51,0.412,02/12/2017,2017.0
32,Robert Morris (NEC),2,1-1,21,31,52,0.404,02/12/2017,2017.0
33,Bryant (NEC),2,1-1,19,31,50,0.380,02/12/2017,2017.0
34,Vermont (America East),2,2-0,20,36,56,0.357,02/12/2017,2017.0
35,Rutgers (Big Ten),1,1-0,9,17,26,0.346,02/12/2017,2017.0
36,Wagner (NEC),1,0-1,11,21,32,0.344,02/12/2017,2017.0
37,Massachusetts (CAA),1,0-1,5,10,15,0.333,02/12/2017,2017.0
38,Monmouth (MAAC),1,1-0,8,17,25,0.320,02/12/2017,2017.0
39,Siena (MAAC),1,0-1,9,20,29,0.310,02/12/2017,2017.0
40,Mount St. Mary's (NEC),1,0-1,8,18,26,0.308,02/12/2017,2017.0
41,Maryland (Big Ten),1,1-0,9,21,30,0.300,02/12/2017,2017.0
42,Hobart (NEC),1,0-1,11,27,38,0.289,02/12/2017,2017.0
43,Fairfield (CAA),1,0-1,6,15,21,0.286,02/12/2017,2017.0
44,Air Force (SoCon),2,1-1,13,33,46,0.283,02/12/2017,2017.0
45,High Point (SoCon),1,0-1,5,14,19,0.263,02/12/2017,2017.0
46,Holy Cross (Patriot),1,0-1,3,16,19,0.158,02/12/2017,2017.0
47,NJIT (Independent),1,0-1,3,21,24,0.125,02/12/2017,2017.0
-,UMass Lowell (America East),1,0-1,9,20,29,0.310,02/12/2017,2017.0
1,Lehigh (Patriot),1,1-0,21,3,24,0.875,02/10/2017,2017.0
2,Duke (ACC),2,1-1,31,12,43,0.721,02/10/2017,2017.0
3,Mercer (SoCon),1,0-1,20,8,28,0.714,02/10/2017,2017.0
4,North Carolina (ACC),1,1-0,19,8,27,0.704,02/10/2017,2017.0
5,Penn St. (Big Ten),1,1-0,21,9,30,0.700,02/10/2017,2017.0
6,Michigan (Big Ten),1,1-0,15,10,25,0.600,02/10/2017,2017.0
7,Ohio St. (Big Ten),1,1-0,13,9,22,0.591,02/10/2017,2017.0
8,Bucknell (Patriot),1,1-0,17,12,29,0.586,02/10/2017,2017.0
9,Manhattan (MAAC),1,0-1,18,13,31,0.581,02/10/2017,2017.0
10,Providence (Big East),1,0-1,10,8,18,0.556,02/10/2017,2017.0
11,Navy (Patriot),1,0-1,14,12,26,0.538,02/10/2017,2017.0
12,Furman (SoCon),2,0-2,25,25,50,0.500,02/10/2017,2017.0
13,Johns Hopkins (Big Ten),1,1-0,12,14,26,0.462,02/10/2017,2017.0
14,Boston U. (Patriot),1,1-0,8,10,18,0.444,02/10/2017,2017.0
15,Bryant (NEC),1,1-0,13,18,31,0.419,02/10/2017,2017.0
16,Delaware (CAA),1,0-1,12,17,29,0.414,02/10/2017,2017.0
17,Cleveland St. (Independent),1,0-1,10,15,25,0.400,02/10/2017,2017.0
18,Vermont (America East),2,2-0,20,36,56,0.357,02/10/2017,2017.0
19,Robert Morris (NEC),1,0-1,9,21,30,0.300,02/10/2017,2017.0
20,UMBC (America East),1,0-1,8,19,27,0.296,02/10/2017,2017.0
21,Air Force (SoCon),1,1-0,7,17,24,0.292,02/10/2017,2017.0
22,High Point (SoCon),1,0-1,5,14,19,0.263,02/10/2017,2017.0
23,NJIT (Independent),1,0-1,3,21,24,0.125,02/10/2017,2017.0
1,Lehigh (Patriot),1,1-0,21,3,24,0.875,02/07/2017,2017.0
2,Mercer (SoCon),1,0-1,20,8,28,0.714,02/07/2017,2017.0
3,Duke (ACC),1,0-1,17,7,24,0.708,02/07/2017,2017.0
4,North Carolina (ACC),1,1-0,19,8,27,0.704,02/07/2017,2017.0
5,Penn St. (Big Ten),1,1-0,21,9,30,0.700,02/07/2017,2017.0
6,Michigan (Big Ten),1,1-0,15,10,25,0.600,02/07/2017,2017.0
7,Ohio St. (Big Ten),1,1-0,13,9,22,0.591,02/07/2017,2017.0
8,Bucknell (Patriot),1,1-0,17,12,29,0.586,02/07/2017,2017.0
9,Manhattan (MAAC),1,0-1,18,13,31,0.581,02/07/2017,2017.0
10,Providence (Big East),1,0-1,10,8,18,0.556,02/07/2017,2017.0
11,Navy (Patriot),1,0-1,14,12,26,0.538,02/07/2017,2017.0
12,Furman (SoCon),2,0-2,25,25,50,0.500,02/07/2017,2017.0
13,Johns Hopkins (Big Ten),1,1-0,12,14,26,0.462,02/07/2017,2017.0
14,Boston U. (Patriot),1,1-0,8,10,18,0.444,02/07/2017,2017.0
15,Bryant (NEC),1,1-0,13,18,31,0.419,02/07/2017,2017.0
16,Delaware (CAA),1,0-1,12,17,29,0.414,02/07/2017,2017.0
17,Cleveland St. (Independent),1,0-1,10,15,25,0.400,02/07/2017,2017.0
18,Vermont (America East),2,2-0,20,36,56,0.357,02/07/2017,2017.0
19,Robert Morris (NEC),1,0-1,9,21,30,0.300,02/07/2017,2017.0
20,UMBC (America East),1,0-1,8,19,27,0.296,02/07/2017,2017.0
21,Air Force (SoCon),1,1-0,7,17,24,0.292,02/07/2017,2017.0
22,NJIT (Independent),1,0-1,3,21,24,0.125,02/07/2017,2017.0
1,Lehigh (Patriot),1,1-0,21,3,24,0.875,02/05/2017,2017.0
2,Mercer (SoCon),1,0-1,20,8,28,0.714,02/05/2017,2017.0
3,Duke (ACC),1,0-1,17,7,24,0.708,02/05/2017,2017.0
4,North Carolina (ACC),1,1-0,19,8,27,0.704,02/05/2017,2017.0
5,Penn St. (Big Ten),1,1-0,21,11,32,0.656,02/05/2017,2017.0
6,Michigan (Big Ten),1,1-0,15,10,25,0.600,02/05/2017,2017.0
7,Ohio St. (Big Ten),1,1-0,13,9,22,0.591,02/05/2017,2017.0
8,Bucknell (Patriot),1,1-0,17,12,29,0.586,02/05/2017,2017.0
9,Manhattan (MAAC),1,0-1,18,13,31,0.581,02/05/2017,2017.0
10,Providence (Big East),1,0-1,10,8,18,0.556,02/05/2017,2017.0
11,Furman (SoCon),2,0-2,25,25,50,0.500,02/05/2017,2017.0
12,Boston U. (Patriot),1,1-0,8,10,18,0.444,02/05/2017,2017.0
13,Bryant (NEC),1,1-0,13,18,31,0.419,02/05/2017,2017.0
14,Delaware (CAA),1,0-1,12,17,29,0.414,02/05/2017,2017.0
15,Cleveland St. (Independent),1,0-1,10,15,25,0.400,02/05/2017,2017.0
16,Vermont (America East),2,2-0,20,36,56,0.357,02/05/2017,2017.0
17,Robert Morris (NEC),1,0-1,11,21,32,0.344,02/05/2017,2017.0
18,UMBC (America East),1,0-1,8,19,27,0.296,02/05/2017,2017.0
19,Air Force (SoCon),1,1-0,7,17,24,0.292,02/05/2017,2017.0
20,NJIT (Independent),1,0-1,3,21,24,0.125,02/05/2017,2017.0
1,UAlbany (America East),19,16-3,382,115,497,0.769,05/28/2018-Final Statistics,2018.0
2,Denver (Big East),17,13-4,282,100,382,0.738,05/28/2018-Final Statistics,2018.0
3,Jacksonville (SoCon),15,8-7,262,112,374,0.701,05/28/2018-Final Statistics,2018.0
4,Bryant (NEC),15,8-7,247,119,366,0.675,05/28/2018-Final Statistics,2018.0
5,Penn St. (Big Ten),14,8-6,234,123,357,0.655,05/28/2018-Final Statistics,2018.0
6,Hobart (NEC),14,4-10,208,128,336,0.619,05/28/2018-Final Statistics,2018.0
7,Towson (CAA),15,7-8,200,131,331,0.604,05/28/2018-Final Statistics,2018.0
8,Yale (Ivy League),20,17-3,308,205,513,0.600,05/28/2018-Final Statistics,2018.0
9,Colgate (Patriot),15,7-8,225,153,378,0.595,05/28/2018-Final Statistics,2018.0
10,Lehigh (Patriot),17,10-7,236,163,399,0.591,05/28/2018-Final Statistics,2018.0
11,Hartford (America East),13,3-10,195,135,330,0.591,05/28/2018-Final Statistics,2018.0
12,Ohio St. (Big Ten),15,8-7,183,133,316,0.579,05/28/2018-Final Statistics,2018.0
13,Virginia (ACC),18,12-6,282,207,489,0.577,05/28/2018-Final Statistics,2018.0
14,Massachusetts (CAA),17,12-5,233,178,411,0.567,05/28/2018-Final Statistics,2018.0
15,Holy Cross (Patriot),13,4-9,152,117,269,0.565,05/28/2018-Final Statistics,2018.0
16,Marquette (Big East),14,6-8,165,129,294,0.561,05/28/2018-Final Statistics,2018.0
17,Quinnipiac (MAAC),15,9-6,210,167,377,0.557,05/28/2018-Final Statistics,2018.0
18,Navy (Patriot),14,9-5,166,134,300,0.553,05/28/2018-Final Statistics,2018.0
19,Hofstra (CAA),14,6-8,152,125,277,0.549,05/28/2018-Final Statistics,2018.0
20,Brown (Ivy League),15,6-9,218,186,404,0.540,05/28/2018-Final Statistics,2018.0
21,Mount St. Mary's (NEC),14,5-9,203,174,377,0.538,05/28/2018-Final Statistics,2018.0
22,Maryland (Big Ten),18,14-4,234,209,443,0.528,05/28/2018-Final Statistics,2018.0
23,VMI (Southland),13,2-11,164,147,311,0.527,05/28/2018-Final Statistics,2018.0
24,Air Force (SoCon),15,5-10,170,153,323,0.526,05/28/2018-Final Statistics,2018.0
25,Notre Dame (ACC),15,9-6,173,156,329,0.526,05/28/2018-Final Statistics,2018.0
26,Johns Hopkins (Big Ten),17,12-5,221,201,422,0.524,05/28/2018-Final Statistics,2018.0
27,Duke (ACC),20,16-4,261,251,512,0.510,05/28/2018-Final Statistics,2018.0
28,High Point (SoCon),14,6-8,191,184,375,0.509,05/28/2018-Final Statistics,2018.0
29,Army West Point (Patriot),13,5-8,136,140,276,0.493,05/28/2018-Final Statistics,2018.0
30,Michigan (Big Ten),14,8-6,160,166,326,0.491,05/28/2018-Final Statistics,2018.0
31,Fairfield (CAA),15,4-11,167,175,342,0.488,05/28/2018-Final Statistics,2018.0
32,Cleveland St. (Independent),14,4-10,158,166,324,0.488,05/28/2018-Final Statistics,2018.0
33,Georgetown (Big East),17,12-5,188,198,386,0.487,05/28/2018-Final Statistics,2018.0
34,Bellarmine (SoCon),13,4-9,129,136,265,0.487,05/28/2018-Final Statistics,2018.0
35,Siena (MAAC),12,3-9,154,165,319,0.483,05/28/2018-Final Statistics,2018.0
36,Syracuse (ACC),15,8-7,184,198,382,0.482,05/28/2018-Final Statistics,2018.0
37,Princeton (Ivy League),13,8-5,180,195,375,0.480,05/28/2018-Final Statistics,2018.0
38,Boston U. (Patriot),17,8-9,202,221,423,0.478,05/28/2018-Final Statistics,2018.0
39,Lafayette (Patriot),15,3-12,176,193,369,0.477,05/28/2018-Final Statistics,2018.0
40,Detroit Mercy (MAAC),16,9-7,173,190,363,0.477,05/28/2018-Final Statistics,2018.0
41,Providence (Big East),15,5-10,161,177,338,0.476,05/28/2018-Final Statistics,2018.0
42,Drexel (CAA),13,5-8,163,180,343,0.475,05/28/2018-Final Statistics,2018.0
43,Sacred Heart (NEC),15,7-8,183,209,392,0.467,05/28/2018-Final Statistics,2018.0
44,Harvard (Ivy League),13,7-6,159,182,341,0.466,05/28/2018-Final Statistics,2018.0
45,Vermont (America East),16,12-4,156,183,339,0.460,05/28/2018-Final Statistics,2018.0
46,Rutgers (Big Ten),15,9-6,167,196,363,0.460,05/28/2018-Final Statistics,2018.0
47,Penn (Ivy League),15,7-8,159,187,346,0.460,05/28/2018-Final Statistics,2018.0
48,Bucknell (Patriot),15,11-4,164,193,357,0.459,05/28/2018-Final Statistics,2018.0
49,Delaware (CAA),14,6-8,156,188,344,0.453,05/28/2018-Final Statistics,2018.0
50,Manhattan (MAAC),14,4-10,149,181,330,0.452,05/28/2018-Final Statistics,2018.0
51,Marist (MAAC),15,3-12,156,192,348,0.448,05/28/2018-Final Statistics,2018.0
52,Cornell (Ivy League),18,13-5,208,261,469,0.443,05/28/2018-Final Statistics,2018.0
53,North Carolina (ACC),14,7-7,153,194,347,0.441,05/28/2018-Final Statistics,2018.0
54,Mercer (SoCon),14,4-10,134,172,306,0.438,05/28/2018-Final Statistics,2018.0
55,Saint Joseph's (NEC),15,11-4,139,179,318,0.437,05/28/2018-Final Statistics,2018.0
56,St. John's (NY) (Big East),14,6-8,140,186,326,0.429,05/28/2018-Final Statistics,2018.0
57,Loyola Maryland (Patriot),17,13-4,185,249,434,0.426,05/28/2018-Final Statistics,2018.0
58,Villanova (Big East),16,10-6,172,232,404,0.426,05/28/2018-Final Statistics,2018.0
59,Binghamton (America East),15,4-11,154,214,368,0.418,05/28/2018-Final Statistics,2018.0
60,Richmond (SoCon),17,11-6,172,240,412,0.417,05/28/2018-Final Statistics,2018.0
61,Hampton (Independent),12,4-8,124,176,300,0.413,05/28/2018-Final Statistics,2018.0
62,Robert Morris (NEC),18,13-5,171,244,415,0.412,05/28/2018-Final Statistics,2018.0
63,Wagner (NEC),14,4-10,118,169,287,0.411,05/28/2018-Final Statistics,2018.0
64,Canisius (MAAC),17,8-9,187,282,469,0.399,05/28/2018-Final Statistics,2018.0
65,Dartmouth (Ivy League),13,2-11,133,202,335,0.397,05/28/2018-Final Statistics,2018.0
66,UMass Lowell (America East),16,8-8,145,235,380,0.382,05/28/2018-Final Statistics,2018.0
67,Monmouth (MAAC),15,7-8,128,211,339,0.378,05/28/2018-Final Statistics,2018.0
68,NJIT (Independent),16,1-15,128,223,351,0.365,05/28/2018-Final Statistics,2018.0
69,UMBC (America East),13,5-8,84,153,237,0.354,05/28/2018-Final Statistics,2018.0
70,Stony Brook (America East),15,7-8,117,234,351,0.333,05/28/2018-Final Statistics,2018.0
71,Furman (SoCon),14,4-10,106,235,341,0.311,05/28/2018-Final Statistics,2018.0
1,Syracuse (ACC),1,0-1,16,6,22,0.727,05/09/2018 - 05/28/2018-DI Men's Lacrosse Championship,2018.0
2,Georgetown (Big East),1,0-1,15,8,23,0.652,05/09/2018 - 05/28/2018-DI Men's Lacrosse Championship,2018.0
3,Maryland (Big Ten),3,2-1,50,28,78,0.641,05/09/2018 - 05/28/2018-DI Men's Lacrosse Championship,2018.0
4,UAlbany (America East),3,2-1,57,36,93,0.613,05/09/2018 - 05/28/2018-DI Men's Lacrosse Championship,2018.0
5,Duke (ACC),4,3-1,67,43,110,0.609,05/09/2018 - 05/28/2018-DI Men's Lacrosse Championship,2018.0
6,Canisius (MAAC),1,0-1,13,9,22,0.591,05/09/2018 - 05/28/2018-DI Men's Lacrosse Championship,2018.0
7,Denver (Big East),2,1-1,29,21,50,0.580,05/09/2018 - 05/28/2018-DI Men's Lacrosse Championship,2018.0
8,Yale (Ivy League),4,4-0,61,47,108,0.565,05/09/2018 - 05/28/2018-DI Men's Lacrosse Championship,2018.0
9,Virginia (ACC),1,0-1,14,15,29,0.483,05/09/2018 - 05/28/2018-DI Men's Lacrosse Championship,2018.0
10,Loyola Maryland (Patriot),2,1-1,20,26,46,0.435,05/09/2018 - 05/28/2018-DI Men's Lacrosse Championship,2018.0
11,Robert Morris (NEC),2,1-1,18,33,51,0.353,05/09/2018 - 05/28/2018-DI Men's Lacrosse Championship,2018.0
12,Massachusetts (CAA),1,0-1,10,20,30,0.333,05/09/2018 - 05/28/2018-DI Men's Lacrosse Championship,2018.0
13,Cornell (Ivy League),2,1-1,15,31,46,0.326,05/09/2018 - 05/28/2018-DI Men's Lacrosse Championship,2018.0
14,Johns Hopkins (Big Ten),2,1-1,15,33,48,0.313,05/09/2018 - 05/28/2018-DI Men's Lacrosse Championship,2018.0
15,Notre Dame (ACC),1,0-1,6,14,20,0.300,05/09/2018 - 05/28/2018-DI Men's Lacrosse Championship,2018.0
16,Villanova (Big East),1,0-1,7,25,32,0.219,05/09/2018 - 05/28/2018-DI Men's Lacrosse Championship,2018.0
17,Richmond (SoCon),1,0-1,6,24,30,0.200,05/09/2018 - 05/28/2018-DI Men's Lacrosse Championship,2018.0
1,UAlbany (America East),19,16-3,382,115,497,0.769,05/26/2018,2018.0
2,Denver (Big East),17,13-4,282,100,382,0.738,05/26/2018,2018.0
3,Jacksonville (SoCon),15,8-7,262,112,374,0.701,05/26/2018,2018.0
4,Bryant (NEC),15,8-7,247,119,366,0.675,05/26/2018,2018.0
5,Penn St. (Big Ten),14,8-6,234,123,357,0.655,05/26/2018,2018.0
6,Hobart (NEC),14,4-10,208,128,336,0.619,05/26/2018,2018.0
7,Yale (Ivy League),19,16-3,294,191,485,0.606,05/26/2018,2018.0
8,Towson (CAA),15,7-8,200,131,331,0.604,05/26/2018,2018.0
9,Colgate (Patriot),15,7-8,225,153,378,0.595,05/26/2018,2018.0
10,Lehigh (Patriot),17,10-7,236,163,399,0.591,05/26/2018,2018.0
11,Hartford (America East),13,3-10,195,135,330,0.591,05/26/2018,2018.0
12,Ohio St. (Big Ten),15,8-7,183,133,316,0.579,05/26/2018,2018.0
13,Virginia (ACC),18,12-6,282,207,489,0.577,05/26/2018,2018.0
14,Massachusetts (CAA),17,12-5,233,178,411,0.567,05/26/2018,2018.0
15,Holy Cross (Patriot),13,4-9,152,117,269,0.565,05/26/2018,2018.0
16,Marquette (Big East),14,6-8,165,129,294,0.561,05/26/2018,2018.0
17,Quinnipiac (MAAC),15,9-6,210,167,377,0.557,05/26/2018,2018.0
18,Navy (Patriot),14,9-5,166,134,300,0.553,05/26/2018,2018.0
19,Hofstra (CAA),14,6-8,152,125,277,0.549,05/26/2018,2018.0
20,Brown (Ivy League),15,6-9,218,186,404,0.540,05/26/2018,2018.0
21,Mount St. Mary's (NEC),14,5-9,203,174,377,0.538,05/26/2018,2018.0
22,Maryland (Big Ten),18,14-4,234,209,443,0.528,05/26/2018,2018.0
23,VMI (Southland),13,2-11,164,147,311,0.527,05/26/2018,2018.0
24,Air Force (SoCon),15,5-10,170,153,323,0.526,05/26/2018,2018.0
25,Notre Dame (ACC),15,9-6,173,156,329,0.526,05/26/2018,2018.0
26,Johns Hopkins (Big Ten),17,12-5,221,201,422,0.524,05/26/2018,2018.0
27,Duke (ACC),19,16-3,247,237,484,0.510,05/26/2018,2018.0
28,High Point (SoCon),14,6-8,191,184,375,0.509,05/26/2018,2018.0
29,Army West Point (Patriot),13,5-8,136,140,276,0.493,05/26/2018,2018.0
30,Michigan (Big Ten),14,8-6,160,166,326,0.491,05/26/2018,2018.0
31,Fairfield (CAA),15,4-11,167,175,342,0.488,05/26/2018,2018.0
32,Cleveland St. (Independent),14,4-10,158,166,324,0.488,05/26/2018,2018.0
33,Georgetown (Big East),17,12-5,188,198,386,0.487,05/26/2018,2018.0
34,Bellarmine (SoCon),13,4-9,129,136,265,0.487,05/26/2018,2018.0
35,Siena (MAAC),12,3-9,154,165,319,0.483,05/26/2018,2018.0
36,Syracuse (ACC),15,8-7,184,198,382,0.482,05/26/2018,2018.0
37,Princeton (Ivy League),13,8-5,180,195,375,0.480,05/26/2018,2018.0
38,Boston U. (Patriot),17,8-9,202,221,423,0.478,05/26/2018,2018.0
39,Lafayette (Patriot),15,3-12,176,193,369,0.477,05/26/2018,2018.0
40,Detroit Mercy (MAAC),16,9-7,173,190,363,0.477,05/26/2018,2018.0
41,Providence (Big East),15,5-10,161,177,338,0.476,05/26/2018,2018.0
42,Drexel (CAA),13,5-8,163,180,343,0.475,05/26/2018,2018.0
43,Sacred Heart (NEC),15,7-8,183,209,392,0.467,05/26/2018,2018.0
44,Harvard (Ivy League),13,7-6,159,182,341,0.466,05/26/2018,2018.0
45,Vermont (America East),16,12-4,156,183,339,0.460,05/26/2018,2018.0
46,Rutgers (Big Ten),15,9-6,167,196,363,0.460,05/26/2018,2018.0
47,Penn (Ivy League),15,7-8,159,187,346,0.460,05/26/2018,2018.0
48,Bucknell (Patriot),15,11-4,164,193,357,0.459,05/26/2018,2018.0
49,Delaware (CAA),14,6-8,156,188,344,0.453,05/26/2018,2018.0
50,Manhattan (MAAC),14,4-10,149,181,330,0.452,05/26/2018,2018.0
51,Marist (MAAC),15,3-12,156,192,348,0.448,05/26/2018,2018.0
52,Cornell (Ivy League),18,13-5,208,261,469,0.443,05/26/2018,2018.0
53,North Carolina (ACC),14,7-7,153,194,347,0.441,05/26/2018,2018.0
54,Mercer (SoCon),14,4-10,134,172,306,0.438,05/26/2018,2018.0
55,Saint Joseph's (NEC),15,11-4,139,179,318,0.437,05/26/2018,2018.0
56,St. John's (NY) (Big East),14,6-8,140,186,326,0.429,05/26/2018,2018.0
57,Loyola Maryland (Patriot),17,13-4,185,249,434,0.426,05/26/2018,2018.0
58,Villanova (Big East),16,10-6,172,232,404,0.426,05/26/2018,2018.0
59,Binghamton (America East),15,4-11,154,214,368,0.418,05/26/2018,2018.0
60,Richmond (SoCon),17,11-6,172,240,412,0.417,05/26/2018,2018.0
61,Hampton (DI Independent),12,4-8,124,176,300,0.413,05/26/2018,2018.0
62,Robert Morris (NEC),18,13-5,171,244,415,0.412,05/26/2018,2018.0
63,Wagner (NEC),14,4-10,118,169,287,0.411,05/26/2018,2018.0
64,Canisius (MAAC),17,8-9,187,282,469,0.399,05/26/2018,2018.0
65,Dartmouth (Ivy League),13,2-11,133,202,335,0.397,05/26/2018,2018.0
66,UMass Lowell (America East),16,8-8,145,235,380,0.382,05/26/2018,2018.0
67,Monmouth (MAAC),15,7-8,128,211,339,0.378,05/26/2018,2018.0
68,NJIT (Independent),16,1-15,128,223,351,0.365,05/26/2018,2018.0
69,UMBC (America East),13,5-8,84,153,237,0.354,05/26/2018,2018.0
1,UAlbany (America East),18,16-2,364,100,464,0.784,05/20/2018,2018.0
2,Denver (Big East),17,13-4,282,100,382,0.738,05/20/2018,2018.0
3,Jacksonville (SoCon),15,8-7,262,112,374,0.701,05/20/2018,2018.0
4,Bryant (NEC),15,8-7,247,119,366,0.675,05/20/2018,2018.0
5,Penn St. (Big Ten),14,8-6,234,123,357,0.655,05/20/2018,2018.0
6,Hobart (NEC),14,4-10,208,128,336,0.619,05/20/2018,2018.0
7,Yale (Ivy League),18,15-3,279,173,452,0.617,05/20/2018,2018.0
8,Towson (CAA),15,7-8,200,131,331,0.604,05/20/2018,2018.0
9,Colgate (Patriot),15,7-8,225,153,378,0.595,05/20/2018,2018.0
10,Lehigh (Patriot),17,10-7,236,163,399,0.591,05/20/2018,2018.0
11,Hartford (America East),13,3-10,195,135,330,0.591,05/20/2018,2018.0
12,Ohio St. (Big Ten),15,8-7,183,133,316,0.579,05/20/2018,2018.0
13,Virginia (ACC),18,12-6,282,207,489,0.577,05/20/2018,2018.0
14,Massachusetts (CAA),17,12-5,233,178,411,0.567,05/20/2018,2018.0
15,Holy Cross (Patriot),13,4-9,152,117,269,0.565,05/20/2018,2018.0
16,Marquette (Big East),14,6-8,165,129,294,0.561,05/20/2018,2018.0
17,Quinnipiac (MAAC),15,9-6,210,167,377,0.557,05/20/2018,2018.0
18,Navy (Patriot),14,9-5,166,134,300,0.553,05/20/2018,2018.0
19,Hofstra (CAA),14,6-8,152,125,277,0.549,05/20/2018,2018.0
20,Brown (Ivy League),15,6-9,218,186,404,0.540,05/20/2018,2018.0
21,Mount St. Mary's (NEC),14,5-9,203,174,377,0.538,05/20/2018,2018.0
22,VMI (Southland),13,2-11,164,147,311,0.527,05/20/2018,2018.0
23,Air Force (SoCon),15,5-10,170,153,323,0.526,05/20/2018,2018.0
24,Notre Dame (ACC),15,9-6,173,156,329,0.526,05/20/2018,2018.0
25,Maryland (Big Ten),17,14-3,219,199,418,0.524,05/20/2018,2018.0
26,Johns Hopkins (Big Ten),17,12-5,221,201,422,0.524,05/20/2018,2018.0
27,Duke (ACC),18,15-3,237,222,459,0.516,05/20/2018,2018.0
28,High Point (SoCon),14,6-8,191,184,375,0.509,05/20/2018,2018.0
29,Army West Point (Patriot),13,5-8,136,140,276,0.493,05/20/2018,2018.0
30,Michigan (Big Ten),14,8-6,160,166,326,0.491,05/20/2018,2018.0
31,Fairfield (CAA),15,4-11,167,175,342,0.488,05/20/2018,2018.0
32,Cleveland St. (Independent),14,4-10,158,166,324,0.488,05/20/2018,2018.0
33,Georgetown (Big East),17,12-5,188,198,386,0.487,05/20/2018,2018.0
34,Bellarmine (SoCon),13,4-9,129,136,265,0.487,05/20/2018,2018.0
35,Siena (MAAC),12,3-9,154,165,319,0.483,05/20/2018,2018.0
36,Syracuse (ACC),15,8-7,184,198,382,0.482,05/20/2018,2018.0
37,Princeton (Ivy League),13,8-5,180,195,375,0.480,05/20/2018,2018.0
38,Boston U. (Patriot),17,8-9,202,221,423,0.478,05/20/2018,2018.0
39,Lafayette (Patriot),15,3-12,176,193,369,0.477,05/20/2018,2018.0
40,Detroit Mercy (MAAC),16,9-7,173,190,363,0.477,05/20/2018,2018.0
41,Providence (Big East),15,5-10,161,177,338,0.476,05/20/2018,2018.0
42,Drexel (CAA),13,5-8,163,180,343,0.475,05/20/2018,2018.0
43,Sacred Heart (NEC),15,7-8,183,209,392,0.467,05/20/2018,2018.0
44,Harvard (Ivy League),13,7-6,159,182,341,0.466,05/20/2018,2018.0
45,Vermont (America East),16,12-4,156,183,339,0.460,05/20/2018,2018.0
46,Rutgers (Big Ten),15,9-6,167,196,363,0.460,05/20/2018,2018.0
47,Penn (Ivy League),15,7-8,159,187,346,0.460,05/20/2018,2018.0
48,Bucknell (Patriot),15,11-4,164,193,357,0.459,05/20/2018,2018.0
49,Delaware (CAA),14,6-8,156,188,344,0.453,05/20/2018,2018.0
50,Manhattan (MAAC),14,4-10,149,181,330,0.452,05/20/2018,2018.0
51,Marist (MAAC),15,3-12,156,192,348,0.448,05/20/2018,2018.0
52,Cornell (Ivy League),18,13-5,208,261,469,0.443,05/20/2018,2018.0
53,North Carolina (ACC),14,7-7,153,194,347,0.441,05/20/2018,2018.0
54,Mercer (SoCon),14,4-10,134,172,306,0.438,05/20/2018,2018.0
55,Saint Joseph's (NEC),15,11-4,139,179,318,0.437,05/20/2018,2018.0
56,St. John's (NY) (Big East),14,6-8,140,186,326,0.429,05/20/2018,2018.0
57,Loyola Maryland (Patriot),17,13-4,185,249,434,0.426,05/20/2018,2018.0
58,Villanova (Big East),16,10-6,172,232,404,0.426,05/20/2018,2018.0
59,Binghamton (America East),15,4-11,154,214,368,0.418,05/20/2018,2018.0
60,Richmond (SoCon),17,11-6,172,240,412,0.417,05/20/2018,2018.0
61,Hampton (DI Independent),12,4-8,124,176,300,0.413,05/20/2018,2018.0
62,Robert Morris (NEC),18,13-5,171,244,415,0.412,05/20/2018,2018.0
63,Wagner (NEC),14,4-10,118,169,287,0.411,05/20/2018,2018.0
64,Canisius (MAAC),17,8-9,187,282,469,0.399,05/20/2018,2018.0
65,Dartmouth (Ivy League),13,2-11,133,202,335,0.397,05/20/2018,2018.0
66,UMass Lowell (America East),16,8-8,145,235,380,0.382,05/20/2018,2018.0
67,Monmouth (MAAC),15,7-8,128,211,339,0.378,05/20/2018,2018.0
68,NJIT (Independent),16,1-15,128,223,351,0.365,05/20/2018,2018.0
69,UMBC (America East),13,5-8,84,153,237,0.354,05/20/2018,2018.0
1,UAlbany (America East),18,16-2,364,100,464,0.784,05/19/2018,2018.0
2,Denver (Big East),17,13-4,282,100,382,0.738,05/19/2018,2018.0
3,Jacksonville (SoCon),15,8-7,262,112,374,0.701,05/19/2018,2018.0
4,Bryant (NEC),15,8-7,247,119,366,0.675,05/19/2018,2018.0
5,Penn St. (Big Ten),14,8-6,234,123,357,0.655,05/19/2018,2018.0
6,Hobart (NEC),14,4-10,208,128,336,0.619,05/19/2018,2018.0
7,Yale (Ivy League),18,15-3,279,173,452,0.617,05/19/2018,2018.0
8,Towson (CAA),15,7-8,200,131,331,0.604,05/19/2018,2018.0
9,Colgate (Patriot),15,7-8,225,153,378,0.595,05/19/2018,2018.0
10,Lehigh (Patriot),17,10-7,236,163,399,0.591,05/19/2018,2018.0
11,Hartford (America East),13,3-10,195,135,330,0.591,05/19/2018,2018.0
12,Ohio St. (Big Ten),15,8-7,183,133,316,0.579,05/19/2018,2018.0
13,Virginia (ACC),18,12-6,282,207,489,0.577,05/19/2018,2018.0
14,Massachusetts (CAA),17,12-5,233,178,411,0.567,05/19/2018,2018.0
15,Holy Cross (Patriot),13,4-9,152,117,269,0.565,05/19/2018,2018.0
16,Marquette (Big East),14,6-8,165,129,294,0.561,05/19/2018,2018.0
17,Quinnipiac (MAAC),15,9-6,210,167,377,0.557,05/19/2018,2018.0
18,Navy (Patriot),14,9-5,166,134,300,0.553,05/19/2018,2018.0
19,Hofstra (CAA),14,6-8,152,125,277,0.549,05/19/2018,2018.0
20,Brown (Ivy League),15,6-9,218,186,404,0.540,05/19/2018,2018.0
21,Johns Hopkins (Big Ten),16,12-4,214,183,397,0.539,05/19/2018,2018.0
22,Mount St. Mary's (NEC),14,5-9,203,174,377,0.538,05/19/2018,2018.0
23,VMI (Southland),13,2-11,164,147,311,0.527,05/19/2018,2018.0
24,Air Force (SoCon),15,5-10,170,153,323,0.526,05/19/2018,2018.0
25,Notre Dame (ACC),15,9-6,173,156,329,0.526,05/19/2018,2018.0
26,Maryland (Big Ten),16,13-3,204,190,394,0.518,05/19/2018,2018.0
27,High Point (SoCon),14,6-8,191,184,375,0.509,05/19/2018,2018.0
28,Duke (ACC),17,14-3,219,215,434,0.505,05/19/2018,2018.0
29,Army West Point (Patriot),13,5-8,136,140,276,0.493,05/19/2018,2018.0
30,Michigan (Big Ten),14,8-6,160,166,326,0.491,05/19/2018,2018.0
31,Fairfield (CAA),15,4-11,167,175,342,0.488,05/19/2018,2018.0
32,Cleveland St. (Independent),14,4-10,158,166,324,0.488,05/19/2018,2018.0
33,Georgetown (Big East),17,12-5,188,198,386,0.487,05/19/2018,2018.0
34,Bellarmine (SoCon),13,4-9,129,136,265,0.487,05/19/2018,2018.0
35,Siena (MAAC),12,3-9,154,165,319,0.483,05/19/2018,2018.0
36,Syracuse (ACC),15,8-7,184,198,382,0.482,05/19/2018,2018.0
37,Princeton (Ivy League),13,8-5,180,195,375,0.480,05/19/2018,2018.0
38,Boston U. (Patriot),17,8-9,202,221,423,0.478,05/19/2018,2018.0
39,Lafayette (Patriot),15,3-12,176,193,369,0.477,05/19/2018,2018.0
40,Detroit Mercy (MAAC),16,9-7,173,190,363,0.477,05/19/2018,2018.0
41,Providence (Big East),15,5-10,161,177,338,0.476,05/19/2018,2018.0
42,Drexel (CAA),13,5-8,163,180,343,0.475,05/19/2018,2018.0
43,Sacred Heart (NEC),15,7-8,183,209,392,0.467,05/19/2018,2018.0
44,Harvard (Ivy League),13,7-6,159,182,341,0.466,05/19/2018,2018.0
45,Vermont (America East),16,12-4,156,183,339,0.460,05/19/2018,2018.0
46,Rutgers (Big Ten),15,9-6,167,196,363,0.460,05/19/2018,2018.0
47,Penn (Ivy League),15,7-8,159,187,346,0.460,05/19/2018,2018.0
48,Bucknell (Patriot),15,11-4,164,193,357,0.459,05/19/2018,2018.0
49,Delaware (CAA),14,6-8,156,188,344,0.453,05/19/2018,2018.0
50,Manhattan (MAAC),14,4-10,149,181,330,0.452,05/19/2018,2018.0
51,Marist (MAAC),15,3-12,156,192,348,0.448,05/19/2018,2018.0
52,Cornell (Ivy League),17,13-4,199,246,445,0.447,05/19/2018,2018.0
53,North Carolina (ACC),14,7-7,153,194,347,0.441,05/19/2018,2018.0
54,Mercer (SoCon),14,4-10,134,172,306,0.438,05/19/2018,2018.0
55,Saint Joseph's (NEC),15,11-4,139,179,318,0.437,05/19/2018,2018.0
56,St. John's (NY) (Big East),14,6-8,140,186,326,0.429,05/19/2018,2018.0
57,Loyola Maryland (Patriot),17,13-4,185,249,434,0.426,05/19/2018,2018.0
58,Villanova (Big East),16,10-6,172,232,404,0.426,05/19/2018,2018.0
59,Binghamton (America East),15,4-11,154,214,368,0.418,05/19/2018,2018.0
60,Richmond (SoCon),17,11-6,172,240,412,0.417,05/19/2018,2018.0
61,Hampton (DI Independent),12,4-8,124,176,300,0.413,05/19/2018,2018.0
62,Robert Morris (NEC),18,13-5,171,244,415,0.412,05/19/2018,2018.0
63,Wagner (NEC),14,4-10,118,169,287,0.411,05/19/2018,2018.0
64,Canisius (MAAC),17,8-9,187,282,469,0.399,05/19/2018,2018.0
65,Dartmouth (Ivy League),13,2-11,133,202,335,0.397,05/19/2018,2018.0
66,UMass Lowell (America East),16,8-8,145,235,380,0.382,05/19/2018,2018.0
67,Monmouth (MAAC),15,7-8,128,211,339,0.378,05/19/2018,2018.0
68,NJIT (Independent),16,1-15,128,223,351,0.365,05/19/2018,2018.0
69,UMBC (America East),13,5-8,84,153,237,0.354,05/19/2018,2018.0
1,UAlbany (America East),17,15-2,349,85,434,0.804,05/13/2018,2018.0
2,Denver (Big East),16,13-3,267,85,352,0.759,05/13/2018,2018.0
3,Jacksonville (SoCon),15,8-7,262,112,374,0.701,05/13/2018,2018.0
4,Bryant (NEC),15,8-7,247,119,366,0.675,05/13/2018,2018.0
5,Penn St. (Big Ten),14,8-6,234,123,357,0.655,05/13/2018,2018.0
6,Hobart (NEC),14,4-10,208,128,336,0.619,05/13/2018,2018.0
7,Yale (Ivy League),17,14-3,267,168,435,0.614,05/13/2018,2018.0
8,Towson (CAA),15,7-8,200,131,331,0.604,05/13/2018,2018.0
9,Colgate (Patriot),15,7-8,225,153,378,0.595,05/13/2018,2018.0
10,Lehigh (Patriot),17,10-7,236,163,399,0.591,05/13/2018,2018.0
11,Hartford (America East),13,3-10,195,135,330,0.591,05/13/2018,2018.0
12,Ohio St. (Big Ten),15,8-7,183,133,316,0.579,05/13/2018,2018.0
13,Virginia (ACC),18,12-6,282,207,489,0.577,05/13/2018,2018.0
14,Massachusetts (CAA),17,12-5,233,178,411,0.567,05/13/2018,2018.0
15,Holy Cross (Patriot),13,4-9,152,117,269,0.565,05/13/2018,2018.0
16,Marquette (Big East),14,6-8,165,129,294,0.561,05/13/2018,2018.0
17,Quinnipiac (MAAC),15,9-6,210,167,377,0.557,05/13/2018,2018.0
18,Navy (Patriot),14,9-5,166,134,300,0.553,05/13/2018,2018.0
19,Hofstra (CAA),14,6-8,152,125,277,0.549,05/13/2018,2018.0
20,Brown (Ivy League),15,6-9,218,186,404,0.540,05/13/2018,2018.0
21,Johns Hopkins (Big Ten),16,12-4,214,183,397,0.539,05/13/2018,2018.0
22,Mount St. Mary's (NEC),14,5-9,203,174,377,0.538,05/13/2018,2018.0
23,VMI (Southland),13,2-11,164,147,311,0.527,05/13/2018,2018.0
24,Air Force (SoCon),15,5-10,170,153,323,0.526,05/13/2018,2018.0
25,Notre Dame (ACC),15,9-6,173,156,329,0.526,05/13/2018,2018.0
26,Maryland (Big Ten),16,13-3,204,190,394,0.518,05/13/2018,2018.0
27,High Point (SoCon),14,6-8,191,184,375,0.509,05/13/2018,2018.0
28,Duke (ACC),17,14-3,219,215,434,0.505,05/13/2018,2018.0
29,Army West Point (Patriot),13,5-8,136,140,276,0.493,05/13/2018,2018.0
30,Michigan (Big Ten),14,8-6,160,166,326,0.491,05/13/2018,2018.0
31,Fairfield (CAA),15,4-11,167,175,342,0.488,05/13/2018,2018.0
32,Cleveland St. (Independent),14,4-10,158,166,324,0.488,05/13/2018,2018.0
33,Georgetown (Big East),17,12-5,188,198,386,0.487,05/13/2018,2018.0
34,Bellarmine (SoCon),13,4-9,129,136,265,0.487,05/13/2018,2018.0
35,Siena (MAAC),12,3-9,154,165,319,0.483,05/13/2018,2018.0
36,Syracuse (ACC),15,8-7,184,198,382,0.482,05/13/2018,2018.0
37,Princeton (Ivy League),13,8-5,180,195,375,0.480,05/13/2018,2018.0
38,Boston U. (Patriot),17,8-9,202,221,423,0.478,05/13/2018,2018.0
39,Lafayette (Patriot),15,3-12,176,193,369,0.477,05/13/2018,2018.0
40,Detroit Mercy (MAAC),16,9-7,173,190,363,0.477,05/13/2018,2018.0
41,Providence (Big East),15,5-10,161,177,338,0.476,05/13/2018,2018.0
42,Drexel (CAA),13,5-8,163,180,343,0.475,05/13/2018,2018.0
43,Sacred Heart (NEC),15,7-8,183,209,392,0.467,05/13/2018,2018.0
44,Harvard (Ivy League),13,7-6,159,182,341,0.466,05/13/2018,2018.0
45,Vermont (America East),16,12-4,156,183,339,0.460,05/13/2018,2018.0
46,Rutgers (Big Ten),15,9-6,167,196,363,0.460,05/13/2018,2018.0
47,Penn (Ivy League),15,7-8,159,187,346,0.460,05/13/2018,2018.0
48,Bucknell (Patriot),15,11-4,164,193,357,0.459,05/13/2018,2018.0
49,Delaware (CAA),14,6-8,156,188,344,0.453,05/13/2018,2018.0
50,Manhattan (MAAC),14,4-10,149,181,330,0.452,05/13/2018,2018.0
51,Marist (MAAC),15,3-12,156,192,348,0.448,05/13/2018,2018.0
52,Cornell (Ivy League),17,13-4,199,246,445,0.447,05/13/2018,2018.0
53,North Carolina (ACC),14,7-7,153,194,347,0.441,05/13/2018,2018.0
54,Mercer (SoCon),14,4-10,134,172,306,0.438,05/13/2018,2018.0
55,Saint Joseph's (NEC),15,11-4,139,179,318,0.437,05/13/2018,2018.0
56,Loyola Maryland (Patriot),16,13-3,180,237,417,0.432,05/13/2018,2018.0
57,St. John's (NY) (Big East),14,6-8,140,186,326,0.429,05/13/2018,2018.0
58,Villanova (Big East),16,10-6,172,232,404,0.426,05/13/2018,2018.0
59,Binghamton (America East),15,4-11,154,214,368,0.418,05/13/2018,2018.0
60,Richmond (SoCon),17,11-6,172,240,412,0.417,05/13/2018,2018.0
61,Hampton (DI Independent),12,4-8,124,176,300,0.413,05/13/2018,2018.0
62,Robert Morris (NEC),18,13-5,171,244,415,0.412,05/13/2018,2018.0
63,Wagner (NEC),14,4-10,118,169,287,0.411,05/13/2018,2018.0
64,Canisius (MAAC),17,8-9,187,282,469,0.399,05/13/2018,2018.0
65,Dartmouth (Ivy League),13,2-11,133,202,335,0.397,05/13/2018,2018.0
66,UMass Lowell (America East),16,8-8,145,235,380,0.382,05/13/2018,2018.0
67,Monmouth (MAAC),15,7-8,128,211,339,0.378,05/13/2018,2018.0
68,NJIT (Independent),16,1-15,128,223,351,0.365,05/13/2018,2018.0
69,UMBC (America East),13,5-8,84,153,237,0.354,05/13/2018,2018.0
1,UAlbany (America East),17,15-2,349,85,434,0.804,05/12/2018,2018.0
2,Denver (Big East),15,12-3,253,79,332,0.762,05/12/2018,2018.0
3,Jacksonville (SoCon),15,8-7,262,112,374,0.701,05/12/2018,2018.0
4,Bryant (NEC),15,8-7,247,119,366,0.675,05/12/2018,2018.0
5,Penn St. (Big Ten),14,8-6,234,123,357,0.655,05/12/2018,2018.0
6,Hobart (NEC),14,4-10,208,128,336,0.619,05/12/2018,2018.0
7,Yale (Ivy League),17,14-3,267,168,435,0.614,05/12/2018,2018.0
8,Towson (CAA),15,7-8,200,131,331,0.604,05/12/2018,2018.0
9,Colgate (Patriot),15,7-8,225,153,378,0.595,05/12/2018,2018.0
10,Lehigh (Patriot),17,10-7,236,163,399,0.591,05/12/2018,2018.0
11,Hartford (America East),13,3-10,195,135,330,0.591,05/12/2018,2018.0
12,Ohio St. (Big Ten),15,8-7,183,133,316,0.579,05/12/2018,2018.0
13,Virginia (ACC),18,12-6,282,207,489,0.577,05/12/2018,2018.0
14,Massachusetts (CAA),17,12-5,233,178,411,0.567,05/12/2018,2018.0
15,Holy Cross (Patriot),13,4-9,152,117,269,0.565,05/12/2018,2018.0
16,Marquette (Big East),14,6-8,165,129,294,0.561,05/12/2018,2018.0
17,Quinnipiac (MAAC),15,9-6,210,167,377,0.557,05/12/2018,2018.0
18,Navy (Patriot),14,9-5,166,134,300,0.553,05/12/2018,2018.0
19,Johns Hopkins (Big Ten),15,11-4,206,168,374,0.551,05/12/2018,2018.0
20,Hofstra (CAA),14,6-8,152,125,277,0.549,05/12/2018,2018.0
21,Notre Dame (ACC),14,9-5,167,142,309,0.540,05/12/2018,2018.0
22,Brown (Ivy League),15,6-9,218,186,404,0.540,05/12/2018,2018.0
23,Mount St. Mary's (NEC),14,5-9,203,174,377,0.538,05/12/2018,2018.0
24,VMI (Southland),13,2-11,164,147,311,0.527,05/12/2018,2018.0
25,Air Force (SoCon),15,5-10,170,153,323,0.526,05/12/2018,2018.0
26,High Point (SoCon),14,6-8,191,184,375,0.509,05/12/2018,2018.0
27,Duke (ACC),17,14-3,219,215,434,0.505,05/12/2018,2018.0
28,Maryland (Big Ten),15,12-3,184,181,365,0.504,05/12/2018,2018.0
29,Army West Point (Patriot),13,5-8,136,140,276,0.493,05/12/2018,2018.0
30,Michigan (Big Ten),14,8-6,160,166,326,0.491,05/12/2018,2018.0
31,Fairfield (CAA),15,4-11,167,175,342,0.488,05/12/2018,2018.0
32,Cleveland St. (Independent),14,4-10,158,166,324,0.488,05/12/2018,2018.0
33,Bellarmine (SoCon),13,4-9,129,136,265,0.487,05/12/2018,2018.0
34,Siena (MAAC),12,3-9,154,165,319,0.483,05/12/2018,2018.0
35,Princeton (Ivy League),13,8-5,180,195,375,0.480,05/12/2018,2018.0
36,Boston U. (Patriot),17,8-9,202,221,423,0.478,05/12/2018,2018.0
37,Lafayette (Patriot),15,3-12,176,193,369,0.477,05/12/2018,2018.0
38,Detroit Mercy (MAAC),16,9-7,173,190,363,0.477,05/12/2018,2018.0
38,Georgetown (Big East),16,12-4,173,190,363,0.477,05/12/2018,2018.0
40,Providence (Big East),15,5-10,161,177,338,0.476,05/12/2018,2018.0
41,Drexel (CAA),13,5-8,163,180,343,0.475,05/12/2018,2018.0
42,Sacred Heart (NEC),15,7-8,183,209,392,0.467,05/12/2018,2018.0
43,Syracuse (ACC),14,8-6,168,192,360,0.467,05/12/2018,2018.0
44,Harvard (Ivy League),13,7-6,159,182,341,0.466,05/12/2018,2018.0
45,Vermont (America East),16,12-4,156,183,339,0.460,05/12/2018,2018.0
46,Rutgers (Big Ten),15,9-6,167,196,363,0.460,05/12/2018,2018.0
47,Penn (Ivy League),15,7-8,159,187,346,0.460,05/12/2018,2018.0
48,Bucknell (Patriot),15,11-4,164,193,357,0.459,05/12/2018,2018.0
49,Cornell (Ivy League),16,12-4,193,230,423,0.456,05/12/2018,2018.0
50,Delaware (CAA),14,6-8,156,188,344,0.453,05/12/2018,2018.0
51,Manhattan (MAAC),14,4-10,149,181,330,0.452,05/12/2018,2018.0
52,Marist (MAAC),15,3-12,156,192,348,0.448,05/12/2018,2018.0
53,North Carolina (ACC),14,7-7,153,194,347,0.441,05/12/2018,2018.0
54,Mercer (SoCon),14,4-10,134,172,306,0.438,05/12/2018,2018.0
55,Saint Joseph's (NEC),15,11-4,139,179,318,0.437,05/12/2018,2018.0
56,Loyola Maryland (Patriot),16,13-3,180,237,417,0.432,05/12/2018,2018.0
57,St. John's (NY) (Big East),14,6-8,140,186,326,0.429,05/12/2018,2018.0
58,Villanova (Big East),16,10-6,172,232,404,0.426,05/12/2018,2018.0
59,Robert Morris (NEC),17,13-4,162,224,386,0.420,05/12/2018,2018.0
60,Binghamton (America East),15,4-11,154,214,368,0.418,05/12/2018,2018.0
61,Richmond (SoCon),17,11-6,172,240,412,0.417,05/12/2018,2018.0
62,Hampton (DI Independent),12,4-8,124,176,300,0.413,05/12/2018,2018.0
63,Wagner (NEC),14,4-10,118,169,287,0.411,05/12/2018,2018.0
64,Canisius (MAAC),17,8-9,187,282,469,0.399,05/12/2018,2018.0
65,Dartmouth (Ivy League),13,2-11,133,202,335,0.397,05/12/2018,2018.0
66,UMass Lowell (America East),16,8-8,145,235,380,0.382,05/12/2018,2018.0
67,Monmouth (MAAC),15,7-8,128,211,339,0.378,05/12/2018,2018.0
68,NJIT (Independent),16,1-15,128,223,351,0.365,05/12/2018,2018.0
69,UMBC (America East),13,5-8,84,153,237,0.354,05/12/2018,2018.0
1,UAlbany (America East),16,14-2,325,79,404,0.804,05/09/2018,2018.0
2,Denver (Big East),15,12-3,253,79,332,0.762,05/09/2018,2018.0
3,Jacksonville (SoCon),15,8-7,262,112,374,0.701,05/09/2018,2018.0
4,Bryant (NEC),15,8-7,247,119,366,0.675,05/09/2018,2018.0
5,Penn St. (Big Ten),14,8-6,234,123,357,0.655,05/09/2018,2018.0
6,Hobart (NEC),14,4-10,208,128,336,0.619,05/09/2018,2018.0
7,Yale (Ivy League),16,13-3,247,158,405,0.610,05/09/2018,2018.0
8,Towson (CAA),15,7-8,200,131,331,0.604,05/09/2018,2018.0
9,Colgate (Patriot),15,7-8,225,153,378,0.595,05/09/2018,2018.0
10,Lehigh (Patriot),17,10-7,236,163,399,0.591,05/09/2018,2018.0
11,Hartford (America East),13,3-10,195,135,330,0.591,05/09/2018,2018.0
12,Massachusetts (CAA),16,12-4,223,158,381,0.585,05/09/2018,2018.0
13,Virginia (ACC),17,12-5,268,192,460,0.583,05/09/2018,2018.0
14,Ohio St. (Big Ten),15,8-7,183,133,316,0.579,05/09/2018,2018.0
15,Holy Cross (Patriot),13,4-9,152,117,269,0.565,05/09/2018,2018.0
16,Marquette (Big East),14,6-8,165,129,294,0.561,05/09/2018,2018.0
17,Quinnipiac (MAAC),15,9-6,210,167,377,0.557,05/09/2018,2018.0
18,Navy (Patriot),14,9-5,166,134,300,0.553,05/09/2018,2018.0
19,Johns Hopkins (Big Ten),15,11-4,206,168,374,0.551,05/09/2018,2018.0
20,Hofstra (CAA),14,6-8,152,125,277,0.549,05/09/2018,2018.0
21,Notre Dame (ACC),14,9-5,167,142,309,0.540,05/09/2018,2018.0
22,Brown (Ivy League),15,6-9,218,186,404,0.540,05/09/2018,2018.0
23,Mount St. Mary's (NEC),14,5-9,203,174,377,0.538,05/09/2018,2018.0
24,VMI (Southland),13,2-11,164,147,311,0.527,05/09/2018,2018.0
25,Air Force (SoCon),15,5-10,170,153,323,0.526,05/09/2018,2018.0
26,High Point (SoCon),14,6-8,191,184,375,0.509,05/09/2018,2018.0
27,Maryland (Big Ten),15,12-3,184,181,365,0.504,05/09/2018,2018.0
28,Army West Point (Patriot),13,5-8,136,140,276,0.493,05/09/2018,2018.0
29,Michigan (Big Ten),14,8-6,160,166,326,0.491,05/09/2018,2018.0
30,Fairfield (CAA),15,4-11,167,175,342,0.488,05/09/2018,2018.0
31,Cleveland St. (Independent),14,4-10,158,166,324,0.488,05/09/2018,2018.0
32,Bellarmine (SoCon),13,4-9,129,136,265,0.487,05/09/2018,2018.0
33,Siena (MAAC),12,3-9,154,165,319,0.483,05/09/2018,2018.0
34,Duke (ACC),16,13-3,194,208,402,0.483,05/09/2018,2018.0
35,Princeton (Ivy League),13,8-5,180,195,375,0.480,05/09/2018,2018.0
36,Boston U. (Patriot),17,8-9,202,221,423,0.478,05/09/2018,2018.0
37,Lafayette (Patriot),15,3-12,176,193,369,0.477,05/09/2018,2018.0
38,Detroit Mercy (MAAC),16,9-7,173,190,363,0.477,05/09/2018,2018.0
38,Georgetown (Big East),16,12-4,173,190,363,0.477,05/09/2018,2018.0
40,Providence (Big East),15,5-10,161,177,338,0.476,05/09/2018,2018.0
41,Drexel (CAA),13,5-8,163,180,343,0.475,05/09/2018,2018.0
42,Sacred Heart (NEC),15,7-8,183,209,392,0.467,05/09/2018,2018.0
43,Syracuse (ACC),14,8-6,168,192,360,0.467,05/09/2018,2018.0
44,Harvard (Ivy League),13,7-6,159,182,341,0.466,05/09/2018,2018.0
45,Vermont (America East),16,12-4,156,183,339,0.460,05/09/2018,2018.0
46,Rutgers (Big Ten),15,9-6,167,196,363,0.460,05/09/2018,2018.0
47,Penn (Ivy League),15,7-8,159,187,346,0.460,05/09/2018,2018.0
48,Bucknell (Patriot),15,11-4,164,193,357,0.459,05/09/2018,2018.0
49,Cornell (Ivy League),16,12-4,193,230,423,0.456,05/09/2018,2018.0
50,Delaware (CAA),14,6-8,156,188,344,0.453,05/09/2018,2018.0
51,Manhattan (MAAC),14,4-10,149,181,330,0.452,05/09/2018,2018.0
52,Marist (MAAC),15,3-12,156,192,348,0.448,05/09/2018,2018.0
53,Villanova (Big East),15,10-5,165,207,372,0.444,05/09/2018,2018.0
54,North Carolina (ACC),14,7-7,153,194,347,0.441,05/09/2018,2018.0
55,Mercer (SoCon),14,4-10,134,172,306,0.438,05/09/2018,2018.0
56,Saint Joseph's (NEC),15,11-4,139,179,318,0.437,05/09/2018,2018.0
57,Richmond (SoCon),16,11-5,166,216,382,0.435,05/09/2018,2018.0
58,St. John's (NY) (Big East),14,6-8,140,186,326,0.429,05/09/2018,2018.0
59,Loyola Maryland (Patriot),15,12-3,165,223,388,0.425,05/09/2018,2018.0
60,Robert Morris (NEC),17,13-4,162,224,386,0.420,05/09/2018,2018.0
61,Binghamton (America East),15,4-11,154,214,368,0.418,05/09/2018,2018.0
62,Hampton (DI Independent),12,4-8,124,176,300,0.413,05/09/2018,2018.0
63,Wagner (NEC),14,4-10,118,169,287,0.411,05/09/2018,2018.0
64,Canisius (MAAC),17,8-9,187,282,469,0.399,05/09/2018,2018.0
65,Dartmouth (Ivy League),13,2-11,133,202,335,0.397,05/09/2018,2018.0
66,UMass Lowell (America East),16,8-8,145,235,380,0.382,05/09/2018,2018.0
67,Monmouth (MAAC),15,7-8,128,211,339,0.378,05/09/2018,2018.0
68,NJIT (Independent),16,1-15,128,223,351,0.365,05/09/2018,2018.0
69,UMBC (America East),13,5-8,84,153,237,0.354,05/09/2018,2018.0
1,UAlbany (America East),16,14-2,325,79,404,0.804,05/06/2018,2018.0
2,Denver (Big East),15,12-3,253,79,332,0.762,05/06/2018,2018.0
3,Jacksonville (SoCon),15,8-7,262,112,374,0.701,05/06/2018,2018.0
4,Bryant (NEC),15,8-7,247,119,366,0.675,05/06/2018,2018.0
5,Penn St. (Big Ten),14,8-6,234,123,357,0.655,05/06/2018,2018.0
6,Hobart (NEC),14,4-10,208,128,336,0.619,05/06/2018,2018.0
7,Yale (Ivy League),16,13-3,247,158,405,0.610,05/06/2018,2018.0
8,Towson (CAA),15,7-8,200,131,331,0.604,05/06/2018,2018.0
9,Colgate (Patriot),15,7-8,225,153,378,0.595,05/06/2018,2018.0
10,Lehigh (Patriot),17,10-7,236,163,399,0.591,05/06/2018,2018.0
11,Hartford (America East),13,3-10,195,135,330,0.591,05/06/2018,2018.0
12,Massachusetts (CAA),16,12-4,223,158,381,0.585,05/06/2018,2018.0
13,Virginia (ACC),17,12-5,268,192,460,0.583,05/06/2018,2018.0
14,Ohio St. (Big Ten),15,8-7,183,133,316,0.579,05/06/2018,2018.0
15,Holy Cross (Patriot),13,4-9,152,117,269,0.565,05/06/2018,2018.0
16,Marquette (Big East),14,6-8,165,129,294,0.561,05/06/2018,2018.0
17,Quinnipiac (MAAC),15,9-6,210,167,377,0.557,05/06/2018,2018.0
18,Navy (Patriot),14,9-5,166,134,300,0.553,05/06/2018,2018.0
19,Johns Hopkins (Big Ten),15,11-4,206,168,374,0.551,05/06/2018,2018.0
20,Hofstra (CAA),14,6-8,152,125,277,0.549,05/06/2018,2018.0
21,Notre Dame (ACC),14,9-5,167,142,309,0.540,05/06/2018,2018.0
22,Brown (Ivy League),15,6-9,218,186,404,0.540,05/06/2018,2018.0
23,Mount St. Mary's (NEC),14,5-9,201,176,377,0.533,05/06/2018,2018.0
24,VMI (Southland),13,2-11,164,147,311,0.527,05/06/2018,2018.0
25,Air Force (SoCon),15,5-10,170,153,323,0.526,05/06/2018,2018.0
26,High Point (SoCon),14,6-8,191,184,375,0.509,05/06/2018,2018.0
27,Maryland (Big Ten),15,12-3,184,181,365,0.504,05/06/2018,2018.0
28,Army West Point (Patriot),13,5-8,136,140,276,0.493,05/06/2018,2018.0
29,Michigan (Big Ten),14,8-6,160,166,326,0.491,05/06/2018,2018.0
30,Fairfield (CAA),15,4-11,167,175,342,0.488,05/06/2018,2018.0
31,Cleveland St. (Independent),14,4-10,158,166,324,0.488,05/06/2018,2018.0
32,Bellarmine (SoCon),13,4-9,129,136,265,0.487,05/06/2018,2018.0
33,Siena (MAAC),12,3-9,154,165,319,0.483,05/06/2018,2018.0
34,Duke (ACC),16,13-3,194,208,402,0.483,05/06/2018,2018.0
35,Princeton (Ivy League),13,8-5,180,195,375,0.480,05/06/2018,2018.0
36,Boston U. (Patriot),17,8-9,202,221,423,0.478,05/06/2018,2018.0
37,Lafayette (Patriot),15,3-12,176,193,369,0.477,05/06/2018,2018.0
38,Detroit Mercy (MAAC),16,9-7,173,190,363,0.477,05/06/2018,2018.0
38,Georgetown (Big East),16,12-4,173,190,363,0.477,05/06/2018,2018.0
40,Providence (Big East),15,5-10,161,177,338,0.476,05/06/2018,2018.0
41,Drexel (CAA),13,5-8,163,180,343,0.475,05/06/2018,2018.0
42,Sacred Heart (NEC),15,7-8,183,209,392,0.467,05/06/2018,2018.0
43,Syracuse (ACC),14,8-6,168,192,360,0.467,05/06/2018,2018.0
44,Harvard (Ivy League),13,7-6,159,182,341,0.466,05/06/2018,2018.0
45,Vermont (America East),16,12-4,156,183,339,0.460,05/06/2018,2018.0
46,Rutgers (Big Ten),15,9-6,167,196,363,0.460,05/06/2018,2018.0
47,Penn (Ivy League),15,7-8,159,187,346,0.460,05/06/2018,2018.0
48,Bucknell (Patriot),15,11-4,164,193,357,0.459,05/06/2018,2018.0
49,Cornell (Ivy League),16,12-4,193,230,423,0.456,05/06/2018,2018.0
50,Delaware (CAA),14,6-8,156,188,344,0.453,05/06/2018,2018.0
51,Manhattan (MAAC),14,4-10,149,181,330,0.452,05/06/2018,2018.0
52,Marist (MAAC),15,3-12,156,192,348,0.448,05/06/2018,2018.0
53,Villanova (Big East),15,10-5,165,207,372,0.444,05/06/2018,2018.0
54,North Carolina (ACC),14,7-7,153,194,347,0.441,05/06/2018,2018.0
55,Mercer (SoCon),14,4-10,134,172,306,0.438,05/06/2018,2018.0
56,Saint Joseph's (NEC),15,11-4,139,179,318,0.437,05/06/2018,2018.0
57,Richmond (SoCon),16,11-5,166,216,382,0.435,05/06/2018,2018.0
58,St. John's (NY) (Big East),14,6-8,140,186,326,0.429,05/06/2018,2018.0
59,Loyola Maryland (Patriot),15,12-3,165,223,388,0.425,05/06/2018,2018.0
60,Robert Morris (NEC),16,12-4,153,211,364,0.420,05/06/2018,2018.0
61,Binghamton (America East),15,4-11,154,214,368,0.418,05/06/2018,2018.0
62,Hampton (DI Independent),12,4-8,124,176,300,0.413,05/06/2018,2018.0
63,Wagner (NEC),14,4-10,118,169,287,0.411,05/06/2018,2018.0
64,Dartmouth (Ivy League),13,2-11,133,202,335,0.397,05/06/2018,2018.0
65,Canisius (MAAC),16,8-8,174,273,447,0.389,05/06/2018,2018.0
66,UMass Lowell (America East),16,8-8,145,235,380,0.382,05/06/2018,2018.0
67,Monmouth (MAAC),15,7-8,128,211,339,0.378,05/06/2018,2018.0
68,NJIT (Independent),16,1-15,128,223,351,0.365,05/06/2018,2018.0
69,UMBC (America East),13,5-8,86,151,237,0.363,05/06/2018,2018.0
1,UAlbany (America East),16,14-2,325,79,404,0.804,05/05/2018,2018.0
2,Denver (Big East),15,12-3,253,79,332,0.762,05/05/2018,2018.0
3,Jacksonville (SoCon),15,8-7,262,112,374,0.701,05/05/2018,2018.0
4,Bryant (NEC),15,8-7,247,119,366,0.675,05/05/2018,2018.0
5,Penn St. (Big Ten),14,8-6,234,123,357,0.655,05/05/2018,2018.0
6,Hobart (NEC),14,4-10,208,128,336,0.619,05/05/2018,2018.0
7,Yale (Ivy League),15,13-2,231,148,379,0.609,05/05/2018,2018.0
8,Towson (CAA),15,7-8,200,131,331,0.604,05/05/2018,2018.0
9,Colgate (Patriot),15,7-8,225,153,378,0.595,05/05/2018,2018.0
10,Lehigh (Patriot),17,10-7,236,163,399,0.591,05/05/2018,2018.0
11,Hartford (America East),13,3-10,195,135,330,0.591,05/05/2018,2018.0
12,Massachusetts (CAA),16,12-4,223,158,381,0.585,05/05/2018,2018.0
13,Virginia (ACC),17,12-5,268,192,460,0.583,05/05/2018,2018.0
14,Ohio St. (Big Ten),15,8-7,183,133,316,0.579,05/05/2018,2018.0
15,Holy Cross (Patriot),13,4-9,152,117,269,0.565,05/05/2018,2018.0
16,Marquette (Big East),14,6-8,165,129,294,0.561,05/05/2018,2018.0
17,Quinnipiac (MAAC),15,9-6,210,167,377,0.557,05/05/2018,2018.0
18,Navy (Patriot),14,9-5,166,134,300,0.553,05/05/2018,2018.0
19,Johns Hopkins (Big Ten),15,11-4,206,168,374,0.551,05/05/2018,2018.0
20,Hofstra (CAA),14,6-8,152,125,277,0.549,05/05/2018,2018.0
21,Notre Dame (ACC),14,9-5,167,142,309,0.540,05/05/2018,2018.0
22,Brown (Ivy League),15,6-9,218,186,404,0.540,05/05/2018,2018.0
23,Mount St. Mary's (NEC),14,5-9,201,176,377,0.533,05/05/2018,2018.0
24,VMI (Southland),13,2-11,164,147,311,0.527,05/05/2018,2018.0
25,Air Force (SoCon),15,5-10,170,153,323,0.526,05/05/2018,2018.0
26,High Point (SoCon),14,6-8,191,184,375,0.509,05/05/2018,2018.0
27,Maryland (Big Ten),15,12-3,184,181,365,0.504,05/05/2018,2018.0
28,Army West Point (Patriot),13,5-8,136,140,276,0.493,05/05/2018,2018.0
29,Duke (ACC),15,12-3,185,191,376,0.492,05/05/2018,2018.0
30,Michigan (Big Ten),14,8-6,160,166,326,0.491,05/05/2018,2018.0
31,Fairfield (CAA),15,4-11,167,175,342,0.488,05/05/2018,2018.0
32,Cleveland St. (Independent),14,4-10,158,166,324,0.488,05/05/2018,2018.0
33,Bellarmine (SoCon),13,4-9,129,136,265,0.487,05/05/2018,2018.0
34,Siena (MAAC),12,3-9,154,165,319,0.483,05/05/2018,2018.0
35,Princeton (Ivy League),13,8-5,180,195,375,0.480,05/05/2018,2018.0
36,Lafayette (Patriot),15,3-12,176,193,369,0.477,05/05/2018,2018.0
37,Georgetown (Big East),16,12-4,173,190,363,0.477,05/05/2018,2018.0
37,Detroit Mercy (MAAC),16,9-7,173,190,363,0.477,05/05/2018,2018.0
39,Providence (Big East),15,5-10,161,177,338,0.476,05/05/2018,2018.0
40,Drexel (CAA),13,5-8,163,180,343,0.475,05/05/2018,2018.0
41,Sacred Heart (NEC),15,7-8,183,209,392,0.467,05/05/2018,2018.0
42,Syracuse (ACC),14,8-6,168,192,360,0.467,05/05/2018,2018.0
43,Harvard (Ivy League),13,7-6,159,182,341,0.466,05/05/2018,2018.0
44,Boston U. (Patriot),16,8-8,185,212,397,0.466,05/05/2018,2018.0
45,Cornell (Ivy League),15,11-4,183,214,397,0.461,05/05/2018,2018.0
46,Vermont (America East),16,12-4,156,183,339,0.460,05/05/2018,2018.0
47,Rutgers (Big Ten),15,9-6,167,196,363,0.460,05/05/2018,2018.0
48,Penn (Ivy League),15,7-8,159,187,346,0.460,05/05/2018,2018.0
49,Bucknell (Patriot),15,11-4,164,193,357,0.459,05/05/2018,2018.0
50,Delaware (CAA),14,6-8,156,188,344,0.453,05/05/2018,2018.0
51,Manhattan (MAAC),14,4-10,149,181,330,0.452,05/05/2018,2018.0
52,Marist (MAAC),15,3-12,156,192,348,0.448,05/05/2018,2018.0
53,Villanova (Big East),15,10-5,165,207,372,0.444,05/05/2018,2018.0
54,North Carolina (ACC),14,7-7,153,194,347,0.441,05/05/2018,2018.0
55,Mercer (SoCon),14,4-10,134,172,306,0.438,05/05/2018,2018.0
56,Saint Joseph's (NEC),14,11-3,130,168,298,0.436,05/05/2018,2018.0
57,Richmond (SoCon),16,11-5,166,216,382,0.435,05/05/2018,2018.0
58,St. John's (NY) (Big East),14,6-8,140,186,326,0.429,05/05/2018,2018.0
59,Loyola Maryland (Patriot),15,12-3,165,223,388,0.425,05/05/2018,2018.0
60,Binghamton (America East),15,4-11,154,214,368,0.418,05/05/2018,2018.0
61,Hampton (DI Independent),12,4-8,124,176,300,0.413,05/05/2018,2018.0
62,Robert Morris (NEC),15,11-4,142,202,344,0.413,05/05/2018,2018.0
63,Wagner (NEC),14,4-10,118,169,287,0.411,05/05/2018,2018.0
64,Dartmouth (Ivy League),13,2-11,133,202,335,0.397,05/05/2018,2018.0
65,Canisius (MAAC),16,8-8,174,273,447,0.389,05/05/2018,2018.0
66,UMass Lowell (America East),16,8-8,145,235,380,0.382,05/05/2018,2018.0
67,Monmouth (MAAC),15,7-8,128,211,339,0.378,05/05/2018,2018.0
68,NJIT (Independent),16,1-15,128,223,351,0.365,05/05/2018,2018.0
69,UMBC (America East),13,5-8,86,151,237,0.363,05/05/2018,2018.0
1,UAlbany (America East),15,13-2,304,79,383,0.794,05/04/2018,2018.0
2,Denver (Big East),14,12-2,242,75,317,0.763,05/04/2018,2018.0
3,Jacksonville (SoCon),14,8-6,246,103,349,0.705,05/04/2018,2018.0
4,Bryant (NEC),15,8-7,247,119,366,0.675,05/04/2018,2018.0
5,Penn St. (Big Ten),14,8-6,234,123,357,0.655,05/04/2018,2018.0
6,Hobart (NEC),14,4-10,208,128,336,0.619,05/04/2018,2018.0
7,Yale (Ivy League),15,13-2,231,148,379,0.609,05/04/2018,2018.0
8,Colgate (Patriot),14,7-7,213,139,352,0.605,05/04/2018,2018.0
9,Towson (CAA),14,7-7,186,122,308,0.604,05/04/2018,2018.0
10,Massachusetts (CAA),15,11-4,214,144,358,0.598,05/04/2018,2018.0
11,Lehigh (Patriot),17,10-7,236,163,399,0.591,05/04/2018,2018.0
12,Hartford (America East),13,3-10,195,135,330,0.591,05/04/2018,2018.0
13,Virginia (ACC),17,12-5,268,192,460,0.583,05/04/2018,2018.0
14,Ohio St. (Big Ten),15,8-7,183,133,316,0.579,05/04/2018,2018.0
15,Holy Cross (Patriot),13,4-9,152,117,269,0.565,05/04/2018,2018.0
16,Marquette (Big East),14,6-8,165,129,294,0.561,05/04/2018,2018.0
17,Quinnipiac (MAAC),15,9-6,210,167,377,0.557,05/04/2018,2018.0
18,Navy (Patriot),14,9-5,166,134,300,0.553,05/04/2018,2018.0
19,Johns Hopkins (Big Ten),14,10-4,191,156,347,0.550,05/04/2018,2018.0
20,Hofstra (CAA),14,6-8,152,125,277,0.549,05/04/2018,2018.0
21,Brown (Ivy League),15,6-9,218,186,404,0.540,05/04/2018,2018.0
22,Mount St. Mary's (NEC),14,5-9,201,176,377,0.533,05/04/2018,2018.0
23,VMI (Southland),13,2-11,164,147,311,0.527,05/04/2018,2018.0
24,Air Force (SoCon),15,5-10,170,153,323,0.526,05/04/2018,2018.0
25,Army West Point (Patriot),12,5-7,130,119,249,0.522,05/04/2018,2018.0
26,Notre Dame (ACC),13,8-5,146,136,282,0.518,05/04/2018,2018.0
27,High Point (SoCon),14,6-8,191,184,375,0.509,05/04/2018,2018.0
28,Maryland (Big Ten),14,12-2,172,166,338,0.509,05/04/2018,2018.0
29,Duke (ACC),15,12-3,185,191,376,0.492,05/04/2018,2018.0
30,Michigan (Big Ten),14,8-6,160,166,326,0.491,05/04/2018,2018.0
31,Vermont (America East),15,12-3,156,162,318,0.491,05/04/2018,2018.0
32,Fairfield (CAA),15,4-11,167,175,342,0.488,05/04/2018,2018.0
33,Cleveland St. (Independent),14,4-10,158,166,324,0.488,05/04/2018,2018.0
34,Bellarmine (SoCon),13,4-9,129,136,265,0.487,05/04/2018,2018.0
35,Georgetown (Big East),15,11-4,169,179,348,0.486,05/04/2018,2018.0
36,Siena (MAAC),12,3-9,154,165,319,0.483,05/04/2018,2018.0
37,Princeton (Ivy League),13,8-5,180,195,375,0.480,05/04/2018,2018.0
38,Lafayette (Patriot),15,3-12,176,193,369,0.477,05/04/2018,2018.0
39,Providence (Big East),15,5-10,161,177,338,0.476,05/04/2018,2018.0
40,Drexel (CAA),13,5-8,163,180,343,0.475,05/04/2018,2018.0
41,Detroit Mercy (MAAC),15,9-6,159,181,340,0.468,05/04/2018,2018.0
42,Sacred Heart (NEC),15,7-8,183,209,392,0.467,05/04/2018,2018.0
43,Harvard (Ivy League),13,7-6,159,182,341,0.466,05/04/2018,2018.0
44,Boston U. (Patriot),16,8-8,185,212,397,0.466,05/04/2018,2018.0
45,Syracuse (ACC),13,7-6,154,180,334,0.461,05/04/2018,2018.0
46,Cornell (Ivy League),15,11-4,183,214,397,0.461,05/04/2018,2018.0
47,Rutgers (Big Ten),15,9-6,167,196,363,0.460,05/04/2018,2018.0
48,Penn (Ivy League),15,7-8,159,187,346,0.460,05/04/2018,2018.0
49,Bucknell (Patriot),15,11-4,164,193,357,0.459,05/04/2018,2018.0
50,Delaware (CAA),14,6-8,156,188,344,0.453,05/04/2018,2018.0
51,Manhattan (MAAC),14,4-10,149,181,330,0.452,05/04/2018,2018.0
52,Marist (MAAC),15,3-12,156,192,348,0.448,05/04/2018,2018.0
53,Villanova (Big East),15,10-5,165,207,372,0.444,05/04/2018,2018.0
54,North Carolina (ACC),14,7-7,153,194,347,0.441,05/04/2018,2018.0
55,Richmond (SoCon),15,10-5,157,200,357,0.440,05/04/2018,2018.0
56,Mercer (SoCon),14,4-10,134,172,306,0.438,05/04/2018,2018.0
57,Saint Joseph's (NEC),14,11-3,130,168,298,0.436,05/04/2018,2018.0
58,St. John's (NY) (Big East),14,6-8,140,186,326,0.429,05/04/2018,2018.0
59,Loyola Maryland (Patriot),15,12-3,165,223,388,0.425,05/04/2018,2018.0
60,Binghamton (America East),15,4-11,154,214,368,0.418,05/04/2018,2018.0
61,Hampton (DI Independent),12,4-8,124,176,300,0.413,05/04/2018,2018.0
62,Robert Morris (NEC),15,11-4,142,202,344,0.413,05/04/2018,2018.0
63,Wagner (NEC),14,4-10,118,169,287,0.411,05/04/2018,2018.0
64,Dartmouth (Ivy League),13,2-11,133,202,335,0.397,05/04/2018,2018.0
65,Canisius (MAAC),15,7-8,165,259,424,0.389,05/04/2018,2018.0
66,UMass Lowell (America East),16,8-8,145,235,380,0.382,05/04/2018,2018.0
67,Monmouth (MAAC),15,7-8,128,211,339,0.378,05/04/2018,2018.0
68,NJIT (Independent),16,1-15,128,223,351,0.365,05/04/2018,2018.0
69,UMBC (America East),13,5-8,86,151,237,0.363,05/04/2018,2018.0
1,UAlbany (America East),15,13-2,304,79,383,0.794,05/03/2018,2018.0
2,Denver (Big East),14,12-2,242,75,317,0.763,05/03/2018,2018.0
3,Jacksonville (SoCon),14,8-6,246,103,349,0.705,05/03/2018,2018.0
4,Bryant (NEC),15,8-7,247,119,366,0.675,05/03/2018,2018.0
5,Penn St. (Big Ten),14,8-6,234,123,357,0.655,05/03/2018,2018.0
6,Hobart (NEC),14,4-10,208,128,336,0.619,05/03/2018,2018.0
7,Yale (Ivy League),14,12-2,215,134,349,0.616,05/03/2018,2018.0
8,Colgate (Patriot),14,7-7,213,139,352,0.605,05/03/2018,2018.0
9,Towson (CAA),14,7-7,186,122,308,0.604,05/03/2018,2018.0
10,Massachusetts (CAA),15,11-4,214,144,358,0.598,05/03/2018,2018.0
11,Lehigh (Patriot),17,10-7,236,163,399,0.591,05/03/2018,2018.0
12,Hartford (America East),13,3-10,195,135,330,0.591,05/03/2018,2018.0
13,Virginia (ACC),17,12-5,268,192,460,0.583,05/03/2018,2018.0
14,Ohio St. (Big Ten),15,8-7,183,133,316,0.579,05/03/2018,2018.0
15,Holy Cross (Patriot),13,4-9,152,117,269,0.565,05/03/2018,2018.0
16,Marquette (Big East),14,6-8,165,129,294,0.561,05/03/2018,2018.0
17,Quinnipiac (MAAC),15,9-6,210,167,377,0.557,05/03/2018,2018.0
18,Navy (Patriot),14,9-5,166,134,300,0.553,05/03/2018,2018.0
19,Johns Hopkins (Big Ten),14,10-4,191,156,347,0.550,05/03/2018,2018.0
20,Hofstra (CAA),14,6-8,152,125,277,0.549,05/03/2018,2018.0
21,Brown (Ivy League),14,6-8,209,181,390,0.536,05/03/2018,2018.0
22,Mount St. Mary's (NEC),14,5-9,201,176,377,0.533,05/03/2018,2018.0
23,VMI (Southland),13,2-11,164,147,311,0.527,05/03/2018,2018.0
24,Air Force (SoCon),15,5-10,170,153,323,0.526,05/03/2018,2018.0
25,Army West Point (Patriot),12,5-7,130,119,249,0.522,05/03/2018,2018.0
26,Notre Dame (ACC),13,8-5,146,136,282,0.518,05/03/2018,2018.0
27,High Point (SoCon),14,6-8,191,184,375,0.509,05/03/2018,2018.0
28,Maryland (Big Ten),14,12-2,172,166,338,0.509,05/03/2018,2018.0
29,Duke (ACC),15,12-3,185,191,376,0.492,05/03/2018,2018.0
30,Michigan (Big Ten),14,8-6,160,166,326,0.491,05/03/2018,2018.0
31,Vermont (America East),15,12-3,156,162,318,0.491,05/03/2018,2018.0
32,Fairfield (CAA),15,4-11,167,175,342,0.488,05/03/2018,2018.0
33,Cleveland St. (Independent),14,4-10,158,166,324,0.488,05/03/2018,2018.0
34,Bellarmine (SoCon),13,4-9,129,136,265,0.487,05/03/2018,2018.0
35,Georgetown (Big East),15,11-4,169,179,348,0.486,05/03/2018,2018.0
36,Siena (MAAC),12,3-9,154,165,319,0.483,05/03/2018,2018.0
37,Princeton (Ivy League),13,8-5,180,195,375,0.480,05/03/2018,2018.0
38,Lafayette (Patriot),15,3-12,176,193,369,0.477,05/03/2018,2018.0
39,Providence (Big East),15,5-10,161,177,338,0.476,05/03/2018,2018.0
40,Drexel (CAA),13,5-8,163,180,343,0.475,05/03/2018,2018.0
41,Detroit Mercy (MAAC),15,9-6,159,181,340,0.468,05/03/2018,2018.0
42,Sacred Heart (NEC),15,7-8,183,209,392,0.467,05/03/2018,2018.0
43,Harvard (Ivy League),13,7-6,159,182,341,0.466,05/03/2018,2018.0
44,Boston U. (Patriot),16,8-8,185,212,397,0.466,05/03/2018,2018.0
45,Cornell (Ivy League),14,10-4,178,205,383,0.465,05/03/2018,2018.0
46,Syracuse (ACC),13,7-6,154,180,334,0.461,05/03/2018,2018.0
47,Rutgers (Big Ten),15,9-6,167,196,363,0.460,05/03/2018,2018.0
48,Bucknell (Patriot),15,11-4,164,193,357,0.459,05/03/2018,2018.0
49,Penn (Ivy League),14,7-7,145,171,316,0.459,05/03/2018,2018.0
50,Delaware (CAA),14,6-8,156,188,344,0.453,05/03/2018,2018.0
51,Manhattan (MAAC),14,4-10,149,181,330,0.452,05/03/2018,2018.0
52,Marist (MAAC),15,3-12,156,192,348,0.448,05/03/2018,2018.0
53,Villanova (Big East),15,10-5,165,207,372,0.444,05/03/2018,2018.0
54,North Carolina (ACC),14,7-7,153,194,347,0.441,05/03/2018,2018.0
55,Richmond (SoCon),15,10-5,157,200,357,0.440,05/03/2018,2018.0
56,Mercer (SoCon),14,4-10,134,172,306,0.438,05/03/2018,2018.0
57,Saint Joseph's (NEC),14,11-3,130,168,298,0.436,05/03/2018,2018.0
58,St. John's (NY) (Big East),14,6-8,140,186,326,0.429,05/03/2018,2018.0
59,Loyola Maryland (Patriot),15,12-3,165,223,388,0.425,05/03/2018,2018.0
60,Binghamton (America East),15,4-11,154,214,368,0.418,05/03/2018,2018.0
61,Hampton (DI Independent),12,4-8,124,176,300,0.413,05/03/2018,2018.0
62,Robert Morris (NEC),15,11-4,142,202,344,0.413,05/03/2018,2018.0
63,Wagner (NEC),14,4-10,118,169,287,0.411,05/03/2018,2018.0
64,Dartmouth (Ivy League),13,2-11,133,202,335,0.397,05/03/2018,2018.0
65,Canisius (MAAC),15,7-8,165,259,424,0.389,05/03/2018,2018.0
66,UMass Lowell (America East),16,8-8,145,235,380,0.382,05/03/2018,2018.0
67,Monmouth (MAAC),15,7-8,128,211,339,0.378,05/03/2018,2018.0
68,NJIT (Independent),16,1-15,128,223,351,0.365,05/03/2018,2018.0
69,UMBC (America East),13,5-8,86,151,237,0.363,05/03/2018,2018.0
1,UAlbany (America East),14,12-2,276,78,354,0.780,05/01/2018,2018.0
2,Denver (Big East),13,11-2,228,68,296,0.770,05/01/2018,2018.0
3,Jacksonville (SoCon),13,7-6,229,94,323,0.709,05/01/2018,2018.0
4,Bryant (NEC),14,8-6,230,116,346,0.665,05/01/2018,2018.0
5,Penn St. (Big Ten),14,8-6,234,123,357,0.655,05/01/2018,2018.0
6,Hobart (NEC),14,4-10,208,128,336,0.619,05/01/2018,2018.0
7,Yale (Ivy League),14,12-2,215,134,349,0.616,05/01/2018,2018.0
8,Colgate (Patriot),14,7-7,213,139,352,0.605,05/01/2018,2018.0
9,Massachusetts (CAA),14,10-4,202,136,338,0.598,05/01/2018,2018.0
10,Towson (CAA),13,6-7,170,117,287,0.592,05/01/2018,2018.0
11,Lehigh (Patriot),17,10-7,236,163,399,0.591,05/01/2018,2018.0
12,Hartford (America East),13,3-10,195,135,330,0.591,05/01/2018,2018.0
13,Virginia (ACC),17,12-5,268,192,460,0.583,05/01/2018,2018.0
14,Marquette (Big East),13,6-7,158,115,273,0.579,05/01/2018,2018.0
15,Ohio St. (Big Ten),14,8-6,172,130,302,0.570,05/01/2018,2018.0
16,Holy Cross (Patriot),13,4-9,152,117,269,0.565,05/01/2018,2018.0
17,Johns Hopkins (Big Ten),13,9-4,188,145,333,0.565,05/01/2018,2018.0
18,Hofstra (CAA),13,6-7,144,113,257,0.560,05/01/2018,2018.0
19,Navy (Patriot),14,9-5,166,134,300,0.553,05/01/2018,2018.0
20,Quinnipiac (MAAC),14,9-5,191,161,352,0.543,05/01/2018,2018.0
21,Brown (Ivy League),14,6-8,209,181,390,0.536,05/01/2018,2018.0
22,Mount St. Mary's (NEC),14,5-9,201,176,377,0.533,05/01/2018,2018.0
23,VMI (Southland),13,2-11,164,147,311,0.527,05/01/2018,2018.0
24,Air Force (SoCon),15,5-10,170,153,323,0.526,05/01/2018,2018.0
25,Army West Point (Patriot),12,5-7,130,119,249,0.522,05/01/2018,2018.0
26,High Point (SoCon),13,6-7,182,167,349,0.521,05/01/2018,2018.0
27,Notre Dame (ACC),13,8-5,146,136,282,0.518,05/01/2018,2018.0
28,Maryland (Big Ten),13,11-2,158,156,314,0.503,05/01/2018,2018.0
29,Duke (ACC),15,12-3,185,191,376,0.492,05/01/2018,2018.0
30,Michigan (Big Ten),14,8-6,160,166,326,0.491,05/01/2018,2018.0
31,Vermont (America East),14,11-3,148,155,303,0.488,05/01/2018,2018.0
32,Fairfield (CAA),15,4-11,167,175,342,0.488,05/01/2018,2018.0
33,Cleveland St. (Independent),14,4-10,158,166,324,0.488,05/01/2018,2018.0
34,Bellarmine (SoCon),13,4-9,129,136,265,0.487,05/01/2018,2018.0
35,Siena (MAAC),12,3-9,154,165,319,0.483,05/01/2018,2018.0
36,Princeton (Ivy League),13,8-5,180,195,375,0.480,05/01/2018,2018.0
37,Lafayette (Patriot),15,3-12,176,193,369,0.477,05/01/2018,2018.0
38,Providence (Big East),15,5-10,161,177,338,0.476,05/01/2018,2018.0
39,Drexel (CAA),13,5-8,163,180,343,0.475,05/01/2018,2018.0
40,Delaware (CAA),13,6-7,151,172,323,0.467,05/01/2018,2018.0
41,Harvard (Ivy League),13,7-6,159,182,341,0.466,05/01/2018,2018.0
42,Boston U. (Patriot),16,8-8,185,212,397,0.466,05/01/2018,2018.0
43,Cornell (Ivy League),14,10-4,178,205,383,0.465,05/01/2018,2018.0
44,Sacred Heart (NEC),14,7-7,171,197,368,0.465,05/01/2018,2018.0
45,Georgetown (Big East),14,10-4,150,173,323,0.464,05/01/2018,2018.0
46,Rutgers (Big Ten),14,9-5,157,182,339,0.463,05/01/2018,2018.0
47,Syracuse (ACC),13,7-6,154,180,334,0.461,05/01/2018,2018.0
48,Bucknell (Patriot),15,11-4,164,193,357,0.459,05/01/2018,2018.0
49,Penn (Ivy League),14,7-7,145,171,316,0.459,05/01/2018,2018.0
50,Villanova (Big East),14,10-4,159,188,347,0.458,05/01/2018,2018.0
51,Manhattan (MAAC),14,4-10,149,181,330,0.452,05/01/2018,2018.0
52,Detroit Mercy (MAAC),14,8-6,142,173,315,0.451,05/01/2018,2018.0
53,Marist (MAAC),15,3-12,156,192,348,0.448,05/01/2018,2018.0
54,North Carolina (ACC),14,7-7,153,194,347,0.441,05/01/2018,2018.0
55,Mercer (SoCon),14,4-10,134,172,306,0.438,05/01/2018,2018.0
56,Saint Joseph's (NEC),13,10-3,118,156,274,0.431,05/01/2018,2018.0
57,St. John's (NY) (Big East),14,6-8,140,186,326,0.429,05/01/2018,2018.0
58,Robert Morris (NEC),14,10-4,139,185,324,0.429,05/01/2018,2018.0
59,Richmond (SoCon),14,9-5,141,190,331,0.426,05/01/2018,2018.0
60,Loyola Maryland (Patriot),15,12-3,165,223,388,0.425,05/01/2018,2018.0
61,Binghamton (America East),15,4-11,154,214,368,0.418,05/01/2018,2018.0
62,Hampton (DI Independent),12,4-8,124,176,300,0.413,05/01/2018,2018.0
63,Wagner (NEC),14,4-10,118,169,287,0.411,05/01/2018,2018.0
64,UMass Lowell (America East),15,8-7,144,207,351,0.410,05/01/2018,2018.0
65,Canisius (MAAC),14,6-8,159,240,399,0.398,05/01/2018,2018.0
66,Dartmouth (Ivy League),13,2-11,133,202,335,0.397,05/01/2018,2018.0
67,Monmouth (MAAC),14,7-7,120,194,314,0.382,05/01/2018,2018.0
68,NJIT (Independent),16,1-15,128,223,351,0.365,05/01/2018,2018.0
69,UMBC (America East),13,5-8,86,151,237,0.363,05/01/2018,2018.0
1,UAlbany (America East),14,12-2,276,78,354,0.780,04/29/2018,2018.0
2,Denver (Big East),13,11-2,228,68,296,0.770,04/29/2018,2018.0
3,Jacksonville (SoCon),13,7-6,229,94,323,0.709,04/29/2018,2018.0
4,Bryant (NEC),14,8-6,230,116,346,0.665,04/29/2018,2018.0
5,Penn St. (Big Ten),14,8-6,234,123,357,0.655,04/29/2018,2018.0
6,Hobart (NEC),14,4-10,208,128,336,0.619,04/29/2018,2018.0
7,Yale (Ivy League),14,12-2,215,134,349,0.616,04/29/2018,2018.0
8,Colgate (Patriot),14,7-7,213,139,352,0.605,04/29/2018,2018.0
9,Massachusetts (CAA),14,10-4,202,136,338,0.598,04/29/2018,2018.0
10,Towson (CAA),13,6-7,170,117,287,0.592,04/29/2018,2018.0
11,Lehigh (Patriot),17,10-7,236,163,399,0.591,04/29/2018,2018.0
12,Hartford (America East),13,3-10,195,135,330,0.591,04/29/2018,2018.0
13,Virginia (ACC),16,11-5,252,181,433,0.582,04/29/2018,2018.0
14,Marquette (Big East),13,6-7,158,115,273,0.579,04/29/2018,2018.0
15,Ohio St. (Big Ten),14,8-6,172,130,302,0.570,04/29/2018,2018.0
16,Holy Cross (Patriot),13,4-9,152,117,269,0.565,04/29/2018,2018.0
17,Johns Hopkins (Big Ten),13,9-4,188,145,333,0.565,04/29/2018,2018.0
18,Hofstra (CAA),13,6-7,144,113,257,0.560,04/29/2018,2018.0
19,Navy (Patriot),14,9-5,166,134,300,0.553,04/29/2018,2018.0
20,Quinnipiac (MAAC),14,9-5,191,161,352,0.543,04/29/2018,2018.0
21,VMI (Southland),12,2-10,153,131,284,0.539,04/29/2018,2018.0
22,Brown (Ivy League),14,6-8,209,181,390,0.536,04/29/2018,2018.0
23,Mount St. Mary's (NEC),14,5-9,201,176,377,0.533,04/29/2018,2018.0
24,Air Force (SoCon),15,5-10,170,153,323,0.526,04/29/2018,2018.0
25,Army West Point (Patriot),12,5-7,130,119,249,0.522,04/29/2018,2018.0
26,High Point (SoCon),13,6-7,182,167,349,0.521,04/29/2018,2018.0
27,Notre Dame (ACC),13,8-5,146,136,282,0.518,04/29/2018,2018.0
28,Maryland (Big Ten),13,11-2,158,156,314,0.503,04/29/2018,2018.0
29,Duke (ACC),15,12-3,185,191,376,0.492,04/29/2018,2018.0
30,Michigan (Big Ten),14,8-6,160,166,326,0.491,04/29/2018,2018.0
31,Vermont (America East),14,11-3,148,155,303,0.488,04/29/2018,2018.0
32,Fairfield (CAA),15,4-11,167,175,342,0.488,04/29/2018,2018.0
33,Cleveland St. (Independent),14,4-10,158,166,324,0.488,04/29/2018,2018.0
34,Bellarmine (SoCon),13,4-9,129,136,265,0.487,04/29/2018,2018.0
35,Siena (MAAC),12,3-9,154,165,319,0.483,04/29/2018,2018.0
36,Princeton (Ivy League),13,8-5,180,195,375,0.480,04/29/2018,2018.0
37,Lafayette (Patriot),15,3-12,176,193,369,0.477,04/29/2018,2018.0
38,Providence (Big East),15,5-10,161,177,338,0.476,04/29/2018,2018.0
39,Drexel (CAA),13,5-8,163,180,343,0.475,04/29/2018,2018.0
40,Delaware (CAA),13,6-7,151,172,323,0.467,04/29/2018,2018.0
41,Harvard (Ivy League),13,7-6,159,182,341,0.466,04/29/2018,2018.0
42,Boston U. (Patriot),16,8-8,185,212,397,0.466,04/29/2018,2018.0
43,Cornell (Ivy League),14,10-4,178,205,383,0.465,04/29/2018,2018.0
44,Sacred Heart (NEC),14,7-7,171,197,368,0.465,04/29/2018,2018.0
45,Georgetown (Big East),14,10-4,150,173,323,0.464,04/29/2018,2018.0
46,Rutgers (Big Ten),14,9-5,157,182,339,0.463,04/29/2018,2018.0
47,Syracuse (ACC),13,7-6,154,180,334,0.461,04/29/2018,2018.0
48,Bucknell (Patriot),15,11-4,164,193,357,0.459,04/29/2018,2018.0
49,Penn (Ivy League),14,7-7,145,171,316,0.459,04/29/2018,2018.0
50,Villanova (Big East),14,10-4,159,188,347,0.458,04/29/2018,2018.0
51,Manhattan (MAAC),14,4-10,149,181,330,0.452,04/29/2018,2018.0
52,Detroit Mercy (MAAC),14,8-6,142,173,315,0.451,04/29/2018,2018.0
53,Marist (MAAC),15,3-12,156,192,348,0.448,04/29/2018,2018.0
54,North Carolina (ACC),14,7-7,153,194,347,0.441,04/29/2018,2018.0
55,Mercer (SoCon),14,4-10,134,172,306,0.438,04/29/2018,2018.0
56,Saint Joseph's (NEC),13,10-3,118,156,274,0.431,04/29/2018,2018.0
57,St. John's (NY) (Big East),14,6-8,140,186,326,0.429,04/29/2018,2018.0
58,Robert Morris (NEC),14,10-4,139,185,324,0.429,04/29/2018,2018.0
59,Richmond (SoCon),14,9-5,141,190,331,0.426,04/29/2018,2018.0
60,Loyola Maryland (Patriot),15,12-3,165,223,388,0.425,04/29/2018,2018.0
61,Binghamton (America East),15,4-11,154,214,368,0.418,04/29/2018,2018.0
62,Hampton (DI Independent),12,4-8,124,176,300,0.413,04/29/2018,2018.0
63,Wagner (NEC),14,4-10,118,169,287,0.411,04/29/2018,2018.0
64,UMass Lowell (America East),15,8-7,144,207,351,0.410,04/29/2018,2018.0
65,Canisius (MAAC),14,6-8,159,240,399,0.398,04/29/2018,2018.0
66,Dartmouth (Ivy League),13,2-11,133,202,335,0.397,04/29/2018,2018.0
67,Monmouth (MAAC),14,7-7,120,194,314,0.382,04/29/2018,2018.0
68,NJIT (Independent),16,1-15,128,223,351,0.365,04/29/2018,2018.0
69,UMBC (America East),13,5-8,86,151,237,0.363,04/29/2018,2018.0
1,UAlbany (America East),13,11-2,259,70,329,0.787,04/27/2018,2018.0
2,Denver (Big East),12,10-2,217,66,283,0.767,04/27/2018,2018.0
3,Jacksonville (SoCon),12,6-6,211,90,301,0.701,04/27/2018,2018.0
4,Penn St. (Big Ten),13,8-5,224,111,335,0.669,04/27/2018,2018.0
5,Bryant (NEC),14,8-6,230,116,346,0.665,04/27/2018,2018.0
6,Hobart (NEC),13,4-9,195,121,316,0.617,04/27/2018,2018.0
7,Hartford (America East),12,3-9,187,118,305,0.613,04/27/2018,2018.0
8,Yale (Ivy League),13,11-2,195,126,321,0.607,04/27/2018,2018.0
9,Colgate (Patriot),14,7-7,213,139,352,0.605,04/27/2018,2018.0
10,Marquette (Big East),12,6-6,156,104,260,0.600,04/27/2018,2018.0
11,Massachusetts (CAA),14,10-4,202,136,338,0.598,04/27/2018,2018.0
12,Lehigh (Patriot),16,10-6,221,151,372,0.594,04/27/2018,2018.0
13,Towson (CAA),12,5-7,159,111,270,0.589,04/27/2018,2018.0
14,Virginia (ACC),15,11-4,237,170,407,0.582,04/27/2018,2018.0
15,VMI (Southland),11,2-9,149,113,262,0.569,04/27/2018,2018.0
16,Johns Hopkins (Big Ten),12,9-3,177,135,312,0.567,04/27/2018,2018.0
17,Holy Cross (Patriot),13,4-9,152,117,269,0.565,04/27/2018,2018.0
18,Hofstra (CAA),13,6-7,144,113,257,0.560,04/27/2018,2018.0
19,Navy (Patriot),14,9-5,166,134,300,0.553,04/27/2018,2018.0
20,Ohio St. (Big Ten),13,7-6,154,127,281,0.548,04/27/2018,2018.0
21,Quinnipiac (MAAC),13,8-5,171,146,317,0.539,04/27/2018,2018.0
22,Air Force (SoCon),14,5-9,161,142,303,0.531,04/27/2018,2018.0
23,Brown (Ivy League),13,5-8,191,170,361,0.529,04/27/2018,2018.0
24,Notre Dame (ACC),12,7-5,135,121,256,0.527,04/27/2018,2018.0
25,Mount St. Mary's (NEC),13,4-9,186,168,354,0.525,04/27/2018,2018.0
26,Army West Point (Patriot),12,5-7,130,119,249,0.522,04/27/2018,2018.0
27,High Point (SoCon),12,5-7,166,159,325,0.511,04/27/2018,2018.0
28,Maryland (Big Ten),12,10-2,148,145,293,0.505,04/27/2018,2018.0
29,Fairfield (CAA),14,4-10,161,164,325,0.495,04/27/2018,2018.0
30,Cleveland St. (Independent),13,4-9,150,153,303,0.495,04/27/2018,2018.0
31,Duke (ACC),15,12-3,185,191,376,0.492,04/27/2018,2018.0
32,Vermont (America East),14,11-3,148,155,303,0.488,04/27/2018,2018.0
33,Michigan (Big Ten),13,7-6,148,156,304,0.487,04/27/2018,2018.0
34,Rutgers (Big Ten),13,9-4,154,164,318,0.484,04/27/2018,2018.0
35,Providence (Big East),14,5-9,153,163,316,0.484,04/27/2018,2018.0
36,Siena (MAAC),12,3-9,154,165,319,0.483,04/27/2018,2018.0
37,Harvard (Ivy League),12,7-5,151,162,313,0.482,04/27/2018,2018.0
38,Lafayette (Patriot),15,3-12,176,193,369,0.477,04/27/2018,2018.0
39,Drexel (CAA),13,5-8,163,180,343,0.475,04/27/2018,2018.0
40,Princeton (Ivy League),12,7-5,166,185,351,0.473,04/27/2018,2018.0
41,Sacred Heart (NEC),13,6-7,164,184,348,0.471,04/27/2018,2018.0
42,Cornell (Ivy League),13,10-3,168,191,359,0.468,04/27/2018,2018.0
43,Delaware (CAA),13,6-7,151,172,323,0.467,04/27/2018,2018.0
44,Boston U. (Patriot),16,8-8,185,212,397,0.466,04/27/2018,2018.0
45,Bellarmine (SoCon),12,4-8,114,132,246,0.463,04/27/2018,2018.0
46,Syracuse (ACC),13,7-6,154,180,334,0.461,04/27/2018,2018.0
47,Bucknell (Patriot),15,11-4,164,193,357,0.459,04/27/2018,2018.0
48,Penn (Ivy League),14,7-7,145,171,316,0.459,04/27/2018,2018.0
49,Georgetown (Big East),13,9-4,137,165,302,0.454,04/27/2018,2018.0
50,Manhattan (MAAC),14,4-10,149,181,330,0.452,04/27/2018,2018.0
51,Marist (MAAC),14,3-11,141,172,313,0.450,04/27/2018,2018.0
52,Mercer (SoCon),13,4-9,126,156,282,0.447,04/27/2018,2018.0
53,Villanova (Big East),13,9-4,145,180,325,0.446,04/27/2018,2018.0
54,North Carolina (ACC),14,7-7,153,194,347,0.441,04/27/2018,2018.0
55,Saint Joseph's (NEC),12,9-3,112,143,255,0.439,04/27/2018,2018.0
56,Detroit Mercy (MAAC),13,7-6,129,165,294,0.439,04/27/2018,2018.0
57,St. John's (NY) (Big East),13,6-7,132,173,305,0.433,04/27/2018,2018.0
58,Loyola Maryland (Patriot),14,11-3,153,208,361,0.424,04/27/2018,2018.0
59,Binghamton (America East),15,4-11,154,214,368,0.418,04/27/2018,2018.0
60,Richmond (SoCon),13,8-5,130,181,311,0.418,04/27/2018,2018.0
61,Wagner (NEC),13,4-9,110,154,264,0.417,04/27/2018,2018.0
62,Robert Morris (NEC),13,10-3,126,179,305,0.413,04/27/2018,2018.0
63,Hampton (DI Independent),11,3-8,114,165,279,0.409,04/27/2018,2018.0
64,UMass Lowell (America East),14,7-7,135,201,336,0.402,04/27/2018,2018.0
65,Dartmouth (Ivy League),12,2-10,122,184,306,0.399,04/27/2018,2018.0
66,Canisius (MAAC),14,6-8,159,240,399,0.398,04/27/2018,2018.0
67,Monmouth (MAAC),14,7-7,120,194,314,0.382,04/27/2018,2018.0
68,NJIT (Independent),15,1-14,122,214,336,0.363,04/27/2018,2018.0
69,UMBC (America East),13,5-8,86,151,237,0.363,04/27/2018,2018.0
1,UAlbany (America East),13,11-2,259,70,329,0.787,04/24/2018,2018.0
2,Denver (Big East),12,10-2,217,66,283,0.767,04/24/2018,2018.0
3,Jacksonville (SoCon),12,6-6,211,90,301,0.701,04/24/2018,2018.0
4,Penn St. (Big Ten),13,8-5,224,111,335,0.669,04/24/2018,2018.0
5,Bryant (NEC),14,8-6,230,116,346,0.665,04/24/2018,2018.0
6,Hobart (NEC),13,4-9,195,121,316,0.617,04/24/2018,2018.0
7,Hartford (America East),12,3-9,187,118,305,0.613,04/24/2018,2018.0
8,Yale (Ivy League),13,11-2,195,126,321,0.607,04/24/2018,2018.0
9,Colgate (Patriot),14,7-7,213,139,352,0.605,04/24/2018,2018.0
10,Massachusetts (CAA),13,9-4,190,125,315,0.603,04/24/2018,2018.0
11,Marquette (Big East),12,6-6,156,104,260,0.600,04/24/2018,2018.0
12,Lehigh (Patriot),15,9-6,209,140,349,0.599,04/24/2018,2018.0
13,Towson (CAA),12,5-7,159,111,270,0.589,04/24/2018,2018.0
14,Virginia (ACC),14,10-4,219,163,382,0.573,04/24/2018,2018.0
15,VMI (Southland),11,2-9,149,113,262,0.569,04/24/2018,2018.0
16,Hofstra (CAA),12,6-6,133,101,234,0.568,04/24/2018,2018.0
17,Johns Hopkins (Big Ten),12,9-3,177,135,312,0.567,04/24/2018,2018.0
18,Holy Cross (Patriot),13,4-9,152,117,269,0.565,04/24/2018,2018.0
19,Navy (Patriot),13,9-4,155,122,277,0.560,04/24/2018,2018.0
20,Ohio St. (Big Ten),13,7-6,154,127,281,0.548,04/24/2018,2018.0
21,Quinnipiac (MAAC),13,8-5,171,146,317,0.539,04/24/2018,2018.0
22,Notre Dame (ACC),11,6-5,122,106,228,0.535,04/24/2018,2018.0
23,Air Force (SoCon),14,5-9,162,142,304,0.533,04/24/2018,2018.0
24,Brown (Ivy League),13,5-8,191,170,361,0.529,04/24/2018,2018.0
25,Mount St. Mary's (NEC),13,4-9,186,168,354,0.525,04/24/2018,2018.0
26,Army West Point (Patriot),12,5-7,130,119,249,0.522,04/24/2018,2018.0
27,High Point (SoCon),12,5-7,166,160,326,0.509,04/24/2018,2018.0
28,Maryland (Big Ten),12,10-2,148,145,293,0.505,04/24/2018,2018.0
29,Fairfield (CAA),14,4-10,161,164,325,0.495,04/24/2018,2018.0
30,Cleveland St. (Independent),13,4-9,150,153,303,0.495,04/24/2018,2018.0
31,Duke (ACC),14,12-2,170,178,348,0.489,04/24/2018,2018.0
32,Michigan (Big Ten),13,7-6,148,156,304,0.487,04/24/2018,2018.0
33,Rutgers (Big Ten),13,9-4,154,164,318,0.484,04/24/2018,2018.0
34,Providence (Big East),14,5-9,153,163,316,0.484,04/24/2018,2018.0
35,Harvard (Ivy League),12,7-5,151,162,313,0.482,04/24/2018,2018.0
36,Siena (MAAC),11,2-9,138,150,288,0.479,04/24/2018,2018.0
37,Drexel (CAA),12,5-7,150,164,314,0.478,04/24/2018,2018.0
38,Lafayette (Patriot),15,3-12,176,193,369,0.477,04/24/2018,2018.0
39,Syracuse (ACC),12,7-5,147,162,309,0.476,04/24/2018,2018.0
40,Princeton (Ivy League),12,7-5,166,185,351,0.473,04/24/2018,2018.0
41,Sacred Heart (NEC),13,6-7,164,184,348,0.471,04/24/2018,2018.0
42,Cornell (Ivy League),13,10-3,168,191,359,0.468,04/24/2018,2018.0
43,Vermont (America East),13,10-3,132,152,284,0.465,04/24/2018,2018.0
44,Bellarmine (SoCon),12,4-8,114,132,246,0.463,04/24/2018,2018.0
45,Bucknell (Patriot),15,11-4,164,193,357,0.459,04/24/2018,2018.0
46,Delaware (CAA),12,5-7,135,159,294,0.459,04/24/2018,2018.0
47,Penn (Ivy League),14,7-7,145,171,316,0.459,04/24/2018,2018.0
48,Georgetown (Big East),13,9-4,137,165,302,0.454,04/24/2018,2018.0
49,Marist (MAAC),14,3-11,141,172,313,0.450,04/24/2018,2018.0
50,Boston U. (Patriot),15,8-7,167,205,372,0.449,04/24/2018,2018.0
51,Manhattan (MAAC),13,4-9,134,165,299,0.448,04/24/2018,2018.0
52,Mercer (SoCon),13,4-9,126,156,282,0.447,04/24/2018,2018.0
53,Villanova (Big East),13,9-4,145,180,325,0.446,04/24/2018,2018.0
54,North Carolina (ACC),14,7-7,153,194,347,0.441,04/24/2018,2018.0
55,Saint Joseph's (NEC),12,9-3,112,143,255,0.439,04/24/2018,2018.0
56,Detroit Mercy (MAAC),13,7-6,129,165,294,0.439,04/24/2018,2018.0
57,Loyola Maryland (Patriot),13,10-3,146,190,336,0.435,04/24/2018,2018.0
58,St. John's (NY) (Big East),13,6-7,132,173,305,0.433,04/24/2018,2018.0
59,Richmond (SoCon),13,8-5,130,181,311,0.418,04/24/2018,2018.0
60,Wagner (NEC),13,4-9,110,154,264,0.417,04/24/2018,2018.0
61,Robert Morris (NEC),13,10-3,126,179,305,0.413,04/24/2018,2018.0
62,Hampton (DI Independent),11,3-8,114,165,279,0.409,04/24/2018,2018.0
63,UMass Lowell (America East),14,7-7,135,201,336,0.402,04/24/2018,2018.0
64,Binghamton (America East),14,4-10,136,204,340,0.400,04/24/2018,2018.0
65,Dartmouth (Ivy League),12,2-10,122,184,306,0.399,04/24/2018,2018.0
66,Canisius (MAAC),13,6-7,146,225,371,0.394,04/24/2018,2018.0
67,UMBC (America East),12,5-7,83,135,218,0.381,04/24/2018,2018.0
68,Monmouth (MAAC),13,6-7,105,181,286,0.367,04/24/2018,2018.0
69,NJIT (Independent),15,1-14,122,214,336,0.363,04/24/2018,2018.0
1,UAlbany (America East),13,11-2,259,70,329,0.787,04/22/2018,2018.0
2,Denver (Big East),12,10-2,217,66,283,0.767,04/22/2018,2018.0
3,Jacksonville (SoCon),12,6-6,211,90,301,0.701,04/22/2018,2018.0
4,Bryant (NEC),13,7-6,213,104,317,0.672,04/22/2018,2018.0
5,Penn St. (Big Ten),13,8-5,224,111,335,0.669,04/22/2018,2018.0
6,Hobart (NEC),13,4-9,195,121,316,0.617,04/22/2018,2018.0
7,Colgate (Patriot),13,7-6,204,128,332,0.614,04/22/2018,2018.0
8,Hartford (America East),12,3-9,187,118,305,0.613,04/22/2018,2018.0
9,Yale (Ivy League),13,11-2,195,126,321,0.607,04/22/2018,2018.0
10,Massachusetts (CAA),13,9-4,190,125,315,0.603,04/22/2018,2018.0
11,Lehigh (Patriot),14,8-6,198,131,329,0.602,04/22/2018,2018.0
12,Marquette (Big East),12,6-6,156,104,260,0.600,04/22/2018,2018.0
13,Towson (CAA),12,5-7,159,111,270,0.589,04/22/2018,2018.0
14,Virginia (ACC),14,10-4,219,163,382,0.573,04/22/2018,2018.0
15,VMI (Southland),11,2-9,149,113,262,0.569,04/22/2018,2018.0
16,Hofstra (CAA),12,6-6,133,101,234,0.568,04/22/2018,2018.0
17,Johns Hopkins (Big Ten),12,9-3,177,135,312,0.567,04/22/2018,2018.0
18,Holy Cross (Patriot),13,4-9,152,117,269,0.565,04/22/2018,2018.0
19,Navy (Patriot),13,9-4,155,122,277,0.560,04/22/2018,2018.0
20,Ohio St. (Big Ten),13,7-6,154,127,281,0.548,04/22/2018,2018.0
21,Quinnipiac (MAAC),13,8-5,171,146,317,0.539,04/22/2018,2018.0
22,Brown (Ivy League),12,5-7,179,153,332,0.539,04/22/2018,2018.0
23,Notre Dame (ACC),11,6-5,122,106,228,0.535,04/22/2018,2018.0
24,Air Force (SoCon),14,5-9,162,142,304,0.533,04/22/2018,2018.0
25,Mount St. Mary's (NEC),13,4-9,186,168,354,0.525,04/22/2018,2018.0
26,Army West Point (Patriot),12,5-7,130,119,249,0.522,04/22/2018,2018.0
27,High Point (SoCon),12,5-7,166,160,326,0.509,04/22/2018,2018.0
28,Maryland (Big Ten),12,10-2,148,145,293,0.505,04/22/2018,2018.0
29,Fairfield (CAA),14,4-10,161,164,325,0.495,04/22/2018,2018.0
30,Cleveland St. (Independent),13,4-9,150,153,303,0.495,04/22/2018,2018.0
31,Duke (ACC),14,12-2,170,178,348,0.489,04/22/2018,2018.0
32,Michigan (Big Ten),13,7-6,148,156,304,0.487,04/22/2018,2018.0
33,Rutgers (Big Ten),13,9-4,154,164,318,0.484,04/22/2018,2018.0
34,Providence (Big East),14,5-9,153,163,316,0.484,04/22/2018,2018.0
35,Harvard (Ivy League),12,7-5,151,162,313,0.482,04/22/2018,2018.0
36,Siena (MAAC),11,2-9,138,150,288,0.479,04/22/2018,2018.0
37,Drexel (CAA),12,5-7,150,164,314,0.478,04/22/2018,2018.0
38,Lafayette (Patriot),15,3-12,176,193,369,0.477,04/22/2018,2018.0
39,Syracuse (ACC),12,7-5,147,162,309,0.476,04/22/2018,2018.0
40,Princeton (Ivy League),12,7-5,166,185,351,0.473,04/22/2018,2018.0
41,Sacred Heart (NEC),13,6-7,164,184,348,0.471,04/22/2018,2018.0
42,Cornell (Ivy League),13,10-3,168,191,359,0.468,04/22/2018,2018.0
43,Vermont (America East),13,10-3,132,152,284,0.465,04/22/2018,2018.0
44,Bellarmine (SoCon),12,4-8,114,132,246,0.463,04/22/2018,2018.0
45,Delaware (CAA),12,5-7,135,159,294,0.459,04/22/2018,2018.0
46,Penn (Ivy League),14,7-7,145,171,316,0.459,04/22/2018,2018.0
47,Georgetown (Big East),13,9-4,137,165,302,0.454,04/22/2018,2018.0
48,Bucknell (Patriot),14,11-3,150,181,331,0.453,04/22/2018,2018.0
49,Marist (MAAC),14,3-11,141,172,313,0.450,04/22/2018,2018.0
50,Manhattan (MAAC),13,4-9,134,165,299,0.448,04/22/2018,2018.0
51,Boston U. (Patriot),14,7-7,155,191,346,0.448,04/22/2018,2018.0
52,Mercer (SoCon),13,4-9,126,156,282,0.447,04/22/2018,2018.0
53,Villanova (Big East),13,9-4,145,180,325,0.446,04/22/2018,2018.0
54,North Carolina (ACC),14,7-7,153,194,347,0.441,04/22/2018,2018.0
55,Saint Joseph's (NEC),12,9-3,112,143,255,0.439,04/22/2018,2018.0
56,Detroit Mercy (MAAC),13,7-6,129,165,294,0.439,04/22/2018,2018.0
57,Loyola Maryland (Patriot),13,10-3,146,190,336,0.435,04/22/2018,2018.0
58,St. John's (NY) (Big East),13,6-7,132,173,305,0.433,04/22/2018,2018.0
59,Richmond (SoCon),13,8-5,130,181,311,0.418,04/22/2018,2018.0
60,Wagner (NEC),13,4-9,110,154,264,0.417,04/22/2018,2018.0
61,Robert Morris (NEC),13,10-3,126,179,305,0.413,04/22/2018,2018.0
62,Hampton (DI Independent),11,3-8,114,165,279,0.409,04/22/2018,2018.0
63,UMass Lowell (America East),14,7-7,135,201,336,0.402,04/22/2018,2018.0
64,Binghamton (America East),14,4-10,136,204,340,0.400,04/22/2018,2018.0
65,Dartmouth (Ivy League),12,2-10,122,184,306,0.399,04/22/2018,2018.0
66,Canisius (MAAC),13,6-7,146,225,371,0.394,04/22/2018,2018.0
67,UMBC (America East),12,5-7,83,135,218,0.381,04/22/2018,2018.0
68,Monmouth (MAAC),13,6-7,105,181,286,0.367,04/22/2018,2018.0
69,NJIT (Independent),15,1-14,122,214,336,0.363,04/22/2018,2018.0
1,UAlbany (America East),11,10-1,230,50,280,0.821,04/17/2018,2018.0
2,Denver (Big East),11,9-2,199,61,260,0.765,04/17/2018,2018.0
3,Bryant (NEC),12,6-6,203,90,293,0.693,04/17/2018,2018.0
4,Jacksonville (SoCon),11,5-6,190,85,275,0.691,04/17/2018,2018.0
5,Penn St. (Big Ten),12,8-4,209,104,313,0.668,04/17/2018,2018.0
6,Hobart (NEC),12,4-8,181,111,292,0.620,04/17/2018,2018.0
7,Colgate (Patriot),12,6-6,188,116,304,0.618,04/17/2018,2018.0
8,Massachusetts (CAA),12,8-4,181,117,298,0.607,04/17/2018,2018.0
9,Marquette (Big East),11,6-5,142,92,234,0.607,04/17/2018,2018.0
10,Yale (Ivy League),12,10-2,182,118,300,0.607,04/17/2018,2018.0
11,Hartford (America East),11,3-8,175,115,290,0.603,04/17/2018,2018.0
12,Lehigh (Patriot),13,8-5,183,122,305,0.600,04/17/2018,2018.0
13,Hofstra (CAA),11,5-6,120,86,206,0.583,04/17/2018,2018.0
14,Virginia (ACC),13,9-4,204,155,359,0.568,04/17/2018,2018.0
15,VMI (Southland),10,2-8,136,105,241,0.564,04/17/2018,2018.0
16,Towson (CAA),11,4-7,137,109,246,0.557,04/17/2018,2018.0
17,Navy (Patriot),12,8-4,139,111,250,0.556,04/17/2018,2018.0
18,Holy Cross (Patriot),12,4-8,141,113,254,0.555,04/17/2018,2018.0
19,Johns Hopkins (Big Ten),11,8-3,160,129,289,0.554,04/17/2018,2018.0
20,Air Force (SoCon),13,5-8,155,132,287,0.540,04/17/2018,2018.0
21,Ohio St. (Big Ten),12,6-6,137,118,255,0.537,04/17/2018,2018.0
22,Brown (Ivy League),11,5-6,162,144,306,0.529,04/17/2018,2018.0
23,Army West Point (Patriot),11,5-6,118,107,225,0.524,04/17/2018,2018.0
24,Mount St. Mary's (NEC),12,4-8,172,158,330,0.521,04/17/2018,2018.0
25,Maryland (Big Ten),11,10-1,139,128,267,0.521,04/17/2018,2018.0
26,Quinnipiac (MAAC),12,7-5,153,142,295,0.519,04/17/2018,2018.0
27,Notre Dame (ACC),10,6-4,105,101,206,0.510,04/17/2018,2018.0
28,Michigan (Big Ten),12,7-5,142,139,281,0.505,04/17/2018,2018.0
29,Providence (Big East),13,5-8,148,145,293,0.505,04/17/2018,2018.0
30,High Point (SoCon),11,4-7,156,153,309,0.505,04/17/2018,2018.0
31,Fairfield (CAA),13,4-9,153,155,308,0.497,04/17/2018,2018.0
32,Rutgers (Big Ten),12,8-4,147,149,296,0.497,04/17/2018,2018.0
33,Delaware (CAA),11,5-6,133,137,270,0.493,04/17/2018,2018.0
34,Duke (ACC),13,11-2,158,164,322,0.491,04/17/2018,2018.0
35,Cleveland St. (Independent),12,3-9,134,142,276,0.486,04/17/2018,2018.0
36,Princeton (Ivy League),11,6-5,156,167,323,0.483,04/17/2018,2018.0
37,Syracuse (ACC),11,7-4,136,146,282,0.482,04/17/2018,2018.0
38,Lafayette (Patriot),14,3-11,164,177,341,0.481,04/17/2018,2018.0
39,Cornell (Ivy League),12,9-3,159,174,333,0.477,04/17/2018,2018.0
40,Sacred Heart (NEC),12,6-6,153,168,321,0.477,04/17/2018,2018.0
41,Vermont (America East),12,10-2,124,137,261,0.475,04/17/2018,2018.0
42,Drexel (CAA),11,5-6,135,151,286,0.472,04/17/2018,2018.0
43,Siena (MAAC),10,2-8,124,139,263,0.471,04/17/2018,2018.0
44,Bellarmine (SoCon),11,3-8,106,119,225,0.471,04/17/2018,2018.0
45,Harvard (Ivy League),11,7-4,133,152,285,0.467,04/17/2018,2018.0
46,Bucknell (Patriot),13,10-3,141,166,307,0.459,04/17/2018,2018.0
47,Boston U. (Patriot),13,6-7,151,180,331,0.456,04/17/2018,2018.0
48,North Carolina (ACC),13,6-7,148,177,325,0.455,04/17/2018,2018.0
49,Marist (MAAC),14,3-11,141,172,313,0.450,04/17/2018,2018.0
50,Penn (Ivy League),13,6-7,130,163,293,0.444,04/17/2018,2018.0
51,Villanova (Big East),12,8-4,134,169,303,0.442,04/17/2018,2018.0
52,Saint Joseph's (NEC),11,8-3,102,129,231,0.442,04/17/2018,2018.0
53,Detroit Mercy (MAAC),12,6-6,118,151,269,0.439,04/17/2018,2018.0
54,Manhattan (MAAC),12,4-8,116,150,266,0.436,04/17/2018,2018.0
55,Loyola Maryland (Patriot),12,9-3,134,178,312,0.429,04/17/2018,2018.0
56,Richmond (SoCon),12,7-5,124,166,290,0.428,04/17/2018,2018.0
57,St. John's (NY) (Big East),12,6-6,121,162,283,0.428,04/17/2018,2018.0
58,Georgetown (Big East),12,8-4,118,159,277,0.426,04/17/2018,2018.0
59,Mercer (SoCon),12,4-8,111,150,261,0.425,04/17/2018,2018.0
60,Binghamton (America East),13,4-9,129,183,312,0.413,04/17/2018,2018.0
61,Wagner (NEC),12,4-8,99,141,240,0.413,04/17/2018,2018.0
62,Hampton (DI Independent),11,3-8,114,165,279,0.409,04/17/2018,2018.0
63,Dartmouth (Ivy League),11,2-9,114,169,283,0.403,04/17/2018,2018.0
64,Robert Morris (NEC),12,9-3,113,168,281,0.402,04/17/2018,2018.0
65,UMass Lowell (America East),13,7-6,122,187,309,0.395,04/17/2018,2018.0
66,UMBC (America East),11,4-7,80,123,203,0.394,04/17/2018,2018.0
67,Canisius (MAAC),12,5-7,131,207,338,0.388,04/17/2018,2018.0
68,Monmouth (MAAC),12,6-6,101,163,264,0.383,04/17/2018,2018.0
69,NJIT (Independent),14,1-13,116,195,311,0.373,04/17/2018,2018.0
1,UAlbany (America East),11,10-1,230,50,280,0.821,04/15/2018,2018.0
2,Denver (Big East),11,9-2,199,61,260,0.765,04/15/2018,2018.0
3,Bryant (NEC),12,6-6,203,90,293,0.693,04/15/2018,2018.0
4,Jacksonville (SoCon),11,5-6,190,85,275,0.691,04/15/2018,2018.0
5,Penn St. (Big Ten),12,8-4,209,104,313,0.668,04/15/2018,2018.0
6,Hobart (NEC),12,4-8,181,111,292,0.620,04/15/2018,2018.0
7,Colgate (Patriot),12,6-6,188,116,304,0.618,04/15/2018,2018.0
8,Massachusetts (CAA),12,8-4,181,117,298,0.607,04/15/2018,2018.0
9,Marquette (Big East),11,6-5,142,92,234,0.607,04/15/2018,2018.0
10,Hartford (America East),11,3-8,175,115,290,0.603,04/15/2018,2018.0
11,Lehigh (Patriot),13,8-5,183,122,305,0.600,04/15/2018,2018.0
12,Yale (Ivy League),11,9-2,166,113,279,0.595,04/15/2018,2018.0
13,Hofstra (CAA),11,5-6,120,86,206,0.583,04/15/2018,2018.0
14,Virginia (ACC),13,9-4,204,155,359,0.568,04/15/2018,2018.0
15,VMI (Southland),10,2-8,136,105,241,0.564,04/15/2018,2018.0
16,Towson (CAA),11,4-7,137,109,246,0.557,04/15/2018,2018.0
17,Navy (Patriot),12,8-4,139,111,250,0.556,04/15/2018,2018.0
18,Holy Cross (Patriot),12,4-8,141,113,254,0.555,04/15/2018,2018.0
19,Johns Hopkins (Big Ten),11,8-3,160,129,289,0.554,04/15/2018,2018.0
20,Air Force (SoCon),13,5-8,155,132,287,0.540,04/15/2018,2018.0
21,Ohio St. (Big Ten),12,6-6,137,118,255,0.537,04/15/2018,2018.0
22,Brown (Ivy League),10,5-5,148,132,280,0.529,04/15/2018,2018.0
23,Army West Point (Patriot),11,5-6,118,107,225,0.524,04/15/2018,2018.0
24,Mount St. Mary's (NEC),12,4-8,172,158,330,0.521,04/15/2018,2018.0
25,Maryland (Big Ten),11,10-1,139,128,267,0.521,04/15/2018,2018.0
26,Quinnipiac (MAAC),12,7-5,153,142,295,0.519,04/15/2018,2018.0
27,Notre Dame (ACC),10,6-4,105,101,206,0.510,04/15/2018,2018.0
28,Providence (Big East),12,4-8,136,131,267,0.509,04/15/2018,2018.0
29,Michigan (Big Ten),12,7-5,142,139,281,0.505,04/15/2018,2018.0
30,High Point (SoCon),11,4-7,156,153,309,0.505,04/15/2018,2018.0
31,Fairfield (CAA),13,4-9,153,155,308,0.497,04/15/2018,2018.0
32,Rutgers (Big Ten),12,8-4,147,149,296,0.497,04/15/2018,2018.0
33,Delaware (CAA),11,5-6,133,137,270,0.493,04/15/2018,2018.0
34,Duke (ACC),13,11-2,158,164,322,0.491,04/15/2018,2018.0
35,Cleveland St. (Independent),12,3-9,134,142,276,0.486,04/15/2018,2018.0
36,Princeton (Ivy League),11,6-5,156,167,323,0.483,04/15/2018,2018.0
37,Syracuse (ACC),11,7-4,136,146,282,0.482,04/15/2018,2018.0
38,Lafayette (Patriot),14,3-11,164,177,341,0.481,04/15/2018,2018.0
39,Cornell (Ivy League),12,9-3,159,174,333,0.477,04/15/2018,2018.0
40,Sacred Heart (NEC),12,6-6,153,168,321,0.477,04/15/2018,2018.0
41,Vermont (America East),12,10-2,124,137,261,0.475,04/15/2018,2018.0
42,Drexel (CAA),11,5-6,135,151,286,0.472,04/15/2018,2018.0
43,Siena (MAAC),10,2-8,124,139,263,0.471,04/15/2018,2018.0
44,Bellarmine (SoCon),11,3-8,106,119,225,0.471,04/15/2018,2018.0
45,Harvard (Ivy League),11,7-4,133,152,285,0.467,04/15/2018,2018.0
46,Marist (MAAC),13,3-10,136,156,292,0.466,04/15/2018,2018.0
47,Bucknell (Patriot),13,10-3,141,166,307,0.459,04/15/2018,2018.0
48,Boston U. (Patriot),13,6-7,151,180,331,0.456,04/15/2018,2018.0
49,North Carolina (ACC),13,6-7,148,177,325,0.455,04/15/2018,2018.0
50,Saint Joseph's (NEC),10,7-3,93,112,205,0.454,04/15/2018,2018.0
51,Villanova (Big East),12,8-4,134,169,303,0.442,04/15/2018,2018.0
52,Detroit Mercy (MAAC),12,6-6,118,151,269,0.439,04/15/2018,2018.0
53,Manhattan (MAAC),12,4-8,116,150,266,0.436,04/15/2018,2018.0
54,Loyola Maryland (Patriot),12,9-3,134,178,312,0.429,04/15/2018,2018.0
55,Richmond (SoCon),12,7-5,124,166,290,0.428,04/15/2018,2018.0
56,St. John's (NY) (Big East),12,6-6,121,162,283,0.428,04/15/2018,2018.0
57,Georgetown (Big East),12,8-4,118,159,277,0.426,04/15/2018,2018.0
58,Mercer (SoCon),12,4-8,111,150,261,0.425,04/15/2018,2018.0
59,Penn (Ivy League),12,6-6,113,154,267,0.423,04/15/2018,2018.0
60,Binghamton (America East),13,4-9,129,183,312,0.413,04/15/2018,2018.0
61,Wagner (NEC),12,4-8,99,141,240,0.413,04/15/2018,2018.0
62,Hampton (DI Independent),11,3-8,114,165,279,0.409,04/15/2018,2018.0
63,Dartmouth (Ivy League),11,2-9,114,169,283,0.403,04/15/2018,2018.0
64,Robert Morris (NEC),12,9-3,113,168,281,0.402,04/15/2018,2018.0
65,UMass Lowell (America East),13,7-6,122,187,309,0.395,04/15/2018,2018.0
66,UMBC (America East),11,4-7,80,123,203,0.394,04/15/2018,2018.0
67,Canisius (MAAC),12,5-7,131,207,338,0.388,04/15/2018,2018.0
68,Monmouth (MAAC),12,6-6,101,163,264,0.383,04/15/2018,2018.0
69,NJIT (Independent),14,1-13,116,195,311,0.373,04/15/2018,2018.0
1,UAlbany (America East),11,10-1,230,50,280,0.821,04/11/2018,2018.0
2,Denver (Big East),10,8-2,180,56,236,0.763,04/11/2018,2018.0
3,Bryant (NEC),11,6-5,186,83,269,0.691,04/11/2018,2018.0
4,Jacksonville (SoCon),10,5-5,169,77,246,0.687,04/11/2018,2018.0
5,Penn St. (Big Ten),11,7-4,191,93,284,0.673,04/11/2018,2018.0
6,Colgate (Patriot),11,6-5,177,103,280,0.632,04/11/2018,2018.0
7,Hobart (NEC),11,4-7,161,100,261,0.617,04/11/2018,2018.0
8,Yale (Ivy League),10,8-2,144,92,236,0.610,04/11/2018,2018.0
9,Marquette (Big East),10,5-5,126,82,208,0.606,04/11/2018,2018.0
10,Hartford (America East),10,3-7,161,106,267,0.603,04/11/2018,2018.0
11,Massachusetts (CAA),11,7-4,169,113,282,0.599,04/11/2018,2018.0
12,VMI (Southland),9,2-7,128,86,214,0.598,04/11/2018,2018.0
13,Lehigh (Patriot),12,8-4,165,115,280,0.589,04/11/2018,2018.0
14,Virginia (ACC),12,9-3,190,134,324,0.586,04/11/2018,2018.0
15,Towson (CAA),10,4-6,133,97,230,0.578,04/11/2018,2018.0
16,Johns Hopkins (Big Ten),10,8-2,149,111,260,0.573,04/11/2018,2018.0
17,Hofstra (CAA),10,5-5,104,80,184,0.565,04/11/2018,2018.0
18,Holy Cross (Patriot),11,3-8,128,102,230,0.557,04/11/2018,2018.0
19,Navy (Patriot),11,7-4,127,103,230,0.552,04/11/2018,2018.0
20,Mount St. Mary's (NEC),11,3-8,161,138,299,0.538,04/11/2018,2018.0
21,Army West Point (Patriot),10,5-5,110,95,205,0.537,04/11/2018,2018.0
22,Brown (Ivy League),9,5-4,127,110,237,0.536,04/11/2018,2018.0
23,Ohio St. (Big Ten),11,5-6,127,111,238,0.534,04/11/2018,2018.0
24,Maryland (Big Ten),10,9-1,129,113,242,0.533,04/11/2018,2018.0
25,Fairfield (CAA),12,4-8,145,130,275,0.527,04/11/2018,2018.0
26,Providence (Big East),11,4-7,126,115,241,0.523,04/11/2018,2018.0
27,Air Force (SoCon),12,4-8,140,130,270,0.519,04/11/2018,2018.0
28,Delaware (CAA),10,4-6,127,121,248,0.512,04/11/2018,2018.0
29,Michigan (Big Ten),11,7-4,135,129,264,0.511,04/11/2018,2018.0
30,Notre Dame (ACC),10,6-4,105,101,206,0.510,04/11/2018,2018.0
31,Quinnipiac (MAAC),11,6-5,130,129,259,0.502,04/11/2018,2018.0
32,Lafayette (Patriot),13,3-10,156,160,316,0.494,04/11/2018,2018.0
33,Cornell (Ivy League),11,8-3,152,156,308,0.494,04/11/2018,2018.0
34,Rutgers (Big Ten),11,8-3,132,139,271,0.487,04/11/2018,2018.0
35,High Point (SoCon),10,3-7,137,145,282,0.486,04/11/2018,2018.0
36,Bellarmine (SoCon),10,2-8,99,106,205,0.483,04/11/2018,2018.0
37,Duke (ACC),12,10-2,137,150,287,0.477,04/11/2018,2018.0
38,Harvard (Ivy League),10,7-3,126,138,264,0.477,04/11/2018,2018.0
39,Saint Joseph's (NEC),9,6-3,86,95,181,0.475,04/11/2018,2018.0
40,Princeton (Ivy League),10,5-5,134,149,283,0.473,04/11/2018,2018.0
41,Syracuse (ACC),10,6-4,120,134,254,0.472,04/11/2018,2018.0
42,Siena (MAAC),10,2-8,124,139,263,0.471,04/11/2018,2018.0
43,Sacred Heart (NEC),11,5-6,139,158,297,0.468,04/11/2018,2018.0
44,Cleveland St. (Independent),11,3-8,118,136,254,0.465,04/11/2018,2018.0
45,Vermont (America East),11,10-1,112,131,243,0.461,04/11/2018,2018.0
46,North Carolina (ACC),12,6-6,136,161,297,0.458,04/11/2018,2018.0
47,Boston U. (Patriot),12,6-6,134,162,296,0.453,04/11/2018,2018.0
48,Marist (MAAC),12,3-9,122,150,272,0.449,04/11/2018,2018.0
49,St. John's (NY) (Big East),11,6-5,116,143,259,0.448,04/11/2018,2018.0
50,Richmond (SoCon),11,6-5,116,145,261,0.444,04/11/2018,2018.0
51,Villanova (Big East),11,8-3,122,154,276,0.442,04/11/2018,2018.0
52,Bucknell (Patriot),12,9-3,124,158,282,0.440,04/11/2018,2018.0
53,Detroit Mercy (MAAC),11,5-6,105,135,240,0.438,04/11/2018,2018.0
54,Drexel (CAA),10,4-6,110,143,253,0.435,04/11/2018,2018.0
55,Manhattan (MAAC),11,4-7,100,137,237,0.422,04/11/2018,2018.0
56,Hampton (DI Independent),10,3-7,106,146,252,0.421,04/11/2018,2018.0
57,Loyola Maryland (Patriot),11,8-3,116,161,277,0.419,04/11/2018,2018.0
58,Robert Morris (NEC),11,8-3,107,152,259,0.413,04/11/2018,2018.0
59,Wagner (NEC),11,4-7,89,127,216,0.412,04/11/2018,2018.0
60,Georgetown (Big East),11,7-4,103,147,250,0.412,04/11/2018,2018.0
61,Mercer (SoCon),11,4-7,98,143,241,0.407,04/11/2018,2018.0
62,Binghamton (America East),12,4-8,122,179,301,0.405,04/11/2018,2018.0
63,Penn (Ivy League),11,5-6,99,147,246,0.402,04/11/2018,2018.0
64,UMBC (America East),10,3-7,76,116,192,0.396,04/11/2018,2018.0
65,UMass Lowell (America East),12,6-6,113,173,286,0.395,04/11/2018,2018.0
66,Dartmouth (Ivy League),10,2-8,96,147,243,0.395,04/11/2018,2018.0
67,Canisius (MAAC),11,5-6,118,184,302,0.391,04/11/2018,2018.0
68,Monmouth (MAAC),11,5-6,95,149,244,0.389,04/11/2018,2018.0
69,NJIT (Independent),13,0-13,97,187,284,0.342,04/11/2018,2018.0
1,UAlbany (America East),11,10-1,230,50,280,0.821,04/10/2018,2018.0
2,Denver (Big East),10,8-2,180,56,236,0.763,04/10/2018,2018.0
3,Bryant (NEC),11,6-5,186,83,269,0.691,04/10/2018,2018.0
4,Jacksonville (SoCon),10,5-5,169,77,246,0.687,04/10/2018,2018.0
5,Penn St. (Big Ten),11,7-4,191,93,284,0.673,04/10/2018,2018.0
6,Colgate (Patriot),11,6-5,177,103,280,0.632,04/10/2018,2018.0
7,Hobart (NEC),11,4-7,161,100,261,0.617,04/10/2018,2018.0
8,Yale (Ivy League),10,8-2,144,92,236,0.610,04/10/2018,2018.0
9,Hartford (America East),10,3-7,161,106,267,0.603,04/10/2018,2018.0
10,Massachusetts (CAA),11,7-4,169,113,282,0.599,04/10/2018,2018.0
11,VMI (Southland),9,2-7,128,86,214,0.598,04/10/2018,2018.0
12,Marquette (Big East),9,5-4,114,79,193,0.591,04/10/2018,2018.0
13,Lehigh (Patriot),12,8-4,165,115,280,0.589,04/10/2018,2018.0
14,Virginia (ACC),12,9-3,190,134,324,0.586,04/10/2018,2018.0
15,Towson (CAA),10,4-6,133,97,230,0.578,04/10/2018,2018.0
16,Johns Hopkins (Big Ten),10,8-2,149,111,260,0.573,04/10/2018,2018.0
17,Hofstra (CAA),10,5-5,104,80,184,0.565,04/10/2018,2018.0
18,Holy Cross (Patriot),11,3-8,128,102,230,0.557,04/10/2018,2018.0
19,Navy (Patriot),11,7-4,127,103,230,0.552,04/10/2018,2018.0
20,Mount St. Mary's (NEC),11,3-8,161,138,299,0.538,04/10/2018,2018.0
21,Army West Point (Patriot),10,5-5,110,95,205,0.537,04/10/2018,2018.0
22,Brown (Ivy League),9,5-4,127,110,237,0.536,04/10/2018,2018.0
23,Notre Dame (ACC),9,5-4,102,89,191,0.534,04/10/2018,2018.0
24,Ohio St. (Big Ten),11,5-6,127,111,238,0.534,04/10/2018,2018.0
25,Maryland (Big Ten),10,9-1,129,113,242,0.533,04/10/2018,2018.0
26,Fairfield (CAA),12,4-8,145,130,275,0.527,04/10/2018,2018.0
27,Providence (Big East),11,4-7,126,115,241,0.523,04/10/2018,2018.0
28,Air Force (SoCon),12,4-8,140,130,270,0.519,04/10/2018,2018.0
29,Delaware (CAA),10,4-6,127,121,248,0.512,04/10/2018,2018.0
30,Michigan (Big Ten),11,7-4,135,129,264,0.511,04/10/2018,2018.0
31,Quinnipiac (MAAC),11,6-5,130,129,259,0.502,04/10/2018,2018.0
32,Lafayette (Patriot),13,3-10,156,160,316,0.494,04/10/2018,2018.0
33,Cornell (Ivy League),11,8-3,152,156,308,0.494,04/10/2018,2018.0
34,Rutgers (Big Ten),11,8-3,132,139,271,0.487,04/10/2018,2018.0
35,High Point (SoCon),10,3-7,137,145,282,0.486,04/10/2018,2018.0
36,Bellarmine (SoCon),10,2-8,99,106,205,0.483,04/10/2018,2018.0
37,Duke (ACC),12,10-2,137,150,287,0.477,04/10/2018,2018.0
38,Harvard (Ivy League),10,7-3,126,138,264,0.477,04/10/2018,2018.0
39,Saint Joseph's (NEC),9,6-3,86,95,181,0.475,04/10/2018,2018.0
40,Princeton (Ivy League),10,5-5,134,149,283,0.473,04/10/2018,2018.0
41,Syracuse (ACC),10,6-4,120,134,254,0.472,04/10/2018,2018.0
42,Siena (MAAC),10,2-8,124,139,263,0.471,04/10/2018,2018.0
43,Sacred Heart (NEC),11,5-6,139,158,297,0.468,04/10/2018,2018.0
44,Cleveland St. (Independent),11,3-8,118,136,254,0.465,04/10/2018,2018.0
45,Vermont (America East),11,10-1,112,131,243,0.461,04/10/2018,2018.0
46,North Carolina (ACC),12,6-6,136,161,297,0.458,04/10/2018,2018.0
47,Boston U. (Patriot),12,6-6,134,162,296,0.453,04/10/2018,2018.0
48,Marist (MAAC),12,3-9,122,150,272,0.449,04/10/2018,2018.0
49,St. John's (NY) (Big East),11,6-5,116,143,259,0.448,04/10/2018,2018.0
50,Richmond (SoCon),11,6-5,116,145,261,0.444,04/10/2018,2018.0
51,Villanova (Big East),11,8-3,122,154,276,0.442,04/10/2018,2018.0
52,Bucknell (Patriot),12,9-3,124,158,282,0.440,04/10/2018,2018.0
53,Detroit Mercy (MAAC),11,5-6,105,135,240,0.438,04/10/2018,2018.0
54,Drexel (CAA),10,4-6,110,143,253,0.435,04/10/2018,2018.0
55,Manhattan (MAAC),11,4-7,100,137,237,0.422,04/10/2018,2018.0
56,Hampton (DI Independent),10,3-7,106,146,252,0.421,04/10/2018,2018.0
57,Loyola Maryland (Patriot),11,8-3,116,161,277,0.419,04/10/2018,2018.0
58,Robert Morris (NEC),11,8-3,107,152,259,0.413,04/10/2018,2018.0
59,Wagner (NEC),11,4-7,89,127,216,0.412,04/10/2018,2018.0
60,Georgetown (Big East),11,7-4,103,147,250,0.412,04/10/2018,2018.0
61,Mercer (SoCon),11,4-7,98,143,241,0.407,04/10/2018,2018.0
62,Binghamton (America East),12,4-8,122,179,301,0.405,04/10/2018,2018.0
63,Penn (Ivy League),11,5-6,99,147,246,0.402,04/10/2018,2018.0
64,UMBC (America East),10,3-7,76,116,192,0.396,04/10/2018,2018.0
65,UMass Lowell (America East),12,6-6,113,173,286,0.395,04/10/2018,2018.0
66,Dartmouth (Ivy League),10,2-8,96,147,243,0.395,04/10/2018,2018.0
67,Canisius (MAAC),11,5-6,118,184,302,0.391,04/10/2018,2018.0
68,Monmouth (MAAC),11,5-6,95,149,244,0.389,04/10/2018,2018.0
69,NJIT (Independent),13,0-13,97,187,284,0.342,04/10/2018,2018.0
1,UAlbany (America East),11,10-1,230,50,280,0.821,04/08/2018,2018.0
2,Denver (Big East),10,8-2,180,56,236,0.763,04/08/2018,2018.0
3,Bryant (NEC),11,6-5,186,83,269,0.691,04/08/2018,2018.0
4,Jacksonville (SoCon),10,5-5,169,77,246,0.687,04/08/2018,2018.0
5,Penn St. (Big Ten),11,7-4,191,93,284,0.673,04/08/2018,2018.0
6,Colgate (Patriot),11,6-5,177,103,280,0.632,04/08/2018,2018.0
7,Hobart (NEC),11,4-7,161,100,261,0.617,04/08/2018,2018.0
8,Yale (Ivy League),10,8-2,144,92,236,0.610,04/08/2018,2018.0
9,Hartford (America East),10,3-7,161,106,267,0.603,04/08/2018,2018.0
10,Massachusetts (CAA),11,7-4,169,113,282,0.599,04/08/2018,2018.0
11,VMI (Southland),9,2-7,128,86,214,0.598,04/08/2018,2018.0
12,Marquette (Big East),9,5-4,114,79,193,0.591,04/08/2018,2018.0
13,Lehigh (Patriot),12,8-4,165,115,280,0.589,04/08/2018,2018.0
14,Virginia (ACC),12,9-3,190,134,324,0.586,04/08/2018,2018.0
15,Towson (CAA),10,4-6,133,97,230,0.578,04/08/2018,2018.0
16,Johns Hopkins (Big Ten),10,8-2,149,111,260,0.573,04/08/2018,2018.0
17,Hofstra (CAA),10,5-5,104,80,184,0.565,04/08/2018,2018.0
18,Holy Cross (Patriot),11,3-8,128,102,230,0.557,04/08/2018,2018.0
19,Navy (Patriot),11,7-4,127,103,230,0.552,04/08/2018,2018.0
20,Mount St. Mary's (NEC),11,3-8,161,138,299,0.538,04/08/2018,2018.0
21,Army West Point (Patriot),10,5-5,110,95,205,0.537,04/08/2018,2018.0
22,Brown (Ivy League),9,5-4,127,110,237,0.536,04/08/2018,2018.0
23,Notre Dame (ACC),9,5-4,102,89,191,0.534,04/08/2018,2018.0
24,Ohio St. (Big Ten),11,5-6,127,111,238,0.534,04/08/2018,2018.0
25,Maryland (Big Ten),10,9-1,129,113,242,0.533,04/08/2018,2018.0
26,Fairfield (CAA),12,4-8,145,130,275,0.527,04/08/2018,2018.0
27,Providence (Big East),11,4-7,126,115,241,0.523,04/08/2018,2018.0
28,Air Force (SoCon),12,4-8,140,130,270,0.519,04/08/2018,2018.0
29,Delaware (CAA),10,4-6,127,121,248,0.512,04/08/2018,2018.0
30,Michigan (Big Ten),11,7-4,135,129,264,0.511,04/08/2018,2018.0
31,Quinnipiac (MAAC),11,6-5,130,129,259,0.502,04/08/2018,2018.0
32,Lafayette (Patriot),13,3-10,156,160,316,0.494,04/08/2018,2018.0
33,Cornell (Ivy League),10,7-3,139,144,283,0.491,04/08/2018,2018.0
34,Rutgers (Big Ten),11,8-3,132,139,271,0.487,04/08/2018,2018.0
35,High Point (SoCon),10,3-7,137,145,282,0.486,04/08/2018,2018.0
36,Bellarmine (SoCon),10,2-8,99,106,205,0.483,04/08/2018,2018.0
37,Duke (ACC),12,10-2,137,150,287,0.477,04/08/2018,2018.0
38,Harvard (Ivy League),10,7-3,126,138,264,0.477,04/08/2018,2018.0
39,Princeton (Ivy League),9,4-5,120,132,252,0.476,04/08/2018,2018.0
40,Saint Joseph's (NEC),9,6-3,86,95,181,0.475,04/08/2018,2018.0
41,Syracuse (ACC),9,6-3,108,121,229,0.472,04/08/2018,2018.0
42,Sacred Heart (NEC),11,5-6,139,158,297,0.468,04/08/2018,2018.0
43,Cleveland St. (Independent),11,3-8,118,136,254,0.465,04/08/2018,2018.0
44,Siena (MAAC),9,2-7,107,125,232,0.461,04/08/2018,2018.0
45,Vermont (America East),11,10-1,112,131,243,0.461,04/08/2018,2018.0
46,North Carolina (ACC),12,6-6,136,161,297,0.458,04/08/2018,2018.0
47,Boston U. (Patriot),12,6-6,134,162,296,0.453,04/08/2018,2018.0
48,Marist (MAAC),12,3-9,122,150,272,0.449,04/08/2018,2018.0
49,St. John's (NY) (Big East),11,6-5,116,143,259,0.448,04/08/2018,2018.0
50,Richmond (SoCon),11,6-5,116,145,261,0.444,04/08/2018,2018.0
51,Villanova (Big East),11,8-3,122,154,276,0.442,04/08/2018,2018.0
52,Bucknell (Patriot),12,9-3,124,158,282,0.440,04/08/2018,2018.0
53,Detroit Mercy (MAAC),11,5-6,105,135,240,0.438,04/08/2018,2018.0
54,Drexel (CAA),10,4-6,110,143,253,0.435,04/08/2018,2018.0
55,Manhattan (MAAC),11,4-7,100,137,237,0.422,04/08/2018,2018.0
56,Hampton (DI Independent),9,2-7,95,134,229,0.415,04/08/2018,2018.0
57,Wagner (NEC),11,4-7,89,127,216,0.412,04/08/2018,2018.0
58,Loyola Maryland (Patriot),10,7-3,104,150,254,0.409,04/08/2018,2018.0
59,Mercer (SoCon),11,4-7,98,143,241,0.407,04/08/2018,2018.0
60,Binghamton (America East),12,4-8,122,179,301,0.405,04/08/2018,2018.0
61,Georgetown (Big East),10,7-3,92,135,227,0.405,04/08/2018,2018.0
62,Robert Morris (NEC),10,7-3,95,140,235,0.404,04/08/2018,2018.0
63,Penn (Ivy League),11,5-6,99,147,246,0.402,04/08/2018,2018.0
64,UMBC (America East),10,3-7,76,116,192,0.396,04/08/2018,2018.0
65,UMass Lowell (America East),11,5-6,104,161,265,0.392,04/08/2018,2018.0
66,Monmouth (MAAC),11,5-6,95,149,244,0.389,04/08/2018,2018.0
67,Canisius (MAAC),10,5-5,106,172,278,0.381,04/08/2018,2018.0
68,Dartmouth (Ivy League),9,2-7,84,138,222,0.378,04/08/2018,2018.0
69,NJIT (Independent),13,0-13,97,187,284,0.342,04/08/2018,2018.0
1,UAlbany (America East),10,10-0,211,48,259,0.815,04/05/2018,2018.0
2,Denver (Big East),9,7-2,153,53,206,0.743,04/05/2018,2018.0
3,Jacksonville (SoCon),9,4-5,150,68,218,0.688,04/05/2018,2018.0
4,Bryant (NEC),10,5-5,173,81,254,0.681,04/05/2018,2018.0
5,Penn St. (Big Ten),10,7-3,172,84,256,0.672,04/05/2018,2018.0
6,Colgate (Patriot),10,6-4,165,90,255,0.647,04/05/2018,2018.0
7,Lehigh (Patriot),11,8-3,153,97,250,0.612,04/05/2018,2018.0
8,Johns Hopkins (Big Ten),9,7-2,141,92,233,0.605,04/05/2018,2018.0
9,Hobart (NEC),10,4-6,144,94,238,0.605,04/05/2018,2018.0
10,Virginia (ACC),11,8-3,178,118,296,0.601,04/05/2018,2018.0
11,Hartford (America East),9,3-6,143,96,239,0.598,04/05/2018,2018.0
12,Yale (Ivy League),9,7-2,124,85,209,0.593,04/05/2018,2018.0
13,Towson (CAA),9,3-6,118,82,200,0.590,04/05/2018,2018.0
14,Massachusetts (CAA),10,6-4,155,109,264,0.587,04/05/2018,2018.0
15,VMI (Southland),8,2-6,109,80,189,0.577,04/05/2018,2018.0
16,Marquette (Big East),8,4-4,96,73,169,0.568,04/05/2018,2018.0
17,Maryland (Big Ten),9,8-1,120,94,214,0.561,04/05/2018,2018.0
18,Navy (Patriot),10,6-4,114,91,205,0.556,04/05/2018,2018.0
19,Holy Cross (Patriot),10,2-8,115,93,208,0.553,04/05/2018,2018.0
20,Hofstra (CAA),9,5-4,94,77,171,0.550,04/05/2018,2018.0
21,Fairfield (CAA),11,3-8,142,120,262,0.542,04/05/2018,2018.0
22,Air Force (SoCon),11,4-7,131,111,242,0.541,04/05/2018,2018.0
23,Delaware (CAA),9,4-5,123,107,230,0.535,04/05/2018,2018.0
24,Army West Point (Patriot),9,5-4,99,87,186,0.532,04/05/2018,2018.0
25,Notre Dame (ACC),8,5-3,94,84,178,0.528,04/05/2018,2018.0
26,Mount St. Mary's (NEC),10,3-7,144,129,273,0.527,04/05/2018,2018.0
27,Brown (Ivy League),8,4-4,113,103,216,0.523,04/05/2018,2018.0
28,Michigan (Big Ten),10,7-3,123,115,238,0.517,04/05/2018,2018.0
29,Ohio St. (Big Ten),10,5-5,108,103,211,0.512,04/05/2018,2018.0
30,Quinnipiac (MAAC),10,5-5,121,120,241,0.502,04/05/2018,2018.0
31,Lafayette (Patriot),12,3-9,147,147,294,0.500,04/05/2018,2018.0
31,Providence (Big East),10,4-6,113,113,226,0.500,04/05/2018,2018.0
33,Harvard (Ivy League),9,7-2,115,119,234,0.491,04/05/2018,2018.0
34,Villanova (Big East),10,8-2,119,127,246,0.484,04/05/2018,2018.0
35,Saint Joseph's (NEC),8,5-3,73,78,151,0.483,04/05/2018,2018.0
36,Duke (ACC),11,9-2,132,142,274,0.482,04/05/2018,2018.0
37,Rutgers (Big Ten),10,7-3,118,127,245,0.482,04/05/2018,2018.0
38,Bellarmine (SoCon),9,2-7,90,98,188,0.479,04/05/2018,2018.0
39,Cornell (Ivy League),9,6-3,120,133,253,0.474,04/05/2018,2018.0
40,Syracuse (ACC),9,6-3,108,121,229,0.472,04/05/2018,2018.0
41,High Point (SoCon),9,2-7,120,136,256,0.469,04/05/2018,2018.0
42,St. John's (NY) (Big East),10,6-4,110,125,235,0.468,04/05/2018,2018.0
43,Sacred Heart (NEC),10,5-5,122,145,267,0.457,04/05/2018,2018.0
44,Boston U. (Patriot),11,5-6,126,151,277,0.455,04/05/2018,2018.0
45,Siena (MAAC),8,2-6,95,114,209,0.455,04/05/2018,2018.0
46,Princeton (Ivy League),8,3-5,102,123,225,0.453,04/05/2018,2018.0
47,Bucknell (Patriot),11,8-3,115,141,256,0.449,04/05/2018,2018.0
48,North Carolina (ACC),11,6-5,120,149,269,0.446,04/05/2018,2018.0
49,Marist (MAAC),11,2-9,111,138,249,0.446,04/05/2018,2018.0
50,Hampton (DI Independent),8,2-6,89,111,200,0.445,04/05/2018,2018.0
51,Richmond (SoCon),10,5-5,108,136,244,0.443,04/05/2018,2018.0
52,Vermont (America East),10,9-1,97,124,221,0.439,04/05/2018,2018.0
53,Wagner (NEC),10,4-6,87,114,201,0.433,04/05/2018,2018.0
54,UMBC (America East),9,2-7,74,97,171,0.433,04/05/2018,2018.0
55,Mercer (SoCon),10,3-7,93,124,217,0.429,04/05/2018,2018.0
56,Drexel (CAA),9,4-5,95,128,223,0.426,04/05/2018,2018.0
57,Georgetown (Big East),9,6-3,90,122,212,0.425,04/05/2018,2018.0
58,Detroit Mercy (MAAC),10,4-6,91,124,215,0.423,04/05/2018,2018.0
59,Cleveland St. (Independent),10,2-8,95,130,225,0.422,04/05/2018,2018.0
60,Robert Morris (NEC),9,6-3,89,123,212,0.420,04/05/2018,2018.0
61,Manhattan (MAAC),10,4-6,91,128,219,0.416,04/05/2018,2018.0
62,Binghamton (America East),11,3-8,112,161,273,0.410,04/05/2018,2018.0
63,Penn (Ivy League),10,5-5,92,133,225,0.409,04/05/2018,2018.0
64,UMass Lowell (America East),10,5-5,97,146,243,0.399,04/05/2018,2018.0
65,Dartmouth (Ivy League),8,2-6,77,118,195,0.395,04/05/2018,2018.0
66,Loyola Maryland (Patriot),9,6-3,86,138,224,0.384,04/05/2018,2018.0
67,Canisius (MAAC),9,5-4,95,158,253,0.375,04/05/2018,2018.0
68,Monmouth (MAAC),10,4-6,84,142,226,0.372,04/05/2018,2018.0
69,NJIT (Independent),12,0-12,90,176,266,0.338,04/05/2018,2018.0
1,UAlbany (America East),10,10-0,211,48,259,0.815,04/04/2018,2018.0
2,Denver (Big East),9,7-2,153,53,206,0.743,04/04/2018,2018.0
3,Jacksonville (SoCon),9,4-5,150,68,218,0.688,04/04/2018,2018.0
4,Bryant (NEC),10,5-5,173,81,254,0.681,04/04/2018,2018.0
5,Penn St. (Big Ten),10,7-3,172,84,256,0.672,04/04/2018,2018.0
6,Colgate (Patriot),10,6-4,165,90,255,0.647,04/04/2018,2018.0
7,Lehigh (Patriot),11,8-3,153,97,250,0.612,04/04/2018,2018.0
8,Johns Hopkins (Big Ten),9,7-2,141,92,233,0.605,04/04/2018,2018.0
9,Hobart (NEC),10,4-6,144,94,238,0.605,04/04/2018,2018.0
10,Virginia (ACC),11,8-3,178,118,296,0.601,04/04/2018,2018.0
11,Hartford (America East),9,3-6,143,96,239,0.598,04/04/2018,2018.0
12,Yale (Ivy League),9,7-2,124,85,209,0.593,04/04/2018,2018.0
13,Towson (CAA),9,3-6,118,82,200,0.590,04/04/2018,2018.0
14,Massachusetts (CAA),10,6-4,155,109,264,0.587,04/04/2018,2018.0
15,VMI (Southland),8,2-6,109,80,189,0.577,04/04/2018,2018.0
16,Marquette (Big East),8,4-4,96,73,169,0.568,04/04/2018,2018.0
17,Maryland (Big Ten),9,8-1,120,94,214,0.561,04/04/2018,2018.0
18,Navy (Patriot),10,6-4,114,91,205,0.556,04/04/2018,2018.0
19,Holy Cross (Patriot),10,2-8,115,93,208,0.553,04/04/2018,2018.0
20,Hofstra (CAA),9,5-4,94,77,171,0.550,04/04/2018,2018.0
21,Fairfield (CAA),11,3-8,142,120,262,0.542,04/04/2018,2018.0
22,Air Force (SoCon),11,4-7,131,111,242,0.541,04/04/2018,2018.0
23,Delaware (CAA),9,4-5,123,107,230,0.535,04/04/2018,2018.0
24,Army West Point (Patriot),9,5-4,99,87,186,0.532,04/04/2018,2018.0
25,Notre Dame (ACC),8,5-3,94,84,178,0.528,04/04/2018,2018.0
26,Mount St. Mary's (NEC),10,3-7,144,129,273,0.527,04/04/2018,2018.0
27,Brown (Ivy League),8,4-4,113,103,216,0.523,04/04/2018,2018.0
28,Michigan (Big Ten),10,7-3,123,115,238,0.517,04/04/2018,2018.0
29,Ohio St. (Big Ten),10,5-5,108,103,211,0.512,04/04/2018,2018.0
30,Quinnipiac (MAAC),10,5-5,121,120,241,0.502,04/04/2018,2018.0
31,Lafayette (Patriot),12,3-9,147,147,294,0.500,04/04/2018,2018.0
31,Providence (Big East),10,4-6,113,113,226,0.500,04/04/2018,2018.0
33,Harvard (Ivy League),9,7-2,115,119,234,0.491,04/04/2018,2018.0
34,Villanova (Big East),10,8-2,119,127,246,0.484,04/04/2018,2018.0
35,Saint Joseph's (NEC),8,5-3,73,78,151,0.483,04/04/2018,2018.0
36,Duke (ACC),11,9-2,132,142,274,0.482,04/04/2018,2018.0
37,Rutgers (Big Ten),10,7-3,118,127,245,0.482,04/04/2018,2018.0
38,Bellarmine (SoCon),9,2-7,90,98,188,0.479,04/04/2018,2018.0
39,Cornell (Ivy League),9,6-3,120,133,253,0.474,04/04/2018,2018.0
40,Syracuse (ACC),9,6-3,108,121,229,0.472,04/04/2018,2018.0
41,High Point (SoCon),9,2-7,120,136,256,0.469,04/04/2018,2018.0
42,St. John's (NY) (Big East),10,6-4,110,125,235,0.468,04/04/2018,2018.0
43,Sacred Heart (NEC),10,5-5,122,145,267,0.457,04/04/2018,2018.0
44,Boston U. (Patriot),11,5-6,126,151,277,0.455,04/04/2018,2018.0
45,Siena (MAAC),8,2-6,95,114,209,0.455,04/04/2018,2018.0
46,Princeton (Ivy League),8,3-5,102,123,225,0.453,04/04/2018,2018.0
47,Bucknell (Patriot),11,8-3,115,141,256,0.449,04/04/2018,2018.0
48,North Carolina (ACC),11,6-5,120,149,269,0.446,04/04/2018,2018.0
49,Marist (MAAC),11,2-9,111,138,249,0.446,04/04/2018,2018.0
50,Hampton (DI Independent),8,2-6,89,111,200,0.445,04/04/2018,2018.0
51,Richmond (SoCon),10,5-5,108,136,244,0.443,04/04/2018,2018.0
52,Vermont (America East),10,9-1,97,124,221,0.439,04/04/2018,2018.0
53,Wagner (NEC),10,4-6,87,114,201,0.433,04/04/2018,2018.0
54,UMBC (America East),9,2-7,74,97,171,0.433,04/04/2018,2018.0
55,Mercer (SoCon),10,3-7,93,124,217,0.429,04/04/2018,2018.0
56,Drexel (CAA),9,4-5,95,128,223,0.426,04/04/2018,2018.0
57,Georgetown (Big East),9,6-3,90,122,212,0.425,04/04/2018,2018.0
58,Detroit Mercy (MAAC),10,4-6,91,124,215,0.423,04/04/2018,2018.0
59,Cleveland St. (Independent),10,2-8,95,130,225,0.422,04/04/2018,2018.0
60,Robert Morris (NEC),9,6-3,89,123,212,0.420,04/04/2018,2018.0
61,Manhattan (MAAC),10,4-6,91,128,219,0.416,04/04/2018,2018.0
62,Binghamton (America East),11,3-8,112,161,273,0.410,04/04/2018,2018.0
63,Penn (Ivy League),10,5-5,92,133,225,0.409,04/04/2018,2018.0
64,UMass Lowell (America East),10,5-5,97,146,243,0.399,04/04/2018,2018.0
65,Dartmouth (Ivy League),8,2-6,77,118,195,0.395,04/04/2018,2018.0
66,Loyola Maryland (Patriot),9,6-3,86,138,224,0.384,04/04/2018,2018.0
67,Canisius (MAAC),9,5-4,95,158,253,0.375,04/04/2018,2018.0
68,Monmouth (MAAC),10,4-6,84,142,226,0.372,04/04/2018,2018.0
69,NJIT (Independent),12,0-12,90,176,266,0.338,04/04/2018,2018.0
1,UAlbany (America East),10,10-0,211,48,259,0.815,04/03/2018,2018.0
2,Denver (Big East),9,7-2,153,53,206,0.743,04/03/2018,2018.0
3,Jacksonville (SoCon),9,4-5,150,68,218,0.688,04/03/2018,2018.0
4,Bryant (NEC),10,5-5,173,81,254,0.681,04/03/2018,2018.0
5,Penn St. (Big Ten),10,7-3,172,84,256,0.672,04/03/2018,2018.0
6,Colgate (Patriot),10,6-4,165,90,255,0.647,04/03/2018,2018.0
7,Lehigh (Patriot),11,8-3,153,97,250,0.612,04/03/2018,2018.0
8,Johns Hopkins (Big Ten),9,7-2,141,92,233,0.605,04/03/2018,2018.0
9,Hobart (NEC),10,4-6,144,94,238,0.605,04/03/2018,2018.0
10,Virginia (ACC),11,8-3,178,118,296,0.601,04/03/2018,2018.0
11,Hartford (America East),9,3-6,143,96,239,0.598,04/03/2018,2018.0
12,Towson (CAA),9,3-6,118,82,200,0.590,04/03/2018,2018.0
13,Massachusetts (CAA),10,6-4,155,109,264,0.587,04/03/2018,2018.0
14,Yale (Ivy League),8,7-1,111,79,190,0.584,04/03/2018,2018.0
15,VMI (Southland),8,2-6,109,80,189,0.577,04/03/2018,2018.0
16,Marquette (Big East),8,4-4,96,73,169,0.568,04/03/2018,2018.0
17,Maryland (Big Ten),9,8-1,120,94,214,0.561,04/03/2018,2018.0
18,Navy (Patriot),10,6-4,114,91,205,0.556,04/03/2018,2018.0
19,Holy Cross (Patriot),10,2-8,115,93,208,0.553,04/03/2018,2018.0
20,Hofstra (CAA),9,5-4,94,77,171,0.550,04/03/2018,2018.0
21,Fairfield (CAA),11,3-8,142,120,262,0.542,04/03/2018,2018.0
22,Air Force (SoCon),11,4-7,131,111,242,0.541,04/03/2018,2018.0
23,Delaware (CAA),9,4-5,123,107,230,0.535,04/03/2018,2018.0
24,Army West Point (Patriot),9,5-4,99,87,186,0.532,04/03/2018,2018.0
25,Notre Dame (ACC),8,5-3,94,84,178,0.528,04/03/2018,2018.0
26,Mount St. Mary's (NEC),10,3-7,144,129,273,0.527,04/03/2018,2018.0
27,Brown (Ivy League),8,4-4,113,103,216,0.523,04/03/2018,2018.0
28,Michigan (Big Ten),10,7-3,123,115,238,0.517,04/03/2018,2018.0
29,Ohio St. (Big Ten),10,5-5,108,103,211,0.512,04/03/2018,2018.0
30,Quinnipiac (MAAC),10,5-5,121,120,241,0.502,04/03/2018,2018.0
31,Lafayette (Patriot),12,3-9,147,147,294,0.500,04/03/2018,2018.0
31,Providence (Big East),10,4-6,113,113,226,0.500,04/03/2018,2018.0
33,Harvard (Ivy League),9,7-2,115,119,234,0.491,04/03/2018,2018.0
34,Villanova (Big East),10,8-2,119,127,246,0.484,04/03/2018,2018.0
35,Saint Joseph's (NEC),8,5-3,73,78,151,0.483,04/03/2018,2018.0
36,Duke (ACC),11,9-2,132,142,274,0.482,04/03/2018,2018.0
37,Rutgers (Big Ten),10,7-3,118,127,245,0.482,04/03/2018,2018.0
38,Bellarmine (SoCon),9,2-7,90,98,188,0.479,04/03/2018,2018.0
39,Cornell (Ivy League),9,6-3,120,133,253,0.474,04/03/2018,2018.0
40,Syracuse (ACC),9,6-3,108,121,229,0.472,04/03/2018,2018.0
41,High Point (SoCon),9,2-7,120,136,256,0.469,04/03/2018,2018.0
42,St. John's (NY) (Big East),10,6-4,110,125,235,0.468,04/03/2018,2018.0
43,Bucknell (Patriot),10,7-3,109,128,237,0.460,04/03/2018,2018.0
44,Sacred Heart (NEC),10,5-5,122,145,267,0.457,04/03/2018,2018.0
45,Boston U. (Patriot),11,5-6,126,151,277,0.455,04/03/2018,2018.0
46,Siena (MAAC),8,2-6,95,114,209,0.455,04/03/2018,2018.0
47,Princeton (Ivy League),8,3-5,102,123,225,0.453,04/03/2018,2018.0
48,North Carolina (ACC),11,6-5,120,149,269,0.446,04/03/2018,2018.0
49,Marist (MAAC),11,2-9,111,138,249,0.446,04/03/2018,2018.0
50,Richmond (SoCon),10,5-5,108,136,244,0.443,04/03/2018,2018.0
51,Vermont (America East),10,9-1,97,124,221,0.439,04/03/2018,2018.0
52,Wagner (NEC),10,4-6,87,114,201,0.433,04/03/2018,2018.0
53,UMBC (America East),9,2-7,74,97,171,0.433,04/03/2018,2018.0
54,Mercer (SoCon),10,3-7,93,124,217,0.429,04/03/2018,2018.0
54,Hampton (DI Independent),7,2-5,69,92,161,0.429,04/03/2018,2018.0
56,Drexel (CAA),9,4-5,95,128,223,0.426,04/03/2018,2018.0
57,Georgetown (Big East),9,6-3,90,122,212,0.425,04/03/2018,2018.0
58,Detroit Mercy (MAAC),10,4-6,91,124,215,0.423,04/03/2018,2018.0
59,Cleveland St. (Independent),10,2-8,95,130,225,0.422,04/03/2018,2018.0
60,Robert Morris (NEC),9,6-3,89,123,212,0.420,04/03/2018,2018.0
61,Manhattan (MAAC),10,4-6,91,128,219,0.416,04/03/2018,2018.0
62,Binghamton (America East),11,3-8,112,161,273,0.410,04/03/2018,2018.0
63,Penn (Ivy League),10,5-5,92,133,225,0.409,04/03/2018,2018.0
64,UMass Lowell (America East),10,5-5,97,146,243,0.399,04/03/2018,2018.0
65,Dartmouth (Ivy League),8,2-6,77,118,195,0.395,04/03/2018,2018.0
66,Loyola Maryland (Patriot),9,6-3,86,138,224,0.384,04/03/2018,2018.0
67,Canisius (MAAC),9,5-4,95,158,253,0.375,04/03/2018,2018.0
68,Monmouth (MAAC),10,4-6,84,142,226,0.372,04/03/2018,2018.0
69,NJIT (Independent),12,0-12,90,176,266,0.338,04/03/2018,2018.0
1,UAlbany (America East),10,10-0,211,48,259,0.815,04/02/2018,2018.0
2,Denver (Big East),9,7-2,153,53,206,0.743,04/02/2018,2018.0
3,Jacksonville (SoCon),9,4-5,150,68,218,0.688,04/02/2018,2018.0
4,Bryant (NEC),10,5-5,173,81,254,0.681,04/02/2018,2018.0
5,Penn St. (Big Ten),10,7-3,172,84,256,0.672,04/02/2018,2018.0
6,Colgate (Patriot),10,6-4,165,90,255,0.647,04/02/2018,2018.0
7,Lehigh (Patriot),11,8-3,153,97,250,0.612,04/02/2018,2018.0
8,Hobart (NEC),9,4-5,134,86,220,0.609,04/02/2018,2018.0
9,Johns Hopkins (Big Ten),9,7-2,141,92,233,0.605,04/02/2018,2018.0
10,Virginia (ACC),11,8-3,178,118,296,0.601,04/02/2018,2018.0
11,Hartford (America East),9,3-6,143,96,239,0.598,04/02/2018,2018.0
12,Towson (CAA),9,3-6,118,82,200,0.590,04/02/2018,2018.0
13,Massachusetts (CAA),10,6-4,155,109,264,0.587,04/02/2018,2018.0
14,Yale (Ivy League),8,7-1,111,79,190,0.584,04/02/2018,2018.0
15,VMI (Southland),8,2-6,109,80,189,0.577,04/02/2018,2018.0
16,Marquette (Big East),8,4-4,96,73,169,0.568,04/02/2018,2018.0
17,Maryland (Big Ten),9,8-1,120,94,214,0.561,04/02/2018,2018.0
18,Navy (Patriot),10,6-4,114,91,205,0.556,04/02/2018,2018.0
19,Holy Cross (Patriot),10,2-8,115,93,208,0.553,04/02/2018,2018.0
20,Hofstra (CAA),9,5-4,94,77,171,0.550,04/02/2018,2018.0
21,Fairfield (CAA),11,3-8,142,120,262,0.542,04/02/2018,2018.0
22,Air Force (SoCon),11,4-7,131,111,242,0.541,04/02/2018,2018.0
23,Delaware (CAA),9,4-5,123,107,230,0.535,04/02/2018,2018.0
24,Army West Point (Patriot),9,5-4,99,87,186,0.532,04/02/2018,2018.0
25,Notre Dame (ACC),8,5-3,94,84,178,0.528,04/02/2018,2018.0
26,Mount St. Mary's (NEC),10,3-7,144,129,273,0.527,04/02/2018,2018.0
27,Brown (Ivy League),8,4-4,113,103,216,0.523,04/02/2018,2018.0
28,Michigan (Big Ten),10,7-3,123,115,238,0.517,04/02/2018,2018.0
29,Ohio St. (Big Ten),10,5-5,108,103,211,0.512,04/02/2018,2018.0
30,Quinnipiac (MAAC),10,5-5,121,120,241,0.502,04/02/2018,2018.0
31,Providence (Big East),10,4-6,113,113,226,0.500,04/02/2018,2018.0
32,Lafayette (Patriot),11,2-9,134,135,269,0.498,04/02/2018,2018.0
33,Harvard (Ivy League),9,7-2,115,119,234,0.491,04/02/2018,2018.0
34,Villanova (Big East),10,8-2,119,127,246,0.484,04/02/2018,2018.0
35,Saint Joseph's (NEC),8,5-3,73,78,151,0.483,04/02/2018,2018.0
36,Duke (ACC),11,9-2,132,142,274,0.482,04/02/2018,2018.0
37,Rutgers (Big Ten),10,7-3,118,127,245,0.482,04/02/2018,2018.0
38,Bellarmine (SoCon),9,2-7,90,98,188,0.479,04/02/2018,2018.0
39,Cornell (Ivy League),9,6-3,120,133,253,0.474,04/02/2018,2018.0
40,Syracuse (ACC),8,5-3,100,111,211,0.474,04/02/2018,2018.0
41,High Point (SoCon),9,2-7,120,136,256,0.469,04/02/2018,2018.0
42,St. John's (NY) (Big East),9,6-3,100,117,217,0.461,04/02/2018,2018.0
43,Bucknell (Patriot),10,7-3,109,128,237,0.460,04/02/2018,2018.0
44,Sacred Heart (NEC),10,5-5,122,145,267,0.457,04/02/2018,2018.0
45,Boston U. (Patriot),11,5-6,126,151,277,0.455,04/02/2018,2018.0
46,Siena (MAAC),8,2-6,95,114,209,0.455,04/02/2018,2018.0
47,Princeton (Ivy League),8,3-5,102,123,225,0.453,04/02/2018,2018.0
48,North Carolina (ACC),11,6-5,120,149,269,0.446,04/02/2018,2018.0
49,Marist (MAAC),11,2-9,111,138,249,0.446,04/02/2018,2018.0
50,Richmond (SoCon),10,5-5,108,136,244,0.443,04/02/2018,2018.0
51,Vermont (America East),10,9-1,97,124,221,0.439,04/02/2018,2018.0
52,Wagner (NEC),10,4-6,87,114,201,0.433,04/02/2018,2018.0
53,UMBC (America East),9,2-7,74,97,171,0.433,04/02/2018,2018.0
54,Mercer (SoCon),10,3-7,93,124,217,0.429,04/02/2018,2018.0
54,Hampton (DI Independent),7,2-5,69,92,161,0.429,04/02/2018,2018.0
56,Drexel (CAA),9,4-5,95,128,223,0.426,04/02/2018,2018.0
57,Georgetown (Big East),9,6-3,90,122,212,0.425,04/02/2018,2018.0
58,Detroit Mercy (MAAC),10,4-6,91,124,215,0.423,04/02/2018,2018.0
59,Cleveland St. (Independent),10,2-8,95,130,225,0.422,04/02/2018,2018.0
60,Robert Morris (NEC),9,6-3,89,123,212,0.420,04/02/2018,2018.0
61,Manhattan (MAAC),10,4-6,91,128,219,0.416,04/02/2018,2018.0
62,Binghamton (America East),11,3-8,112,161,273,0.410,04/02/2018,2018.0
63,Penn (Ivy League),10,5-5,92,133,225,0.409,04/02/2018,2018.0
64,UMass Lowell (America East),10,5-5,97,146,243,0.399,04/02/2018,2018.0
65,Dartmouth (Ivy League),8,2-6,77,118,195,0.395,04/02/2018,2018.0
66,Loyola Maryland (Patriot),9,6-3,86,138,224,0.384,04/02/2018,2018.0
67,Canisius (MAAC),9,5-4,95,158,253,0.375,04/02/2018,2018.0
68,Monmouth (MAAC),9,4-5,72,129,201,0.358,04/02/2018,2018.0
69,NJIT (Independent),12,0-12,90,176,266,0.338,04/02/2018,2018.0
1,UAlbany (America East),9,9-0,187,48,235,0.796,03/28/2018,2018.0
2,Denver (Big East),8,6-2,141,50,191,0.738,03/28/2018,2018.0
3,Jacksonville (SoCon),8,4-4,136,60,196,0.694,03/28/2018,2018.0
4,Bryant (NEC),9,4-5,159,74,233,0.682,03/28/2018,2018.0
5,Penn St. (Big Ten),9,6-3,159,77,236,0.674,03/28/2018,2018.0
6,Colgate (Patriot),9,6-3,148,85,233,0.635,03/28/2018,2018.0
7,Johns Hopkins (Big Ten),8,6-2,129,77,206,0.626,03/28/2018,2018.0
8,Lehigh (Patriot),10,7-3,145,88,233,0.622,03/28/2018,2018.0
9,Hobart (NEC),9,4-5,134,86,220,0.609,03/28/2018,2018.0
10,Virginia (ACC),10,7-3,161,108,269,0.599,03/28/2018,2018.0
11,Massachusetts (CAA),9,5-4,142,97,239,0.594,03/28/2018,2018.0
12,Hartford (America East),8,3-5,128,92,220,0.582,03/28/2018,2018.0
13,Towson (CAA),8,3-5,107,77,184,0.582,03/28/2018,2018.0
14,Maryland (Big Ten),8,7-1,111,81,192,0.578,03/28/2018,2018.0
15,Hofstra (CAA),8,4-4,89,66,155,0.574,03/28/2018,2018.0
16,Holy Cross (Patriot),9,2-7,111,84,195,0.569,03/28/2018,2018.0
17,Yale (Ivy League),7,6-1,95,73,168,0.565,03/28/2018,2018.0
18,Fairfield (CAA),10,3-7,131,106,237,0.553,03/28/2018,2018.0
19,Marquette (Big East),7,4-3,79,64,143,0.552,03/28/2018,2018.0
20,Navy (Patriot),9,5-4,105,87,192,0.547,03/28/2018,2018.0
21,VMI (Southland),7,1-6,90,76,166,0.542,03/28/2018,2018.0
22,Air Force (SoCon),10,3-7,120,103,223,0.538,03/28/2018,2018.0
23,Army West Point (Patriot),8,5-3,88,77,165,0.533,03/28/2018,2018.0
24,Delaware (CAA),8,3-5,109,96,205,0.532,03/28/2018,2018.0
25,Ohio St. (Big Ten),9,5-4,101,90,191,0.529,03/28/2018,2018.0
26,Brown (Ivy League),7,3-4,97,88,185,0.524,03/28/2018,2018.0
27,Mount St. Mary's (NEC),9,3-6,131,119,250,0.524,03/28/2018,2018.0
28,Notre Dame (ACC),7,5-2,83,76,159,0.522,03/28/2018,2018.0
29,Quinnipiac (MAAC),9,4-5,111,105,216,0.514,03/28/2018,2018.0
30,Michigan (Big Ten),9,7-2,110,106,216,0.509,03/28/2018,2018.0
31,Villanova (Big East),9,7-2,110,110,220,0.500,03/28/2018,2018.0
32,Saint Joseph's (NEC),7,4-3,63,65,128,0.492,03/28/2018,2018.0
33,Harvard (Ivy League),9,7-2,115,119,234,0.491,03/28/2018,2018.0
34,Providence (Big East),9,3-6,98,102,200,0.490,03/28/2018,2018.0
35,Bellarmine (SoCon),8,2-6,82,87,169,0.485,03/28/2018,2018.0
36,Lafayette (Patriot),10,2-8,117,127,244,0.480,03/28/2018,2018.0
37,Syracuse (ACC),7,4-3,92,100,192,0.479,03/28/2018,2018.0
38,High Point (SoCon),8,1-7,112,122,234,0.479,03/28/2018,2018.0
39,Rutgers (Big Ten),9,7-2,103,115,218,0.472,03/28/2018,2018.0
40,Hampton (DI Independent),6,2-4,65,73,138,0.471,03/28/2018,2018.0
41,St. John's (NY) (Big East),8,6-2,89,102,191,0.466,03/28/2018,2018.0
42,North Carolina (ACC),10,6-4,113,132,245,0.461,03/28/2018,2018.0
43,Vermont (America East),9,8-1,93,109,202,0.460,03/28/2018,2018.0
44,Duke (ACC),10,8-2,115,135,250,0.460,03/28/2018,2018.0
45,Sacred Heart (NEC),9,4-5,112,132,244,0.459,03/28/2018,2018.0
46,Bucknell (Patriot),9,6-3,99,117,216,0.458,03/28/2018,2018.0
47,Cornell (Ivy League),8,5-3,99,118,217,0.456,03/28/2018,2018.0
48,Richmond (SoCon),9,5-4,98,119,217,0.452,03/28/2018,2018.0
49,Boston U. (Patriot),10,5-5,117,143,260,0.450,03/28/2018,2018.0
50,Marist (MAAC),10,2-8,101,124,225,0.449,03/28/2018,2018.0
51,Princeton (Ivy League),7,3-4,87,107,194,0.448,03/28/2018,2018.0
52,Georgetown (Big East),8,6-2,87,110,197,0.442,03/28/2018,2018.0
53,Robert Morris (NEC),8,6-2,82,109,191,0.429,03/28/2018,2018.0
54,Siena (MAAC),7,2-5,78,105,183,0.426,03/28/2018,2018.0
55,Penn (Ivy League),9,5-4,86,117,203,0.424,03/28/2018,2018.0
56,Cleveland St. (Independent),10,2-8,95,130,225,0.422,03/28/2018,2018.0
57,Binghamton (America East),10,2-8,104,144,248,0.419,03/28/2018,2018.0
58,Drexel (CAA),8,4-4,83,115,198,0.419,03/28/2018,2018.0
59,Wagner (NEC),9,4-5,74,104,178,0.416,03/28/2018,2018.0
60,Manhattan (MAAC),9,3-6,82,116,198,0.414,03/28/2018,2018.0
61,UMass Lowell (America East),9,4-5,90,132,222,0.405,03/28/2018,2018.0
62,Loyola Maryland (Patriot),8,5-3,81,121,202,0.401,03/28/2018,2018.0
63,Detroit Mercy (MAAC),9,4-5,76,114,190,0.400,03/28/2018,2018.0
63,UMBC (America East),8,2-6,60,90,150,0.400,03/28/2018,2018.0
65,Dartmouth (Ivy League),7,2-5,62,97,159,0.390,03/28/2018,2018.0
66,Mercer (SoCon),9,3-6,77,121,198,0.389,03/28/2018,2018.0
67,Monmouth (MAAC),8,3-5,63,112,175,0.360,03/28/2018,2018.0
68,Canisius (MAAC),8,4-4,81,148,229,0.354,03/28/2018,2018.0
69,Furman (SoCon),8,2-6,73,136,209,0.349,03/28/2018,2018.0
1,UAlbany (America East),8,8-0,171,40,211,0.810,03/27/2018,2018.0
2,Denver (Big East),8,6-2,141,50,191,0.738,03/27/2018,2018.0
3,Jacksonville (SoCon),8,4-4,136,60,196,0.694,03/27/2018,2018.0
4,Bryant (NEC),9,4-5,159,74,233,0.682,03/27/2018,2018.0
5,Penn St. (Big Ten),9,6-3,159,77,236,0.674,03/27/2018,2018.0
6,Colgate (Patriot),9,6-3,148,85,233,0.635,03/27/2018,2018.0
7,Johns Hopkins (Big Ten),8,6-2,129,77,206,0.626,03/27/2018,2018.0
8,Lehigh (Patriot),10,7-3,145,88,233,0.622,03/27/2018,2018.0
9,Hobart (NEC),9,4-5,134,86,220,0.609,03/27/2018,2018.0
10,Virginia (ACC),10,7-3,161,108,269,0.599,03/27/2018,2018.0
11,Massachusetts (CAA),9,5-4,142,97,239,0.594,03/27/2018,2018.0
12,Hartford (America East),8,3-5,128,92,220,0.582,03/27/2018,2018.0
13,Towson (CAA),8,3-5,107,77,184,0.582,03/27/2018,2018.0
14,Maryland (Big Ten),8,7-1,111,81,192,0.578,03/27/2018,2018.0
15,Hofstra (CAA),8,4-4,89,66,155,0.574,03/27/2018,2018.0
16,Holy Cross (Patriot),9,2-7,111,84,195,0.569,03/27/2018,2018.0
17,Yale (Ivy League),7,6-1,95,73,168,0.565,03/27/2018,2018.0
18,Fairfield (CAA),10,3-7,131,106,237,0.553,03/27/2018,2018.0
19,Marquette (Big East),7,4-3,79,64,143,0.552,03/27/2018,2018.0
20,Navy (Patriot),9,5-4,105,87,192,0.547,03/27/2018,2018.0
21,VMI (Southland),7,1-6,90,76,166,0.542,03/27/2018,2018.0
22,Air Force (SoCon),10,3-7,120,103,223,0.538,03/27/2018,2018.0
23,Army West Point (Patriot),8,5-3,88,77,165,0.533,03/27/2018,2018.0
24,Delaware (CAA),8,3-5,109,96,205,0.532,03/27/2018,2018.0
25,Ohio St. (Big Ten),9,5-4,101,90,191,0.529,03/27/2018,2018.0
26,Brown (Ivy League),7,3-4,97,88,185,0.524,03/27/2018,2018.0
27,Mount St. Mary's (NEC),9,3-6,131,119,250,0.524,03/27/2018,2018.0
28,Notre Dame (ACC),7,5-2,83,76,159,0.522,03/27/2018,2018.0
29,Quinnipiac (MAAC),9,4-5,111,105,216,0.514,03/27/2018,2018.0
30,Harvard (Ivy League),8,7-1,107,103,210,0.510,03/27/2018,2018.0
31,Michigan (Big Ten),9,7-2,110,106,216,0.509,03/27/2018,2018.0
32,Villanova (Big East),9,7-2,110,110,220,0.500,03/27/2018,2018.0
33,Saint Joseph's (NEC),7,4-3,63,65,128,0.492,03/27/2018,2018.0
34,Providence (Big East),9,3-6,98,102,200,0.490,03/27/2018,2018.0
35,Bellarmine (SoCon),8,2-6,82,87,169,0.485,03/27/2018,2018.0
36,Lafayette (Patriot),10,2-8,117,127,244,0.480,03/27/2018,2018.0
37,Syracuse (ACC),7,4-3,92,100,192,0.479,03/27/2018,2018.0
38,High Point (SoCon),8,1-7,112,122,234,0.479,03/27/2018,2018.0
39,Rutgers (Big Ten),9,7-2,103,115,218,0.472,03/27/2018,2018.0
40,Hampton (DI Independent),6,2-4,65,73,138,0.471,03/27/2018,2018.0
41,St. John's (NY) (Big East),8,6-2,89,102,191,0.466,03/27/2018,2018.0
42,North Carolina (ACC),10,6-4,113,132,245,0.461,03/27/2018,2018.0
43,Vermont (America East),9,8-1,93,109,202,0.460,03/27/2018,2018.0
44,Duke (ACC),10,8-2,115,135,250,0.460,03/27/2018,2018.0
45,Sacred Heart (NEC),9,4-5,112,132,244,0.459,03/27/2018,2018.0
46,Bucknell (Patriot),9,6-3,99,117,216,0.458,03/27/2018,2018.0
47,Cornell (Ivy League),8,5-3,99,118,217,0.456,03/27/2018,2018.0
48,Richmond (SoCon),9,5-4,98,119,217,0.452,03/27/2018,2018.0
49,Boston U. (Patriot),10,5-5,117,143,260,0.450,03/27/2018,2018.0
50,Marist (MAAC),10,2-8,101,124,225,0.449,03/27/2018,2018.0
51,Princeton (Ivy League),7,3-4,87,107,194,0.448,03/27/2018,2018.0
52,Georgetown (Big East),8,6-2,87,110,197,0.442,03/27/2018,2018.0
53,Robert Morris (NEC),8,6-2,82,109,191,0.429,03/27/2018,2018.0
54,Siena (MAAC),7,2-5,78,105,183,0.426,03/27/2018,2018.0
55,Penn (Ivy League),9,5-4,86,117,203,0.424,03/27/2018,2018.0
56,Cleveland St. (Independent),10,2-8,95,130,225,0.422,03/27/2018,2018.0
57,Binghamton (America East),10,2-8,104,144,248,0.419,03/27/2018,2018.0
58,Drexel (CAA),8,4-4,83,115,198,0.419,03/27/2018,2018.0
59,Wagner (NEC),9,4-5,74,104,178,0.416,03/27/2018,2018.0
60,Manhattan (MAAC),9,3-6,82,116,198,0.414,03/27/2018,2018.0
61,UMass Lowell (America East),9,4-5,90,132,222,0.405,03/27/2018,2018.0
62,Loyola Maryland (Patriot),8,5-3,81,121,202,0.401,03/27/2018,2018.0
63,Detroit Mercy (MAAC),9,4-5,76,114,190,0.400,03/27/2018,2018.0
63,UMBC (America East),8,2-6,60,90,150,0.400,03/27/2018,2018.0
65,Dartmouth (Ivy League),7,2-5,62,97,159,0.390,03/27/2018,2018.0
66,Mercer (SoCon),9,3-6,77,121,198,0.389,03/27/2018,2018.0
67,Monmouth (MAAC),8,3-5,63,112,175,0.360,03/27/2018,2018.0
68,Canisius (MAAC),8,4-4,81,148,229,0.354,03/27/2018,2018.0
69,Furman (SoCon),8,2-6,73,136,209,0.349,03/27/2018,2018.0
1,UAlbany (America East),8,8-0,171,40,211,0.810,03/26/2018,2018.0
2,Denver (Big East),8,6-2,141,50,191,0.738,03/26/2018,2018.0
3,Jacksonville (SoCon),8,4-4,136,60,196,0.694,03/26/2018,2018.0
4,Bryant (NEC),9,4-5,159,74,233,0.682,03/26/2018,2018.0
5,Penn St. (Big Ten),9,6-3,159,77,236,0.674,03/26/2018,2018.0
6,Colgate (Patriot),9,6-3,148,85,233,0.635,03/26/2018,2018.0
7,Johns Hopkins (Big Ten),8,6-2,129,77,206,0.626,03/26/2018,2018.0
8,Lehigh (Patriot),10,7-3,145,88,233,0.622,03/26/2018,2018.0
9,Virginia (ACC),10,7-3,161,108,269,0.599,03/26/2018,2018.0
10,Massachusetts (CAA),9,5-4,142,97,239,0.594,03/26/2018,2018.0
11,Hobart (NEC),8,3-5,110,79,189,0.582,03/26/2018,2018.0
12,Hartford (America East),8,3-5,128,92,220,0.582,03/26/2018,2018.0
13,Towson (CAA),8,3-5,107,77,184,0.582,03/26/2018,2018.0
14,Maryland (Big Ten),8,7-1,111,81,192,0.578,03/26/2018,2018.0
15,Hofstra (CAA),8,4-4,89,66,155,0.574,03/26/2018,2018.0
16,Air Force (SoCon),9,3-6,110,82,192,0.573,03/26/2018,2018.0
17,Holy Cross (Patriot),9,2-7,111,84,195,0.569,03/26/2018,2018.0
18,Yale (Ivy League),7,6-1,95,73,168,0.565,03/26/2018,2018.0
19,Fairfield (CAA),10,3-7,131,106,237,0.553,03/26/2018,2018.0
20,Marquette (Big East),7,4-3,79,64,143,0.552,03/26/2018,2018.0
21,Navy (Patriot),9,5-4,105,87,192,0.547,03/26/2018,2018.0
22,VMI (Southland),7,1-6,90,76,166,0.542,03/26/2018,2018.0
23,Army West Point (Patriot),8,5-3,88,77,165,0.533,03/26/2018,2018.0
24,Delaware (CAA),8,3-5,109,96,205,0.532,03/26/2018,2018.0
25,Ohio St. (Big Ten),9,5-4,101,90,191,0.529,03/26/2018,2018.0
26,Brown (Ivy League),7,3-4,97,88,185,0.524,03/26/2018,2018.0
27,Mount St. Mary's (NEC),9,3-6,131,119,250,0.524,03/26/2018,2018.0
28,Notre Dame (ACC),7,5-2,83,76,159,0.522,03/26/2018,2018.0
29,Quinnipiac (MAAC),9,4-5,111,105,216,0.514,03/26/2018,2018.0
30,Harvard (Ivy League),8,7-1,107,103,210,0.510,03/26/2018,2018.0
31,Michigan (Big Ten),9,7-2,110,106,216,0.509,03/26/2018,2018.0
32,Villanova (Big East),9,7-2,110,110,220,0.500,03/26/2018,2018.0
33,Saint Joseph's (NEC),7,4-3,63,65,128,0.492,03/26/2018,2018.0
34,Providence (Big East),9,3-6,98,102,200,0.490,03/26/2018,2018.0
35,Bellarmine (SoCon),8,2-6,82,87,169,0.485,03/26/2018,2018.0
36,Lafayette (Patriot),10,2-8,117,127,244,0.480,03/26/2018,2018.0
37,Syracuse (ACC),7,4-3,92,100,192,0.479,03/26/2018,2018.0
38,High Point (SoCon),8,1-7,112,122,234,0.479,03/26/2018,2018.0
39,Rutgers (Big Ten),9,7-2,103,115,218,0.472,03/26/2018,2018.0
40,Hampton (DI Independent),6,2-4,65,73,138,0.471,03/26/2018,2018.0
41,St. John's (NY) (Big East),8,6-2,89,102,191,0.466,03/26/2018,2018.0
42,North Carolina (ACC),10,6-4,113,132,245,0.461,03/26/2018,2018.0
43,Vermont (America East),9,8-1,93,109,202,0.460,03/26/2018,2018.0
44,Duke (ACC),10,8-2,115,135,250,0.460,03/26/2018,2018.0
45,Sacred Heart (NEC),9,4-5,112,132,244,0.459,03/26/2018,2018.0
46,Bucknell (Patriot),9,6-3,99,117,216,0.458,03/26/2018,2018.0
47,Richmond (SoCon),9,5-4,98,119,217,0.452,03/26/2018,2018.0
48,Boston U. (Patriot),10,5-5,117,143,260,0.450,03/26/2018,2018.0
49,Marist (MAAC),10,2-8,101,124,225,0.449,03/26/2018,2018.0
50,Princeton (Ivy League),7,3-4,87,107,194,0.448,03/26/2018,2018.0
51,Georgetown (Big East),8,6-2,87,110,197,0.442,03/26/2018,2018.0
52,Robert Morris (NEC),8,6-2,82,109,191,0.429,03/26/2018,2018.0
53,Penn (Ivy League),9,5-4,86,117,203,0.424,03/26/2018,2018.0
54,Cleveland St. (Independent),10,2-8,95,130,225,0.422,03/26/2018,2018.0
55,Cornell (Ivy League),7,4-3,78,108,186,0.419,03/26/2018,2018.0
55,Siena (MAAC),6,2-4,65,90,155,0.419,03/26/2018,2018.0
57,Drexel (CAA),8,4-4,83,115,198,0.419,03/26/2018,2018.0
58,Wagner (NEC),9,4-5,74,104,178,0.416,03/26/2018,2018.0
59,Manhattan (MAAC),9,3-6,82,116,198,0.414,03/26/2018,2018.0
60,UMass Lowell (America East),9,4-5,90,132,222,0.405,03/26/2018,2018.0
61,Binghamton (America East),9,1-8,89,131,220,0.405,03/26/2018,2018.0
62,Loyola Maryland (Patriot),8,5-3,81,121,202,0.401,03/26/2018,2018.0
63,Detroit Mercy (MAAC),9,4-5,76,114,190,0.400,03/26/2018,2018.0
63,UMBC (America East),8,2-6,60,90,150,0.400,03/26/2018,2018.0
65,Dartmouth (Ivy League),7,2-5,62,97,159,0.390,03/26/2018,2018.0
66,Mercer (SoCon),9,3-6,77,121,198,0.389,03/26/2018,2018.0
67,Canisius (MAAC),7,4-3,74,124,198,0.374,03/26/2018,2018.0
68,Monmouth (MAAC),8,3-5,63,112,175,0.360,03/26/2018,2018.0
69,Furman (SoCon),8,2-6,73,136,209,0.349,03/26/2018,2018.0
1,UAlbany (America East),8,8-0,171,40,211,0.810,03/25/2018,2018.0
2,Denver (Big East),8,6-2,141,50,191,0.738,03/25/2018,2018.0
3,Jacksonville (SoCon),8,4-4,136,60,196,0.694,03/25/2018,2018.0
4,Bryant (NEC),9,4-5,159,74,233,0.682,03/25/2018,2018.0
5,Penn St. (Big Ten),9,6-3,159,77,236,0.674,03/25/2018,2018.0
6,Colgate (Patriot),9,6-3,148,85,233,0.635,03/25/2018,2018.0
7,Johns Hopkins (Big Ten),8,6-2,129,77,206,0.626,03/25/2018,2018.0
8,Lehigh (Patriot),10,7-3,145,88,233,0.622,03/25/2018,2018.0
9,Virginia (ACC),10,7-3,161,108,269,0.599,03/25/2018,2018.0
10,Massachusetts (CAA),9,5-4,142,97,239,0.594,03/25/2018,2018.0
11,Hobart (NEC),8,3-5,110,79,189,0.582,03/25/2018,2018.0
12,Hartford (America East),8,3-5,128,92,220,0.582,03/25/2018,2018.0
13,Towson (CAA),8,3-5,107,77,184,0.582,03/25/2018,2018.0
14,Maryland (Big Ten),8,7-1,111,81,192,0.578,03/25/2018,2018.0
15,Hofstra (CAA),8,4-4,89,66,155,0.574,03/25/2018,2018.0
16,Air Force (SoCon),9,3-6,110,82,192,0.573,03/25/2018,2018.0
17,Holy Cross (Patriot),9,2-7,111,84,195,0.569,03/25/2018,2018.0
18,Yale (Ivy League),7,6-1,95,73,168,0.565,03/25/2018,2018.0
19,Fairfield (CAA),10,3-7,131,106,237,0.553,03/25/2018,2018.0
20,Marquette (Big East),7,4-3,79,64,143,0.552,03/25/2018,2018.0
21,Navy (Patriot),9,5-4,105,87,192,0.547,03/25/2018,2018.0
22,VMI (Southland),7,1-6,90,76,166,0.542,03/25/2018,2018.0
23,Army West Point (Patriot),8,5-3,88,77,165,0.533,03/25/2018,2018.0
24,Delaware (CAA),8,3-5,108,95,203,0.532,03/25/2018,2018.0
25,Ohio St. (Big Ten),9,5-4,101,90,191,0.529,03/25/2018,2018.0
26,Brown (Ivy League),7,3-4,97,88,185,0.524,03/25/2018,2018.0
27,Mount St. Mary's (NEC),9,3-6,131,119,250,0.524,03/25/2018,2018.0
28,Notre Dame (ACC),7,5-2,83,76,159,0.522,03/25/2018,2018.0
29,Quinnipiac (MAAC),9,4-5,111,105,216,0.514,03/25/2018,2018.0
30,Harvard (Ivy League),8,7-1,107,103,210,0.510,03/25/2018,2018.0
31,Michigan (Big Ten),9,7-2,110,106,216,0.509,03/25/2018,2018.0
32,Villanova (Big East),9,7-2,110,110,220,0.500,03/25/2018,2018.0
33,Saint Joseph's (NEC),7,4-3,63,65,128,0.492,03/25/2018,2018.0
34,Providence (Big East),9,3-6,98,102,200,0.490,03/25/2018,2018.0
35,Bellarmine (SoCon),8,2-6,82,87,169,0.485,03/25/2018,2018.0
36,Lafayette (Patriot),10,2-8,117,127,244,0.480,03/25/2018,2018.0
37,Syracuse (ACC),7,4-3,92,100,192,0.479,03/25/2018,2018.0
38,High Point (SoCon),8,1-7,112,122,234,0.479,03/25/2018,2018.0
39,Rutgers (Big Ten),9,7-2,102,114,216,0.472,03/25/2018,2018.0
40,Hampton (DI Independent),6,2-4,65,73,138,0.471,03/25/2018,2018.0
41,St. John's (NY) (Big East),8,6-2,89,102,191,0.466,03/25/2018,2018.0
42,North Carolina (ACC),10,6-4,113,132,245,0.461,03/25/2018,2018.0
43,Vermont (America East),9,8-1,93,109,202,0.460,03/25/2018,2018.0
44,Duke (ACC),10,8-2,115,135,250,0.460,03/25/2018,2018.0
45,Sacred Heart (NEC),9,4-5,112,132,244,0.459,03/25/2018,2018.0
46,Bucknell (Patriot),9,6-3,99,117,216,0.458,03/25/2018,2018.0
47,Richmond (SoCon),9,5-4,98,119,217,0.452,03/25/2018,2018.0
48,Boston U. (Patriot),10,5-5,117,143,260,0.450,03/25/2018,2018.0
49,Marist (MAAC),10,2-8,101,124,225,0.449,03/25/2018,2018.0
50,Princeton (Ivy League),7,3-4,87,107,194,0.448,03/25/2018,2018.0
51,Georgetown (Big East),8,6-2,87,110,197,0.442,03/25/2018,2018.0
52,Robert Morris (NEC),8,6-2,82,109,191,0.429,03/25/2018,2018.0
53,Penn (Ivy League),9,5-4,86,117,203,0.424,03/25/2018,2018.0
54,Cleveland St. (Independent),10,2-8,95,130,225,0.422,03/25/2018,2018.0
55,Cornell (Ivy League),7,4-3,78,108,186,0.419,03/25/2018,2018.0
55,Siena (MAAC),6,2-4,65,90,155,0.419,03/25/2018,2018.0
57,Drexel (CAA),8,4-4,83,115,198,0.419,03/25/2018,2018.0
58,Wagner (NEC),9,4-5,74,104,178,0.416,03/25/2018,2018.0
59,Manhattan (MAAC),9,3-6,82,116,198,0.414,03/25/2018,2018.0
60,UMass Lowell (America East),9,4-5,90,132,222,0.405,03/25/2018,2018.0
61,Binghamton (America East),9,1-8,89,131,220,0.405,03/25/2018,2018.0
62,Loyola Maryland (Patriot),8,5-3,81,121,202,0.401,03/25/2018,2018.0
63,Detroit Mercy (MAAC),9,4-5,76,114,190,0.400,03/25/2018,2018.0
63,UMBC (America East),8,2-6,60,90,150,0.400,03/25/2018,2018.0
65,Dartmouth (Ivy League),7,2-5,62,97,159,0.390,03/25/2018,2018.0
66,Mercer (SoCon),9,3-6,77,121,198,0.389,03/25/2018,2018.0
67,Canisius (MAAC),7,4-3,74,124,198,0.374,03/25/2018,2018.0
68,Monmouth (MAAC),8,3-5,63,112,175,0.360,03/25/2018,2018.0
69,Furman (SoCon),8,2-6,73,136,209,0.349,03/25/2018,2018.0
1,UAlbany (America East),7,7-0,150,39,189,0.794,03/21/2018,2018.0
2,Denver (Big East),7,5-2,120,47,167,0.719,03/21/2018,2018.0
3,Penn St. (Big Ten),8,5-3,146,66,212,0.689,03/21/2018,2018.0
4,Jacksonville (SoCon),7,3-4,123,57,180,0.683,03/21/2018,2018.0
5,Bryant (NEC),8,3-5,139,67,206,0.675,03/21/2018,2018.0
6,Johns Hopkins (Big Ten),7,5-2,114,60,174,0.655,03/21/2018,2018.0
7,Towson (CAA),7,3-4,104,56,160,0.650,03/21/2018,2018.0
8,Colgate (Patriot),8,5-3,136,79,215,0.633,03/21/2018,2018.0
9,Lehigh (Patriot),9,7-2,132,80,212,0.623,03/21/2018,2018.0
10,Massachusetts (CAA),8,4-4,129,81,210,0.614,03/21/2018,2018.0
11,Virginia (ACC),9,7-2,144,93,237,0.608,03/21/2018,2018.0
12,Hartford (America East),7,3-4,115,83,198,0.581,03/21/2018,2018.0
13,Hobart (NEC),7,3-4,101,74,175,0.577,03/21/2018,2018.0
14,Air Force (SoCon),8,3-5,99,73,172,0.576,03/21/2018,2018.0
15,Hofstra (CAA),7,4-3,77,57,134,0.575,03/21/2018,2018.0
16,Ohio St. (Big Ten),8,5-3,97,73,170,0.571,03/21/2018,2018.0
17,Navy (Patriot),8,4-4,97,74,171,0.567,03/21/2018,2018.0
18,Quinnipiac (MAAC),8,4-4,105,81,186,0.565,03/21/2018,2018.0
19,Army West Point (Patriot),7,5-2,82,65,147,0.558,03/21/2018,2018.0
20,Maryland (Big Ten),7,6-1,95,77,172,0.552,03/21/2018,2018.0
21,Marquette (Big East),6,3-3,67,55,122,0.549,03/21/2018,2018.0
22,Fairfield (CAA),9,3-6,114,95,209,0.545,03/21/2018,2018.0
23,Delaware (CAA),7,3-4,94,82,176,0.534,03/21/2018,2018.0
24,Yale (Ivy League),6,5-1,75,67,142,0.528,03/21/2018,2018.0
25,Holy Cross (Patriot),8,1-7,87,78,165,0.527,03/21/2018,2018.0
26,Brown (Ivy League),6,3-3,81,75,156,0.519,03/21/2018,2018.0
27,Villanova (Big East),8,6-2,99,93,192,0.516,03/21/2018,2018.0
28,Harvard (Ivy League),7,6-1,96,92,188,0.511,03/21/2018,2018.0
29,Bellarmine (SoCon),7,2-5,78,75,153,0.510,03/21/2018,2018.0
30,Saint Joseph's (NEC),6,3-3,58,56,114,0.509,03/21/2018,2018.0
31,Mount St. Mary's (NEC),8,3-5,115,113,228,0.504,03/21/2018,2018.0
32,Michigan (Big Ten),8,6-2,99,99,198,0.500,03/21/2018,2018.0
32,Providence (Big East),8,3-5,87,87,174,0.500,03/21/2018,2018.0
32,Syracuse (ACC),6,3-3,80,80,160,0.500,03/21/2018,2018.0
35,VMI (Southland),6,1-5,72,73,145,0.497,03/21/2018,2018.0
36,High Point (SoCon),7,1-6,100,104,204,0.490,03/21/2018,2018.0
37,Lafayette (Patriot),9,2-7,108,113,221,0.489,03/21/2018,2018.0
38,North Carolina (ACC),9,6-3,109,116,225,0.484,03/21/2018,2018.0
39,Sacred Heart (NEC),8,4-4,105,112,217,0.484,03/21/2018,2018.0
40,Princeton (Ivy League),6,3-3,81,87,168,0.482,03/21/2018,2018.0
41,Notre Dame (ACC),6,4-2,66,72,138,0.478,03/21/2018,2018.0
42,Hampton (DI Independent),6,2-4,65,73,138,0.471,03/21/2018,2018.0
43,Rutgers (Big Ten),8,6-2,89,100,189,0.471,03/21/2018,2018.0
44,St. John's (NY) (Big East),7,5-2,80,90,170,0.471,03/21/2018,2018.0
45,Robert Morris (NEC),7,5-2,76,93,169,0.450,03/21/2018,2018.0
46,Wagner (NEC),8,3-5,73,90,163,0.448,03/21/2018,2018.0
47,UMass Lowell (America East),8,4-4,89,111,200,0.445,03/21/2018,2018.0
48,Bucknell (Patriot),8,5-3,84,105,189,0.444,03/21/2018,2018.0
49,Georgetown (Big East),7,6-1,78,98,176,0.443,03/21/2018,2018.0
50,Marist (MAAC),9,1-8,90,115,205,0.439,03/21/2018,2018.0
51,Vermont (America East),8,7-1,80,103,183,0.437,03/21/2018,2018.0
52,Duke (ACC),9,8-1,95,123,218,0.436,03/21/2018,2018.0
53,Boston U. (Patriot),9,4-5,103,134,237,0.435,03/21/2018,2018.0
54,Richmond (SoCon),8,4-4,80,107,187,0.428,03/21/2018,2018.0
55,Penn (Ivy League),8,5-3,71,96,167,0.425,03/21/2018,2018.0
56,Cleveland St. (Independent),9,2-7,84,117,201,0.418,03/21/2018,2018.0
57,Binghamton (America East),8,1-7,83,118,201,0.413,03/21/2018,2018.0
58,Manhattan (MAAC),8,3-5,73,105,178,0.410,03/21/2018,2018.0
59,Siena (MAAC),5,2-3,52,75,127,0.409,03/21/2018,2018.0
60,UMBC (America East),7,2-5,53,79,132,0.402,03/21/2018,2018.0
61,Drexel (CAA),7,3-4,68,104,172,0.395,03/21/2018,2018.0
62,Loyola Maryland (Patriot),7,5-2,69,106,175,0.394,03/21/2018,2018.0
63,Mercer (SoCon),8,2-6,69,109,178,0.388,03/21/2018,2018.0
64,Detroit Mercy (MAAC),8,3-5,65,105,170,0.382,03/21/2018,2018.0
65,Cornell (Ivy League),6,3-3,57,93,150,0.380,03/21/2018,2018.0
66,Furman (SoCon),7,1-6,70,118,188,0.372,03/21/2018,2018.0
67,Dartmouth (Ivy League),6,2-4,51,86,137,0.372,03/21/2018,2018.0
68,Monmouth (MAAC),7,3-4,54,101,155,0.348,03/21/2018,2018.0
69,Canisius (MAAC),6,3-3,59,111,170,0.347,03/21/2018,2018.0
1,UAlbany (America East),7,7-0,150,39,189,0.794,03/20/2018,2018.0
2,Denver (Big East),7,5-2,120,47,167,0.719,03/20/2018,2018.0
3,Penn St. (Big Ten),8,5-3,146,66,212,0.689,03/20/2018,2018.0
4,Jacksonville (SoCon),7,3-4,123,57,180,0.683,03/20/2018,2018.0
5,Bryant (NEC),8,3-5,139,67,206,0.675,03/20/2018,2018.0
6,Johns Hopkins (Big Ten),7,5-2,114,60,174,0.655,03/20/2018,2018.0
7,Towson (CAA),7,3-4,104,56,160,0.650,03/20/2018,2018.0
8,Colgate (Patriot),8,5-3,136,79,215,0.633,03/20/2018,2018.0
9,Lehigh (Patriot),9,7-2,132,80,212,0.623,03/20/2018,2018.0
10,Massachusetts (CAA),8,4-4,129,81,210,0.614,03/20/2018,2018.0
11,Virginia (ACC),9,7-2,144,93,237,0.608,03/20/2018,2018.0
12,Hartford (America East),7,3-4,115,83,198,0.581,03/20/2018,2018.0
13,Hobart (NEC),7,3-4,101,74,175,0.577,03/20/2018,2018.0
14,Air Force (SoCon),8,3-5,99,73,172,0.576,03/20/2018,2018.0
15,Hofstra (CAA),7,4-3,77,57,134,0.575,03/20/2018,2018.0
16,Ohio St. (Big Ten),8,5-3,97,73,170,0.571,03/20/2018,2018.0
17,Navy (Patriot),8,4-4,97,74,171,0.567,03/20/2018,2018.0
18,Quinnipiac (MAAC),8,4-4,105,81,186,0.565,03/20/2018,2018.0
19,Army West Point (Patriot),7,5-2,82,65,147,0.558,03/20/2018,2018.0
20,Maryland (Big Ten),7,6-1,95,77,172,0.552,03/20/2018,2018.0
21,Marquette (Big East),6,3-3,67,55,122,0.549,03/20/2018,2018.0
22,Fairfield (CAA),9,3-6,114,95,209,0.545,03/20/2018,2018.0
23,Delaware (CAA),7,3-4,94,82,176,0.534,03/20/2018,2018.0
24,Yale (Ivy League),6,5-1,75,67,142,0.528,03/20/2018,2018.0
25,Holy Cross (Patriot),8,1-7,87,78,165,0.527,03/20/2018,2018.0
26,Brown (Ivy League),6,3-3,81,75,156,0.519,03/20/2018,2018.0
27,Villanova (Big East),8,6-2,99,93,192,0.516,03/20/2018,2018.0
28,Harvard (Ivy League),7,6-1,96,92,188,0.511,03/20/2018,2018.0
29,Bellarmine (SoCon),7,2-5,78,75,153,0.510,03/20/2018,2018.0
30,Saint Joseph's (NEC),6,3-3,58,56,114,0.509,03/20/2018,2018.0
31,Mount St. Mary's (NEC),8,3-5,115,113,228,0.504,03/20/2018,2018.0
32,Providence (Big East),8,3-5,87,87,174,0.500,03/20/2018,2018.0
32,Syracuse (ACC),6,3-3,80,80,160,0.500,03/20/2018,2018.0
34,Michigan (Big Ten),7,5-2,84,85,169,0.497,03/20/2018,2018.0
35,VMI (Southland),6,1-5,72,73,145,0.497,03/20/2018,2018.0
36,High Point (SoCon),7,1-6,100,104,204,0.490,03/20/2018,2018.0
37,Lafayette (Patriot),9,2-7,108,113,221,0.489,03/20/2018,2018.0
38,North Carolina (ACC),9,6-3,109,116,225,0.484,03/20/2018,2018.0
39,Sacred Heart (NEC),8,4-4,105,112,217,0.484,03/20/2018,2018.0
40,Princeton (Ivy League),6,3-3,81,87,168,0.482,03/20/2018,2018.0
41,Notre Dame (ACC),5,4-1,52,57,109,0.477,03/20/2018,2018.0
42,Hampton (DI Independent),6,2-4,65,73,138,0.471,03/20/2018,2018.0
43,Rutgers (Big Ten),8,6-2,89,100,189,0.471,03/20/2018,2018.0
44,St. John's (NY) (Big East),7,5-2,80,90,170,0.471,03/20/2018,2018.0
45,Robert Morris (NEC),7,5-2,76,93,169,0.450,03/20/2018,2018.0
46,Wagner (NEC),8,3-5,73,90,163,0.448,03/20/2018,2018.0
47,UMass Lowell (America East),8,4-4,89,111,200,0.445,03/20/2018,2018.0
48,Bucknell (Patriot),8,5-3,84,105,189,0.444,03/20/2018,2018.0
49,Georgetown (Big East),7,6-1,78,98,176,0.443,03/20/2018,2018.0
50,Marist (MAAC),9,1-8,90,115,205,0.439,03/20/2018,2018.0
51,Vermont (America East),8,7-1,80,103,183,0.437,03/20/2018,2018.0
52,Duke (ACC),9,8-1,95,123,218,0.436,03/20/2018,2018.0
53,Boston U. (Patriot),9,4-5,103,134,237,0.435,03/20/2018,2018.0
54,Richmond (SoCon),8,4-4,80,107,187,0.428,03/20/2018,2018.0
55,Penn (Ivy League),8,5-3,71,96,167,0.425,03/20/2018,2018.0
56,Cleveland St. (Independent),9,2-7,84,117,201,0.418,03/20/2018,2018.0
57,Binghamton (America East),8,1-7,83,118,201,0.413,03/20/2018,2018.0
58,Manhattan (MAAC),8,3-5,73,105,178,0.410,03/20/2018,2018.0
59,Siena (MAAC),5,2-3,52,75,127,0.409,03/20/2018,2018.0
60,UMBC (America East),7,2-5,53,79,132,0.402,03/20/2018,2018.0
61,Drexel (CAA),7,3-4,68,104,172,0.395,03/20/2018,2018.0
62,Loyola Maryland (Patriot),7,5-2,69,106,175,0.394,03/20/2018,2018.0
63,Mercer (SoCon),8,2-6,69,109,178,0.388,03/20/2018,2018.0
64,Detroit Mercy (MAAC),8,3-5,65,105,170,0.382,03/20/2018,2018.0
65,Cornell (Ivy League),6,3-3,57,93,150,0.380,03/20/2018,2018.0
66,Furman (SoCon),7,1-6,70,118,188,0.372,03/20/2018,2018.0
67,Dartmouth (Ivy League),6,2-4,51,86,137,0.372,03/20/2018,2018.0
68,Monmouth (MAAC),7,3-4,54,101,155,0.348,03/20/2018,2018.0
69,Canisius (MAAC),6,3-3,59,111,170,0.347,03/20/2018,2018.0
1,UAlbany (America East),6,6-0,124,31,155,0.800,03/19/2018,2018.0
2,Denver (Big East),7,5-2,120,47,167,0.719,03/19/2018,2018.0
3,Penn St. (Big Ten),8,5-3,146,66,212,0.689,03/19/2018,2018.0
4,Jacksonville (SoCon),7,3-4,123,57,180,0.683,03/19/2018,2018.0
5,Bryant (NEC),8,3-5,139,67,206,0.675,03/19/2018,2018.0
6,Johns Hopkins (Big Ten),7,5-2,114,60,174,0.655,03/19/2018,2018.0
7,Towson (CAA),7,3-4,104,56,160,0.650,03/19/2018,2018.0
8,Colgate (Patriot),8,5-3,136,79,215,0.633,03/19/2018,2018.0
9,Quinnipiac (MAAC),7,4-3,102,60,162,0.630,03/19/2018,2018.0
10,Lehigh (Patriot),8,6-2,117,71,188,0.622,03/19/2018,2018.0
11,Hofstra (CAA),6,4-2,68,42,110,0.618,03/19/2018,2018.0
12,Massachusetts (CAA),8,4-4,129,81,210,0.614,03/19/2018,2018.0
13,Virginia (ACC),8,6-2,131,85,216,0.606,03/19/2018,2018.0
14,Hobart (NEC),7,3-4,101,74,175,0.577,03/19/2018,2018.0
15,Air Force (SoCon),8,3-5,99,73,172,0.576,03/19/2018,2018.0
16,Ohio St. (Big Ten),8,5-3,97,73,170,0.571,03/19/2018,2018.0
17,Navy (Patriot),8,4-4,97,74,171,0.567,03/19/2018,2018.0
18,Army West Point (Patriot),7,5-2,82,65,147,0.558,03/19/2018,2018.0
19,Maryland (Big Ten),7,6-1,95,77,172,0.552,03/19/2018,2018.0
20,Marquette (Big East),6,3-3,67,55,122,0.549,03/19/2018,2018.0
21,Hartford (America East),6,2-4,94,80,174,0.540,03/19/2018,2018.0
22,Delaware (CAA),7,3-4,94,82,176,0.534,03/19/2018,2018.0
23,Brown (Ivy League),5,2-3,67,59,126,0.532,03/19/2018,2018.0
24,Fairfield (CAA),8,2-6,99,88,187,0.529,03/19/2018,2018.0
25,Yale (Ivy League),6,5-1,75,67,142,0.528,03/19/2018,2018.0
26,Holy Cross (Patriot),7,1-6,71,64,135,0.526,03/19/2018,2018.0
27,Villanova (Big East),8,6-2,99,93,192,0.516,03/19/2018,2018.0
28,Bellarmine (SoCon),7,2-5,78,75,153,0.510,03/19/2018,2018.0
29,Saint Joseph's (NEC),6,3-3,58,56,114,0.509,03/19/2018,2018.0
30,Harvard (Ivy League),6,5-1,75,73,148,0.507,03/19/2018,2018.0
31,Mount St. Mary's (NEC),8,3-5,115,113,228,0.504,03/19/2018,2018.0
32,Providence (Big East),8,3-5,87,87,174,0.500,03/19/2018,2018.0
32,Syracuse (ACC),6,3-3,80,80,160,0.500,03/19/2018,2018.0
34,Michigan (Big Ten),7,5-2,84,85,169,0.497,03/19/2018,2018.0
35,VMI (Southland),6,1-5,72,73,145,0.497,03/19/2018,2018.0
36,High Point (SoCon),7,1-6,100,104,204,0.490,03/19/2018,2018.0
37,Lafayette (Patriot),9,2-7,108,113,221,0.489,03/19/2018,2018.0
38,North Carolina (ACC),9,6-3,109,116,225,0.484,03/19/2018,2018.0
39,Sacred Heart (NEC),8,4-4,105,112,217,0.484,03/19/2018,2018.0
40,Princeton (Ivy League),6,3-3,81,87,168,0.482,03/19/2018,2018.0
41,Notre Dame (ACC),5,4-1,52,57,109,0.477,03/19/2018,2018.0
42,Hampton (DI Independent),6,2-4,65,73,138,0.471,03/19/2018,2018.0
43,Rutgers (Big Ten),8,6-2,89,100,189,0.471,03/19/2018,2018.0
44,St. John's (NY) (Big East),7,5-2,80,90,170,0.471,03/19/2018,2018.0
45,Robert Morris (NEC),7,5-2,76,93,169,0.450,03/19/2018,2018.0
46,Wagner (NEC),8,3-5,73,90,163,0.448,03/19/2018,2018.0
47,UMass Lowell (America East),8,4-4,89,111,200,0.445,03/19/2018,2018.0
48,Georgetown (Big East),7,6-1,78,98,176,0.443,03/19/2018,2018.0
49,Marist (MAAC),9,1-8,90,115,205,0.439,03/19/2018,2018.0
50,Bucknell (Patriot),7,5-2,74,95,169,0.438,03/19/2018,2018.0
51,Vermont (America East),8,7-1,80,103,183,0.437,03/19/2018,2018.0
52,Duke (ACC),9,8-1,95,123,218,0.436,03/19/2018,2018.0
53,Richmond (SoCon),8,4-4,80,107,187,0.428,03/19/2018,2018.0
54,Boston U. (Patriot),8,4-4,84,113,197,0.426,03/19/2018,2018.0
55,Cleveland St. (Independent),9,2-7,84,117,201,0.418,03/19/2018,2018.0
56,Penn (Ivy League),7,4-3,61,86,147,0.415,03/19/2018,2018.0
57,Binghamton (America East),8,1-7,83,118,201,0.413,03/19/2018,2018.0
58,Manhattan (MAAC),8,3-5,73,105,178,0.410,03/19/2018,2018.0
59,Siena (MAAC),5,2-3,52,75,127,0.409,03/19/2018,2018.0
60,UMBC (America East),7,2-5,53,79,132,0.402,03/19/2018,2018.0
61,Drexel (CAA),7,3-4,68,104,172,0.395,03/19/2018,2018.0
62,Loyola Maryland (Patriot),7,5-2,69,106,175,0.394,03/19/2018,2018.0
63,Mercer (SoCon),8,2-6,69,109,178,0.388,03/19/2018,2018.0
64,Detroit Mercy (MAAC),8,3-5,65,105,170,0.382,03/19/2018,2018.0
65,Cornell (Ivy League),6,3-3,57,93,150,0.380,03/19/2018,2018.0
66,Canisius (MAAC),5,3-2,51,85,136,0.375,03/19/2018,2018.0
67,Furman (SoCon),7,1-6,70,118,188,0.372,03/19/2018,2018.0
68,Dartmouth (Ivy League),5,2-3,43,73,116,0.371,03/19/2018,2018.0
69,Monmouth (MAAC),7,3-4,54,101,155,0.348,03/19/2018,2018.0
1,UAlbany (America East),6,6-0,124,31,155,0.800,03/18/2018,2018.0
2,Denver (Big East),7,5-2,120,47,167,0.719,03/18/2018,2018.0
3,Penn St. (Big Ten),8,5-3,146,66,212,0.689,03/18/2018,2018.0
4,Jacksonville (SoCon),7,3-4,123,57,180,0.683,03/18/2018,2018.0
5,Bryant (NEC),8,3-5,139,67,206,0.675,03/18/2018,2018.0
6,Johns Hopkins (Big Ten),7,5-2,114,60,174,0.655,03/18/2018,2018.0
7,Towson (CAA),7,3-4,104,56,160,0.650,03/18/2018,2018.0
8,Colgate (Patriot),8,5-3,136,79,215,0.633,03/18/2018,2018.0
9,Quinnipiac (MAAC),7,4-3,102,60,162,0.630,03/18/2018,2018.0
10,Lehigh (Patriot),8,6-2,117,71,188,0.622,03/18/2018,2018.0
11,Hofstra (CAA),6,4-2,68,42,110,0.618,03/18/2018,2018.0
12,Massachusetts (CAA),8,4-4,129,81,210,0.614,03/18/2018,2018.0
13,Virginia (ACC),8,6-2,131,85,216,0.606,03/18/2018,2018.0
14,Hobart (NEC),7,3-4,101,74,175,0.577,03/18/2018,2018.0
15,Air Force (SoCon),8,3-5,99,73,172,0.576,03/18/2018,2018.0
16,Ohio St. (Big Ten),8,5-3,97,73,170,0.571,03/18/2018,2018.0
17,Navy (Patriot),8,4-4,97,74,171,0.567,03/18/2018,2018.0
18,Army West Point (Patriot),7,5-2,82,65,147,0.558,03/18/2018,2018.0
19,Maryland (Big Ten),7,6-1,95,77,172,0.552,03/18/2018,2018.0
20,Marquette (Big East),6,3-3,67,55,122,0.549,03/18/2018,2018.0
21,Hartford (America East),6,2-4,94,80,174,0.540,03/18/2018,2018.0
22,Delaware (CAA),7,3-4,94,82,176,0.534,03/18/2018,2018.0
23,Brown (Ivy League),5,2-3,67,59,126,0.532,03/18/2018,2018.0
24,Fairfield (CAA),8,2-6,99,88,187,0.529,03/18/2018,2018.0
25,Yale (Ivy League),6,5-1,75,67,142,0.528,03/18/2018,2018.0
26,Holy Cross (Patriot),7,1-6,71,64,135,0.526,03/18/2018,2018.0
27,Villanova (Big East),8,6-2,99,93,192,0.516,03/18/2018,2018.0
28,Bellarmine (SoCon),7,2-5,78,75,153,0.510,03/18/2018,2018.0
29,Saint Joseph's (NEC),6,3-3,58,56,114,0.509,03/18/2018,2018.0
30,Harvard (Ivy League),6,5-1,75,73,148,0.507,03/18/2018,2018.0
31,Mount St. Mary's (NEC),8,3-5,115,113,228,0.504,03/18/2018,2018.0
32,Providence (Big East),8,3-5,87,87,174,0.500,03/18/2018,2018.0
32,Syracuse (ACC),6,3-3,80,80,160,0.500,03/18/2018,2018.0
34,Michigan (Big Ten),7,5-2,84,85,169,0.497,03/18/2018,2018.0
35,VMI (Southland),6,1-5,72,73,145,0.497,03/18/2018,2018.0
36,Hampton (DI Independent),5,2-3,58,59,117,0.496,03/18/2018,2018.0
37,High Point (SoCon),7,1-6,100,104,204,0.490,03/18/2018,2018.0
38,Lafayette (Patriot),9,2-7,108,113,221,0.489,03/18/2018,2018.0
39,North Carolina (ACC),9,6-3,109,116,225,0.484,03/18/2018,2018.0
40,Sacred Heart (NEC),8,4-4,105,112,217,0.484,03/18/2018,2018.0
41,Princeton (Ivy League),6,3-3,81,87,168,0.482,03/18/2018,2018.0
42,Notre Dame (ACC),5,4-1,52,57,109,0.477,03/18/2018,2018.0
43,Rutgers (Big Ten),8,6-2,89,100,189,0.471,03/18/2018,2018.0
44,St. John's (NY) (Big East),7,5-2,80,90,170,0.471,03/18/2018,2018.0
45,Robert Morris (NEC),7,5-2,76,93,169,0.450,03/18/2018,2018.0
46,UMass Lowell (America East),8,4-4,89,111,200,0.445,03/18/2018,2018.0
47,Georgetown (Big East),7,6-1,78,98,176,0.443,03/18/2018,2018.0
48,Marist (MAAC),9,1-8,90,115,205,0.439,03/18/2018,2018.0
49,Bucknell (Patriot),7,5-2,74,95,169,0.438,03/18/2018,2018.0
50,Vermont (America East),8,7-1,80,103,183,0.437,03/18/2018,2018.0
51,Duke (ACC),9,8-1,95,123,218,0.436,03/18/2018,2018.0
52,Richmond (SoCon),8,4-4,80,107,187,0.428,03/18/2018,2018.0
53,Boston U. (Patriot),8,4-4,84,113,197,0.426,03/18/2018,2018.0
54,Cleveland St. (Independent),9,2-7,84,117,201,0.418,03/18/2018,2018.0
55,Wagner (NEC),7,2-5,59,83,142,0.415,03/18/2018,2018.0
56,Penn (Ivy League),7,4-3,61,86,147,0.415,03/18/2018,2018.0
57,Binghamton (America East),8,1-7,83,118,201,0.413,03/18/2018,2018.0
58,Manhattan (MAAC),8,3-5,73,105,178,0.410,03/18/2018,2018.0
59,Siena (MAAC),5,2-3,52,75,127,0.409,03/18/2018,2018.0
60,UMBC (America East),7,2-5,53,79,132,0.402,03/18/2018,2018.0
61,Drexel (CAA),7,3-4,68,104,172,0.395,03/18/2018,2018.0
62,Loyola Maryland (Patriot),7,5-2,69,106,175,0.394,03/18/2018,2018.0
63,Mercer (SoCon),8,2-6,69,109,178,0.388,03/18/2018,2018.0
64,Detroit Mercy (MAAC),8,3-5,65,105,170,0.382,03/18/2018,2018.0
65,Cornell (Ivy League),6,3-3,57,93,150,0.380,03/18/2018,2018.0
66,Canisius (MAAC),5,3-2,51,85,136,0.375,03/18/2018,2018.0
67,Furman (SoCon),7,1-6,70,118,188,0.372,03/18/2018,2018.0
68,Dartmouth (Ivy League),5,2-3,43,73,116,0.371,03/18/2018,2018.0
69,Monmouth (MAAC),7,3-4,54,101,155,0.348,03/18/2018,2018.0
1,UAlbany (America East),5,5-0,100,27,127,0.787,03/14/2018,2018.0
2,Denver (Big East),6,4-2,106,38,144,0.736,03/14/2018,2018.0
3,Penn St. (Big Ten),7,4-3,124,54,178,0.697,03/14/2018,2018.0
4,Bryant (NEC),7,2-5,117,54,171,0.684,03/14/2018,2018.0
5,Jacksonville (SoCon),6,2-4,103,51,154,0.669,03/14/2018,2018.0
6,Towson (CAA),6,3-3,91,48,139,0.655,03/14/2018,2018.0
7,Quinnipiac (MAAC),6,3-3,87,49,136,0.640,03/14/2018,2018.0
8,Johns Hopkins (Big Ten),6,4-2,94,54,148,0.635,03/14/2018,2018.0
9,Virginia (ACC),7,6-1,122,75,197,0.619,03/14/2018,2018.0
10,Colgate (Patriot),7,4-3,116,72,188,0.617,03/14/2018,2018.0
11,Massachusetts (CAA),7,3-4,106,71,177,0.599,03/14/2018,2018.0
12,Ohio St. (Big Ten),7,5-2,88,59,147,0.599,03/14/2018,2018.0
13,Hofstra (CAA),5,3-2,52,35,87,0.598,03/14/2018,2018.0
14,Hartford (America East),5,2-3,84,57,141,0.596,03/14/2018,2018.0
15,Delaware (CAA),6,3-3,88,62,150,0.587,03/14/2018,2018.0
16,Lehigh (Patriot),7,5-2,90,65,155,0.581,03/14/2018,2018.0
17,Marquette (Big East),5,3-2,57,42,99,0.576,03/14/2018,2018.0
18,Fairfield (CAA),7,2-5,87,66,153,0.569,03/14/2018,2018.0
19,Army West Point (Patriot),6,4-2,76,59,135,0.563,03/14/2018,2018.0
20,Yale (Ivy League),5,4-1,64,50,114,0.561,03/14/2018,2018.0
21,Hobart (NEC),6,2-4,85,70,155,0.548,03/14/2018,2018.0
22,Air Force (SoCon),7,2-5,83,69,152,0.546,03/14/2018,2018.0
23,VMI (Southland),5,1-4,68,57,125,0.544,03/14/2018,2018.0
24,Lafayette (Patriot),8,2-6,102,86,188,0.543,03/14/2018,2018.0
25,Maryland (Big Ten),6,5-1,78,66,144,0.542,03/14/2018,2018.0
26,Villanova (Big East),7,6-1,88,76,164,0.537,03/14/2018,2018.0
27,Navy (Patriot),7,4-3,76,67,143,0.531,03/14/2018,2018.0
28,Providence (Big East),7,3-4,80,71,151,0.530,03/14/2018,2018.0
29,Mount St. Mary's (NEC),7,3-4,102,91,193,0.528,03/14/2018,2018.0
30,Holy Cross (Patriot),6,1-5,65,58,123,0.528,03/14/2018,2018.0
31,Harvard (Ivy League),5,4-1,66,59,125,0.528,03/14/2018,2018.0
32,Bellarmine (SoCon),6,2-4,67,60,127,0.528,03/14/2018,2018.0
33,Brown (Ivy League),4,2-2,53,50,103,0.515,03/14/2018,2018.0
34,Hampton (DI Independent),5,2-3,58,59,117,0.496,03/14/2018,2018.0
35,Sacred Heart (NEC),7,4-3,95,98,193,0.492,03/14/2018,2018.0
36,Vermont (America East),7,7-0,76,79,155,0.490,03/14/2018,2018.0
37,Michigan (Big Ten),6,4-2,71,75,146,0.486,03/14/2018,2018.0
38,Syracuse (ACC),5,3-2,64,68,132,0.485,03/14/2018,2018.0
39,North Carolina (ACC),9,6-3,109,116,225,0.484,03/14/2018,2018.0
40,Georgetown (Big East),6,6-0,72,77,149,0.483,03/14/2018,2018.0
41,Rutgers (Big Ten),7,5-2,77,84,161,0.478,03/14/2018,2018.0
42,High Point (SoCon),6,0-6,85,93,178,0.478,03/14/2018,2018.0
43,St. John's (NY) (Big East),6,4-2,71,79,150,0.473,03/14/2018,2018.0
44,Notre Dame (ACC),4,3-1,42,48,90,0.467,03/14/2018,2018.0
45,Princeton (Ivy League),5,3-2,66,78,144,0.458,03/14/2018,2018.0
46,Wagner (NEC),6,2-4,55,67,122,0.451,03/14/2018,2018.0
47,Marist (MAAC),8,1-7,80,98,178,0.449,03/14/2018,2018.0
48,Richmond (SoCon),7,4-3,74,91,165,0.448,03/14/2018,2018.0
49,UMass Lowell (America East),7,3-4,77,95,172,0.448,03/14/2018,2018.0
50,Duke (ACC),7,6-1,81,100,181,0.448,03/14/2018,2018.0
51,Saint Joseph's (NEC),5,2-3,42,52,94,0.447,03/14/2018,2018.0
52,Bucknell (Patriot),6,4-2,62,78,140,0.443,03/14/2018,2018.0
53,Robert Morris (NEC),6,4-2,62,83,145,0.428,03/14/2018,2018.0
54,Penn (Ivy League),6,3-3,52,71,123,0.423,03/14/2018,2018.0
55,Loyola Maryland (Patriot),6,4-2,62,85,147,0.422,03/14/2018,2018.0
56,Mercer (SoCon),7,2-5,63,89,152,0.414,03/14/2018,2018.0
57,Siena (MAAC),4,2-2,41,60,101,0.406,03/14/2018,2018.0
58,Canisius (MAAC),4,3-1,44,65,109,0.404,03/14/2018,2018.0
59,Cleveland St. (Independent),8,2-6,74,111,185,0.400,03/14/2018,2018.0
60,Boston U. (Patriot),7,4-3,67,101,168,0.399,03/14/2018,2018.0
61,Binghamton (America East),7,1-6,67,106,173,0.387,03/14/2018,2018.0
62,Manhattan (MAAC),7,3-4,56,98,154,0.364,03/14/2018,2018.0
63,Monmouth (MAAC),6,2-4,47,84,131,0.359,03/14/2018,2018.0
64,UMBC (America East),6,2-4,41,74,115,0.357,03/14/2018,2018.0
65,Detroit Mercy (MAAC),7,2-5,48,95,143,0.336,03/14/2018,2018.0
66,Dartmouth (Ivy League),4,2-2,32,64,96,0.333,03/14/2018,2018.0
67,Cornell (Ivy League),5,3-2,40,82,122,0.328,03/14/2018,2018.0
68,Furman (SoCon),6,0-6,54,112,166,0.325,03/14/2018,2018.0
69,Drexel (CAA),6,2-4,47,98,145,0.324,03/14/2018,2018.0
1,UAlbany (America East),5,5-0,100,27,127,0.787,03/13/2018,2018.0
2,Denver (Big East),6,4-2,106,38,144,0.736,03/13/2018,2018.0
3,Penn St. (Big Ten),7,4-3,124,54,178,0.697,03/13/2018,2018.0
4,Bryant (NEC),7,2-5,117,54,171,0.684,03/13/2018,2018.0
5,Jacksonville (SoCon),6,2-4,103,51,154,0.669,03/13/2018,2018.0
6,Towson (CAA),6,3-3,91,48,139,0.655,03/13/2018,2018.0
7,Quinnipiac (MAAC),6,3-3,87,49,136,0.640,03/13/2018,2018.0
8,Johns Hopkins (Big Ten),6,4-2,94,54,148,0.635,03/13/2018,2018.0
9,Virginia (ACC),7,6-1,122,75,197,0.619,03/13/2018,2018.0
10,Colgate (Patriot),7,4-3,116,72,188,0.617,03/13/2018,2018.0
11,Ohio St. (Big Ten),7,5-2,88,59,147,0.599,03/13/2018,2018.0
12,Hartford (America East),5,2-3,84,57,141,0.596,03/13/2018,2018.0
13,Delaware (CAA),6,3-3,88,62,150,0.587,03/13/2018,2018.0
14,Lehigh (Patriot),6,5-1,79,57,136,0.581,03/13/2018,2018.0
15,Hofstra (CAA),4,2-2,41,30,71,0.577,03/13/2018,2018.0
16,Marquette (Big East),5,3-2,57,42,99,0.576,03/13/2018,2018.0
17,Fairfield (CAA),7,2-5,87,66,153,0.569,03/13/2018,2018.0
18,Army West Point (Patriot),6,4-2,76,59,135,0.563,03/13/2018,2018.0
19,Yale (Ivy League),5,4-1,64,50,114,0.561,03/13/2018,2018.0
20,Massachusetts (CAA),6,2-4,87,69,156,0.558,03/13/2018,2018.0
21,Hobart (NEC),6,2-4,85,70,155,0.548,03/13/2018,2018.0
22,Air Force (SoCon),7,2-5,83,69,152,0.546,03/13/2018,2018.0
23,VMI (Southland),5,1-4,68,57,125,0.544,03/13/2018,2018.0
24,Lafayette (Patriot),8,2-6,102,86,188,0.543,03/13/2018,2018.0
25,Maryland (Big Ten),6,5-1,78,66,144,0.542,03/13/2018,2018.0
26,Villanova (Big East),7,6-1,88,76,164,0.537,03/13/2018,2018.0
27,Navy (Patriot),7,4-3,76,67,143,0.531,03/13/2018,2018.0
28,Providence (Big East),7,3-4,80,71,151,0.530,03/13/2018,2018.0
29,Mount St. Mary's (NEC),7,3-4,102,91,193,0.528,03/13/2018,2018.0
30,Holy Cross (Patriot),6,1-5,65,58,123,0.528,03/13/2018,2018.0
31,Harvard (Ivy League),5,4-1,66,59,125,0.528,03/13/2018,2018.0
32,Bellarmine (SoCon),6,2-4,67,60,127,0.528,03/13/2018,2018.0
33,Brown (Ivy League),4,2-2,53,50,103,0.515,03/13/2018,2018.0
34,Hampton (DI Independent),4,1-3,48,47,95,0.505,03/13/2018,2018.0
35,UMass Lowell (America East),6,3-3,75,76,151,0.497,03/13/2018,2018.0
36,North Carolina (ACC),8,6-2,99,102,201,0.493,03/13/2018,2018.0
37,Sacred Heart (NEC),7,4-3,95,98,193,0.492,03/13/2018,2018.0
38,Vermont (America East),7,7-0,76,79,155,0.490,03/13/2018,2018.0
39,Michigan (Big Ten),6,4-2,71,75,146,0.486,03/13/2018,2018.0
40,Rutgers (Big Ten),6,4-2,69,73,142,0.486,03/13/2018,2018.0
41,Syracuse (ACC),5,3-2,64,68,132,0.485,03/13/2018,2018.0
42,Georgetown (Big East),6,6-0,72,77,149,0.483,03/13/2018,2018.0
43,High Point (SoCon),6,0-6,85,93,178,0.478,03/13/2018,2018.0
44,St. John's (NY) (Big East),6,4-2,71,79,150,0.473,03/13/2018,2018.0
45,Notre Dame (ACC),4,3-1,42,48,90,0.467,03/13/2018,2018.0
46,Princeton (Ivy League),5,3-2,66,78,144,0.458,03/13/2018,2018.0
47,Wagner (NEC),6,2-4,55,67,122,0.451,03/13/2018,2018.0
48,Marist (MAAC),8,1-7,80,98,178,0.449,03/13/2018,2018.0
49,Duke (ACC),7,6-1,81,100,181,0.448,03/13/2018,2018.0
50,Saint Joseph's (NEC),5,2-3,42,52,94,0.447,03/13/2018,2018.0
51,Bucknell (Patriot),6,4-2,62,78,140,0.443,03/13/2018,2018.0
52,Robert Morris (NEC),6,4-2,62,83,145,0.428,03/13/2018,2018.0
53,Richmond (SoCon),6,3-3,60,81,141,0.426,03/13/2018,2018.0
54,Penn (Ivy League),6,3-3,52,71,123,0.423,03/13/2018,2018.0
55,Loyola Maryland (Patriot),6,4-2,62,85,147,0.422,03/13/2018,2018.0
56,Mercer (SoCon),7,2-5,63,89,152,0.414,03/13/2018,2018.0
57,Siena (MAAC),4,2-2,41,60,101,0.406,03/13/2018,2018.0
58,Canisius (MAAC),4,3-1,44,65,109,0.404,03/13/2018,2018.0
59,Cleveland St. (Independent),8,2-6,74,111,185,0.400,03/13/2018,2018.0
60,Boston U. (Patriot),7,4-3,67,101,168,0.399,03/13/2018,2018.0
61,Binghamton (America East),7,1-6,67,106,173,0.387,03/13/2018,2018.0
62,Monmouth (MAAC),5,2-3,42,73,115,0.365,03/13/2018,2018.0
63,Manhattan (MAAC),7,3-4,56,98,154,0.364,03/13/2018,2018.0
64,UMBC (America East),6,2-4,41,74,115,0.357,03/13/2018,2018.0
65,Detroit Mercy (MAAC),7,2-5,48,95,143,0.336,03/13/2018,2018.0
66,Dartmouth (Ivy League),4,2-2,32,64,96,0.333,03/13/2018,2018.0
67,Cornell (Ivy League),5,3-2,40,82,122,0.328,03/13/2018,2018.0
68,Furman (SoCon),6,0-6,54,112,166,0.325,03/13/2018,2018.0
69,Drexel (CAA),6,2-4,47,98,145,0.324,03/13/2018,2018.0
1,UAlbany (America East),5,5-0,100,27,127,0.787,03/11/2018,2018.0
2,Denver (Big East),6,4-2,106,38,144,0.736,03/11/2018,2018.0
3,Penn St. (Big Ten),7,4-3,124,54,178,0.697,03/11/2018,2018.0
4,Bryant (NEC),7,2-5,117,54,171,0.684,03/11/2018,2018.0
5,Jacksonville (SoCon),6,2-4,103,51,154,0.669,03/11/2018,2018.0
6,Towson (CAA),6,3-3,91,48,139,0.655,03/11/2018,2018.0
7,Quinnipiac (MAAC),6,3-3,87,49,136,0.640,03/11/2018,2018.0
8,Virginia (ACC),7,6-1,122,75,197,0.619,03/11/2018,2018.0
9,Colgate (Patriot),7,4-3,116,72,188,0.617,03/11/2018,2018.0
10,Johns Hopkins (Big Ten),5,3-2,78,49,127,0.614,03/11/2018,2018.0
11,Ohio St. (Big Ten),7,5-2,88,59,147,0.599,03/11/2018,2018.0
12,Hartford (America East),5,2-3,84,57,141,0.596,03/11/2018,2018.0
13,Delaware (CAA),6,3-3,88,62,150,0.587,03/11/2018,2018.0
14,Lehigh (Patriot),6,5-1,79,57,136,0.581,03/11/2018,2018.0
15,Hofstra (CAA),4,2-2,41,30,71,0.577,03/11/2018,2018.0
16,Marquette (Big East),5,3-2,57,42,99,0.576,03/11/2018,2018.0
17,Fairfield (CAA),7,2-5,87,66,153,0.569,03/11/2018,2018.0
18,Army West Point (Patriot),6,4-2,76,59,135,0.563,03/11/2018,2018.0
19,Yale (Ivy League),5,4-1,64,50,114,0.561,03/11/2018,2018.0
20,Massachusetts (CAA),6,2-4,87,69,156,0.558,03/11/2018,2018.0
21,Hobart (NEC),6,2-4,85,70,155,0.548,03/11/2018,2018.0
22,Air Force (SoCon),7,2-5,83,69,152,0.546,03/11/2018,2018.0
23,VMI (Southland),5,1-4,68,57,125,0.544,03/11/2018,2018.0
24,Lafayette (Patriot),7,2-5,90,76,166,0.542,03/11/2018,2018.0
25,Maryland (Big Ten),6,5-1,78,66,144,0.542,03/11/2018,2018.0
26,Villanova (Big East),7,6-1,88,76,164,0.537,03/11/2018,2018.0
27,Navy (Patriot),7,4-3,76,67,143,0.531,03/11/2018,2018.0
28,Providence (Big East),7,3-4,80,71,151,0.530,03/11/2018,2018.0
29,Mount St. Mary's (NEC),7,3-4,102,91,193,0.528,03/11/2018,2018.0
30,Holy Cross (Patriot),6,1-5,65,58,123,0.528,03/11/2018,2018.0
31,Harvard (Ivy League),5,4-1,66,59,125,0.528,03/11/2018,2018.0
32,Bellarmine (SoCon),6,2-4,67,60,127,0.528,03/11/2018,2018.0
33,Brown (Ivy League),4,2-2,53,50,103,0.515,03/11/2018,2018.0
34,Hampton (DI Independent),4,1-3,48,47,95,0.505,03/11/2018,2018.0
35,UMass Lowell (America East),6,3-3,75,76,151,0.497,03/11/2018,2018.0
36,North Carolina (ACC),8,6-2,99,102,201,0.493,03/11/2018,2018.0
37,Sacred Heart (NEC),7,4-3,95,98,193,0.492,03/11/2018,2018.0
38,Vermont (America East),7,7-0,76,79,155,0.490,03/11/2018,2018.0
39,Michigan (Big Ten),6,4-2,71,75,146,0.486,03/11/2018,2018.0
40,Rutgers (Big Ten),6,4-2,69,73,142,0.486,03/11/2018,2018.0
41,Syracuse (ACC),5,3-2,64,68,132,0.485,03/11/2018,2018.0
42,Georgetown (Big East),6,6-0,72,77,149,0.483,03/11/2018,2018.0
43,Saint Joseph's (NEC),4,1-3,35,38,73,0.479,03/11/2018,2018.0
44,High Point (SoCon),6,0-6,85,93,178,0.478,03/11/2018,2018.0
45,St. John's (NY) (Big East),6,4-2,71,79,150,0.473,03/11/2018,2018.0
46,Notre Dame (ACC),4,3-1,42,48,90,0.467,03/11/2018,2018.0
47,Princeton (Ivy League),5,3-2,66,78,144,0.458,03/11/2018,2018.0
48,Wagner (NEC),6,2-4,55,67,122,0.451,03/11/2018,2018.0
49,Marist (MAAC),8,1-7,80,98,178,0.449,03/11/2018,2018.0
50,Duke (ACC),7,6-1,81,100,181,0.448,03/11/2018,2018.0
51,Bucknell (Patriot),6,4-2,62,78,140,0.443,03/11/2018,2018.0
52,Robert Morris (NEC),6,4-2,62,83,145,0.428,03/11/2018,2018.0
53,Richmond (SoCon),6,3-3,60,81,141,0.426,03/11/2018,2018.0
54,Penn (Ivy League),6,3-3,52,71,123,0.423,03/11/2018,2018.0
55,Loyola Maryland (Patriot),6,4-2,62,85,147,0.422,03/11/2018,2018.0
56,Mercer (SoCon),7,2-5,63,89,152,0.414,03/11/2018,2018.0
57,Siena (MAAC),4,2-2,41,60,101,0.406,03/11/2018,2018.0
58,Canisius (MAAC),4,3-1,44,65,109,0.404,03/11/2018,2018.0
59,Boston U. (Patriot),7,4-3,67,101,168,0.399,03/11/2018,2018.0
60,Cleveland St. (Independent),7,1-6,64,99,163,0.393,03/11/2018,2018.0
61,Binghamton (America East),7,1-6,67,106,173,0.387,03/11/2018,2018.0
62,UMBC (America East),5,2-3,36,58,94,0.383,03/11/2018,2018.0
63,Monmouth (MAAC),5,2-3,42,73,115,0.365,03/11/2018,2018.0
64,Manhattan (MAAC),7,3-4,56,98,154,0.364,03/11/2018,2018.0
65,Detroit Mercy (MAAC),7,2-5,48,95,143,0.336,03/11/2018,2018.0
66,Dartmouth (Ivy League),4,2-2,32,64,96,0.333,03/11/2018,2018.0
67,Cornell (Ivy League),5,3-2,40,82,122,0.328,03/11/2018,2018.0
68,Furman (SoCon),6,0-6,54,112,166,0.325,03/11/2018,2018.0
69,Stony Brook (America East),6,1-5,49,106,155,0.316,03/11/2018,2018.0
1,UAlbany (America East),4,4-0,86,17,103,0.835,03/07/2018,2018.0
2,Denver (Big East),5,4-1,91,29,120,0.758,03/07/2018,2018.0
3,Penn St. (Big Ten),6,4-2,113,46,159,0.711,03/07/2018,2018.0
4,Towson (CAA),5,2-3,85,37,122,0.697,03/07/2018,2018.0
5,Jacksonville (SoCon),6,2-4,103,51,154,0.669,03/07/2018,2018.0
6,Bryant (NEC),6,2-4,94,53,147,0.639,03/07/2018,2018.0
7,Fairfield (CAA),6,2-4,87,51,138,0.630,03/07/2018,2018.0
8,Quinnipiac (MAAC),5,2-3,72,46,118,0.610,03/07/2018,2018.0
9,Johns Hopkins (Big Ten),4,2-2,60,39,99,0.606,03/07/2018,2018.0
10,Colgate (Patriot),6,3-3,96,64,160,0.600,03/07/2018,2018.0
11,Virginia (ACC),6,5-1,100,67,167,0.599,03/07/2018,2018.0
12,Air Force (SoCon),5,1-4,64,44,108,0.593,03/07/2018,2018.0
13,Ohio St. (Big Ten),6,5-1,77,53,130,0.592,03/07/2018,2018.0
14,Army West Point (Patriot),5,4-1,68,47,115,0.591,03/07/2018,2018.0
15,Marquette (Big East),4,3-1,48,34,82,0.585,03/07/2018,2018.0
16,Lehigh (Patriot),5,4-1,67,49,116,0.578,03/07/2018,2018.0
17,Delaware (CAA),5,3-2,74,56,130,0.569,03/07/2018,2018.0
18,Maryland (Big Ten),5,5-0,68,52,120,0.567,03/07/2018,2018.0
19,Hartford (America East),4,1-3,66,51,117,0.564,03/07/2018,2018.0
20,Hofstra (CAA),3,1-2,28,23,51,0.549,03/07/2018,2018.0
21,Lafayette (Patriot),6,2-4,78,65,143,0.545,03/07/2018,2018.0
22,Navy (Patriot),6,3-3,65,55,120,0.542,03/07/2018,2018.0
23,Harvard (Ivy League),4,3-1,55,47,102,0.539,03/07/2018,2018.0
24,Hobart (NEC),5,2-3,70,61,131,0.534,03/07/2018,2018.0
25,Villanova (Big East),6,5-1,78,68,146,0.534,03/07/2018,2018.0
26,Providence (Big East),6,3-3,68,60,128,0.531,03/07/2018,2018.0
27,Bellarmine (SoCon),6,2-4,67,60,127,0.528,03/07/2018,2018.0
28,Sacred Heart (NEC),6,4-2,89,80,169,0.527,03/07/2018,2018.0
29,Syracuse (ACC),4,3-1,54,50,104,0.519,03/07/2018,2018.0
30,Massachusetts (CAA),5,1-4,68,64,132,0.515,03/07/2018,2018.0
31,Brown (Ivy League),4,2-2,53,50,103,0.515,03/07/2018,2018.0
32,Holy Cross (Patriot),5,1-4,54,51,105,0.514,03/07/2018,2018.0
33,VMI (Southland),4,1-3,47,45,92,0.511,03/07/2018,2018.0
34,North Carolina (ACC),7,6-1,92,89,181,0.508,03/07/2018,2018.0
35,Hampton (DI Independent),4,1-3,48,47,95,0.505,03/07/2018,2018.0
36,Rutgers (Big Ten),5,4-1,55,54,109,0.505,03/07/2018,2018.0
37,Georgetown (Big East),5,5-0,63,62,125,0.504,03/07/2018,2018.0
38,Wagner (NEC),5,2-3,52,52,104,0.500,03/07/2018,2018.0
38,Notre Dame (ACC),3,2-1,33,33,66,0.500,03/07/2018,2018.0
40,Yale (Ivy League),4,3-1,49,50,99,0.495,03/07/2018,2018.0
41,Mount St. Mary's (NEC),6,2-4,83,85,168,0.494,03/07/2018,2018.0
42,Michigan (Big Ten),5,3-2,59,61,120,0.492,03/07/2018,2018.0
43,Vermont (America East),7,7-0,76,79,155,0.490,03/07/2018,2018.0
44,High Point (SoCon),6,0-6,85,93,178,0.478,03/07/2018,2018.0
45,UMass Lowell (America East),5,2-3,58,69,127,0.457,03/07/2018,2018.0
46,Bucknell (Patriot),5,3-2,55,67,122,0.451,03/07/2018,2018.0
47,Mercer (SoCon),6,2-4,57,70,127,0.449,03/07/2018,2018.0
48,Siena (MAAC),3,2-1,35,43,78,0.449,03/07/2018,2018.0
49,Marist (MAAC),7,1-6,73,90,163,0.448,03/07/2018,2018.0
50,Richmond (SoCon),5,2-3,48,60,108,0.444,03/07/2018,2018.0
51,Loyola Maryland (Patriot),5,4-1,54,68,122,0.443,03/07/2018,2018.0
52,St. John's (NY) (Big East),5,3-2,54,73,127,0.425,03/07/2018,2018.0
53,Princeton (Ivy League),4,2-2,47,64,111,0.423,03/07/2018,2018.0
54,Robert Morris (NEC),5,3-2,54,74,128,0.422,03/07/2018,2018.0
55,Boston U. (Patriot),6,4-2,59,81,140,0.421,03/07/2018,2018.0
56,Penn (Ivy League),5,3-2,44,61,105,0.419,03/07/2018,2018.0
57,Duke (ACC),6,5-1,64,92,156,0.410,03/07/2018,2018.0
58,Saint Joseph's (NEC),3,0-3,22,32,54,0.407,03/07/2018,2018.0
59,Canisius (MAAC),4,3-1,44,65,109,0.404,03/07/2018,2018.0
60,Binghamton (America East),6,0-6,61,92,153,0.399,03/07/2018,2018.0
61,Cleveland St. (Independent),7,1-6,64,99,163,0.393,03/07/2018,2018.0
62,Manhattan (MAAC),6,3-3,49,81,130,0.377,03/07/2018,2018.0
63,Monmouth (MAAC),4,2-2,36,60,96,0.375,03/07/2018,2018.0
64,UMBC (America East),4,1-3,28,51,79,0.354,03/07/2018,2018.0
65,Dartmouth (Ivy League),4,2-2,32,64,96,0.333,03/07/2018,2018.0
66,Stony Brook (America East),5,1-4,41,84,125,0.328,03/07/2018,2018.0
67,Furman (SoCon),6,0-6,54,112,166,0.325,03/07/2018,2018.0
68,Drexel (CAA),4,1-3,32,68,100,0.320,03/07/2018,2018.0
69,Cornell (Ivy League),4,2-2,32,71,103,0.311,03/07/2018,2018.0
1,UAlbany (America East),4,4-0,86,17,103,0.835,03/06/2018,2018.0
2,Denver (Big East),5,4-1,91,29,120,0.758,03/06/2018,2018.0
3,Penn St. (Big Ten),6,4-2,113,46,159,0.711,03/06/2018,2018.0
4,Towson (CAA),5,2-3,85,37,122,0.697,03/06/2018,2018.0
5,Jacksonville (SoCon),6,2-4,103,51,154,0.669,03/06/2018,2018.0
6,Bryant (NEC),6,2-4,94,53,147,0.639,03/06/2018,2018.0
7,Fairfield (CAA),6,2-4,87,51,138,0.630,03/06/2018,2018.0
8,Quinnipiac (MAAC),5,2-3,72,46,118,0.610,03/06/2018,2018.0
9,Johns Hopkins (Big Ten),4,2-2,60,39,99,0.606,03/06/2018,2018.0
10,Colgate (Patriot),6,3-3,96,64,160,0.600,03/06/2018,2018.0
11,Virginia (ACC),6,5-1,100,67,167,0.599,03/06/2018,2018.0
12,Air Force (SoCon),5,1-4,64,44,108,0.593,03/06/2018,2018.0
13,Ohio St. (Big Ten),6,5-1,77,53,130,0.592,03/06/2018,2018.0
14,Army West Point (Patriot),5,4-1,68,47,115,0.591,03/06/2018,2018.0
15,Marquette (Big East),4,3-1,48,34,82,0.585,03/06/2018,2018.0
16,Lehigh (Patriot),5,4-1,67,49,116,0.578,03/06/2018,2018.0
17,Delaware (CAA),5,3-2,74,56,130,0.569,03/06/2018,2018.0
18,Maryland (Big Ten),5,5-0,68,52,120,0.567,03/06/2018,2018.0
19,Hartford (America East),4,1-3,66,51,117,0.564,03/06/2018,2018.0
20,Sacred Heart (NEC),5,4-1,76,59,135,0.563,03/06/2018,2018.0
21,Hofstra (CAA),3,1-2,28,23,51,0.549,03/06/2018,2018.0
22,Lafayette (Patriot),6,2-4,78,65,143,0.545,03/06/2018,2018.0
23,Navy (Patriot),6,3-3,65,55,120,0.542,03/06/2018,2018.0
24,Harvard (Ivy League),4,3-1,55,47,102,0.539,03/06/2018,2018.0
25,Hobart (NEC),5,2-3,70,61,131,0.534,03/06/2018,2018.0
26,Villanova (Big East),6,5-1,78,68,146,0.534,03/06/2018,2018.0
27,Providence (Big East),6,3-3,68,60,128,0.531,03/06/2018,2018.0
28,Bellarmine (SoCon),6,2-4,67,60,127,0.528,03/06/2018,2018.0
29,Syracuse (ACC),4,3-1,54,50,104,0.519,03/06/2018,2018.0
30,Massachusetts (CAA),5,1-4,68,64,132,0.515,03/06/2018,2018.0
31,Brown (Ivy League),4,2-2,53,50,103,0.515,03/06/2018,2018.0
32,Holy Cross (Patriot),5,1-4,54,51,105,0.514,03/06/2018,2018.0
33,VMI (Southland),4,1-3,47,45,92,0.511,03/06/2018,2018.0
34,North Carolina (ACC),7,6-1,92,89,181,0.508,03/06/2018,2018.0
35,Hampton (DI Independent),4,1-3,48,47,95,0.505,03/06/2018,2018.0
36,Rutgers (Big Ten),5,4-1,55,54,109,0.505,03/06/2018,2018.0
37,Georgetown (Big East),5,5-0,63,62,125,0.504,03/06/2018,2018.0
38,Wagner (NEC),5,2-3,52,52,104,0.500,03/06/2018,2018.0
38,Notre Dame (ACC),3,2-1,33,33,66,0.500,03/06/2018,2018.0
40,Yale (Ivy League),4,3-1,49,50,99,0.495,03/06/2018,2018.0
41,Mount St. Mary's (NEC),6,2-4,83,85,168,0.494,03/06/2018,2018.0
42,Michigan (Big Ten),5,3-2,59,61,120,0.492,03/06/2018,2018.0
43,High Point (SoCon),6,0-6,85,93,178,0.478,03/06/2018,2018.0
44,UMass Lowell (America East),5,2-3,58,69,127,0.457,03/06/2018,2018.0
45,Vermont (America East),6,6-0,55,66,121,0.455,03/06/2018,2018.0
46,Bucknell (Patriot),5,3-2,55,67,122,0.451,03/06/2018,2018.0
47,Mercer (SoCon),6,2-4,57,70,127,0.449,03/06/2018,2018.0
48,Siena (MAAC),3,2-1,35,43,78,0.449,03/06/2018,2018.0
49,Marist (MAAC),7,1-6,73,90,163,0.448,03/06/2018,2018.0
50,Richmond (SoCon),5,2-3,48,60,108,0.444,03/06/2018,2018.0
51,Loyola Maryland (Patriot),5,4-1,54,68,122,0.443,03/06/2018,2018.0
52,St. John's (NY) (Big East),5,3-2,54,73,127,0.425,03/06/2018,2018.0
53,Princeton (Ivy League),4,2-2,47,64,111,0.423,03/06/2018,2018.0
54,Robert Morris (NEC),5,3-2,54,74,128,0.422,03/06/2018,2018.0
55,Boston U. (Patriot),6,4-2,59,81,140,0.421,03/06/2018,2018.0
56,Penn (Ivy League),5,3-2,44,61,105,0.419,03/06/2018,2018.0
57,Duke (ACC),6,5-1,64,92,156,0.410,03/06/2018,2018.0
58,Saint Joseph's (NEC),3,0-3,22,32,54,0.407,03/06/2018,2018.0
59,Canisius (MAAC),4,3-1,44,65,109,0.404,03/06/2018,2018.0
60,Binghamton (America East),6,0-6,61,92,153,0.399,03/06/2018,2018.0
61,Cleveland St. (Independent),7,1-6,64,99,163,0.393,03/06/2018,2018.0
62,Manhattan (MAAC),6,3-3,49,81,130,0.377,03/06/2018,2018.0
63,Monmouth (MAAC),4,2-2,36,60,96,0.375,03/06/2018,2018.0
64,UMBC (America East),4,1-3,28,51,79,0.354,03/06/2018,2018.0
65,Dartmouth (Ivy League),4,2-2,32,64,96,0.333,03/06/2018,2018.0
66,Stony Brook (America East),5,1-4,41,84,125,0.328,03/06/2018,2018.0
67,Furman (SoCon),6,0-6,54,112,166,0.325,03/06/2018,2018.0
68,Drexel (CAA),4,1-3,32,68,100,0.320,03/06/2018,2018.0
69,Cornell (Ivy League),4,2-2,32,71,103,0.311,03/06/2018,2018.0
1,UAlbany (America East),3,3-0,66,7,73,0.904,03/05/2018,2018.0
2,Denver (Big East),5,4-1,91,29,120,0.758,03/05/2018,2018.0
3,Towson (CAA),5,2-3,85,37,122,0.697,03/05/2018,2018.0
4,Penn St. (Big Ten),5,3-2,91,43,134,0.679,03/05/2018,2018.0
5,Quinnipiac (MAAC),4,2-2,67,32,99,0.677,03/05/2018,2018.0
6,Jacksonville (SoCon),6,2-4,103,51,154,0.669,03/05/2018,2018.0
7,Bryant (NEC),6,2-4,94,53,147,0.639,03/05/2018,2018.0
8,Colgate (Patriot),5,3-2,84,50,134,0.627,03/05/2018,2018.0
9,Fairfield (CAA),5,1-4,73,46,119,0.613,03/05/2018,2018.0
10,Johns Hopkins (Big Ten),4,2-2,60,39,99,0.606,03/05/2018,2018.0
11,Virginia (ACC),5,4-1,91,60,151,0.603,03/05/2018,2018.0
12,Air Force (SoCon),5,1-4,64,44,108,0.593,03/05/2018,2018.0
13,Ohio St. (Big Ten),6,5-1,77,53,130,0.592,03/05/2018,2018.0
14,Army West Point (Patriot),5,4-1,68,47,115,0.591,03/05/2018,2018.0
15,Marquette (Big East),4,3-1,48,34,82,0.585,03/05/2018,2018.0
16,Lehigh (Patriot),5,4-1,67,49,116,0.578,03/05/2018,2018.0
17,Massachusetts (CAA),4,1-3,58,44,102,0.569,03/05/2018,2018.0
18,Maryland (Big Ten),5,5-0,68,52,120,0.567,03/05/2018,2018.0
19,Hartford (America East),4,1-3,66,51,117,0.564,03/05/2018,2018.0
20,Sacred Heart (NEC),5,4-1,76,59,135,0.563,03/05/2018,2018.0
21,Villanova (Big East),5,5-0,69,54,123,0.561,03/05/2018,2018.0
22,Delaware (CAA),4,3-1,60,49,109,0.550,03/05/2018,2018.0
23,Navy (Patriot),5,3-2,56,46,102,0.549,03/05/2018,2018.0
23,Hofstra (CAA),3,1-2,28,23,51,0.549,03/05/2018,2018.0
25,Lafayette (Patriot),6,2-4,78,65,143,0.545,03/05/2018,2018.0
26,Harvard (Ivy League),4,3-1,55,47,102,0.539,03/05/2018,2018.0
27,Hobart (NEC),4,1-3,56,49,105,0.533,03/05/2018,2018.0
28,Bellarmine (SoCon),6,2-4,67,60,127,0.528,03/05/2018,2018.0
29,VMI (Southland),3,1-2,37,34,71,0.521,03/05/2018,2018.0
30,Syracuse (ACC),4,3-1,54,50,104,0.519,03/05/2018,2018.0
31,Holy Cross (Patriot),5,1-4,54,51,105,0.514,03/05/2018,2018.0
32,North Carolina (ACC),7,6-1,92,89,181,0.508,03/05/2018,2018.0
33,Hampton (DI Independent),4,1-3,48,47,95,0.505,03/05/2018,2018.0
34,Rutgers (Big Ten),5,4-1,55,54,109,0.505,03/05/2018,2018.0
35,Notre Dame (ACC),3,2-1,33,33,66,0.500,03/05/2018,2018.0
36,Providence (Big East),5,3-2,50,51,101,0.495,03/05/2018,2018.0
37,Yale (Ivy League),4,3-1,49,50,99,0.495,03/05/2018,2018.0
38,Mount St. Mary's (NEC),6,2-4,83,85,168,0.494,03/05/2018,2018.0
39,Wagner (NEC),4,1-3,41,42,83,0.494,03/05/2018,2018.0
40,Michigan (Big Ten),5,3-2,59,61,120,0.492,03/05/2018,2018.0
41,Georgetown (Big East),4,4-0,50,52,102,0.490,03/05/2018,2018.0
42,UMass Lowell (America East),4,1-3,49,51,100,0.490,03/05/2018,2018.0
43,Brown (Ivy League),3,1-2,39,41,80,0.488,03/05/2018,2018.0
44,High Point (SoCon),6,0-6,85,93,178,0.478,03/05/2018,2018.0
45,Mercer (SoCon),5,1-4,50,56,106,0.472,03/05/2018,2018.0
46,Vermont (America East),6,6-0,55,66,121,0.455,03/05/2018,2018.0
47,Bucknell (Patriot),5,3-2,55,67,122,0.451,03/05/2018,2018.0
48,Marist (MAAC),6,1-5,63,77,140,0.450,03/05/2018,2018.0
49,Siena (MAAC),3,2-1,35,43,78,0.449,03/05/2018,2018.0
50,Richmond (SoCon),5,2-3,48,60,108,0.444,03/05/2018,2018.0
51,Loyola Maryland (Patriot),5,4-1,54,68,122,0.443,03/05/2018,2018.0
52,St. John's (NY) (Big East),4,2-2,46,58,104,0.442,03/05/2018,2018.0
53,Robert Morris (NEC),5,3-2,54,74,128,0.422,03/05/2018,2018.0
54,Boston U. (Patriot),6,4-2,59,81,140,0.421,03/05/2018,2018.0
55,Duke (ACC),6,5-1,64,92,156,0.410,03/05/2018,2018.0
56,Canisius (MAAC),4,3-1,44,65,109,0.404,03/05/2018,2018.0
57,Penn (Ivy League),4,2-2,35,52,87,0.402,03/05/2018,2018.0
58,Cleveland St. (Independent),7,1-6,64,99,163,0.393,03/05/2018,2018.0
59,Binghamton (America East),5,0-5,49,80,129,0.380,03/05/2018,2018.0
60,Monmouth (MAAC),4,2-2,36,60,96,0.375,03/05/2018,2018.0
61,Manhattan (MAAC),5,3-2,42,72,114,0.368,03/05/2018,2018.0
62,Furman (SoCon),5,0-5,51,90,141,0.362,03/05/2018,2018.0
63,UMBC (America East),4,1-3,28,51,79,0.354,03/05/2018,2018.0
64,Dartmouth (Ivy League),4,2-2,32,64,96,0.333,03/05/2018,2018.0
64,Princeton (Ivy League),3,1-2,28,56,84,0.333,03/05/2018,2018.0
66,Stony Brook (America East),5,1-4,41,84,125,0.328,03/05/2018,2018.0
67,Drexel (CAA),4,1-3,32,68,100,0.320,03/05/2018,2018.0
68,NJIT (Independent),6,0-6,40,97,137,0.292,03/05/2018,2018.0
69,Detroit Mercy (MAAC),6,2-4,35,90,125,0.280,03/05/2018,2018.0
1,UAlbany (America East),3,3-0,66,7,73,0.904,03/04/2018,2018.0
2,Denver (Big East),4,3-1,79,21,100,0.790,03/04/2018,2018.0
3,Towson (CAA),5,2-3,85,37,122,0.697,03/04/2018,2018.0
4,Penn St. (Big Ten),5,3-2,91,43,134,0.679,03/04/2018,2018.0
5,Quinnipiac (MAAC),4,2-2,67,32,99,0.677,03/04/2018,2018.0
6,Jacksonville (SoCon),6,2-4,103,51,154,0.669,03/04/2018,2018.0
7,Bryant (NEC),6,2-4,94,53,147,0.639,03/04/2018,2018.0
8,Colgate (Patriot),5,3-2,84,50,134,0.627,03/04/2018,2018.0
9,Fairfield (CAA),5,1-4,73,46,119,0.613,03/04/2018,2018.0
10,Johns Hopkins (Big Ten),4,2-2,60,39,99,0.606,03/04/2018,2018.0
11,Virginia (ACC),5,4-1,91,60,151,0.603,03/04/2018,2018.0
12,Air Force (SoCon),5,1-4,64,44,108,0.593,03/04/2018,2018.0
13,Ohio St. (Big Ten),6,5-1,77,53,130,0.592,03/04/2018,2018.0
14,Army West Point (Patriot),5,4-1,68,47,115,0.591,03/04/2018,2018.0
15,Marquette (Big East),4,3-1,48,34,82,0.585,03/04/2018,2018.0
16,Lehigh (Patriot),5,4-1,67,49,116,0.578,03/04/2018,2018.0
17,Massachusetts (CAA),4,1-3,58,44,102,0.569,03/04/2018,2018.0
18,Maryland (Big Ten),5,5-0,68,52,120,0.567,03/04/2018,2018.0
19,Hartford (America East),4,1-3,66,51,117,0.564,03/04/2018,2018.0
20,Sacred Heart (NEC),5,4-1,76,59,135,0.563,03/04/2018,2018.0
21,Villanova (Big East),5,5-0,69,54,123,0.561,03/04/2018,2018.0
22,Delaware (CAA),4,3-1,60,49,109,0.550,03/04/2018,2018.0
23,Navy (Patriot),5,3-2,56,46,102,0.549,03/04/2018,2018.0
23,Hofstra (CAA),3,1-2,28,23,51,0.549,03/04/2018,2018.0
25,Lafayette (Patriot),6,2-4,78,65,143,0.545,03/04/2018,2018.0
26,Harvard (Ivy League),4,3-1,55,47,102,0.539,03/04/2018,2018.0
27,Hobart (NEC),4,1-3,56,49,105,0.533,03/04/2018,2018.0
28,Bellarmine (SoCon),6,2-4,67,60,127,0.528,03/04/2018,2018.0
29,North Carolina (ACC),6,6-0,84,77,161,0.522,03/04/2018,2018.0
30,VMI (Southland),3,1-2,37,34,71,0.521,03/04/2018,2018.0
31,Syracuse (ACC),4,3-1,54,50,104,0.519,03/04/2018,2018.0
32,Holy Cross (Patriot),5,1-4,54,51,105,0.514,03/04/2018,2018.0
33,Rutgers (Big Ten),5,4-1,55,54,109,0.505,03/04/2018,2018.0
34,Notre Dame (ACC),3,2-1,33,33,66,0.500,03/04/2018,2018.0
35,Providence (Big East),5,3-2,50,51,101,0.495,03/04/2018,2018.0
36,Yale (Ivy League),4,3-1,49,50,99,0.495,03/04/2018,2018.0
37,Mount St. Mary's (NEC),6,2-4,83,85,168,0.494,03/04/2018,2018.0
38,Wagner (NEC),4,1-3,41,42,83,0.494,03/04/2018,2018.0
39,Michigan (Big Ten),5,3-2,59,61,120,0.492,03/04/2018,2018.0
40,Georgetown (Big East),4,4-0,50,52,102,0.490,03/04/2018,2018.0
41,UMass Lowell (America East),4,1-3,49,51,100,0.490,03/04/2018,2018.0
42,Brown (Ivy League),3,1-2,39,41,80,0.488,03/04/2018,2018.0
43,High Point (SoCon),6,0-6,85,93,178,0.478,03/04/2018,2018.0
44,Mercer (SoCon),5,1-4,50,56,106,0.472,03/04/2018,2018.0
45,Hampton (DI Independent),3,0-3,35,40,75,0.467,03/04/2018,2018.0
46,Vermont (America East),6,6-0,55,66,121,0.455,03/04/2018,2018.0
47,Bucknell (Patriot),5,3-2,55,67,122,0.451,03/04/2018,2018.0
48,Marist (MAAC),6,1-5,63,77,140,0.450,03/04/2018,2018.0
49,Siena (MAAC),3,2-1,35,43,78,0.449,03/04/2018,2018.0
50,Richmond (SoCon),5,2-3,48,60,108,0.444,03/04/2018,2018.0
51,Loyola Maryland (Patriot),5,4-1,54,68,122,0.443,03/04/2018,2018.0
52,St. John's (NY) (Big East),4,2-2,46,58,104,0.442,03/04/2018,2018.0
53,Robert Morris (NEC),5,3-2,54,74,128,0.422,03/04/2018,2018.0
54,Boston U. (Patriot),6,4-2,59,81,140,0.421,03/04/2018,2018.0
55,Duke (ACC),6,5-1,64,92,156,0.410,03/04/2018,2018.0
56,Canisius (MAAC),4,3-1,44,65,109,0.404,03/04/2018,2018.0
57,Penn (Ivy League),4,2-2,35,52,87,0.402,03/04/2018,2018.0
58,Cleveland St. (Independent),7,1-6,64,99,163,0.393,03/04/2018,2018.0
59,Binghamton (America East),5,0-5,49,80,129,0.380,03/04/2018,2018.0
60,Monmouth (MAAC),4,2-2,36,60,96,0.375,03/04/2018,2018.0
61,Manhattan (MAAC),5,3-2,42,72,114,0.368,03/04/2018,2018.0
62,Furman (SoCon),5,0-5,51,90,141,0.362,03/04/2018,2018.0
63,UMBC (America East),4,1-3,28,51,79,0.354,03/04/2018,2018.0
64,Dartmouth (Ivy League),4,2-2,32,64,96,0.333,03/04/2018,2018.0
64,Princeton (Ivy League),3,1-2,28,56,84,0.333,03/04/2018,2018.0
66,Stony Brook (America East),5,1-4,41,84,125,0.328,03/04/2018,2018.0
67,Drexel (CAA),4,1-3,32,68,100,0.320,03/04/2018,2018.0
68,NJIT (Independent),6,0-6,40,97,137,0.292,03/04/2018,2018.0
69,Detroit Mercy (MAAC),6,2-4,35,90,125,0.280,03/04/2018,2018.0
1,UAlbany (America East),2,2-0,42,7,49,0.857,02/28/2018,2018.0
2,Denver (Big East),3,2-1,56,20,76,0.737,02/28/2018,2018.0
3,Jacksonville (SoCon),5,2-3,87,42,129,0.674,02/28/2018,2018.0
4,Towson (CAA),4,1-3,70,34,104,0.673,02/28/2018,2018.0
5,Colgate (Patriot),4,3-1,75,39,114,0.658,02/28/2018,2018.0
6,Bryant (NEC),5,2-3,81,44,125,0.648,02/28/2018,2018.0
7,Virginia (ACC),4,4-0,80,44,124,0.645,02/28/2018,2018.0
8,Penn St. (Big Ten),4,2-2,73,41,114,0.640,02/28/2018,2018.0
9,Fairfield (CAA),4,1-3,60,36,96,0.625,02/28/2018,2018.0
10,VMI (Southland),2,1-1,27,17,44,0.614,02/28/2018,2018.0
11,Quinnipiac (MAAC),3,1-2,44,28,72,0.611,02/28/2018,2018.0
12,Sacred Heart (NEC),4,3-1,69,44,113,0.611,02/28/2018,2018.0
13,Delaware (CAA),3,3-0,50,32,82,0.610,02/28/2018,2018.0
14,Army West Point (Patriot),4,3-1,57,37,94,0.606,02/28/2018,2018.0
15,Air Force (SoCon),4,1-3,48,32,80,0.600,02/28/2018,2018.0
16,Marquette (Big East),2,2-0,28,19,47,0.596,02/28/2018,2018.0
17,Hartford (America East),3,1-2,53,36,89,0.596,02/28/2018,2018.0
18,Notre Dame (ACC),2,2-0,25,17,42,0.595,02/28/2018,2018.0
19,Lehigh (Patriot),4,3-1,56,40,96,0.583,02/28/2018,2018.0
20,Ohio St. (Big Ten),4,4-0,54,39,93,0.581,02/28/2018,2018.0
21,Johns Hopkins (Big Ten),3,1-2,40,31,71,0.563,02/28/2018,2018.0
22,Bellarmine (SoCon),4,1-3,51,40,91,0.560,02/28/2018,2018.0
23,Lafayette (Patriot),5,2-3,68,54,122,0.557,02/28/2018,2018.0
24,Massachusetts (CAA),4,1-3,57,46,103,0.553,02/28/2018,2018.0
25,Hofstra (CAA),3,1-2,28,23,51,0.549,02/28/2018,2018.0
26,Maryland (Big Ten),4,4-0,52,44,96,0.542,02/28/2018,2018.0
26,Villanova (Big East),4,4-0,52,44,96,0.542,02/28/2018,2018.0
28,Harvard (Ivy League),3,2-1,40,34,74,0.541,02/28/2018,2018.0
29,Navy (Patriot),4,2-2,41,36,77,0.532,02/28/2018,2018.0
30,Holy Cross (Patriot),4,1-3,44,40,84,0.524,02/28/2018,2018.0
31,Yale (Ivy League),3,2-1,40,37,77,0.519,02/28/2018,2018.0
32,North Carolina (ACC),5,5-0,72,68,140,0.514,02/28/2018,2018.0
33,Hobart (NEC),3,0-3,40,38,78,0.513,02/28/2018,2018.0
34,Rutgers (Big Ten),4,3-1,44,44,88,0.500,02/28/2018,2018.0
34,Hampton (DI Independent),2,0-2,27,27,54,0.500,02/28/2018,2018.0
36,Syracuse (ACC),3,2-1,38,39,77,0.494,02/28/2018,2018.0
37,Penn (Ivy League),3,2-1,33,34,67,0.493,02/28/2018,2018.0
38,Brown (Ivy League),2,1-1,29,30,59,0.492,02/28/2018,2018.0
39,Georgetown (Big East),4,4-0,50,52,102,0.490,02/28/2018,2018.0
40,Michigan (Big Ten),4,2-2,46,51,97,0.474,02/28/2018,2018.0
41,High Point (SoCon),5,0-5,70,78,148,0.473,02/28/2018,2018.0
42,Mercer (SoCon),5,1-4,50,56,106,0.472,02/28/2018,2018.0
43,Mount St. Mary's (NEC),5,1-4,66,75,141,0.468,02/28/2018,2018.0
44,Bucknell (Patriot),4,3-1,45,52,97,0.464,02/28/2018,2018.0
45,Providence (Big East),4,3-1,36,42,78,0.462,02/28/2018,2018.0
46,Vermont (America East),5,5-0,44,52,96,0.458,02/28/2018,2018.0
47,Siena (MAAC),2,2-0,25,30,55,0.455,02/28/2018,2018.0
48,Richmond (SoCon),4,2-2,39,48,87,0.448,02/28/2018,2018.0
49,St. John's (NY) (Big East),3,2-1,37,46,83,0.446,02/28/2018,2018.0
50,Marist (MAAC),5,1-4,50,66,116,0.431,02/28/2018,2018.0
51,Furman (SoCon),4,0-4,50,67,117,0.427,02/28/2018,2018.0
52,Monmouth (MAAC),3,1-2,32,43,75,0.427,02/28/2018,2018.0
53,Loyola Maryland (Patriot),4,3-1,43,58,101,0.426,02/28/2018,2018.0
54,Boston U. (Patriot),5,3-2,47,65,112,0.420,02/28/2018,2018.0
55,UMBC (America East),3,1-2,25,36,61,0.410,02/28/2018,2018.0
56,UMass Lowell (America East),3,1-2,32,47,79,0.405,02/28/2018,2018.0
57,Robert Morris (NEC),4,2-2,39,59,98,0.398,02/28/2018,2018.0
58,Wagner (NEC),3,1-2,25,38,63,0.397,02/28/2018,2018.0
59,Canisius (MAAC),3,2-1,32,50,82,0.390,02/28/2018,2018.0
60,Duke (ACC),5,4-1,52,83,135,0.385,02/28/2018,2018.0
61,Binghamton (America East),4,0-4,38,64,102,0.373,02/28/2018,2018.0
62,Manhattan (MAAC),5,3-2,42,72,114,0.368,02/28/2018,2018.0
62,Dartmouth (Ivy League),3,1-2,28,48,76,0.368,02/28/2018,2018.0
64,Cornell (Ivy League),2,1-1,20,35,55,0.364,02/28/2018,2018.0
65,Cleveland St. (Independent),6,1-5,49,87,136,0.360,02/28/2018,2018.0
66,Princeton (Ivy League),2,1-1,20,36,56,0.357,02/28/2018,2018.0
67,NJIT (Independent),5,0-5,36,74,110,0.327,02/28/2018,2018.0
68,Stony Brook (America East),4,0-4,31,71,102,0.304,02/28/2018,2018.0
69,Drexel (CAA),3,0-3,21,55,76,0.276,02/28/2018,2018.0
1,UAlbany (America East),2,2-0,42,7,49,0.857,02/27/2018,2018.0
2,Denver (Big East),3,2-1,56,20,76,0.737,02/27/2018,2018.0
3,Towson (CAA),3,1-2,54,26,80,0.675,02/27/2018,2018.0
4,Jacksonville (SoCon),5,2-3,87,42,129,0.674,02/27/2018,2018.0
5,Colgate (Patriot),4,3-1,75,39,114,0.658,02/27/2018,2018.0
6,Bryant (NEC),5,2-3,81,44,125,0.648,02/27/2018,2018.0
7,Virginia (ACC),4,4-0,80,44,124,0.645,02/27/2018,2018.0
8,Penn St. (Big Ten),4,2-2,73,41,114,0.640,02/27/2018,2018.0
9,Fairfield (CAA),4,1-3,60,36,96,0.625,02/27/2018,2018.0
10,VMI (Southland),2,1-1,27,17,44,0.614,02/27/2018,2018.0
11,Quinnipiac (MAAC),3,1-2,44,28,72,0.611,02/27/2018,2018.0
12,Sacred Heart (NEC),4,3-1,69,44,113,0.611,02/27/2018,2018.0
13,Delaware (CAA),3,3-0,50,32,82,0.610,02/27/2018,2018.0
14,Army West Point (Patriot),4,3-1,57,37,94,0.606,02/27/2018,2018.0
15,Air Force (SoCon),4,1-3,48,32,80,0.600,02/27/2018,2018.0
16,Marquette (Big East),2,2-0,28,19,47,0.596,02/27/2018,2018.0
17,Hartford (America East),3,1-2,53,36,89,0.596,02/27/2018,2018.0
18,Notre Dame (ACC),2,2-0,25,17,42,0.595,02/27/2018,2018.0
19,Lehigh (Patriot),4,3-1,56,40,96,0.583,02/27/2018,2018.0
20,Ohio St. (Big Ten),4,4-0,54,39,93,0.581,02/27/2018,2018.0
21,Johns Hopkins (Big Ten),3,1-2,40,31,71,0.563,02/27/2018,2018.0
22,Bellarmine (SoCon),4,1-3,51,40,91,0.560,02/27/2018,2018.0
23,Lafayette (Patriot),5,2-3,68,54,122,0.557,02/27/2018,2018.0
24,Massachusetts (CAA),4,1-3,57,46,103,0.553,02/27/2018,2018.0
25,Hofstra (CAA),3,1-2,28,23,51,0.549,02/27/2018,2018.0
26,Villanova (Big East),4,4-0,52,44,96,0.542,02/27/2018,2018.0
26,Maryland (Big Ten),4,4-0,52,44,96,0.542,02/27/2018,2018.0
28,Harvard (Ivy League),3,2-1,40,34,74,0.541,02/27/2018,2018.0
29,Navy (Patriot),4,2-2,41,36,77,0.532,02/27/2018,2018.0
30,Holy Cross (Patriot),4,1-3,44,40,84,0.524,02/27/2018,2018.0
31,Yale (Ivy League),3,2-1,40,37,77,0.519,02/27/2018,2018.0
32,Hobart (NEC),3,0-3,40,38,78,0.513,02/27/2018,2018.0
33,Rutgers (Big Ten),4,3-1,44,44,88,0.500,02/27/2018,2018.0
33,Mercer (SoCon),4,1-3,41,41,82,0.500,02/27/2018,2018.0
33,Hampton (DI Independent),2,0-2,27,27,54,0.500,02/27/2018,2018.0
36,Syracuse (ACC),3,2-1,38,39,77,0.494,02/27/2018,2018.0
37,Penn (Ivy League),3,2-1,33,34,67,0.493,02/27/2018,2018.0
38,Brown (Ivy League),2,1-1,29,30,59,0.492,02/27/2018,2018.0
39,North Carolina (ACC),4,4-0,57,59,116,0.491,02/27/2018,2018.0
40,Georgetown (Big East),4,4-0,50,52,102,0.490,02/27/2018,2018.0
41,Michigan (Big Ten),4,2-2,46,51,97,0.474,02/27/2018,2018.0
42,High Point (SoCon),5,0-5,70,78,148,0.473,02/27/2018,2018.0
43,Mount St. Mary's (NEC),5,1-4,66,75,141,0.468,02/27/2018,2018.0
44,Bucknell (Patriot),4,3-1,45,52,97,0.464,02/27/2018,2018.0
45,Providence (Big East),4,3-1,36,42,78,0.462,02/27/2018,2018.0
46,Vermont (America East),5,5-0,44,52,96,0.458,02/27/2018,2018.0
47,Loyola Maryland (Patriot),3,2-1,35,42,77,0.455,02/27/2018,2018.0
47,Siena (MAAC),2,2-0,25,30,55,0.455,02/27/2018,2018.0
49,Richmond (SoCon),4,2-2,39,48,87,0.448,02/27/2018,2018.0
50,St. John's (NY) (Big East),3,2-1,37,46,83,0.446,02/27/2018,2018.0
51,Marist (MAAC),5,1-4,50,66,116,0.431,02/27/2018,2018.0
52,Furman (SoCon),4,0-4,50,67,117,0.427,02/27/2018,2018.0
53,Monmouth (MAAC),3,1-2,32,43,75,0.427,02/27/2018,2018.0
54,Boston U. (Patriot),5,3-2,47,65,112,0.420,02/27/2018,2018.0
55,UMBC (America East),3,1-2,25,36,61,0.410,02/27/2018,2018.0
56,UMass Lowell (America East),3,1-2,32,47,79,0.405,02/27/2018,2018.0
57,Robert Morris (NEC),4,2-2,39,59,98,0.398,02/27/2018,2018.0
58,Wagner (NEC),3,1-2,25,38,63,0.397,02/27/2018,2018.0
59,Canisius (MAAC),3,2-1,32,50,82,0.390,02/27/2018,2018.0
60,Duke (ACC),5,4-1,52,83,135,0.385,02/27/2018,2018.0
61,Binghamton (America East),4,0-4,38,64,102,0.373,02/27/2018,2018.0
62,Manhattan (MAAC),5,3-2,42,72,114,0.368,02/27/2018,2018.0
62,Dartmouth (Ivy League),3,1-2,28,48,76,0.368,02/27/2018,2018.0
64,Cornell (Ivy League),2,1-1,20,35,55,0.364,02/27/2018,2018.0
65,Cleveland St. (Independent),6,1-5,49,87,136,0.360,02/27/2018,2018.0
66,Princeton (Ivy League),2,1-1,20,36,56,0.357,02/27/2018,2018.0
67,NJIT (Independent),5,0-5,36,74,110,0.327,02/27/2018,2018.0
68,Stony Brook (America East),4,0-4,31,71,102,0.304,02/27/2018,2018.0
69,Drexel (CAA),3,0-3,21,55,76,0.276,02/27/2018,2018.0
1,UAlbany (America East),2,2-0,42,7,49,0.857,02/25/2018,2018.0
2,Denver (Big East),3,2-1,56,20,76,0.737,02/25/2018,2018.0
3,Hartford (America East),2,0-2,40,18,58,0.690,02/25/2018,2018.0
4,Towson (CAA),3,1-2,54,26,80,0.675,02/25/2018,2018.0
5,Jacksonville (SoCon),5,2-3,87,42,129,0.674,02/25/2018,2018.0
6,Colgate (Patriot),4,3-1,75,39,114,0.658,02/25/2018,2018.0
7,Fairfield (CAA),3,1-2,42,23,65,0.646,02/25/2018,2018.0
8,Virginia (ACC),4,4-0,80,44,124,0.645,02/25/2018,2018.0
9,Penn St. (Big Ten),4,2-2,73,41,114,0.640,02/25/2018,2018.0
10,Bryant (NEC),4,2-2,66,40,106,0.623,02/25/2018,2018.0
11,VMI (Southland),2,1-1,27,17,44,0.614,02/25/2018,2018.0
12,Quinnipiac (MAAC),3,1-2,44,28,72,0.611,02/25/2018,2018.0
13,Sacred Heart (NEC),4,3-1,69,44,113,0.611,02/25/2018,2018.0
14,Delaware (CAA),3,3-0,50,32,82,0.610,02/25/2018,2018.0
15,Army West Point (Patriot),4,3-1,57,37,94,0.606,02/25/2018,2018.0
16,Air Force (SoCon),4,1-3,48,32,80,0.600,02/25/2018,2018.0
17,Yale (Ivy League),2,1-1,31,21,52,0.596,02/25/2018,2018.0
18,Marquette (Big East),2,2-0,28,19,47,0.596,02/25/2018,2018.0
19,Notre Dame (ACC),2,2-0,25,17,42,0.595,02/25/2018,2018.0
20,Lehigh (Patriot),4,3-1,56,40,96,0.583,02/25/2018,2018.0
21,Ohio St. (Big Ten),4,4-0,54,39,93,0.581,02/25/2018,2018.0
22,Johns Hopkins (Big Ten),3,1-2,40,31,71,0.563,02/25/2018,2018.0
23,Bellarmine (SoCon),4,1-3,51,40,91,0.560,02/25/2018,2018.0
24,Lafayette (Patriot),5,2-3,68,54,122,0.557,02/25/2018,2018.0
25,Maryland (Big Ten),4,4-0,52,44,96,0.542,02/25/2018,2018.0
25,Villanova (Big East),3,3-0,39,33,72,0.542,02/25/2018,2018.0
27,Harvard (Ivy League),3,2-1,40,34,74,0.541,02/25/2018,2018.0
28,Navy (Patriot),4,2-2,41,36,77,0.532,02/25/2018,2018.0
29,Massachusetts (CAA),3,1-2,41,37,78,0.526,02/25/2018,2018.0
30,Holy Cross (Patriot),4,1-3,44,40,84,0.524,02/25/2018,2018.0
31,Hobart (NEC),3,0-3,40,38,78,0.513,02/25/2018,2018.0
32,Rutgers (Big Ten),4,3-1,44,44,88,0.500,02/25/2018,2018.0
32,Mercer (SoCon),4,1-3,41,41,82,0.500,02/25/2018,2018.0
32,Hampton (DI Independent),2,0-2,27,27,54,0.500,02/25/2018,2018.0
35,Syracuse (ACC),3,2-1,38,39,77,0.494,02/25/2018,2018.0
36,Penn (Ivy League),3,2-1,33,34,67,0.493,02/25/2018,2018.0
37,Brown (Ivy League),2,1-1,29,30,59,0.492,02/25/2018,2018.0
38,North Carolina (ACC),4,4-0,57,59,116,0.491,02/25/2018,2018.0
39,Mount St. Mary's (NEC),4,1-3,55,60,115,0.478,02/25/2018,2018.0
40,Michigan (Big Ten),4,2-2,46,51,97,0.474,02/25/2018,2018.0
41,High Point (SoCon),5,0-5,70,78,148,0.473,02/25/2018,2018.0
42,Bucknell (Patriot),4,3-1,45,52,97,0.464,02/25/2018,2018.0
43,Boston U. (Patriot),4,2-2,43,50,93,0.462,02/25/2018,2018.0
44,Providence (Big East),4,3-1,36,42,78,0.462,02/25/2018,2018.0
45,Georgetown (Big East),3,3-0,35,41,76,0.461,02/25/2018,2018.0
46,Vermont (America East),5,5-0,44,52,96,0.458,02/25/2018,2018.0
47,Loyola Maryland (Patriot),3,2-1,35,42,77,0.455,02/25/2018,2018.0
47,Siena (MAAC),2,2-0,25,30,55,0.455,02/25/2018,2018.0
49,Richmond (SoCon),4,2-2,39,48,87,0.448,02/25/2018,2018.0
50,St. John's (NY) (Big East),3,2-1,37,46,83,0.446,02/25/2018,2018.0
51,Marist (MAAC),5,1-4,50,66,116,0.431,02/25/2018,2018.0
52,Furman (SoCon),4,0-4,50,67,117,0.427,02/25/2018,2018.0
53,Monmouth (MAAC),3,1-2,32,43,75,0.427,02/25/2018,2018.0
54,UMBC (America East),3,1-2,25,36,61,0.410,02/25/2018,2018.0
55,UMass Lowell (America East),3,1-2,32,47,79,0.405,02/25/2018,2018.0
56,Robert Morris (NEC),4,2-2,39,59,98,0.398,02/25/2018,2018.0
57,Wagner (NEC),3,1-2,25,38,63,0.397,02/25/2018,2018.0
58,Canisius (MAAC),3,2-1,32,50,82,0.390,02/25/2018,2018.0
59,Hofstra (CAA),2,0-2,12,19,31,0.387,02/25/2018,2018.0
60,Duke (ACC),5,4-1,52,83,135,0.385,02/25/2018,2018.0
61,Binghamton (America East),4,0-4,38,64,102,0.373,02/25/2018,2018.0
62,Manhattan (MAAC),5,3-2,42,72,114,0.368,02/25/2018,2018.0
62,Dartmouth (Ivy League),3,1-2,28,48,76,0.368,02/25/2018,2018.0
64,Cornell (Ivy League),2,1-1,20,35,55,0.364,02/25/2018,2018.0
65,Cleveland St. (Independent),6,1-5,49,87,136,0.360,02/25/2018,2018.0
66,Princeton (Ivy League),2,1-1,20,36,56,0.357,02/25/2018,2018.0
67,Stony Brook (America East),3,0-3,27,55,82,0.329,02/25/2018,2018.0
68,NJIT (Independent),5,0-5,36,74,110,0.327,02/25/2018,2018.0
69,Detroit Mercy (MAAC),4,1-3,23,64,87,0.264,02/25/2018,2018.0
1,UAlbany (America East),1,1-0,17,5,22,0.773,02/21/2018,2018.0
2,Fairfield (CAA),2,1-1,31,11,42,0.738,02/21/2018,2018.0
3,Hartford (America East),1,0-1,22,8,30,0.733,02/21/2018,2018.0
4,Jacksonville (SoCon),4,2-2,74,29,103,0.718,02/21/2018,2018.0
5,Bryant (NEC),3,1-2,56,22,78,0.718,02/21/2018,2018.0
6,Colgate (Patriot),3,3-0,63,27,90,0.700,02/21/2018,2018.0
7,Towson (CAA),2,1-1,37,18,55,0.673,02/21/2018,2018.0
8,Denver (Big East),2,1-1,32,16,48,0.667,02/21/2018,2018.0
9,Hampton (DI Independent),1,0-1,19,10,29,0.655,02/21/2018,2018.0
10,Notre Dame (ACC),1,1-0,13,7,20,0.650,02/21/2018,2018.0
11,Quinnipiac (MAAC),2,1-1,35,20,55,0.636,02/21/2018,2018.0
11,VMI (Southland),1,0-1,14,8,22,0.636,02/21/2018,2018.0
13,Penn St. (Big Ten),3,2-1,56,34,90,0.622,02/21/2018,2018.0
14,Lafayette (Patriot),4,2-2,58,36,94,0.617,02/21/2018,2018.0
15,Virginia (ACC),3,3-0,54,34,88,0.614,02/21/2018,2018.0
16,Ohio St. (Big Ten),3,3-0,41,26,67,0.612,02/21/2018,2018.0
17,Army West Point (Patriot),3,3-0,40,28,68,0.588,02/21/2018,2018.0
18,Air Force (SoCon),3,1-2,37,26,63,0.587,02/21/2018,2018.0
19,Lehigh (Patriot),3,2-1,43,31,74,0.581,02/21/2018,2018.0
20,Syracuse (ACC),2,1-1,29,22,51,0.569,02/21/2018,2018.0
21,Sacred Heart (NEC),3,2-1,46,35,81,0.568,02/21/2018,2018.0
22,Holy Cross (Patriot),3,1-2,35,27,62,0.565,02/21/2018,2018.0
23,Massachusetts (CAA),2,1-1,28,22,50,0.560,02/21/2018,2018.0
24,Michigan (Big Ten),3,2-1,37,30,67,0.552,02/21/2018,2018.0
25,Harvard (Ivy League),2,1-1,25,21,46,0.543,02/21/2018,2018.0
26,Maryland (Big Ten),4,4-0,52,44,96,0.542,02/21/2018,2018.0
27,North Carolina (ACC),3,3-0,48,41,89,0.539,02/21/2018,2018.0
28,Delaware (CAA),2,2-0,28,24,52,0.538,02/21/2018,2018.0
29,Monmouth (MAAC),2,1-1,24,21,45,0.533,02/21/2018,2018.0
30,Bellarmine (SoCon),3,1-2,36,32,68,0.529,02/21/2018,2018.0
30,Georgetown (Big East),2,2-0,27,24,51,0.529,02/21/2018,2018.0
32,Hobart (NEC),2,0-2,27,25,52,0.519,02/21/2018,2018.0
33,Mercer (SoCon),4,1-3,41,41,82,0.500,02/21/2018,2018.0
33,Johns Hopkins (Big Ten),2,1-1,22,22,44,0.500,02/21/2018,2018.0
33,Princeton (Ivy League),1,1-0,10,10,20,0.500,02/21/2018,2018.0
33,Hofstra (CAA),1,0-1,9,9,18,0.500,02/21/2018,2018.0
37,Boston U. (Patriot),3,2-1,35,36,71,0.493,02/21/2018,2018.0
38,Rutgers (Big Ten),3,2-1,32,33,65,0.492,02/21/2018,2018.0
39,Villanova (Big East),2,2-0,29,30,59,0.492,02/21/2018,2018.0
40,Navy (Patriot),3,1-2,27,28,55,0.491,02/21/2018,2018.0
41,Marquette (Big East),1,1-0,12,13,25,0.480,02/21/2018,2018.0
42,High Point (SoCon),4,0-4,56,62,118,0.475,02/21/2018,2018.0
43,Mount St. Mary's (NEC),3,0-3,41,47,88,0.466,02/21/2018,2018.0
44,Vermont (America East),4,4-0,36,43,79,0.456,02/21/2018,2018.0
45,Yale (Ivy League),1,0-1,10,12,22,0.455,02/21/2018,2018.0
46,Bucknell (Patriot),3,2-1,33,40,73,0.452,02/21/2018,2018.0
47,Richmond (SoCon),3,2-1,29,36,65,0.446,02/21/2018,2018.0
48,Robert Morris (NEC),3,1-2,32,42,74,0.432,02/21/2018,2018.0
49,Dartmouth (Ivy League),2,1-1,19,25,44,0.432,02/21/2018,2018.0
50,Cleveland St. (Independent),4,0-4,39,52,91,0.429,02/21/2018,2018.0
51,Providence (Big East),3,2-1,29,39,68,0.426,02/21/2018,2018.0
52,Marist (MAAC),4,0-4,40,57,97,0.412,02/21/2018,2018.0
53,Penn (Ivy League),2,1-1,18,27,45,0.400,02/21/2018,2018.0
54,Duke (ACC),4,4-0,45,68,113,0.398,02/21/2018,2018.0
55,Wagner (NEC),3,1-2,25,38,63,0.397,02/21/2018,2018.0
56,St. John's (NY) (Big East),2,1-1,21,32,53,0.396,02/21/2018,2018.0
57,Canisius (MAAC),2,1-1,20,31,51,0.392,02/21/2018,2018.0
58,Manhattan (MAAC),4,2-2,34,57,91,0.374,02/21/2018,2018.0
59,Furman (SoCon),3,0-3,31,55,86,0.360,02/21/2018,2018.0
60,UMBC (America East),2,1-1,12,22,34,0.353,02/21/2018,2018.0
61,Binghamton (America East),3,0-3,29,54,83,0.349,02/21/2018,2018.0
62,Loyola Maryland (Patriot),2,1-1,17,32,49,0.347,02/21/2018,2018.0
63,Siena (MAAC),1,1-0,9,17,26,0.346,02/21/2018,2018.0
64,Stony Brook (America East),2,0-2,16,34,50,0.320,02/21/2018,2018.0
64,Drexel (CAA),1,0-1,8,17,25,0.320,02/21/2018,2018.0
66,NJIT (Independent),4,0-4,27,61,88,0.307,02/21/2018,2018.0
67,Brown (Ivy League),1,0-1,8,19,27,0.296,02/21/2018,2018.0
68,Detroit Mercy (MAAC),3,1-2,17,48,65,0.262,02/21/2018,2018.0
69,Cornell (Ivy League),1,0-1,7,22,29,0.241,02/21/2018,2018.0
-,UMass Lowell (America East),2,1-1,19,31,50,0.380,02/21/2018,2018.0
1,UAlbany (America East),1,1-0,17,5,22,0.773,02/20/2018,2018.0
2,Fairfield (CAA),2,1-1,31,11,42,0.738,02/20/2018,2018.0
3,Hartford (America East),1,0-1,22,8,30,0.733,02/20/2018,2018.0
4,Jacksonville (SoCon),4,2-2,74,29,103,0.718,02/20/2018,2018.0
5,Bryant (NEC),3,1-2,56,22,78,0.718,02/20/2018,2018.0
6,Colgate (Patriot),3,3-0,63,27,90,0.700,02/20/2018,2018.0
7,Towson (CAA),2,1-1,37,18,55,0.673,02/20/2018,2018.0
8,Denver (Big East),2,1-1,32,16,48,0.667,02/20/2018,2018.0
9,Hampton (DI Independent),1,0-1,19,10,29,0.655,02/20/2018,2018.0
10,Notre Dame (ACC),1,1-0,13,7,20,0.650,02/20/2018,2018.0
11,Quinnipiac (MAAC),2,1-1,35,20,55,0.636,02/20/2018,2018.0
11,VMI (Southland),1,0-1,14,8,22,0.636,02/20/2018,2018.0
13,Penn St. (Big Ten),3,2-1,56,34,90,0.622,02/20/2018,2018.0
14,Lafayette (Patriot),4,2-2,58,36,94,0.617,02/20/2018,2018.0
15,Virginia (ACC),3,3-0,54,34,88,0.614,02/20/2018,2018.0
16,Ohio St. (Big Ten),3,3-0,41,26,67,0.612,02/20/2018,2018.0
17,Army West Point (Patriot),3,3-0,40,28,68,0.588,02/20/2018,2018.0
18,Air Force (SoCon),3,1-2,37,26,63,0.587,02/20/2018,2018.0
19,Lehigh (Patriot),3,2-1,43,31,74,0.581,02/20/2018,2018.0
20,Syracuse (ACC),2,1-1,29,22,51,0.569,02/20/2018,2018.0
21,Sacred Heart (NEC),3,2-1,46,35,81,0.568,02/20/2018,2018.0
22,Holy Cross (Patriot),3,1-2,35,27,62,0.565,02/20/2018,2018.0
23,Massachusetts (CAA),2,1-1,28,22,50,0.560,02/20/2018,2018.0
24,Michigan (Big Ten),3,2-1,37,30,67,0.552,02/20/2018,2018.0
25,Harvard (Ivy League),2,1-1,25,21,46,0.543,02/20/2018,2018.0
26,North Carolina (ACC),3,3-0,48,41,89,0.539,02/20/2018,2018.0
27,Delaware (CAA),2,2-0,28,24,52,0.538,02/20/2018,2018.0
28,Bellarmine (SoCon),3,1-2,36,32,68,0.529,02/20/2018,2018.0
28,Georgetown (Big East),2,2-0,27,24,51,0.529,02/20/2018,2018.0
30,Maryland (Big Ten),3,3-0,39,35,74,0.527,02/20/2018,2018.0
31,Hobart (NEC),2,0-2,27,25,52,0.519,02/20/2018,2018.0
32,Mercer (SoCon),4,1-3,41,41,82,0.500,02/20/2018,2018.0
32,Johns Hopkins (Big Ten),2,1-1,22,22,44,0.500,02/20/2018,2018.0
32,Princeton (Ivy League),1,1-0,10,10,20,0.500,02/20/2018,2018.0
32,Monmouth (MAAC),1,0-1,10,10,20,0.500,02/20/2018,2018.0
32,Hofstra (CAA),1,0-1,9,9,18,0.500,02/20/2018,2018.0
37,Boston U. (Patriot),3,2-1,35,36,71,0.493,02/20/2018,2018.0
38,Rutgers (Big Ten),3,2-1,32,33,65,0.492,02/20/2018,2018.0
39,Villanova (Big East),2,2-0,29,30,59,0.492,02/20/2018,2018.0
40,Navy (Patriot),3,1-2,27,28,55,0.491,02/20/2018,2018.0
41,Marquette (Big East),1,1-0,12,13,25,0.480,02/20/2018,2018.0
42,High Point (SoCon),4,0-4,56,62,118,0.475,02/20/2018,2018.0
43,Mount St. Mary's (NEC),3,0-3,41,47,88,0.466,02/20/2018,2018.0
44,Vermont (America East),4,4-0,36,43,79,0.456,02/20/2018,2018.0
45,Yale (Ivy League),1,0-1,10,12,22,0.455,02/20/2018,2018.0
46,Bucknell (Patriot),3,2-1,33,40,73,0.452,02/20/2018,2018.0
47,Richmond (SoCon),3,2-1,29,36,65,0.446,02/20/2018,2018.0
48,Robert Morris (NEC),3,1-2,32,42,74,0.432,02/20/2018,2018.0
49,Dartmouth (Ivy League),2,1-1,19,25,44,0.432,02/20/2018,2018.0
50,Cleveland St. (Independent),4,0-4,39,52,91,0.429,02/20/2018,2018.0
51,Providence (Big East),3,2-1,29,39,68,0.426,02/20/2018,2018.0
52,Marist (MAAC),4,0-4,40,57,97,0.412,02/20/2018,2018.0
53,Duke (ACC),4,4-0,45,68,113,0.398,02/20/2018,2018.0
54,St. John's (NY) (Big East),2,1-1,21,32,53,0.396,02/20/2018,2018.0
55,Canisius (MAAC),2,1-1,20,31,51,0.392,02/20/2018,2018.0
56,Penn (Ivy League),1,1-0,9,14,23,0.391,02/20/2018,2018.0
57,Manhattan (MAAC),4,2-2,34,57,91,0.374,02/20/2018,2018.0
58,Wagner (NEC),2,1-1,14,24,38,0.368,02/20/2018,2018.0
59,Furman (SoCon),3,0-3,31,55,86,0.360,02/20/2018,2018.0
60,UMBC (America East),2,1-1,12,22,34,0.353,02/20/2018,2018.0
61,Binghamton (America East),3,0-3,29,54,83,0.349,02/20/2018,2018.0
62,Loyola Maryland (Patriot),2,1-1,17,32,49,0.347,02/20/2018,2018.0
63,Siena (MAAC),1,1-0,9,17,26,0.346,02/20/2018,2018.0
64,Stony Brook (America East),2,0-2,16,34,50,0.320,02/20/2018,2018.0
64,Drexel (CAA),1,0-1,8,17,25,0.320,02/20/2018,2018.0
66,NJIT (Independent),4,0-4,27,61,88,0.307,02/20/2018,2018.0
67,Brown (Ivy League),1,0-1,8,19,27,0.296,02/20/2018,2018.0
68,Detroit Mercy (MAAC),3,1-2,17,48,65,0.262,02/20/2018,2018.0
69,Cornell (Ivy League),1,0-1,7,22,29,0.241,02/20/2018,2018.0
-,UMass Lowell (America East),2,1-1,19,31,50,0.380,02/20/2018,2018.0
1,UAlbany (America East),1,1-0,17,5,22,0.773,02/18/2018,2018.0
2,Fairfield (CAA),2,1-1,31,11,42,0.738,02/18/2018,2018.0
3,Hartford (America East),1,0-1,22,8,30,0.733,02/18/2018,2018.0
4,Bryant (NEC),3,1-2,56,22,78,0.718,02/18/2018,2018.0
5,Colgate (Patriot),3,3-0,63,27,90,0.700,02/18/2018,2018.0
6,Harvard (Ivy League),1,1-0,15,7,22,0.682,02/18/2018,2018.0
7,Towson (CAA),2,1-1,37,18,55,0.673,02/18/2018,2018.0
8,Denver (Big East),2,1-1,32,16,48,0.667,02/18/2018,2018.0
9,Hampton (DI Independent),1,0-1,19,10,29,0.655,02/18/2018,2018.0
10,Notre Dame (ACC),1,1-0,13,7,20,0.650,02/18/2018,2018.0
11,Jacksonville (SoCon),3,1-2,50,27,77,0.649,02/18/2018,2018.0
12,Virginia (ACC),2,2-0,35,19,54,0.648,02/18/2018,2018.0
13,Quinnipiac (MAAC),2,1-1,35,20,55,0.636,02/18/2018,2018.0
13,VMI (Southland),1,0-1,14,8,22,0.636,02/18/2018,2018.0
15,Penn St. (Big Ten),3,2-1,56,34,90,0.622,02/18/2018,2018.0
16,Ohio St. (Big Ten),3,3-0,41,26,67,0.612,02/18/2018,2018.0
17,Lafayette (Patriot),3,2-1,41,28,69,0.594,02/18/2018,2018.0
18,Army West Point (Patriot),3,3-0,40,28,68,0.588,02/18/2018,2018.0
19,Air Force (SoCon),3,1-2,37,26,63,0.587,02/18/2018,2018.0
20,Lehigh (Patriot),3,2-1,43,31,74,0.581,02/18/2018,2018.0
21,Syracuse (ACC),2,1-1,29,22,51,0.569,02/18/2018,2018.0
22,Sacred Heart (NEC),3,2-1,46,35,81,0.568,02/18/2018,2018.0
23,Massachusetts (CAA),2,1-1,28,22,50,0.560,02/18/2018,2018.0
24,Holy Cross (Patriot),2,0-2,21,17,38,0.553,02/18/2018,2018.0
25,Michigan (Big Ten),3,2-1,37,30,67,0.552,02/18/2018,2018.0
26,North Carolina (ACC),3,3-0,48,41,89,0.539,02/18/2018,2018.0
27,Delaware (CAA),2,2-0,28,24,52,0.538,02/18/2018,2018.0
28,Bellarmine (SoCon),3,1-2,36,32,68,0.529,02/18/2018,2018.0
28,Georgetown (Big East),2,2-0,27,24,51,0.529,02/18/2018,2018.0
30,Maryland (Big Ten),3,3-0,39,35,74,0.527,02/18/2018,2018.0
31,Hobart (NEC),2,0-2,27,25,52,0.519,02/18/2018,2018.0
32,Mercer (SoCon),4,1-3,41,41,82,0.500,02/18/2018,2018.0
32,Johns Hopkins (Big Ten),2,1-1,22,22,44,0.500,02/18/2018,2018.0
32,Dartmouth (Ivy League),1,1-0,13,13,26,0.500,02/18/2018,2018.0
32,Canisius (MAAC),1,0-1,13,13,26,0.500,02/18/2018,2018.0
32,Princeton (Ivy League),1,1-0,10,10,20,0.500,02/18/2018,2018.0
32,Monmouth (MAAC),1,0-1,10,10,20,0.500,02/18/2018,2018.0
32,Hofstra (CAA),1,0-1,9,9,18,0.500,02/18/2018,2018.0
39,Rutgers (Big Ten),3,2-1,32,33,65,0.492,02/18/2018,2018.0
40,Villanova (Big East),2,2-0,29,30,59,0.492,02/18/2018,2018.0
41,Navy (Patriot),3,1-2,27,28,55,0.491,02/18/2018,2018.0
42,High Point (SoCon),3,0-3,41,43,84,0.488,02/18/2018,2018.0
43,Marquette (Big East),1,1-0,12,13,25,0.480,02/18/2018,2018.0
44,Richmond (SoCon),2,1-1,18,21,39,0.462,02/18/2018,2018.0
45,Vermont (America East),4,4-0,36,43,79,0.456,02/18/2018,2018.0
46,Yale (Ivy League),1,0-1,10,12,22,0.455,02/18/2018,2018.0
47,Bucknell (Patriot),3,2-1,33,40,73,0.452,02/18/2018,2018.0
48,Boston U. (Patriot),2,1-1,23,30,53,0.434,02/18/2018,2018.0
49,Robert Morris (NEC),3,1-2,32,42,74,0.432,02/18/2018,2018.0
50,Cleveland St. (Independent),4,0-4,39,52,91,0.429,02/18/2018,2018.0
51,Providence (Big East),3,2-1,29,39,68,0.426,02/18/2018,2018.0
52,Mount St. Mary's (NEC),2,0-2,26,36,62,0.419,02/18/2018,2018.0
53,Marist (MAAC),4,0-4,40,57,97,0.412,02/18/2018,2018.0
54,Duke (ACC),4,4-0,45,68,113,0.398,02/18/2018,2018.0
55,St. John's (NY) (Big East),2,1-1,21,32,53,0.396,02/18/2018,2018.0
56,Manhattan (MAAC),3,1-2,26,40,66,0.394,02/18/2018,2018.0
57,Penn (Ivy League),1,1-0,9,14,23,0.391,02/18/2018,2018.0
58,Detroit Mercy (MAAC),2,1-1,15,24,39,0.385,02/18/2018,2018.0
59,Wagner (NEC),2,1-1,14,24,38,0.368,02/18/2018,2018.0
60,Furman (SoCon),3,0-3,31,55,86,0.360,02/18/2018,2018.0
61,UMBC (America East),2,1-1,12,22,34,0.353,02/18/2018,2018.0
62,Loyola Maryland (Patriot),2,1-1,17,32,49,0.347,02/18/2018,2018.0
63,Siena (MAAC),1,1-0,9,17,26,0.346,02/18/2018,2018.0
64,Stony Brook (America East),2,0-2,16,34,50,0.320,02/18/2018,2018.0
64,Drexel (CAA),1,0-1,8,17,25,0.320,02/18/2018,2018.0
66,NJIT (Independent),4,0-4,27,61,88,0.307,02/18/2018,2018.0
67,Brown (Ivy League),1,0-1,8,19,27,0.296,02/18/2018,2018.0
68,Cornell (Ivy League),1,0-1,7,22,29,0.241,02/18/2018,2018.0
69,Saint Joseph's (NEC),1,0-1,4,17,21,0.190,02/18/2018,2018.0
-,UMass Lowell (America East),2,1-1,19,31,50,0.380,02/18/2018,2018.0
1,Syracuse (ACC),1,1-0,24,5,29,0.828,02/13/2018,2018.0
2,Jacksonville (SoCon),2,1-1,37,15,52,0.712,02/13/2018,2018.0
3,Bryant (NEC),2,1-1,38,17,55,0.691,02/13/2018,2018.0
4,Colgate (Patriot),2,2-0,41,20,61,0.672,02/13/2018,2018.0
5,Lehigh (Patriot),2,2-0,32,16,48,0.667,02/13/2018,2018.0
5,Towson (CAA),1,0-1,16,8,24,0.667,02/13/2018,2018.0
5,Fairfield (CAA),1,0-1,14,7,21,0.667,02/13/2018,2018.0
8,Hampton (DI Independent),1,0-1,19,10,29,0.655,02/13/2018,2018.0
9,Ohio St. (Big Ten),2,2-0,32,17,49,0.653,02/13/2018,2018.0
10,Notre Dame (ACC),1,1-0,13,7,20,0.650,02/13/2018,2018.0
11,Virginia (ACC),1,1-0,18,11,29,0.621,02/13/2018,2018.0
12,Army West Point (Patriot),2,2-0,29,19,48,0.604,02/13/2018,2018.0
13,Lafayette (Patriot),2,1-1,29,21,50,0.580,02/13/2018,2018.0
14,Penn St. (Big Ten),2,1-1,36,27,63,0.571,02/13/2018,2018.0
14,Quinnipiac (MAAC),1,0-1,16,12,28,0.571,02/13/2018,2018.0
16,Air Force (SoCon),2,0-2,25,19,44,0.568,02/13/2018,2018.0
17,St. John's (NY) (Big East),1,0-1,13,10,23,0.565,02/13/2018,2018.0
18,Sacred Heart (NEC),2,1-1,27,21,48,0.563,02/13/2018,2018.0
19,Maryland (Big Ten),2,2-0,23,18,41,0.561,02/13/2018,2018.0
20,Massachusetts (CAA),2,1-1,28,22,50,0.560,02/13/2018,2018.0
21,Providence (Big East),2,1-1,24,21,45,0.533,02/13/2018,2018.0
22,Richmond (SoCon),1,0-1,10,9,19,0.526,02/13/2018,2018.0
23,North Carolina (ACC),2,2-0,33,30,63,0.524,02/13/2018,2018.0
24,Michigan (Big Ten),2,2-0,23,21,44,0.523,02/13/2018,2018.0
25,Mount St. Mary's (NEC),1,0-1,16,15,31,0.516,02/13/2018,2018.0
26,Rutgers (Big Ten),2,2-0,23,22,45,0.511,02/13/2018,2018.0
27,Denver (Big East),1,1-0,9,9,18,0.500,02/13/2018,2018.0
28,Bellarmine (SoCon),2,0-2,22,23,45,0.489,02/13/2018,2018.0
29,Delaware (CAA),1,1-0,15,16,31,0.484,02/13/2018,2018.0
30,Vermont (America East),3,3-0,29,31,60,0.483,02/13/2018,2018.0
31,Mercer (SoCon),3,1-2,30,33,63,0.476,02/13/2018,2018.0
32,UMBC (America East),1,1-0,9,10,19,0.474,02/13/2018,2018.0
32,Holy Cross (Patriot),1,0-1,9,10,19,0.474,02/13/2018,2018.0
34,High Point (SoCon),2,0-2,24,27,51,0.471,02/13/2018,2018.0
35,Villanova (Big East),1,1-0,17,20,37,0.459,02/13/2018,2018.0
36,Georgetown (Big East),1,1-0,11,13,24,0.458,02/13/2018,2018.0
37,Duke (ACC),3,3-0,38,45,83,0.458,02/13/2018,2018.0
38,Robert Morris (NEC),2,1-1,21,26,47,0.447,02/13/2018,2018.0
39,Cleveland St. (Independent),3,0-3,30,38,68,0.441,02/13/2018,2018.0
40,Boston U. (Patriot),2,1-1,23,30,53,0.434,02/13/2018,2018.0
41,Marist (MAAC),3,0-3,33,45,78,0.423,02/13/2018,2018.0
42,Manhattan (MAAC),2,0-2,18,26,44,0.409,02/13/2018,2018.0
43,Bucknell (Patriot),2,2-0,21,32,53,0.396,02/13/2018,2018.0
44,Stony Brook (America East),1,0-1,9,14,23,0.391,02/13/2018,2018.0
45,Hobart (NEC),1,0-1,10,16,26,0.385,02/13/2018,2018.0
46,Loyola Maryland (Patriot),1,0-1,11,18,29,0.379,02/13/2018,2018.0
47,Navy (Patriot),2,0-2,15,25,40,0.375,02/13/2018,2018.0
48,Wagner (NEC),1,1-0,7,12,19,0.368,02/13/2018,2018.0
49,Detroit Mercy (MAAC),1,0-1,7,13,20,0.350,02/13/2018,2018.0
50,Johns Hopkins (Big Ten),1,1-0,8,16,24,0.333,02/13/2018,2018.0
51,Furman (SoCon),2,0-2,17,36,53,0.321,02/13/2018,2018.0
52,NJIT (Independent),3,0-3,19,48,67,0.284,02/13/2018,2018.0
53,Binghamton (America East),2,0-2,11,47,58,0.190,02/13/2018,2018.0
-,UMass Lowell (America East),1,1-0,12,16,28,0.429,02/13/2018,2018.0
1,Syracuse (ACC),1,1-0,24,5,29,0.828,02/11/2018,2018.0
2,Jacksonville (SoCon),2,1-1,37,15,52,0.712,02/11/2018,2018.0
3,Bryant (NEC),2,1-1,38,17,55,0.691,02/11/2018,2018.0
4,Lehigh (Patriot),2,2-0,32,16,48,0.667,02/11/2018,2018.0
4,Towson (CAA),1,0-1,16,8,24,0.667,02/11/2018,2018.0
4,Fairfield (CAA),1,0-1,14,7,21,0.667,02/11/2018,2018.0
7,Hampton (DI Independent),1,0-1,19,10,29,0.655,02/11/2018,2018.0
8,Ohio St. (Big Ten),2,2-0,32,17,49,0.653,02/11/2018,2018.0
9,Notre Dame (ACC),1,1-0,13,7,20,0.650,02/11/2018,2018.0
10,Massachusetts (CAA),1,0-1,16,9,25,0.640,02/11/2018,2018.0
11,Virginia (ACC),1,1-0,18,11,29,0.621,02/11/2018,2018.0
12,Sacred Heart (NEC),1,1-0,14,9,23,0.609,02/11/2018,2018.0
13,Lafayette (Patriot),2,1-1,29,21,50,0.580,02/11/2018,2018.0
14,Penn St. (Big Ten),2,1-1,36,27,63,0.571,02/11/2018,2018.0
14,Quinnipiac (MAAC),1,0-1,16,12,28,0.571,02/11/2018,2018.0
16,Air Force (SoCon),2,0-2,25,19,44,0.568,02/11/2018,2018.0
17,St. John's (NY) (Big East),1,0-1,13,10,23,0.565,02/11/2018,2018.0
18,Colgate (Patriot),1,1-0,18,14,32,0.563,02/11/2018,2018.0
19,Providence (Big East),2,1-1,24,21,45,0.533,02/11/2018,2018.0
20,Richmond (SoCon),1,0-1,10,9,19,0.526,02/11/2018,2018.0
21,North Carolina (ACC),2,2-0,33,30,63,0.524,02/11/2018,2018.0
22,Bellarmine (SoCon),1,0-1,13,12,25,0.520,02/11/2018,2018.0
23,Mount St. Mary's (NEC),1,0-1,16,15,31,0.516,02/11/2018,2018.0
24,Rutgers (Big Ten),2,2-0,23,22,45,0.511,02/11/2018,2018.0
25,Michigan (Big Ten),1,1-0,12,12,24,0.500,02/11/2018,2018.0
25,Denver (Big East),1,1-0,9,9,18,0.500,02/11/2018,2018.0
27,Marist (MAAC),2,0-2,27,28,55,0.491,02/11/2018,2018.0
28,Mercer (SoCon),2,0-2,20,21,41,0.488,02/11/2018,2018.0
29,Delaware (CAA),1,1-0,15,16,31,0.484,02/11/2018,2018.0
30,Vermont (America East),3,3-0,29,31,60,0.483,02/11/2018,2018.0
31,UMBC (America East),1,1-0,9,10,19,0.474,02/11/2018,2018.0
31,Holy Cross (Patriot),1,0-1,9,10,19,0.474,02/11/2018,2018.0
33,Villanova (Big East),1,1-0,17,20,37,0.459,02/11/2018,2018.0
34,Duke (ACC),3,3-0,38,45,83,0.458,02/11/2018,2018.0
35,Robert Morris (NEC),2,1-1,21,26,47,0.447,02/11/2018,2018.0
36,Boston U. (Patriot),2,1-1,23,30,53,0.434,02/11/2018,2018.0
37,Manhattan (MAAC),2,0-2,18,26,44,0.409,02/11/2018,2018.0
38,High Point (SoCon),1,0-1,11,16,27,0.407,02/11/2018,2018.0
39,Bucknell (Patriot),2,2-0,21,32,53,0.396,02/11/2018,2018.0
40,Cleveland St. (Independent),2,0-2,18,28,46,0.391,02/11/2018,2018.0
40,Stony Brook (America East),1,0-1,9,14,23,0.391,02/11/2018,2018.0
42,Hobart (NEC),1,0-1,10,16,26,0.385,02/11/2018,2018.0
43,Loyola Maryland (Patriot),1,0-1,11,18,29,0.379,02/11/2018,2018.0
44,Navy (Patriot),2,0-2,15,25,40,0.375,02/11/2018,2018.0
45,Wagner (NEC),1,1-0,7,12,19,0.368,02/11/2018,2018.0
46,NJIT (Independent),2,0-2,16,28,44,0.364,02/11/2018,2018.0
47,Army West Point (Patriot),1,1-0,9,16,25,0.360,02/11/2018,2018.0
48,Detroit Mercy (MAAC),1,0-1,7,13,20,0.350,02/11/2018,2018.0
49,Johns Hopkins (Big Ten),1,1-0,8,16,24,0.333,02/11/2018,2018.0
49,Maryland (Big Ten),1,1-0,6,12,18,0.333,02/11/2018,2018.0
51,Furman (SoCon),2,0-2,17,36,53,0.321,02/11/2018,2018.0
52,Binghamton (America East),1,0-1,5,24,29,0.172,02/11/2018,2018.0
-,UMass Lowell (America East),1,1-0,12,16,28,0.429,02/11/2018,2018.0
1,Jacksonville (SoCon),1,1-0,19,3,22,0.864,02/08/2018,2018.0
2,Bryant (NEC),1,1-0,19,6,25,0.760,02/08/2018,2018.0
3,Ohio St. (Big Ten),1,1-0,16,6,22,0.727,02/08/2018,2018.0
4,Lehigh (Patriot),1,1-0,18,7,25,0.720,02/08/2018,2018.0
5,Hampton (DI Independent),1,0-1,19,10,29,0.655,02/08/2018,2018.0
6,Air Force (SoCon),1,0-1,16,10,26,0.615,02/08/2018,2018.0
7,Lafayette (Patriot),1,0-1,19,12,31,0.613,02/08/2018,2018.0
8,Mercer (SoCon),1,0-1,11,7,18,0.611,02/08/2018,2018.0
9,Rutgers (Big Ten),1,1-0,13,9,22,0.591,02/08/2018,2018.0
10,Marist (MAAC),1,0-1,13,10,23,0.565,02/08/2018,2018.0
11,Vermont (America East),2,2-0,22,17,39,0.564,02/08/2018,2018.0
12,Penn St. (Big Ten),1,0-1,20,17,37,0.541,02/08/2018,2018.0
13,Providence (Big East),1,0-1,14,12,26,0.538,02/08/2018,2018.0
14,Duke (ACC),2,2-0,26,27,53,0.491,02/08/2018,2018.0
15,Boston U. (Patriot),1,1-0,12,14,26,0.462,02/08/2018,2018.0
16,Villanova (Big East),1,1-0,17,20,37,0.459,02/08/2018,2018.0
17,Bucknell (Patriot),1,1-0,10,13,23,0.435,02/08/2018,2018.0
18,Robert Morris (NEC),1,0-1,9,13,22,0.409,02/08/2018,2018.0
19,High Point (SoCon),1,0-1,11,16,27,0.407,02/08/2018,2018.0
20,North Carolina (ACC),1,1-0,12,19,31,0.387,02/08/2018,2018.0
21,Furman (SoCon),1,0-1,6,15,21,0.286,02/08/2018,2018.0
22,NJIT (Independent),1,0-1,7,18,25,0.280,02/08/2018,2018.0
23,Cleveland St. (Independent),1,0-1,6,16,22,0.273,02/08/2018,2018.0
24,Manhattan (MAAC),1,0-1,6,19,25,0.240,02/08/2018,2018.0
25,Navy (Patriot),1,0-1,3,19,22,0.136,02/08/2018,2018.0
1,Jacksonville (SoCon),1,1-0,20,3,23,0.870,02/04/2018,2018.0
2,Bryant (NEC),1,1-0,19,6,25,0.760,02/04/2018,2018.0
3,Ohio St. (Big Ten),1,1-0,16,6,22,0.727,02/04/2018,2018.0
4,Lehigh (Patriot),1,1-0,18,7,25,0.720,02/04/2018,2018.0
5,Hampton (DI Independent),1,0-1,19,10,29,0.655,02/04/2018,2018.0
6,Air Force (SoCon),1,0-1,16,10,26,0.615,02/04/2018,2018.0
7,Lafayette (Patriot),1,0-1,19,12,31,0.613,02/04/2018,2018.0
8,Mercer (SoCon),1,0-1,11,7,18,0.611,02/04/2018,2018.0
9,Rutgers (Big Ten),1,1-0,13,9,22,0.591,02/04/2018,2018.0
10,Marist (MAAC),1,0-1,13,10,23,0.565,02/04/2018,2018.0
11,Vermont (America East),2,2-0,22,17,39,0.564,02/04/2018,2018.0
12,Penn St. (Big Ten),1,0-1,20,17,37,0.541,02/04/2018,2018.0
13,Providence (Big East),1,0-1,14,12,26,0.538,02/04/2018,2018.0
14,Boston U. (Patriot),1,1-0,12,14,26,0.462,02/04/2018,2018.0
15,Villanova (Big East),1,1-0,17,20,37,0.459,02/04/2018,2018.0
16,Bucknell (Patriot),1,1-0,10,13,23,0.435,02/04/2018,2018.0
17,Robert Morris (NEC),1,0-1,9,13,22,0.409,02/04/2018,2018.0
18,North Carolina (ACC),1,1-0,12,19,31,0.387,02/04/2018,2018.0
19,Duke (ACC),1,1-0,10,16,26,0.385,02/04/2018,2018.0
20,Furman (SoCon),1,0-1,6,15,21,0.286,02/04/2018,2018.0
21,NJIT (Independent),1,0-1,7,18,25,0.280,02/04/2018,2018.0
22,Cleveland St. (Independent),1,0-1,6,16,22,0.273,02/04/2018,2018.0
23,Manhattan (MAAC),1,0-1,6,19,25,0.240,02/04/2018,2018.0
24,Navy (Patriot),1,0-1,3,20,23,0.130,02/04/2018,2018.0
1,Vermont (America East),1,1-0,15,6,21,0.714,02/01/2018,2018.0
2,Furman (SoCon),1,0-1,6,15,21,0.286,02/01/2018,2018.0
1,Yale (Ivy League),19,15-4,432,143,575,0.751,05/27/2019-Final Statistics,2019.0
2,Hampton (DI Independent),11,6-5,221,101,322,0.686,05/27/2019-Final Statistics,2019.0
3,Towson (CAA),16,11-5,293,134,427,0.686,05/27/2019-Final Statistics,2019.0
4,Lehigh (Patriot),17,9-8,274,126,400,0.685,05/27/2019-Final Statistics,2019.0
5,Holy Cross (Patriot),14,7-7,213,121,334,0.638,05/27/2019-Final Statistics,2019.0
6,Cleveland St. (DI Independent),15,8-7,239,140,379,0.631,05/27/2019-Final Statistics,2019.0
7,Marist (MAAC),17,10-7,252,151,403,0.625,05/27/2019-Final Statistics,2019.0
8,Air Force (SoCon),15,10-5,211,128,339,0.622,05/27/2019-Final Statistics,2019.0
9,Penn (Ivy League),16,12-4,295,181,476,0.620,05/27/2019-Final Statistics,2019.0
10,Ohio St. (Big Ten),12,8-4,190,117,307,0.619,05/27/2019-Final Statistics,2019.0
11,Saint Joseph's (NEC),14,7-7,207,129,336,0.616,05/27/2019-Final Statistics,2019.0
12,Hobart (NEC),16,11-5,279,176,455,0.613,05/27/2019-Final Statistics,2019.0
13,Massachusetts (CAA),15,10-5,229,147,376,0.609,05/27/2019-Final Statistics,2019.0
14,Mercer (SoCon),13,1-12,225,153,378,0.595,05/27/2019-Final Statistics,2019.0
15,UMass Lowell (America East),14,5-9,206,145,351,0.587,05/27/2019-Final Statistics,2019.0
16,Denver (Big East),15,10-5,219,155,374,0.586,05/27/2019-Final Statistics,2019.0
17,Detroit Mercy (MAAC),15,8-7,223,158,381,0.585,05/27/2019-Final Statistics,2019.0
18,Penn St. (Big Ten),18,16-2,337,240,577,0.584,05/27/2019-Final Statistics,2019.0
19,Notre Dame (ACC),16,9-7,229,166,395,0.580,05/27/2019-Final Statistics,2019.0
20,High Point (SoCon),16,13-3,268,195,463,0.579,05/27/2019-Final Statistics,2019.0
21,Virginia (ACC),20,17-3,313,233,546,0.573,05/27/2019-Final Statistics,2019.0
22,Drexel (CAA),15,7-8,248,189,437,0.568,05/27/2019-Final Statistics,2019.0
23,Syracuse (ACC),14,9-5,207,159,366,0.566,05/27/2019-Final Statistics,2019.0
24,Hofstra (CAA),14,5-9,173,137,310,0.558,05/27/2019-Final Statistics,2019.0
25,Boston U. (Patriot),17,11-6,245,201,446,0.549,05/27/2019-Final Statistics,2019.0
26,Johns Hopkins (Big Ten),16,8-8,243,207,450,0.540,05/27/2019-Final Statistics,2019.0
27,Maryland (Big Ten),17,12-5,246,211,457,0.538,05/27/2019-Final Statistics,2019.0
28,Bryant (NEC),14,3-11,175,151,326,0.537,05/27/2019-Final Statistics,2019.0
29,Loyola Maryland (Patriot),17,12-5,249,228,477,0.522,05/27/2019-Final Statistics,2019.0
30,Mount St. Mary's (NEC),16,9-7,202,186,388,0.521,05/27/2019-Final Statistics,2019.0
31,Brown (Ivy League),16,7-9,218,208,426,0.512,05/27/2019-Final Statistics,2019.0
32,Vermont (America East),15,8-7,190,182,372,0.511,05/27/2019-Final Statistics,2019.0
33,Duke (ACC),18,13-5,230,222,452,0.509,05/27/2019-Final Statistics,2019.0
34,Quinnipiac (MAAC),16,9-7,223,217,440,0.507,05/27/2019-Final Statistics,2019.0
35,Navy (Patriot),13,6-7,172,168,340,0.506,05/27/2019-Final Statistics,2019.0
36,Villanova (Big East),15,8-7,196,197,393,0.499,05/27/2019-Final Statistics,2019.0
37,Monmouth (MAAC),12,4-8,114,115,229,0.498,05/27/2019-Final Statistics,2019.0
38,Stony Brook (America East),15,9-6,180,185,365,0.493,05/27/2019-Final Statistics,2019.0
39,Providence (Big East),16,7-9,188,197,385,0.488,05/27/2019-Final Statistics,2019.0
40,North Carolina (ACC),15,8-7,191,201,392,0.487,05/27/2019-Final Statistics,2019.0
41,Canisius (MAAC),16,8-8,186,200,386,0.482,05/27/2019-Final Statistics,2019.0
42,Marquette (Big East),14,6-8,172,188,360,0.478,05/27/2019-Final Statistics,2019.0
43,Colgate (Patriot),13,4-9,145,159,304,0.477,05/27/2019-Final Statistics,2019.0
44,Hartford (America East),15,4-11,200,225,425,0.471,05/27/2019-Final Statistics,2019.0
45,Bucknell (Patriot),15,6-9,171,193,364,0.470,05/27/2019-Final Statistics,2019.0
46,Fairfield (CAA),14,5-9,175,202,377,0.464,05/27/2019-Final Statistics,2019.0
47,Georgetown (Big East),18,13-5,238,279,517,0.460,05/27/2019-Final Statistics,2019.0
48,Robert Morris (NEC),17,9-8,238,282,520,0.458,05/27/2019-Final Statistics,2019.0
49,Wagner (NEC),14,2-12,146,175,321,0.455,05/27/2019-Final Statistics,2019.0
50,St. John's (NY) (Big East),14,4-10,171,207,378,0.452,05/27/2019-Final Statistics,2019.0
51,Princeton (Ivy League),14,7-7,179,218,397,0.451,05/27/2019-Final Statistics,2019.0
52,UAlbany (America East),14,5-9,157,201,358,0.439,05/27/2019-Final Statistics,2019.0
53,Siena (MAAC),13,6-7,171,219,390,0.438,05/27/2019-Final Statistics,2019.0
54,Manhattan (MAAC),14,6-8,130,172,302,0.430,05/27/2019-Final Statistics,2019.0
55,Rutgers (Big Ten),15,7-8,168,225,393,0.427,05/27/2019-Final Statistics,2019.0
56,Harvard (Ivy League),13,5-8,167,227,394,0.424,05/27/2019-Final Statistics,2019.0
57,Binghamton (America East),13,2-11,133,183,316,0.421,05/27/2019-Final Statistics,2019.0
58,Jacksonville (SoCon),15,6-9,172,241,413,0.416,05/27/2019-Final Statistics,2019.0
59,Bellarmine (SoCon),13,3-10,148,209,357,0.415,05/27/2019-Final Statistics,2019.0
60,Sacred Heart (NEC),15,9-6,176,254,430,0.409,05/27/2019-Final Statistics,2019.0
61,NJIT (DI Independent),15,2-13,171,254,425,0.402,05/27/2019-Final Statistics,2019.0
62,UMBC (America East),16,7-9,173,269,442,0.391,05/27/2019-Final Statistics,2019.0
63,Cornell (Ivy League),15,10-5,171,274,445,0.384,05/27/2019-Final Statistics,2019.0
64,Delaware (CAA),15,10-5,142,231,373,0.381,05/27/2019-Final Statistics,2019.0
65,VMI (SoCon),13,4-9,136,222,358,0.380,05/27/2019-Final Statistics,2019.0
66,Furman (SoCon),14,4-10,145,243,388,0.374,05/27/2019-Final Statistics,2019.0
67,Richmond (SoCon),17,10-7,157,277,434,0.362,05/27/2019-Final Statistics,2019.0
68,Army West Point (Patriot),18,13-5,138,283,421,0.328,05/27/2019-Final Statistics,2019.0
69,Michigan (Big Ten),13,4-9,118,248,366,0.322,05/27/2019-Final Statistics,2019.0
70,Utah (DI Independent),15,5-10,123,259,382,0.322,05/27/2019-Final Statistics,2019.0
71,Dartmouth (Ivy League),13,2-11,93,215,308,0.302,05/27/2019-Final Statistics,2019.0
72,Lafayette (Patriot),15,4-11,109,263,372,0.293,05/27/2019-Final Statistics,2019.0
73,St. Bonaventure (MAAC),13,0-13,76,240,316,0.241,05/27/2019-Final Statistics,2019.0
1,Towson (CAA),1,0-1,22,9,31,0.710,05/08/2019 - 05/27/2019-DI Men's Lacrosse Tournament,2019.0
2,Yale (Ivy League),4,3-1,103,44,147,0.701,05/08/2019 - 05/27/2019-DI Men's Lacrosse Tournament,2019.0
3,Marist (MAAC),1,0-1,18,8,26,0.692,05/08/2019 - 05/27/2019-DI Men's Lacrosse Tournament,2019.0
4,Penn (Ivy League),2,1-1,41,25,66,0.621,05/08/2019 - 05/27/2019-DI Men's Lacrosse Tournament,2019.0
5,Penn St. (Big Ten),3,2-1,70,48,118,0.593,05/08/2019 - 05/27/2019-DI Men's Lacrosse Tournament,2019.0
6,Virginia (ACC),4,4-0,68,48,116,0.586,05/08/2019 - 05/27/2019-DI Men's Lacrosse Tournament,2019.0
7,Notre Dame (ACC),2,1-1,32,27,59,0.542,05/08/2019 - 05/27/2019-DI Men's Lacrosse Tournament,2019.0
8,Loyola Maryland (Patriot),2,1-1,34,35,69,0.493,05/08/2019 - 05/27/2019-DI Men's Lacrosse Tournament,2019.0
9,Richmond (SoCon),1,0-1,13,14,27,0.481,05/08/2019 - 05/27/2019-DI Men's Lacrosse Tournament,2019.0
10,Duke (ACC),3,2-1,41,46,87,0.471,05/08/2019 - 05/27/2019-DI Men's Lacrosse Tournament,2019.0
11,Syracuse (ACC),1,0-1,13,18,31,0.419,05/08/2019 - 05/27/2019-DI Men's Lacrosse Tournament,2019.0
12,Johns Hopkins (Big Ten),1,0-1,12,17,29,0.414,05/08/2019 - 05/27/2019-DI Men's Lacrosse Tournament,2019.0
13,Maryland (Big Ten),2,1-1,18,41,59,0.305,05/08/2019 - 05/27/2019-DI Men's Lacrosse Tournament,2019.0
14,Robert Morris (NEC),1,0-1,8,25,33,0.242,05/08/2019 - 05/27/2019-DI Men's Lacrosse Tournament,2019.0
15,UMBC (America East),2,1-1,12,52,64,0.188,05/08/2019 - 05/27/2019-DI Men's Lacrosse Tournament,2019.0
16,Georgetown (Big East),1,0-1,5,34,39,0.128,05/08/2019 - 05/27/2019-DI Men's Lacrosse Tournament,2019.0
17,Army West Point (Patriot),1,0-1,3,22,25,0.120,05/08/2019 - 05/27/2019-DI Men's Lacrosse Tournament,2019.0
1,Yale (Ivy League),18,15-3,413,137,550,0.751,05/25/2019,2019.0
2,Hampton (DI Independent),11,6-5,221,101,322,0.686,05/25/2019,2019.0
3,Towson (CAA),16,11-5,293,134,427,0.686,05/25/2019,2019.0
4,Lehigh (Patriot),17,9-8,274,126,400,0.685,05/25/2019,2019.0
5,Holy Cross (Patriot),14,7-7,213,121,334,0.638,05/25/2019,2019.0
6,Cleveland St. (DI Independent),15,8-7,239,140,379,0.631,05/25/2019,2019.0
7,Marist (MAAC),17,10-7,252,151,403,0.625,05/25/2019,2019.0
8,Air Force (SoCon),15,10-5,211,128,339,0.622,05/25/2019,2019.0
9,Penn (Ivy League),16,12-4,295,181,476,0.620,05/25/2019,2019.0
10,Ohio St. (Big Ten),12,8-4,190,117,307,0.619,05/25/2019,2019.0
11,Saint Joseph's (NEC),14,7-7,207,129,336,0.616,05/25/2019,2019.0
12,Hobart (NEC),16,11-5,279,176,455,0.613,05/25/2019,2019.0
13,Massachusetts (CAA),15,10-5,229,147,376,0.609,05/25/2019,2019.0
14,Mercer (SoCon),13,1-12,229,149,378,0.606,05/25/2019,2019.0
15,Virginia (ACC),19,16-3,307,214,521,0.589,05/25/2019,2019.0
16,UMass Lowell (America East),14,5-9,206,145,351,0.587,05/25/2019,2019.0
17,Denver (Big East),15,10-5,219,155,374,0.586,05/25/2019,2019.0
18,Detroit Mercy (MAAC),15,8-7,223,158,381,0.585,05/25/2019,2019.0
19,Penn St. (Big Ten),18,16-2,337,240,577,0.584,05/25/2019,2019.0
20,Notre Dame (ACC),16,9-7,229,166,395,0.580,05/25/2019,2019.0
21,High Point (SoCon),16,13-3,268,195,463,0.579,05/25/2019,2019.0
22,Drexel (CAA),15,7-8,248,189,437,0.568,05/25/2019,2019.0
23,Syracuse (ACC),14,9-5,207,159,366,0.566,05/25/2019,2019.0
24,Hofstra (CAA),14,5-9,173,137,310,0.558,05/25/2019,2019.0
25,Boston U. (Patriot),17,11-6,245,201,446,0.549,05/25/2019,2019.0
26,Johns Hopkins (Big Ten),16,8-8,243,207,450,0.540,05/25/2019,2019.0
27,Maryland (Big Ten),17,12-5,246,211,457,0.538,05/25/2019,2019.0
28,Bryant (NEC),14,3-11,175,151,326,0.537,05/25/2019,2019.0
29,Loyola Maryland (Patriot),17,12-5,249,228,477,0.522,05/25/2019,2019.0
30,Mount St. Mary's (NEC),16,9-7,202,186,388,0.521,05/25/2019,2019.0
31,Brown (Ivy League),16,7-9,218,208,426,0.512,05/25/2019,2019.0
32,Vermont (America East),15,8-7,190,182,372,0.511,05/25/2019,2019.0
33,Duke (ACC),18,13-5,230,222,452,0.509,05/25/2019,2019.0
34,Quinnipiac (MAAC),16,9-7,223,217,440,0.507,05/25/2019,2019.0
35,Navy (Patriot),13,6-7,172,168,340,0.506,05/25/2019,2019.0
36,Villanova (Big East),15,8-7,196,197,393,0.499,05/25/2019,2019.0
37,Monmouth (MAAC),12,4-8,114,115,229,0.498,05/25/2019,2019.0
38,Stony Brook (America East),15,9-6,180,185,365,0.493,05/25/2019,2019.0
39,Providence (Big East),16,7-9,188,197,385,0.488,05/25/2019,2019.0
40,North Carolina (ACC),15,8-7,191,201,392,0.487,05/25/2019,2019.0
41,Canisius (MAAC),16,8-8,185,201,386,0.479,05/25/2019,2019.0
42,Marquette (Big East),14,6-8,172,188,360,0.478,05/25/2019,2019.0
43,Colgate (Patriot),13,4-9,145,159,304,0.477,05/25/2019,2019.0
44,Hartford (America East),15,4-11,200,225,425,0.471,05/25/2019,2019.0
45,Bucknell (Patriot),15,6-9,171,193,364,0.470,05/25/2019,2019.0
46,Fairfield (CAA),14,5-9,175,202,377,0.464,05/25/2019,2019.0
47,Georgetown (Big East),18,13-5,238,279,517,0.460,05/25/2019,2019.0
48,Robert Morris (NEC),17,9-8,238,282,520,0.458,05/25/2019,2019.0
49,Wagner (NEC),14,2-12,146,175,321,0.455,05/25/2019,2019.0
50,St. John's (NY) (Big East),14,4-10,171,207,378,0.452,05/25/2019,2019.0
51,Princeton (Ivy League),14,7-7,179,218,397,0.451,05/25/2019,2019.0
52,UAlbany (America East),14,5-9,157,201,358,0.439,05/25/2019,2019.0
53,Siena (MAAC),13,6-7,171,219,390,0.438,05/25/2019,2019.0
54,Manhattan (MAAC),14,6-8,130,172,302,0.430,05/25/2019,2019.0
55,Rutgers (Big Ten),15,7-8,168,225,393,0.427,05/25/2019,2019.0
56,Harvard (Ivy League),13,5-8,167,227,394,0.424,05/25/2019,2019.0
57,Binghamton (America East),13,2-11,133,183,316,0.421,05/25/2019,2019.0
58,Jacksonville (SoCon),15,6-9,172,241,413,0.416,05/25/2019,2019.0
59,Sacred Heart (NEC),15,9-6,176,254,430,0.409,05/25/2019,2019.0
60,Bellarmine (SoCon),13,3-10,145,212,357,0.406,05/25/2019,2019.0
61,NJIT (DI Independent),15,2-13,171,254,425,0.402,05/25/2019,2019.0
62,UMBC (America East),16,7-9,173,269,442,0.391,05/25/2019,2019.0
63,Cornell (Ivy League),15,10-5,171,274,445,0.384,05/25/2019,2019.0
64,Delaware (CAA),15,10-5,142,231,373,0.381,05/25/2019,2019.0
65,VMI (SoCon),13,4-9,136,222,358,0.380,05/25/2019,2019.0
66,Furman (SoCon),14,4-10,145,243,388,0.374,05/25/2019,2019.0
67,Richmond (SoCon),17,10-7,157,277,434,0.362,05/25/2019,2019.0
68,Army West Point (Patriot),18,13-5,138,283,421,0.328,05/25/2019,2019.0
69,Michigan (Big Ten),13,4-9,118,248,366,0.322,05/25/2019,2019.0
70,Utah (DI Independent),15,5-10,123,259,382,0.322,05/25/2019,2019.0
71,Dartmouth (Ivy League),13,2-11,93,215,308,0.302,05/25/2019,2019.0
72,Lafayette (Patriot),15,4-11,109,263,372,0.293,05/25/2019,2019.0
73,St. Bonaventure (MAAC),13,0-13,76,240,316,0.241,05/25/2019,2019.0
1,Yale (Ivy League),17,14-3,385,123,508,0.758,05/19/2019,2019.0
2,Hampton (DI Independent),11,6-5,221,101,322,0.686,05/19/2019,2019.0
3,Towson (CAA),16,11-5,293,134,427,0.686,05/19/2019,2019.0
4,Lehigh (Patriot),17,9-8,274,126,400,0.685,05/19/2019,2019.0
5,Holy Cross (Patriot),14,7-7,213,121,334,0.638,05/19/2019,2019.0
6,Cleveland St. (DI Independent),15,8-7,239,140,379,0.631,05/19/2019,2019.0
7,Marist (MAAC),17,10-7,252,151,403,0.625,05/19/2019,2019.0
8,Air Force (SoCon),15,10-5,211,128,339,0.622,05/19/2019,2019.0
9,Penn (Ivy League),16,12-4,295,181,476,0.620,05/19/2019,2019.0
10,Ohio St. (Big Ten),12,8-4,190,117,307,0.619,05/19/2019,2019.0
11,Saint Joseph's (NEC),14,7-7,207,129,336,0.616,05/19/2019,2019.0
12,Hobart (NEC),16,11-5,279,176,455,0.613,05/19/2019,2019.0
13,Massachusetts (CAA),15,10-5,229,147,376,0.609,05/19/2019,2019.0
14,Mercer (SoCon),13,1-12,229,149,378,0.606,05/19/2019,2019.0
15,Penn St. (Big Ten),17,16-1,323,212,535,0.604,05/19/2019,2019.0
16,Virginia (ACC),18,15-3,289,202,491,0.589,05/19/2019,2019.0
17,UMass Lowell (America East),14,5-9,206,145,351,0.587,05/19/2019,2019.0
18,Denver (Big East),15,10-5,219,155,374,0.586,05/19/2019,2019.0
19,Detroit Mercy (MAAC),15,8-7,223,158,381,0.585,05/19/2019,2019.0
20,Notre Dame (ACC),16,9-7,229,166,395,0.580,05/19/2019,2019.0
21,High Point (SoCon),16,13-3,268,195,463,0.579,05/19/2019,2019.0
22,Drexel (CAA),15,7-8,248,189,437,0.568,05/19/2019,2019.0
23,Syracuse (ACC),14,9-5,207,159,366,0.566,05/19/2019,2019.0
24,Hofstra (CAA),14,5-9,173,137,310,0.558,05/19/2019,2019.0
25,Boston U. (Patriot),17,11-6,245,201,446,0.549,05/19/2019,2019.0
26,Johns Hopkins (Big Ten),16,8-8,243,207,450,0.540,05/19/2019,2019.0
27,Maryland (Big Ten),17,12-5,246,211,457,0.538,05/19/2019,2019.0
28,Bryant (NEC),14,3-11,175,151,326,0.537,05/19/2019,2019.0
29,Loyola Maryland (Patriot),17,12-5,249,228,477,0.522,05/19/2019,2019.0
30,Mount St. Mary's (NEC),16,9-7,202,186,388,0.521,05/19/2019,2019.0
31,Duke (ACC),17,13-4,218,204,422,0.517,05/19/2019,2019.0
32,Brown (Ivy League),16,7-9,218,208,426,0.512,05/19/2019,2019.0
33,Vermont (America East),15,8-7,190,182,372,0.511,05/19/2019,2019.0
34,Quinnipiac (MAAC),16,9-7,223,217,440,0.507,05/19/2019,2019.0
35,Navy (Patriot),13,6-7,172,168,340,0.506,05/19/2019,2019.0
36,Villanova (Big East),15,8-7,196,197,393,0.499,05/19/2019,2019.0
37,Monmouth (MAAC),12,4-8,114,115,229,0.498,05/19/2019,2019.0
38,Stony Brook (America East),15,9-6,180,185,365,0.493,05/19/2019,2019.0
39,Providence (Big East),16,7-9,188,197,385,0.488,05/19/2019,2019.0
40,North Carolina (ACC),15,8-7,191,201,392,0.487,05/19/2019,2019.0
41,Canisius (MAAC),16,8-8,185,201,386,0.479,05/19/2019,2019.0
42,Marquette (Big East),14,6-8,172,188,360,0.478,05/19/2019,2019.0
43,Colgate (Patriot),13,4-9,145,159,304,0.477,05/19/2019,2019.0
44,Hartford (America East),15,4-11,200,225,425,0.471,05/19/2019,2019.0
45,Bucknell (Patriot),15,6-9,171,193,364,0.470,05/19/2019,2019.0
46,Fairfield (CAA),14,5-9,175,202,377,0.464,05/19/2019,2019.0
47,Georgetown (Big East),18,13-5,238,279,517,0.460,05/19/2019,2019.0
48,Robert Morris (NEC),17,9-8,238,282,520,0.458,05/19/2019,2019.0
49,Wagner (NEC),14,2-12,146,175,321,0.455,05/19/2019,2019.0
50,St. John's (NY) (Big East),14,4-10,171,207,378,0.452,05/19/2019,2019.0
51,Princeton (Ivy League),14,7-7,179,218,397,0.451,05/19/2019,2019.0
52,UAlbany (America East),14,5-9,157,201,358,0.439,05/19/2019,2019.0
53,Siena (MAAC),13,6-7,171,219,390,0.438,05/19/2019,2019.0
54,Manhattan (MAAC),14,6-8,130,172,302,0.430,05/19/2019,2019.0
55,Rutgers (Big Ten),15,7-8,168,225,393,0.427,05/19/2019,2019.0
56,Harvard (Ivy League),13,5-8,167,227,394,0.424,05/19/2019,2019.0
57,Binghamton (America East),13,2-11,133,183,316,0.421,05/19/2019,2019.0
58,Jacksonville (SoCon),15,6-9,172,241,413,0.416,05/19/2019,2019.0
59,Sacred Heart (NEC),15,9-6,176,254,430,0.409,05/19/2019,2019.0
60,Bellarmine (SoCon),13,3-10,145,212,357,0.406,05/19/2019,2019.0
61,NJIT (DI Independent),15,2-13,171,254,425,0.402,05/19/2019,2019.0
62,UMBC (America East),16,7-9,173,269,442,0.391,05/19/2019,2019.0
63,Cornell (Ivy League),15,10-5,171,274,445,0.384,05/19/2019,2019.0
64,Delaware (CAA),15,10-5,142,231,373,0.381,05/19/2019,2019.0
65,VMI (SoCon),13,4-9,136,222,358,0.380,05/19/2019,2019.0
66,Furman (SoCon),14,4-10,145,243,388,0.374,05/19/2019,2019.0
67,Richmond (SoCon),17,10-7,157,277,434,0.362,05/19/2019,2019.0
68,Army West Point (Patriot),18,13-5,138,283,421,0.328,05/19/2019,2019.0
69,Michigan (Big Ten),13,4-9,118,248,366,0.322,05/19/2019,2019.0
70,Utah (DI Independent),15,5-10,123,259,382,0.322,05/19/2019,2019.0
71,Dartmouth (Ivy League),13,2-11,93,215,308,0.302,05/19/2019,2019.0
72,Lafayette (Patriot),15,4-11,109,263,372,0.293,05/19/2019,2019.0
73,St. Bonaventure (MAAC),13,0-13,76,240,316,0.241,05/19/2019,2019.0
1,Yale (Ivy League),16,13-3,363,104,467,0.777,05/18/2019,2019.0
2,Hampton (DI Independent),11,6-5,221,101,322,0.686,05/18/2019,2019.0
3,Towson (CAA),16,11-5,293,134,427,0.686,05/18/2019,2019.0
4,Lehigh (Patriot),17,9-8,274,126,400,0.685,05/18/2019,2019.0
5,Holy Cross (Patriot),14,7-7,213,121,334,0.638,05/18/2019,2019.0
6,Penn (Ivy League),15,12-3,276,159,435,0.634,05/18/2019,2019.0
7,Cleveland St. (DI Independent),15,8-7,239,140,379,0.631,05/18/2019,2019.0
8,Marist (MAAC),17,10-7,252,151,403,0.625,05/18/2019,2019.0
9,Air Force (SoCon),15,10-5,211,128,339,0.622,05/18/2019,2019.0
10,Ohio St. (Big Ten),12,8-4,190,117,307,0.619,05/18/2019,2019.0
11,Saint Joseph's (NEC),14,7-7,207,129,336,0.616,05/18/2019,2019.0
12,Hobart (NEC),16,11-5,279,176,455,0.613,05/18/2019,2019.0
13,Massachusetts (CAA),15,10-5,229,147,376,0.609,05/18/2019,2019.0
14,Mercer (SoCon),13,1-12,229,149,378,0.606,05/18/2019,2019.0
15,Penn St. (Big Ten),16,15-1,301,196,497,0.606,05/18/2019,2019.0
16,Virginia (ACC),18,15-3,289,202,491,0.589,05/18/2019,2019.0
17,UMass Lowell (America East),14,5-9,206,145,351,0.587,05/18/2019,2019.0
18,Denver (Big East),15,10-5,219,155,374,0.586,05/18/2019,2019.0
19,Detroit Mercy (MAAC),15,8-7,223,158,381,0.585,05/18/2019,2019.0
20,Notre Dame (ACC),16,9-7,229,166,395,0.580,05/18/2019,2019.0
21,High Point (SoCon),16,13-3,268,195,463,0.579,05/18/2019,2019.0
22,Drexel (CAA),15,7-8,248,189,437,0.568,05/18/2019,2019.0
23,Syracuse (ACC),14,9-5,207,159,366,0.566,05/18/2019,2019.0
24,Hofstra (CAA),14,5-9,173,137,310,0.558,05/18/2019,2019.0
25,Boston U. (Patriot),17,11-6,245,201,446,0.549,05/18/2019,2019.0
26,Johns Hopkins (Big Ten),16,8-8,243,207,450,0.540,05/18/2019,2019.0
27,Maryland (Big Ten),17,12-5,246,211,457,0.538,05/18/2019,2019.0
28,Bryant (NEC),14,3-11,175,151,326,0.537,05/18/2019,2019.0
29,Loyola Maryland (Patriot),16,12-4,233,206,439,0.531,05/18/2019,2019.0
30,Mount St. Mary's (NEC),16,9-7,202,186,388,0.521,05/18/2019,2019.0
31,Duke (ACC),17,13-4,218,204,422,0.517,05/18/2019,2019.0
32,Brown (Ivy League),16,7-9,218,208,426,0.512,05/18/2019,2019.0
33,Vermont (America East),15,8-7,190,182,372,0.511,05/18/2019,2019.0
34,Quinnipiac (MAAC),16,9-7,223,217,440,0.507,05/18/2019,2019.0
35,Navy (Patriot),13,6-7,172,168,340,0.506,05/18/2019,2019.0
36,Villanova (Big East),15,8-7,196,197,393,0.499,05/18/2019,2019.0
37,Monmouth (MAAC),12,4-8,114,115,229,0.498,05/18/2019,2019.0
38,Stony Brook (America East),15,9-6,180,185,365,0.493,05/18/2019,2019.0
39,Providence (Big East),16,7-9,188,197,385,0.488,05/18/2019,2019.0
40,North Carolina (ACC),15,8-7,191,201,392,0.487,05/18/2019,2019.0
41,Canisius (MAAC),16,8-8,185,201,386,0.479,05/18/2019,2019.0
42,Marquette (Big East),14,6-8,172,188,360,0.478,05/18/2019,2019.0
43,Colgate (Patriot),13,4-9,145,159,304,0.477,05/18/2019,2019.0
44,Hartford (America East),15,4-11,200,225,425,0.471,05/18/2019,2019.0
45,Bucknell (Patriot),15,6-9,171,193,364,0.470,05/18/2019,2019.0
46,Fairfield (CAA),14,5-9,175,202,377,0.464,05/18/2019,2019.0
47,Georgetown (Big East),18,13-5,238,279,517,0.460,05/18/2019,2019.0
48,Robert Morris (NEC),17,9-8,238,282,520,0.458,05/18/2019,2019.0
49,Wagner (NEC),14,2-12,146,175,321,0.455,05/18/2019,2019.0
50,St. John's (NY) (Big East),14,4-10,171,207,378,0.452,05/18/2019,2019.0
51,Princeton (Ivy League),14,7-7,179,218,397,0.451,05/18/2019,2019.0
52,UAlbany (America East),14,5-9,157,201,358,0.439,05/18/2019,2019.0
53,Siena (MAAC),13,6-7,171,219,390,0.438,05/18/2019,2019.0
54,Manhattan (MAAC),14,6-8,130,172,302,0.430,05/18/2019,2019.0
55,Rutgers (Big Ten),15,7-8,168,225,393,0.427,05/18/2019,2019.0
56,Harvard (Ivy League),13,5-8,167,227,394,0.424,05/18/2019,2019.0
57,Binghamton (America East),13,2-11,133,183,316,0.421,05/18/2019,2019.0
58,Jacksonville (SoCon),15,6-9,172,241,413,0.416,05/18/2019,2019.0
59,Sacred Heart (NEC),15,9-6,176,254,430,0.409,05/18/2019,2019.0
60,Bellarmine (SoCon),13,3-10,145,212,357,0.406,05/18/2019,2019.0
61,NJIT (DI Independent),15,2-13,171,254,425,0.402,05/18/2019,2019.0
62,UMBC (America East),16,7-9,173,269,442,0.391,05/18/2019,2019.0
63,Cornell (Ivy League),15,10-5,171,274,445,0.384,05/18/2019,2019.0
64,Delaware (CAA),15,10-5,142,231,373,0.381,05/18/2019,2019.0
65,VMI (SoCon),13,4-9,136,222,358,0.380,05/18/2019,2019.0
66,Furman (SoCon),14,4-10,145,243,388,0.374,05/18/2019,2019.0
67,Richmond (SoCon),17,10-7,157,277,434,0.362,05/18/2019,2019.0
68,Army West Point (Patriot),18,13-5,138,283,421,0.328,05/18/2019,2019.0
69,Michigan (Big Ten),13,4-9,118,248,366,0.322,05/18/2019,2019.0
70,Utah (DI Independent),15,5-10,123,259,382,0.322,05/18/2019,2019.0
71,Dartmouth (Ivy League),13,2-11,93,215,308,0.302,05/18/2019,2019.0
72,Lafayette (Patriot),15,4-11,109,263,372,0.293,05/18/2019,2019.0
73,St. Bonaventure (MAAC),13,0-13,76,240,316,0.241,05/18/2019,2019.0
1,Yale (Ivy League),16,13-3,363,104,467,0.777,05/12/2019,2019.0
2,Hampton (DI Independent),11,6-5,221,101,322,0.686,05/12/2019,2019.0
3,Towson (CAA),16,11-5,293,134,427,0.686,05/12/2019,2019.0
4,Lehigh (Patriot),17,9-8,274,126,400,0.685,05/12/2019,2019.0
5,Holy Cross (Patriot),14,7-7,213,121,334,0.638,05/12/2019,2019.0
6,Penn (Ivy League),15,12-3,276,159,435,0.634,05/12/2019,2019.0
7,Cleveland St. (DI Independent),15,8-7,239,140,379,0.631,05/12/2019,2019.0
8,Marist (MAAC),17,10-7,252,151,403,0.625,05/12/2019,2019.0
9,Air Force (SoCon),15,10-5,211,128,339,0.622,05/12/2019,2019.0
10,Ohio St. (Big Ten),12,8-4,190,117,307,0.619,05/12/2019,2019.0
11,Saint Joseph's (NEC),14,7-7,207,129,336,0.616,05/12/2019,2019.0
12,Hobart (NEC),16,11-5,279,176,455,0.613,05/12/2019,2019.0
13,Massachusetts (CAA),15,10-5,229,147,376,0.609,05/12/2019,2019.0
14,Mercer (SoCon),13,1-12,229,149,378,0.606,05/12/2019,2019.0
15,Penn St. (Big Ten),16,15-1,301,196,497,0.606,05/12/2019,2019.0
16,UMass Lowell (America East),14,5-9,206,145,351,0.587,05/12/2019,2019.0
17,Notre Dame (ACC),15,9-6,214,151,365,0.586,05/12/2019,2019.0
18,Denver (Big East),15,10-5,219,155,374,0.586,05/12/2019,2019.0
19,Detroit Mercy (MAAC),15,8-7,223,158,381,0.585,05/12/2019,2019.0
20,Virginia (ACC),17,14-3,270,193,463,0.583,05/12/2019,2019.0
21,High Point (SoCon),16,13-3,268,195,463,0.579,05/12/2019,2019.0
22,Drexel (CAA),15,7-8,248,189,437,0.568,05/12/2019,2019.0
23,Syracuse (ACC),14,9-5,207,159,366,0.566,05/12/2019,2019.0
24,Hofstra (CAA),14,5-9,173,137,310,0.558,05/12/2019,2019.0
25,Maryland (Big Ten),16,12-4,237,192,429,0.552,05/12/2019,2019.0
26,Boston U. (Patriot),17,11-6,245,201,446,0.549,05/12/2019,2019.0
27,Johns Hopkins (Big Ten),16,8-8,243,207,450,0.540,05/12/2019,2019.0
28,Bryant (NEC),14,3-11,175,151,326,0.537,05/12/2019,2019.0
29,Loyola Maryland (Patriot),16,12-4,233,206,439,0.531,05/12/2019,2019.0
30,Mount St. Mary's (NEC),16,9-7,202,186,388,0.521,05/12/2019,2019.0
31,Duke (ACC),16,12-4,203,189,392,0.518,05/12/2019,2019.0
32,Brown (Ivy League),16,7-9,218,208,426,0.512,05/12/2019,2019.0
33,Vermont (America East),15,8-7,190,182,372,0.511,05/12/2019,2019.0
34,Quinnipiac (MAAC),16,9-7,223,217,440,0.507,05/12/2019,2019.0
35,Navy (Patriot),13,6-7,172,168,340,0.506,05/12/2019,2019.0
36,Villanova (Big East),15,8-7,196,197,393,0.499,05/12/2019,2019.0
37,Monmouth (MAAC),12,4-8,114,115,229,0.498,05/12/2019,2019.0
38,Stony Brook (America East),15,9-6,180,185,365,0.493,05/12/2019,2019.0
39,Providence (Big East),16,7-9,188,197,385,0.488,05/12/2019,2019.0
40,North Carolina (ACC),15,8-7,191,201,392,0.487,05/12/2019,2019.0
41,Canisius (MAAC),16,8-8,185,201,386,0.479,05/12/2019,2019.0
42,Marquette (Big East),14,6-8,172,188,360,0.478,05/12/2019,2019.0
43,Colgate (Patriot),13,4-9,145,159,304,0.477,05/12/2019,2019.0
44,Hartford (America East),15,4-11,200,225,425,0.471,05/12/2019,2019.0
45,Bucknell (Patriot),15,6-9,171,193,364,0.470,05/12/2019,2019.0
46,Fairfield (CAA),14,5-9,175,202,377,0.464,05/12/2019,2019.0
47,Georgetown (Big East),18,13-5,238,279,517,0.460,05/12/2019,2019.0
48,Robert Morris (NEC),17,9-8,238,282,520,0.458,05/12/2019,2019.0
49,Wagner (NEC),14,2-12,146,175,321,0.455,05/12/2019,2019.0
50,St. John's (NY) (Big East),14,4-10,171,207,378,0.452,05/12/2019,2019.0
51,Princeton (Ivy League),14,7-7,179,218,397,0.451,05/12/2019,2019.0
52,UAlbany (America East),14,5-9,157,201,358,0.439,05/12/2019,2019.0
53,Siena (MAAC),13,6-7,171,219,390,0.438,05/12/2019,2019.0
54,Manhattan (MAAC),14,6-8,130,172,302,0.430,05/12/2019,2019.0
55,Rutgers (Big Ten),15,7-8,168,225,393,0.427,05/12/2019,2019.0
56,Harvard (Ivy League),13,5-8,167,227,394,0.424,05/12/2019,2019.0
57,Binghamton (America East),13,2-11,133,183,316,0.421,05/12/2019,2019.0
58,Jacksonville (SoCon),15,6-9,172,241,413,0.416,05/12/2019,2019.0
59,Sacred Heart (NEC),15,9-6,176,254,430,0.409,05/12/2019,2019.0
60,Bellarmine (SoCon),13,3-10,145,212,357,0.406,05/12/2019,2019.0
61,NJIT (DI Independent),15,2-13,171,254,425,0.402,05/12/2019,2019.0
62,UMBC (America East),16,7-9,173,269,442,0.391,05/12/2019,2019.0
63,Cornell (Ivy League),15,10-5,171,274,445,0.384,05/12/2019,2019.0
64,Delaware (CAA),15,10-5,142,231,373,0.381,05/12/2019,2019.0
65,VMI (SoCon),13,4-9,136,222,358,0.380,05/12/2019,2019.0
66,Furman (SoCon),14,4-10,145,243,388,0.374,05/12/2019,2019.0
67,Richmond (SoCon),17,10-7,157,277,434,0.362,05/12/2019,2019.0
68,Army West Point (Patriot),18,13-5,138,283,421,0.328,05/12/2019,2019.0
69,Michigan (Big Ten),13,4-9,118,248,366,0.322,05/12/2019,2019.0
70,Utah (DI Independent),15,5-10,123,259,382,0.322,05/12/2019,2019.0
71,Dartmouth (Ivy League),13,2-11,93,215,308,0.302,05/12/2019,2019.0
72,Lafayette (Patriot),15,4-11,109,263,372,0.293,05/12/2019,2019.0
73,St. Bonaventure (MAAC),13,0-13,76,240,316,0.241,05/12/2019,2019.0
1,Yale (Ivy League),16,13-3,363,104,467,0.777,05/11/2019,2019.0
2,Hampton (DI Independent),11,6-5,221,101,322,0.686,05/11/2019,2019.0
3,Lehigh (Patriot),17,9-8,274,126,400,0.685,05/11/2019,2019.0
4,Towson (CAA),15,11-4,271,125,396,0.684,05/11/2019,2019.0
5,Holy Cross (Patriot),14,7-7,213,121,334,0.638,05/11/2019,2019.0
6,Penn (Ivy League),15,12-3,276,159,435,0.634,05/11/2019,2019.0
7,Cleveland St. (DI Independent),15,8-7,239,140,379,0.631,05/11/2019,2019.0
8,Marist (MAAC),17,10-7,252,151,403,0.625,05/11/2019,2019.0
9,Air Force (SoCon),15,10-5,211,128,339,0.622,05/11/2019,2019.0
10,Ohio St. (Big Ten),12,8-4,190,117,307,0.619,05/11/2019,2019.0
11,Saint Joseph's (NEC),14,7-7,207,129,336,0.616,05/11/2019,2019.0
12,Hobart (NEC),16,11-5,279,176,455,0.613,05/11/2019,2019.0
13,Massachusetts (CAA),15,10-5,229,147,376,0.609,05/11/2019,2019.0
14,Mercer (SoCon),13,1-12,229,149,378,0.606,05/11/2019,2019.0
15,UMass Lowell (America East),14,5-9,206,145,351,0.587,05/11/2019,2019.0
16,Notre Dame (ACC),14,8-6,197,139,336,0.586,05/11/2019,2019.0
17,Denver (Big East),15,10-5,219,155,374,0.586,05/11/2019,2019.0
18,Detroit Mercy (MAAC),15,8-7,223,158,381,0.585,05/11/2019,2019.0
19,Virginia (ACC),17,14-3,270,193,463,0.583,05/11/2019,2019.0
20,Penn St. (Big Ten),15,14-1,267,192,459,0.582,05/11/2019,2019.0
21,High Point (SoCon),16,13-3,268,195,463,0.579,05/11/2019,2019.0
22,Maryland (Big Ten),15,11-4,228,170,398,0.573,05/11/2019,2019.0
23,Drexel (CAA),15,7-8,248,189,437,0.568,05/11/2019,2019.0
24,Syracuse (ACC),14,9-5,207,159,366,0.566,05/11/2019,2019.0
25,Hofstra (CAA),14,5-9,173,137,310,0.558,05/11/2019,2019.0
26,Boston U. (Patriot),17,11-6,245,201,446,0.549,05/11/2019,2019.0
27,Johns Hopkins (Big Ten),15,8-7,231,190,421,0.549,05/11/2019,2019.0
28,Bryant (NEC),14,3-11,175,151,326,0.537,05/11/2019,2019.0
29,Loyola Maryland (Patriot),16,12-4,233,206,439,0.531,05/11/2019,2019.0
30,Mount St. Mary's (NEC),16,9-7,202,186,388,0.521,05/11/2019,2019.0
31,Duke (ACC),15,11-4,189,176,365,0.518,05/11/2019,2019.0
32,Brown (Ivy League),16,7-9,218,208,426,0.512,05/11/2019,2019.0
33,Vermont (America East),15,8-7,190,182,372,0.511,05/11/2019,2019.0
34,Quinnipiac (MAAC),16,9-7,223,217,440,0.507,05/11/2019,2019.0
35,Navy (Patriot),13,6-7,172,168,340,0.506,05/11/2019,2019.0
36,Villanova (Big East),15,8-7,196,197,393,0.499,05/11/2019,2019.0
37,Monmouth (MAAC),12,4-8,114,115,229,0.498,05/11/2019,2019.0
38,Stony Brook (America East),15,9-6,180,185,365,0.493,05/11/2019,2019.0
39,Providence (Big East),16,7-9,188,197,385,0.488,05/11/2019,2019.0
40,North Carolina (ACC),15,8-7,191,201,392,0.487,05/11/2019,2019.0
41,Canisius (MAAC),16,8-8,185,201,386,0.479,05/11/2019,2019.0
42,Marquette (Big East),14,6-8,172,188,360,0.478,05/11/2019,2019.0
43,Colgate (Patriot),13,4-9,145,159,304,0.477,05/11/2019,2019.0
44,Hartford (America East),15,4-11,200,225,425,0.471,05/11/2019,2019.0
45,Bucknell (Patriot),15,6-9,171,193,364,0.470,05/11/2019,2019.0
46,Fairfield (CAA),14,5-9,175,202,377,0.464,05/11/2019,2019.0
47,Georgetown (Big East),18,13-5,238,279,517,0.460,05/11/2019,2019.0
48,Robert Morris (NEC),17,9-8,238,282,520,0.458,05/11/2019,2019.0
49,Wagner (NEC),14,2-12,146,175,321,0.455,05/11/2019,2019.0
50,St. John's (NY) (Big East),14,4-10,171,207,378,0.452,05/11/2019,2019.0
51,Princeton (Ivy League),14,7-7,179,218,397,0.451,05/11/2019,2019.0
52,UAlbany (America East),14,5-9,157,201,358,0.439,05/11/2019,2019.0
53,Siena (MAAC),13,6-7,171,219,390,0.438,05/11/2019,2019.0
54,Manhattan (MAAC),14,6-8,130,172,302,0.430,05/11/2019,2019.0
55,Rutgers (Big Ten),15,7-8,168,225,393,0.427,05/11/2019,2019.0
56,Harvard (Ivy League),13,5-8,167,227,394,0.424,05/11/2019,2019.0
57,Binghamton (America East),13,2-11,133,183,316,0.421,05/11/2019,2019.0
58,UMBC (America East),15,7-8,169,235,404,0.418,05/11/2019,2019.0
59,Jacksonville (SoCon),15,6-9,172,241,413,0.416,05/11/2019,2019.0
60,Sacred Heart (NEC),15,9-6,176,254,430,0.409,05/11/2019,2019.0
61,Bellarmine (SoCon),13,3-10,145,212,357,0.406,05/11/2019,2019.0
62,NJIT (DI Independent),15,2-13,171,254,425,0.402,05/11/2019,2019.0
63,Cornell (Ivy League),15,10-5,171,274,445,0.384,05/11/2019,2019.0
64,Delaware (CAA),15,10-5,142,231,373,0.381,05/11/2019,2019.0
65,VMI (SoCon),13,4-9,136,222,358,0.380,05/11/2019,2019.0
66,Furman (SoCon),14,4-10,145,243,388,0.374,05/11/2019,2019.0
67,Richmond (SoCon),16,10-6,144,263,407,0.354,05/11/2019,2019.0
68,Army West Point (Patriot),18,13-5,138,283,421,0.328,05/11/2019,2019.0
69,Michigan (Big Ten),13,4-9,118,248,366,0.322,05/11/2019,2019.0
70,Utah (DI Independent),15,5-10,123,259,382,0.322,05/11/2019,2019.0
71,Dartmouth (Ivy League),13,2-11,93,215,308,0.302,05/11/2019,2019.0
72,Lafayette (Patriot),15,4-11,109,263,372,0.293,05/11/2019,2019.0
73,St. Bonaventure (MAAC),13,0-13,76,240,316,0.241,05/11/2019,2019.0
1,Yale (Ivy League),15,12-3,329,99,428,0.769,05/08/2019,2019.0
2,Hampton (DI Independent),11,6-5,221,101,322,0.686,05/08/2019,2019.0
3,Lehigh (Patriot),17,9-8,274,126,400,0.685,05/08/2019,2019.0
4,Towson (CAA),15,11-4,271,125,396,0.684,05/08/2019,2019.0
5,Holy Cross (Patriot),14,7-7,213,121,334,0.638,05/08/2019,2019.0
6,Cleveland St. (DI Independent),15,8-7,239,140,379,0.631,05/08/2019,2019.0
7,Marist (MAAC),17,10-7,252,151,403,0.625,05/08/2019,2019.0
8,Air Force (SoCon),15,10-5,211,128,339,0.622,05/08/2019,2019.0
9,Penn (Ivy League),14,11-3,254,156,410,0.620,05/08/2019,2019.0
10,Ohio St. (Big Ten),12,8-4,190,117,307,0.619,05/08/2019,2019.0
11,Saint Joseph's (NEC),14,7-7,207,129,336,0.616,05/08/2019,2019.0
12,Hobart (NEC),16,11-5,279,176,455,0.613,05/08/2019,2019.0
13,Massachusetts (CAA),15,10-5,229,147,376,0.609,05/08/2019,2019.0
14,Mercer (SoCon),13,1-12,229,149,378,0.606,05/08/2019,2019.0
15,UMass Lowell (America East),14,5-9,206,145,351,0.587,05/08/2019,2019.0
16,Notre Dame (ACC),14,8-6,197,139,336,0.586,05/08/2019,2019.0
17,Denver (Big East),15,10-5,219,155,374,0.586,05/08/2019,2019.0
18,Detroit Mercy (MAAC),15,8-7,223,158,381,0.585,05/08/2019,2019.0
19,Penn St. (Big Ten),15,14-1,267,192,459,0.582,05/08/2019,2019.0
20,Syracuse (ACC),13,9-4,194,141,335,0.579,05/08/2019,2019.0
21,High Point (SoCon),16,13-3,268,195,463,0.579,05/08/2019,2019.0
22,Maryland (Big Ten),15,11-4,228,170,398,0.573,05/08/2019,2019.0
23,Virginia (ACC),16,13-3,245,185,430,0.570,05/08/2019,2019.0
24,Drexel (CAA),15,7-8,248,189,437,0.568,05/08/2019,2019.0
25,Hofstra (CAA),14,5-9,173,137,310,0.558,05/08/2019,2019.0
26,Boston U. (Patriot),17,11-6,245,201,446,0.549,05/08/2019,2019.0
27,Johns Hopkins (Big Ten),15,8-7,231,190,421,0.549,05/08/2019,2019.0
28,Bryant (NEC),14,3-11,175,151,326,0.537,05/08/2019,2019.0
29,Loyola Maryland (Patriot),15,11-4,215,193,408,0.527,05/08/2019,2019.0
30,Mount St. Mary's (NEC),16,9-7,202,186,388,0.521,05/08/2019,2019.0
31,Duke (ACC),15,11-4,189,176,365,0.518,05/08/2019,2019.0
32,Brown (Ivy League),16,7-9,218,208,426,0.512,05/08/2019,2019.0
33,Vermont (America East),15,8-7,190,182,372,0.511,05/08/2019,2019.0
34,Quinnipiac (MAAC),16,9-7,223,217,440,0.507,05/08/2019,2019.0
35,Navy (Patriot),13,6-7,172,168,340,0.506,05/08/2019,2019.0
36,Villanova (Big East),15,8-7,196,197,393,0.499,05/08/2019,2019.0
37,Monmouth (MAAC),12,4-8,114,115,229,0.498,05/08/2019,2019.0
38,Stony Brook (America East),15,9-6,180,185,365,0.493,05/08/2019,2019.0
39,Providence (Big East),16,7-9,188,197,385,0.488,05/08/2019,2019.0
40,Georgetown (Big East),17,13-4,233,245,478,0.487,05/08/2019,2019.0
41,North Carolina (ACC),15,8-7,191,201,392,0.487,05/08/2019,2019.0
42,Canisius (MAAC),16,8-8,185,201,386,0.479,05/08/2019,2019.0
43,Marquette (Big East),14,6-8,172,188,360,0.478,05/08/2019,2019.0
44,Colgate (Patriot),13,4-9,145,159,304,0.477,05/08/2019,2019.0
45,Robert Morris (NEC),16,9-7,230,257,487,0.472,05/08/2019,2019.0
46,Hartford (America East),15,4-11,200,225,425,0.471,05/08/2019,2019.0
47,Bucknell (Patriot),15,6-9,171,193,364,0.470,05/08/2019,2019.0
48,Fairfield (CAA),14,5-9,175,202,377,0.464,05/08/2019,2019.0
49,Wagner (NEC),14,2-12,146,175,321,0.455,05/08/2019,2019.0
50,St. John's (NY) (Big East),14,4-10,171,207,378,0.452,05/08/2019,2019.0
51,Princeton (Ivy League),14,7-7,179,218,397,0.451,05/08/2019,2019.0
52,UAlbany (America East),14,5-9,157,201,358,0.439,05/08/2019,2019.0
53,Siena (MAAC),13,6-7,171,219,390,0.438,05/08/2019,2019.0
54,Manhattan (MAAC),14,6-8,130,172,302,0.430,05/08/2019,2019.0
55,Rutgers (Big Ten),15,7-8,168,225,393,0.427,05/08/2019,2019.0
56,Harvard (Ivy League),13,5-8,167,227,394,0.424,05/08/2019,2019.0
57,Binghamton (America East),13,2-11,133,183,316,0.421,05/08/2019,2019.0
58,UMBC (America East),15,7-8,169,235,404,0.418,05/08/2019,2019.0
59,Jacksonville (SoCon),15,6-9,172,241,413,0.416,05/08/2019,2019.0
60,Sacred Heart (NEC),15,9-6,176,254,430,0.409,05/08/2019,2019.0
61,Bellarmine (SoCon),13,3-10,145,212,357,0.406,05/08/2019,2019.0
62,NJIT (DI Independent),15,2-13,171,254,425,0.402,05/08/2019,2019.0
63,Cornell (Ivy League),15,10-5,171,274,445,0.384,05/08/2019,2019.0
64,Delaware (CAA),15,10-5,142,231,373,0.381,05/08/2019,2019.0
65,VMI (SoCon),13,4-9,136,222,358,0.380,05/08/2019,2019.0
66,Furman (SoCon),14,4-10,145,243,388,0.374,05/08/2019,2019.0
67,Richmond (SoCon),16,10-6,144,263,407,0.354,05/08/2019,2019.0
68,Army West Point (Patriot),17,13-4,135,261,396,0.341,05/08/2019,2019.0
69,Michigan (Big Ten),13,4-9,118,248,366,0.322,05/08/2019,2019.0
70,Utah (DI Independent),15,5-10,123,259,382,0.322,05/08/2019,2019.0
71,Dartmouth (Ivy League),13,2-11,93,215,308,0.302,05/08/2019,2019.0
72,Lafayette (Patriot),15,4-11,109,263,372,0.293,05/08/2019,2019.0
73,St. Bonaventure (MAAC),13,0-13,76,240,316,0.241,05/08/2019,2019.0
1,Yale (Ivy League),15,12-3,329,99,428,0.769,05/05/2019,2019.0
2,Hampton (DI Independent),11,6-5,221,101,322,0.686,05/05/2019,2019.0
3,Lehigh (Patriot),17,9-8,274,126,400,0.685,05/05/2019,2019.0
4,Towson (CAA),15,11-4,271,125,396,0.684,05/05/2019,2019.0
5,Holy Cross (Patriot),14,7-7,213,121,334,0.638,05/05/2019,2019.0
6,Cleveland St. (DI Independent),15,8-7,239,140,379,0.631,05/05/2019,2019.0
7,Air Force (SoCon),15,10-5,211,128,339,0.622,05/05/2019,2019.0
8,Marist (MAAC),16,10-6,234,143,377,0.621,05/05/2019,2019.0
9,Penn (Ivy League),14,11-3,254,156,410,0.620,05/05/2019,2019.0
10,Ohio St. (Big Ten),12,8-4,190,117,307,0.619,05/05/2019,2019.0
11,Saint Joseph's (NEC),14,7-7,207,129,336,0.616,05/05/2019,2019.0
12,Hobart (NEC),16,11-5,279,176,455,0.613,05/05/2019,2019.0
13,Massachusetts (CAA),15,10-5,229,147,376,0.609,05/05/2019,2019.0
14,Mercer (SoCon),13,1-12,229,149,378,0.606,05/05/2019,2019.0
15,UMass Lowell (America East),14,5-9,206,145,351,0.587,05/05/2019,2019.0
16,Notre Dame (ACC),14,8-6,197,139,336,0.586,05/05/2019,2019.0
17,Denver (Big East),15,10-5,219,155,374,0.586,05/05/2019,2019.0
18,Detroit Mercy (MAAC),15,8-7,223,158,381,0.585,05/05/2019,2019.0
19,Penn St. (Big Ten),15,14-1,267,192,459,0.582,05/05/2019,2019.0
20,Syracuse (ACC),13,9-4,194,141,335,0.579,05/05/2019,2019.0
21,High Point (SoCon),16,13-3,268,195,463,0.579,05/05/2019,2019.0
22,Maryland (Big Ten),15,11-4,228,170,398,0.573,05/05/2019,2019.0
23,Virginia (ACC),16,13-3,245,185,430,0.570,05/05/2019,2019.0
24,Drexel (CAA),15,7-8,248,189,437,0.568,05/05/2019,2019.0
25,Hofstra (CAA),14,5-9,173,137,310,0.558,05/05/2019,2019.0
26,Boston U. (Patriot),17,11-6,245,201,446,0.549,05/05/2019,2019.0
27,Johns Hopkins (Big Ten),15,8-7,231,190,421,0.549,05/05/2019,2019.0
28,Bryant (NEC),14,3-11,175,151,326,0.537,05/05/2019,2019.0
29,Loyola Maryland (Patriot),15,11-4,215,193,408,0.527,05/05/2019,2019.0
30,Mount St. Mary's (NEC),16,9-7,202,186,388,0.521,05/05/2019,2019.0
31,Duke (ACC),15,11-4,189,176,365,0.518,05/05/2019,2019.0
32,Brown (Ivy League),16,7-9,218,208,426,0.512,05/05/2019,2019.0
33,Vermont (America East),15,8-7,190,182,372,0.511,05/05/2019,2019.0
34,Quinnipiac (MAAC),16,9-7,223,217,440,0.507,05/05/2019,2019.0
35,Navy (Patriot),13,6-7,172,168,340,0.506,05/05/2019,2019.0
36,Villanova (Big East),15,8-7,196,197,393,0.499,05/05/2019,2019.0
37,Monmouth (MAAC),12,4-8,114,115,229,0.498,05/05/2019,2019.0
38,Stony Brook (America East),15,9-6,180,185,365,0.493,05/05/2019,2019.0
39,Providence (Big East),16,7-9,188,197,385,0.488,05/05/2019,2019.0
40,Georgetown (Big East),17,13-4,233,245,478,0.487,05/05/2019,2019.0
41,North Carolina (ACC),15,8-7,191,201,392,0.487,05/05/2019,2019.0
42,Canisius (MAAC),16,8-8,185,201,386,0.479,05/05/2019,2019.0
43,Marquette (Big East),14,6-8,172,188,360,0.478,05/05/2019,2019.0
44,Colgate (Patriot),13,4-9,145,159,304,0.477,05/05/2019,2019.0
45,Robert Morris (NEC),16,9-7,230,257,487,0.472,05/05/2019,2019.0
46,Hartford (America East),15,4-11,200,225,425,0.471,05/05/2019,2019.0
47,Bucknell (Patriot),15,6-9,171,193,364,0.470,05/05/2019,2019.0
48,Fairfield (CAA),14,5-9,175,202,377,0.464,05/05/2019,2019.0
49,Wagner (NEC),14,2-12,146,175,321,0.455,05/05/2019,2019.0
50,St. John's (NY) (Big East),14,4-10,171,207,378,0.452,05/05/2019,2019.0
51,Princeton (Ivy League),14,7-7,179,218,397,0.451,05/05/2019,2019.0
52,UAlbany (America East),14,5-9,157,201,358,0.439,05/05/2019,2019.0
53,Siena (MAAC),13,6-7,171,219,390,0.438,05/05/2019,2019.0
54,Manhattan (MAAC),14,6-8,130,172,302,0.430,05/05/2019,2019.0
55,Rutgers (Big Ten),15,7-8,168,225,393,0.427,05/05/2019,2019.0
56,UMBC (America East),14,6-8,161,217,378,0.426,05/05/2019,2019.0
57,Harvard (Ivy League),13,5-8,167,227,394,0.424,05/05/2019,2019.0
58,Binghamton (America East),13,2-11,133,183,316,0.421,05/05/2019,2019.0
59,Jacksonville (SoCon),15,6-9,172,241,413,0.416,05/05/2019,2019.0
60,Sacred Heart (NEC),15,9-6,176,254,430,0.409,05/05/2019,2019.0
61,Bellarmine (SoCon),13,3-10,145,212,357,0.406,05/05/2019,2019.0
62,NJIT (DI Independent),15,2-13,171,254,425,0.402,05/05/2019,2019.0
63,Cornell (Ivy League),15,10-5,171,274,445,0.384,05/05/2019,2019.0
64,Delaware (CAA),15,10-5,142,231,373,0.381,05/05/2019,2019.0
65,VMI (SoCon),13,4-9,136,222,358,0.380,05/05/2019,2019.0
66,Furman (SoCon),14,4-10,145,243,388,0.374,05/05/2019,2019.0
67,Richmond (SoCon),16,10-6,144,263,407,0.354,05/05/2019,2019.0
68,Army West Point (Patriot),17,13-4,135,261,396,0.341,05/05/2019,2019.0
69,Michigan (Big Ten),13,4-9,118,248,366,0.322,05/05/2019,2019.0
70,Utah (DI Independent),15,5-10,123,259,382,0.322,05/05/2019,2019.0
71,Dartmouth (Ivy League),13,2-11,93,215,308,0.302,05/05/2019,2019.0
72,Lafayette (Patriot),15,4-11,109,263,372,0.293,05/05/2019,2019.0
73,St. Bonaventure (MAAC),13,0-13,76,240,316,0.241,05/05/2019,2019.0
1,Yale (Ivy League),14,12-2,318,84,402,0.791,05/04/2019,2019.0
2,Hampton (DI Independent),11,6-5,221,101,322,0.686,05/04/2019,2019.0
3,Towson (CAA),15,11-4,271,125,396,0.684,05/04/2019,2019.0
4,Lehigh (Patriot),16,9-7,256,122,378,0.677,05/04/2019,2019.0
5,Holy Cross (Patriot),14,7-7,213,121,334,0.638,05/04/2019,2019.0
6,Cleveland St. (DI Independent),15,8-7,239,140,379,0.631,05/04/2019,2019.0
7,Air Force (SoCon),15,10-5,211,128,339,0.622,05/04/2019,2019.0
8,Penn (Ivy League),13,10-3,239,145,384,0.622,05/04/2019,2019.0
9,Marist (MAAC),16,10-6,234,143,377,0.621,05/04/2019,2019.0
10,Ohio St. (Big Ten),12,8-4,190,117,307,0.619,05/04/2019,2019.0
11,Saint Joseph's (NEC),14,7-7,207,129,336,0.616,05/04/2019,2019.0
12,Hobart (NEC),16,11-5,279,176,455,0.613,05/04/2019,2019.0
13,Massachusetts (CAA),15,10-5,229,147,376,0.609,05/04/2019,2019.0
14,Mercer (SoCon),13,1-12,229,149,378,0.606,05/04/2019,2019.0
15,UMass Lowell (America East),14,5-9,206,145,351,0.587,05/04/2019,2019.0
16,Notre Dame (ACC),14,8-6,197,139,336,0.586,05/04/2019,2019.0
17,Denver (Big East),15,10-5,219,155,374,0.586,05/04/2019,2019.0
18,Detroit Mercy (MAAC),15,8-7,223,158,381,0.585,05/04/2019,2019.0
19,Penn St. (Big Ten),15,14-1,267,192,459,0.582,05/04/2019,2019.0
20,Syracuse (ACC),13,9-4,194,141,335,0.579,05/04/2019,2019.0
21,High Point (SoCon),16,13-3,268,195,463,0.579,05/04/2019,2019.0
22,Maryland (Big Ten),15,11-4,228,170,398,0.573,05/04/2019,2019.0
23,Virginia (ACC),16,13-3,245,185,430,0.570,05/04/2019,2019.0
24,Drexel (CAA),15,7-8,248,189,437,0.568,05/04/2019,2019.0
25,Hofstra (CAA),14,5-9,173,137,310,0.558,05/04/2019,2019.0
26,Boston U. (Patriot),17,11-6,245,201,446,0.549,05/04/2019,2019.0
27,Johns Hopkins (Big Ten),15,8-7,231,190,421,0.549,05/04/2019,2019.0
28,Bryant (NEC),14,3-11,175,151,326,0.537,05/04/2019,2019.0
29,Loyola Maryland (Patriot),15,11-4,215,193,408,0.527,05/04/2019,2019.0
30,Mount St. Mary's (NEC),16,9-7,202,186,388,0.521,05/04/2019,2019.0
31,Duke (ACC),15,11-4,189,176,365,0.518,05/04/2019,2019.0
32,Brown (Ivy League),16,7-9,218,208,426,0.512,05/04/2019,2019.0
33,Vermont (America East),15,8-7,190,182,372,0.511,05/04/2019,2019.0
34,Quinnipiac (MAAC),16,9-7,223,217,440,0.507,05/04/2019,2019.0
35,Navy (Patriot),13,6-7,172,168,340,0.506,05/04/2019,2019.0
36,Villanova (Big East),15,8-7,196,197,393,0.499,05/04/2019,2019.0
37,Monmouth (MAAC),12,4-8,114,115,229,0.498,05/04/2019,2019.0
38,Stony Brook (America East),15,9-6,180,185,365,0.493,05/04/2019,2019.0
39,Providence (Big East),16,7-9,188,197,385,0.488,05/04/2019,2019.0
40,Georgetown (Big East),17,13-4,233,245,478,0.487,05/04/2019,2019.0
41,North Carolina (ACC),15,8-7,191,201,392,0.487,05/04/2019,2019.0
42,Canisius (MAAC),16,8-8,185,201,386,0.479,05/04/2019,2019.0
43,Marquette (Big East),14,6-8,172,188,360,0.478,05/04/2019,2019.0
44,Colgate (Patriot),13,4-9,145,159,304,0.477,05/04/2019,2019.0
45,Robert Morris (NEC),16,9-7,230,257,487,0.472,05/04/2019,2019.0
46,Hartford (America East),15,4-11,200,225,425,0.471,05/04/2019,2019.0
47,Bucknell (Patriot),15,6-9,171,193,364,0.470,05/04/2019,2019.0
48,Fairfield (CAA),14,5-9,175,202,377,0.464,05/04/2019,2019.0
49,Wagner (NEC),14,2-12,146,175,321,0.455,05/04/2019,2019.0
50,St. John's (NY) (Big East),14,4-10,171,207,378,0.452,05/04/2019,2019.0
51,Princeton (Ivy League),14,7-7,179,218,397,0.451,05/04/2019,2019.0
52,UAlbany (America East),14,5-9,157,201,358,0.439,05/04/2019,2019.0
53,Siena (MAAC),13,6-7,171,219,390,0.438,05/04/2019,2019.0
54,Manhattan (MAAC),14,6-8,130,172,302,0.430,05/04/2019,2019.0
55,Rutgers (Big Ten),15,7-8,168,225,393,0.427,05/04/2019,2019.0
56,UMBC (America East),14,6-8,161,217,378,0.426,05/04/2019,2019.0
57,Harvard (Ivy League),13,5-8,167,227,394,0.424,05/04/2019,2019.0
58,Binghamton (America East),13,2-11,133,183,316,0.421,05/04/2019,2019.0
59,Jacksonville (SoCon),15,6-9,172,241,413,0.416,05/04/2019,2019.0
60,Sacred Heart (NEC),15,9-6,176,254,430,0.409,05/04/2019,2019.0
61,Bellarmine (SoCon),13,3-10,145,212,357,0.406,05/04/2019,2019.0
62,NJIT (DI Independent),15,2-13,171,254,425,0.402,05/04/2019,2019.0
63,Cornell (Ivy League),15,10-5,171,274,445,0.384,05/04/2019,2019.0
64,Delaware (CAA),15,10-5,142,231,373,0.381,05/04/2019,2019.0
65,VMI (SoCon),13,4-9,136,222,358,0.380,05/04/2019,2019.0
66,Furman (SoCon),14,4-10,145,243,388,0.374,05/04/2019,2019.0
67,Richmond (SoCon),16,10-6,144,263,407,0.354,05/04/2019,2019.0
68,Army West Point (Patriot),16,12-4,131,243,374,0.350,05/04/2019,2019.0
69,Michigan (Big Ten),13,4-9,118,248,366,0.322,05/04/2019,2019.0
70,Utah (DI Independent),15,5-10,123,259,382,0.322,05/04/2019,2019.0
71,Dartmouth (Ivy League),13,2-11,93,215,308,0.302,05/04/2019,2019.0
72,Lafayette (Patriot),15,4-11,109,263,372,0.293,05/04/2019,2019.0
73,St. Bonaventure (MAAC),13,0-13,76,240,316,0.241,05/04/2019,2019.0
1,Yale (Ivy League),14,12-2,318,84,402,0.791,05/03/2019,2019.0
2,Towson (CAA),14,10-4,261,102,363,0.719,05/03/2019,2019.0
3,Hampton (DI Independent),11,6-5,221,101,322,0.686,05/03/2019,2019.0
4,Lehigh (Patriot),16,9-7,256,122,378,0.677,05/03/2019,2019.0
5,Holy Cross (Patriot),14,7-7,213,121,334,0.638,05/03/2019,2019.0
6,Marist (MAAC),15,9-6,218,127,345,0.632,05/03/2019,2019.0
7,Cleveland St. (DI Independent),15,8-7,239,140,379,0.631,05/03/2019,2019.0
8,Air Force (SoCon),15,10-5,211,128,339,0.622,05/03/2019,2019.0
9,Penn (Ivy League),13,10-3,239,145,384,0.622,05/03/2019,2019.0
10,Hobart (NEC),15,11-4,267,164,431,0.619,05/03/2019,2019.0
11,Ohio St. (Big Ten),12,8-4,190,117,307,0.619,05/03/2019,2019.0
12,Saint Joseph's (NEC),14,7-7,207,129,336,0.616,05/03/2019,2019.0
13,Massachusetts (CAA),15,10-5,229,147,376,0.609,05/03/2019,2019.0
14,Mercer (SoCon),13,1-12,229,149,378,0.606,05/03/2019,2019.0
15,Penn St. (Big Ten),14,13-1,250,172,422,0.592,05/03/2019,2019.0
16,Notre Dame (ACC),13,8-5,188,130,318,0.591,05/03/2019,2019.0
17,Denver (Big East),14,10-4,206,143,349,0.590,05/03/2019,2019.0
18,UMass Lowell (America East),14,5-9,206,145,351,0.587,05/03/2019,2019.0
19,Detroit Mercy (MAAC),15,8-7,223,158,381,0.585,05/03/2019,2019.0
20,Syracuse (ACC),13,9-4,194,141,335,0.579,05/03/2019,2019.0
21,Maryland (Big Ten),15,11-4,228,170,398,0.573,05/03/2019,2019.0
22,Virginia (ACC),15,12-3,236,176,412,0.573,05/03/2019,2019.0
23,High Point (SoCon),15,13-2,250,187,437,0.572,05/03/2019,2019.0
24,Hofstra (CAA),14,5-9,173,137,310,0.558,05/03/2019,2019.0
25,Drexel (CAA),14,7-7,225,179,404,0.557,05/03/2019,2019.0
26,Johns Hopkins (Big Ten),14,8-6,211,173,384,0.549,05/03/2019,2019.0
27,Boston U. (Patriot),17,11-6,245,201,446,0.549,05/03/2019,2019.0
28,Bryant (NEC),14,3-11,175,151,326,0.537,05/03/2019,2019.0
29,Loyola Maryland (Patriot),15,11-4,215,193,408,0.527,05/03/2019,2019.0
30,Mount St. Mary's (NEC),16,9-7,202,186,388,0.521,05/03/2019,2019.0
31,Duke (ACC),15,11-4,189,176,365,0.518,05/03/2019,2019.0
32,Brown (Ivy League),16,7-9,218,208,426,0.512,05/03/2019,2019.0
33,Quinnipiac (MAAC),15,9-6,207,201,408,0.507,05/03/2019,2019.0
34,Navy (Patriot),13,6-7,172,168,340,0.506,05/03/2019,2019.0
35,Vermont (America East),14,8-6,174,170,344,0.506,05/03/2019,2019.0
36,Villanova (Big East),15,8-7,196,197,393,0.499,05/03/2019,2019.0
37,Monmouth (MAAC),12,4-8,114,115,229,0.498,05/03/2019,2019.0
38,Stony Brook (America East),15,9-6,180,185,365,0.493,05/03/2019,2019.0
39,Providence (Big East),16,7-9,188,197,385,0.488,05/03/2019,2019.0
40,Georgetown (Big East),16,12-4,221,232,453,0.488,05/03/2019,2019.0
41,North Carolina (ACC),15,8-7,191,201,392,0.487,05/03/2019,2019.0
42,Canisius (MAAC),16,8-8,185,201,386,0.479,05/03/2019,2019.0
43,Marquette (Big East),14,6-8,172,188,360,0.478,05/03/2019,2019.0
44,Colgate (Patriot),13,4-9,145,159,304,0.477,05/03/2019,2019.0
45,Robert Morris (NEC),15,8-7,218,245,463,0.471,05/03/2019,2019.0
46,Hartford (America East),15,4-11,200,225,425,0.471,05/03/2019,2019.0
47,Bucknell (Patriot),15,6-9,171,193,364,0.470,05/03/2019,2019.0
48,Fairfield (CAA),14,5-9,175,202,377,0.464,05/03/2019,2019.0
49,Wagner (NEC),14,2-12,146,175,321,0.455,05/03/2019,2019.0
50,St. John's (NY) (Big East),14,4-10,171,207,378,0.452,05/03/2019,2019.0
51,Princeton (Ivy League),14,7-7,179,218,397,0.451,05/03/2019,2019.0
52,UAlbany (America East),14,5-9,157,201,358,0.439,05/03/2019,2019.0
53,Siena (MAAC),13,6-7,171,219,390,0.438,05/03/2019,2019.0
54,Manhattan (MAAC),14,6-8,130,172,302,0.430,05/03/2019,2019.0
55,Rutgers (Big Ten),15,7-8,168,225,393,0.427,05/03/2019,2019.0
56,UMBC (America East),13,5-8,149,201,350,0.426,05/03/2019,2019.0
57,Harvard (Ivy League),13,5-8,167,227,394,0.424,05/03/2019,2019.0
58,Binghamton (America East),13,2-11,133,183,316,0.421,05/03/2019,2019.0
59,Jacksonville (SoCon),15,6-9,172,241,413,0.416,05/03/2019,2019.0
60,Sacred Heart (NEC),15,9-6,176,254,430,0.409,05/03/2019,2019.0
61,Bellarmine (SoCon),13,3-10,145,212,357,0.406,05/03/2019,2019.0
62,NJIT (DI Independent),15,2-13,171,254,425,0.402,05/03/2019,2019.0
63,Cornell (Ivy League),15,10-5,171,274,445,0.384,05/03/2019,2019.0
64,Delaware (CAA),15,10-5,142,231,373,0.381,05/03/2019,2019.0
65,VMI (SoCon),13,4-9,136,222,358,0.380,05/03/2019,2019.0
66,Furman (SoCon),14,4-10,145,243,388,0.374,05/03/2019,2019.0
67,Richmond (SoCon),15,9-6,136,245,381,0.357,05/03/2019,2019.0
68,Army West Point (Patriot),16,12-4,131,243,374,0.350,05/03/2019,2019.0
69,Michigan (Big Ten),13,4-9,118,248,366,0.322,05/03/2019,2019.0
70,Utah (DI Independent),15,5-10,123,259,382,0.322,05/03/2019,2019.0
71,Dartmouth (Ivy League),13,2-11,93,215,308,0.302,05/03/2019,2019.0
72,Lafayette (Patriot),15,4-11,109,263,372,0.293,05/03/2019,2019.0
73,St. Bonaventure (MAAC),13,0-13,76,240,316,0.241,05/03/2019,2019.0
1,Yale (Ivy League),13,11-2,297,77,374,0.794,05/02/2019,2019.0
2,Towson (CAA),14,10-4,261,102,363,0.719,05/02/2019,2019.0
3,Hampton (DI Independent),11,6-5,221,101,322,0.686,05/02/2019,2019.0
4,Lehigh (Patriot),15,8-7,241,115,356,0.677,05/02/2019,2019.0
5,Holy Cross (Patriot),14,7-7,213,121,334,0.638,05/02/2019,2019.0
6,Marist (MAAC),15,9-6,218,127,345,0.632,05/02/2019,2019.0
7,Penn (Ivy League),12,9-3,224,131,355,0.631,05/02/2019,2019.0
8,Cleveland St. (DI Independent),15,8-7,239,140,379,0.631,05/02/2019,2019.0
9,Air Force (SoCon),15,10-5,211,128,339,0.622,05/02/2019,2019.0
10,Hobart (NEC),15,11-4,267,164,431,0.619,05/02/2019,2019.0
11,Ohio St. (Big Ten),12,8-4,190,117,307,0.619,05/02/2019,2019.0
12,Saint Joseph's (NEC),14,7-7,207,129,336,0.616,05/02/2019,2019.0
13,Massachusetts (CAA),15,10-5,229,147,376,0.609,05/02/2019,2019.0
14,Mercer (SoCon),13,1-12,229,149,378,0.606,05/02/2019,2019.0
15,Penn St. (Big Ten),14,13-1,250,172,422,0.592,05/02/2019,2019.0
16,Notre Dame (ACC),13,8-5,188,130,318,0.591,05/02/2019,2019.0
17,Denver (Big East),14,10-4,206,143,349,0.590,05/02/2019,2019.0
18,UMass Lowell (America East),14,5-9,206,145,351,0.587,05/02/2019,2019.0
19,Detroit Mercy (MAAC),15,8-7,223,158,381,0.585,05/02/2019,2019.0
20,Syracuse (ACC),13,9-4,194,141,335,0.579,05/02/2019,2019.0
21,Maryland (Big Ten),15,11-4,228,170,398,0.573,05/02/2019,2019.0
22,Virginia (ACC),15,12-3,236,176,412,0.573,05/02/2019,2019.0
23,High Point (SoCon),15,13-2,250,187,437,0.572,05/02/2019,2019.0
24,Boston U. (Patriot),16,11-5,238,186,424,0.561,05/02/2019,2019.0
25,Hofstra (CAA),14,5-9,173,137,310,0.558,05/02/2019,2019.0
26,Drexel (CAA),14,7-7,225,179,404,0.557,05/02/2019,2019.0
27,Johns Hopkins (Big Ten),14,8-6,211,173,384,0.549,05/02/2019,2019.0
28,Bryant (NEC),14,3-11,175,151,326,0.537,05/02/2019,2019.0
29,Mount St. Mary's (NEC),16,9-7,202,186,388,0.521,05/02/2019,2019.0
30,Loyola Maryland (Patriot),14,11-3,204,188,392,0.520,05/02/2019,2019.0
31,Duke (ACC),15,11-4,189,176,365,0.518,05/02/2019,2019.0
32,Brown (Ivy League),15,7-8,204,193,397,0.514,05/02/2019,2019.0
33,Quinnipiac (MAAC),15,9-6,207,201,408,0.507,05/02/2019,2019.0
34,Navy (Patriot),13,6-7,172,168,340,0.506,05/02/2019,2019.0
35,Vermont (America East),14,8-6,174,170,344,0.506,05/02/2019,2019.0
36,Villanova (Big East),15,8-7,196,197,393,0.499,05/02/2019,2019.0
37,Monmouth (MAAC),12,4-8,114,115,229,0.498,05/02/2019,2019.0
38,Stony Brook (America East),15,9-6,180,185,365,0.493,05/02/2019,2019.0
39,Providence (Big East),16,7-9,188,197,385,0.488,05/02/2019,2019.0
40,Georgetown (Big East),16,12-4,221,232,453,0.488,05/02/2019,2019.0
41,North Carolina (ACC),15,8-7,191,201,392,0.487,05/02/2019,2019.0
42,Canisius (MAAC),16,8-8,185,201,386,0.479,05/02/2019,2019.0
43,Marquette (Big East),14,6-8,172,188,360,0.478,05/02/2019,2019.0
44,Colgate (Patriot),13,4-9,145,159,304,0.477,05/02/2019,2019.0
45,Robert Morris (NEC),15,8-7,218,245,463,0.471,05/02/2019,2019.0
46,Hartford (America East),15,4-11,200,225,425,0.471,05/02/2019,2019.0
47,Bucknell (Patriot),15,6-9,171,193,364,0.470,05/02/2019,2019.0
48,Fairfield (CAA),14,5-9,175,202,377,0.464,05/02/2019,2019.0
49,Wagner (NEC),14,2-12,146,175,321,0.455,05/02/2019,2019.0
50,St. John's (NY) (Big East),14,4-10,171,207,378,0.452,05/02/2019,2019.0
51,Princeton (Ivy League),14,7-7,179,218,397,0.451,05/02/2019,2019.0
52,UAlbany (America East),14,5-9,157,201,358,0.439,05/02/2019,2019.0
53,Siena (MAAC),13,6-7,171,219,390,0.438,05/02/2019,2019.0
54,Manhattan (MAAC),14,6-8,130,172,302,0.430,05/02/2019,2019.0
55,Rutgers (Big Ten),15,7-8,168,225,393,0.427,05/02/2019,2019.0
56,UMBC (America East),13,5-8,149,201,350,0.426,05/02/2019,2019.0
57,Harvard (Ivy League),13,5-8,167,227,394,0.424,05/02/2019,2019.0
58,Binghamton (America East),13,2-11,133,183,316,0.421,05/02/2019,2019.0
59,Jacksonville (SoCon),15,6-9,172,241,413,0.416,05/02/2019,2019.0
60,Sacred Heart (NEC),15,9-6,176,254,430,0.409,05/02/2019,2019.0
61,Bellarmine (SoCon),13,3-10,145,212,357,0.406,05/02/2019,2019.0
62,NJIT (DI Independent),15,2-13,171,254,425,0.402,05/02/2019,2019.0
63,Cornell (Ivy League),14,10-4,164,253,417,0.393,05/02/2019,2019.0
64,Delaware (CAA),15,10-5,142,231,373,0.381,05/02/2019,2019.0
65,VMI (SoCon),13,4-9,136,222,358,0.380,05/02/2019,2019.0
66,Furman (SoCon),14,4-10,145,243,388,0.374,05/02/2019,2019.0
67,Richmond (SoCon),15,9-6,136,245,381,0.357,05/02/2019,2019.0
68,Army West Point (Patriot),15,11-4,126,232,358,0.352,05/02/2019,2019.0
69,Michigan (Big Ten),13,4-9,118,248,366,0.322,05/02/2019,2019.0
70,Utah (DI Independent),15,5-10,123,259,382,0.322,05/02/2019,2019.0
71,Dartmouth (Ivy League),13,2-11,93,215,308,0.302,05/02/2019,2019.0
72,Lafayette (Patriot),15,4-11,109,263,372,0.293,05/02/2019,2019.0
73,St. Bonaventure (MAAC),13,0-13,76,240,316,0.241,05/02/2019,2019.0
1,Yale (Ivy League),13,11-2,297,77,374,0.794,04/30/2019,2019.0
2,Towson (CAA),13,9-4,233,98,331,0.704,04/30/2019,2019.0
3,Hampton (DI Independent),11,6-5,221,101,322,0.686,04/30/2019,2019.0
4,Lehigh (Patriot),15,8-7,241,115,356,0.677,04/30/2019,2019.0
5,Marist (MAAC),14,8-6,205,115,320,0.641,04/30/2019,2019.0
6,Holy Cross (Patriot),14,7-7,213,121,334,0.638,04/30/2019,2019.0
7,Penn (Ivy League),12,9-3,224,131,355,0.631,04/30/2019,2019.0
8,Cleveland St. (DI Independent),15,8-7,239,140,379,0.631,04/30/2019,2019.0
9,Ohio St. (Big Ten),12,8-4,190,117,307,0.619,04/30/2019,2019.0
10,Saint Joseph's (NEC),14,7-7,207,129,336,0.616,04/30/2019,2019.0
11,Massachusetts (CAA),14,10-4,213,133,346,0.616,04/30/2019,2019.0
12,Hobart (NEC),14,10-4,245,155,400,0.613,04/30/2019,2019.0
13,Air Force (SoCon),14,10-4,197,125,322,0.612,04/30/2019,2019.0
14,Mercer (SoCon),13,1-12,229,149,378,0.606,04/30/2019,2019.0
15,Denver (Big East),13,9-4,190,127,317,0.599,04/30/2019,2019.0
16,Penn St. (Big Ten),13,12-1,235,162,397,0.592,04/30/2019,2019.0
17,Notre Dame (ACC),13,8-5,188,130,318,0.591,04/30/2019,2019.0
18,UMass Lowell (America East),14,5-9,206,145,351,0.587,04/30/2019,2019.0
19,Syracuse (ACC),13,9-4,194,141,335,0.579,04/30/2019,2019.0
20,Detroit Mercy (MAAC),14,8-6,202,148,350,0.577,04/30/2019,2019.0
21,High Point (SoCon),14,12-2,238,176,414,0.575,04/30/2019,2019.0
22,Virginia (ACC),15,12-3,236,176,412,0.573,04/30/2019,2019.0
23,Maryland (Big Ten),14,11-3,214,161,375,0.571,04/30/2019,2019.0
24,Drexel (CAA),13,6-7,211,163,374,0.564,04/30/2019,2019.0
25,Boston U. (Patriot),16,11-5,238,186,424,0.561,04/30/2019,2019.0
26,Johns Hopkins (Big Ten),13,7-6,202,159,361,0.560,04/30/2019,2019.0
27,Hofstra (CAA),14,5-9,173,137,310,0.558,04/30/2019,2019.0
28,Bryant (NEC),14,3-11,175,151,326,0.537,04/30/2019,2019.0
29,Quinnipiac (MAAC),14,8-6,197,180,377,0.523,04/30/2019,2019.0
30,Loyola Maryland (Patriot),14,11-3,204,188,392,0.520,04/30/2019,2019.0
31,Duke (ACC),15,11-4,189,176,365,0.518,04/30/2019,2019.0
32,Mount St. Mary's (NEC),15,9-6,185,174,359,0.515,04/30/2019,2019.0
33,Brown (Ivy League),15,7-8,204,193,397,0.514,04/30/2019,2019.0
34,Navy (Patriot),13,6-7,172,168,340,0.506,04/30/2019,2019.0
35,Villanova (Big East),14,8-6,180,181,361,0.499,04/30/2019,2019.0
36,Monmouth (MAAC),12,4-8,114,115,229,0.498,04/30/2019,2019.0
37,Vermont (America East),13,7-6,158,161,319,0.495,04/30/2019,2019.0
38,Georgetown (Big East),15,11-4,208,217,425,0.489,04/30/2019,2019.0
39,Stony Brook (America East),14,9-5,167,175,342,0.488,04/30/2019,2019.0
40,North Carolina (ACC),15,8-7,191,201,392,0.487,04/30/2019,2019.0
41,Providence (Big East),15,7-8,173,184,357,0.485,04/30/2019,2019.0
42,Canisius (MAAC),15,8-7,173,188,361,0.479,04/30/2019,2019.0
43,Marquette (Big East),14,6-8,172,188,360,0.478,04/30/2019,2019.0
44,Colgate (Patriot),13,4-9,145,159,304,0.477,04/30/2019,2019.0
45,Robert Morris (NEC),14,7-7,206,228,434,0.475,04/30/2019,2019.0
46,Hartford (America East),15,4-11,200,225,425,0.471,04/30/2019,2019.0
47,Bucknell (Patriot),15,6-9,171,193,364,0.470,04/30/2019,2019.0
48,Fairfield (CAA),14,5-9,175,202,377,0.464,04/30/2019,2019.0
49,Wagner (NEC),14,2-12,146,175,321,0.455,04/30/2019,2019.0
50,St. John's (NY) (Big East),14,4-10,171,207,378,0.452,04/30/2019,2019.0
51,Princeton (Ivy League),14,7-7,179,218,397,0.451,04/30/2019,2019.0
52,UAlbany (America East),13,5-8,148,185,333,0.444,04/30/2019,2019.0
53,Siena (MAAC),13,6-7,171,219,390,0.438,04/30/2019,2019.0
54,Manhattan (MAAC),14,6-8,130,172,302,0.430,04/30/2019,2019.0
55,Rutgers (Big Ten),14,7-7,158,210,368,0.429,04/30/2019,2019.0
56,UMBC (America East),12,4-8,139,188,327,0.425,04/30/2019,2019.0
57,Harvard (Ivy League),13,5-8,167,227,394,0.424,04/30/2019,2019.0
58,Binghamton (America East),13,2-11,133,183,316,0.421,04/30/2019,2019.0
59,Sacred Heart (NEC),14,9-5,167,232,399,0.419,04/30/2019,2019.0
60,Jacksonville (SoCon),14,6-8,161,229,390,0.413,04/30/2019,2019.0
61,Bellarmine (SoCon),13,3-10,145,212,357,0.406,04/30/2019,2019.0
62,Delaware (CAA),14,10-4,138,203,341,0.405,04/30/2019,2019.0
63,NJIT (DI Independent),15,2-13,171,254,425,0.402,04/30/2019,2019.0
64,Cornell (Ivy League),14,10-4,164,253,417,0.393,04/30/2019,2019.0
65,VMI (SoCon),13,4-9,136,222,358,0.380,04/30/2019,2019.0
66,Furman (SoCon),14,4-10,145,243,388,0.374,04/30/2019,2019.0
67,Richmond (SoCon),14,8-6,133,231,364,0.365,04/30/2019,2019.0
68,Army West Point (Patriot),15,11-4,126,232,358,0.352,04/30/2019,2019.0
69,Michigan (Big Ten),13,4-9,118,248,366,0.322,04/30/2019,2019.0
70,Utah (DI Independent),15,5-10,123,259,382,0.322,04/30/2019,2019.0
71,Dartmouth (Ivy League),13,2-11,93,215,308,0.302,04/30/2019,2019.0
72,Lafayette (Patriot),15,4-11,109,263,372,0.293,04/30/2019,2019.0
73,St. Bonaventure (MAAC),13,0-13,76,240,316,0.241,04/30/2019,2019.0
1,Yale (Ivy League),13,11-2,297,77,374,0.794,04/27/2019,2019.0
2,Towson (CAA),13,9-4,233,98,331,0.704,04/27/2019,2019.0
3,Hampton (DI Independent),11,6-5,221,101,322,0.686,04/27/2019,2019.0
4,Lehigh (Patriot),15,8-7,241,115,356,0.677,04/27/2019,2019.0
5,Marist (MAAC),14,8-6,205,115,320,0.641,04/27/2019,2019.0
6,Penn (Ivy League),12,9-3,224,131,355,0.631,04/27/2019,2019.0
7,Cleveland St. (DI Independent),15,8-7,239,140,379,0.631,04/27/2019,2019.0
8,Holy Cross (Patriot),13,7-6,193,118,311,0.621,04/27/2019,2019.0
9,Ohio St. (Big Ten),12,8-4,190,117,307,0.619,04/27/2019,2019.0
10,Saint Joseph's (NEC),14,7-7,207,129,336,0.616,04/27/2019,2019.0
11,Massachusetts (CAA),14,10-4,213,133,346,0.616,04/27/2019,2019.0
12,Hobart (NEC),14,10-4,245,155,400,0.613,04/27/2019,2019.0
13,Air Force (SoCon),14,10-4,197,125,322,0.612,04/27/2019,2019.0
14,Mercer (SoCon),13,1-12,229,149,378,0.606,04/27/2019,2019.0
15,Denver (Big East),13,9-4,190,127,317,0.599,04/27/2019,2019.0
16,Penn St. (Big Ten),13,12-1,235,162,397,0.592,04/27/2019,2019.0
17,Notre Dame (ACC),13,8-5,188,130,318,0.591,04/27/2019,2019.0
18,UMass Lowell (America East),14,5-9,206,145,351,0.587,04/27/2019,2019.0
19,Syracuse (ACC),13,9-4,194,141,335,0.579,04/27/2019,2019.0
20,Detroit Mercy (MAAC),14,8-6,202,148,350,0.577,04/27/2019,2019.0
21,High Point (SoCon),14,12-2,238,176,414,0.575,04/27/2019,2019.0
22,Virginia (ACC),15,12-3,236,176,412,0.573,04/27/2019,2019.0
23,Maryland (Big Ten),14,11-3,214,161,375,0.571,04/27/2019,2019.0
24,Drexel (CAA),13,6-7,211,163,374,0.564,04/27/2019,2019.0
25,Boston U. (Patriot),15,10-5,223,175,398,0.560,04/27/2019,2019.0
26,Johns Hopkins (Big Ten),13,7-6,202,159,361,0.560,04/27/2019,2019.0
27,Hofstra (CAA),14,5-9,173,137,310,0.558,04/27/2019,2019.0
28,Bryant (NEC),14,3-11,175,151,326,0.537,04/27/2019,2019.0
29,Quinnipiac (MAAC),14,8-6,197,180,377,0.523,04/27/2019,2019.0
30,Loyola Maryland (Patriot),14,11-3,204,188,392,0.520,04/27/2019,2019.0
31,Duke (ACC),15,11-4,189,176,365,0.518,04/27/2019,2019.0
32,Mount St. Mary's (NEC),15,9-6,185,174,359,0.515,04/27/2019,2019.0
33,Brown (Ivy League),15,7-8,204,193,397,0.514,04/27/2019,2019.0
34,Navy (Patriot),13,6-7,172,168,340,0.506,04/27/2019,2019.0
35,Villanova (Big East),14,8-6,180,181,361,0.499,04/27/2019,2019.0
36,Monmouth (MAAC),12,4-8,114,115,229,0.498,04/27/2019,2019.0
37,Vermont (America East),13,7-6,158,161,319,0.495,04/27/2019,2019.0
38,Georgetown (Big East),15,11-4,208,217,425,0.489,04/27/2019,2019.0
39,Stony Brook (America East),14,9-5,167,175,342,0.488,04/27/2019,2019.0
40,North Carolina (ACC),15,8-7,191,201,392,0.487,04/27/2019,2019.0
41,Providence (Big East),15,7-8,173,184,357,0.485,04/27/2019,2019.0
42,Canisius (MAAC),15,8-7,173,188,361,0.479,04/27/2019,2019.0
43,Marquette (Big East),14,6-8,172,188,360,0.478,04/27/2019,2019.0
44,Colgate (Patriot),13,4-9,145,159,304,0.477,04/27/2019,2019.0
45,Robert Morris (NEC),14,7-7,206,228,434,0.475,04/27/2019,2019.0
46,Bucknell (Patriot),14,6-8,160,178,338,0.473,04/27/2019,2019.0
47,Hartford (America East),15,4-11,200,225,425,0.471,04/27/2019,2019.0
48,Fairfield (CAA),14,5-9,175,202,377,0.464,04/27/2019,2019.0
49,Wagner (NEC),14,2-12,146,175,321,0.455,04/27/2019,2019.0
50,St. John's (NY) (Big East),14,4-10,171,207,378,0.452,04/27/2019,2019.0
51,Princeton (Ivy League),14,7-7,179,218,397,0.451,04/27/2019,2019.0
52,UAlbany (America East),13,5-8,148,185,333,0.444,04/27/2019,2019.0
53,Siena (MAAC),13,6-7,171,219,390,0.438,04/27/2019,2019.0
54,Manhattan (MAAC),14,6-8,130,172,302,0.430,04/27/2019,2019.0
55,Rutgers (Big Ten),14,7-7,158,210,368,0.429,04/27/2019,2019.0
56,UMBC (America East),12,4-8,139,188,327,0.425,04/27/2019,2019.0
57,Harvard (Ivy League),13,5-8,167,227,394,0.424,04/27/2019,2019.0
58,Binghamton (America East),13,2-11,133,183,316,0.421,04/27/2019,2019.0
59,Sacred Heart (NEC),14,9-5,167,232,399,0.419,04/27/2019,2019.0
60,Jacksonville (SoCon),14,6-8,161,229,390,0.413,04/27/2019,2019.0
61,Bellarmine (SoCon),13,3-10,145,212,357,0.406,04/27/2019,2019.0
62,Delaware (CAA),14,10-4,138,203,341,0.405,04/27/2019,2019.0
63,NJIT (DI Independent),15,2-13,171,254,425,0.402,04/27/2019,2019.0
64,Cornell (Ivy League),14,10-4,164,253,417,0.393,04/27/2019,2019.0
65,VMI (SoCon),13,4-9,136,222,358,0.380,04/27/2019,2019.0
66,Furman (SoCon),14,4-10,145,243,388,0.374,04/27/2019,2019.0
67,Army West Point (Patriot),14,10-4,123,212,335,0.367,04/27/2019,2019.0
68,Richmond (SoCon),14,8-6,133,231,364,0.365,04/27/2019,2019.0
69,Michigan (Big Ten),13,4-9,118,248,366,0.322,04/27/2019,2019.0
70,Utah (DI Independent),15,5-10,123,259,382,0.322,04/27/2019,2019.0
71,Dartmouth (Ivy League),13,2-11,93,215,308,0.302,04/27/2019,2019.0
72,Lafayette (Patriot),15,4-11,109,263,372,0.293,04/27/2019,2019.0
73,St. Bonaventure (MAAC),13,0-13,76,240,316,0.241,04/27/2019,2019.0
1,Yale (Ivy League),12,10-2,262,75,337,0.777,04/26/2019,2019.0
2,Towson (CAA),12,8-4,226,81,307,0.736,04/26/2019,2019.0
3,Lehigh (Patriot),15,8-7,241,115,356,0.677,04/26/2019,2019.0
4,Hampton (DI Independent),10,6-4,200,98,298,0.671,04/26/2019,2019.0
5,Marist (MAAC),14,8-6,205,115,320,0.641,04/26/2019,2019.0
6,Cleveland St. (DI Independent),15,8-7,239,140,379,0.631,04/26/2019,2019.0
7,Penn (Ivy League),11,8-3,206,125,331,0.622,04/26/2019,2019.0
8,Saint Joseph's (NEC),13,7-6,198,121,319,0.621,04/26/2019,2019.0
9,Holy Cross (Patriot),13,7-6,193,118,311,0.621,04/26/2019,2019.0
10,Ohio St. (Big Ten),12,8-4,190,117,307,0.619,04/26/2019,2019.0
11,Hobart (NEC),13,10-3,227,140,367,0.619,04/26/2019,2019.0
12,Massachusetts (CAA),14,10-4,213,133,346,0.616,04/26/2019,2019.0
13,Denver (Big East),13,9-4,190,127,317,0.599,04/26/2019,2019.0
14,Air Force (SoCon),13,9-4,179,120,299,0.599,04/26/2019,2019.0
15,Mercer (SoCon),12,1-11,203,139,342,0.594,04/26/2019,2019.0
16,Penn St. (Big Ten),12,11-1,217,151,368,0.590,04/26/2019,2019.0
17,Detroit Mercy (MAAC),13,8-5,189,133,322,0.587,04/26/2019,2019.0
18,UMass Lowell (America East),14,5-9,206,145,351,0.587,04/26/2019,2019.0
19,Notre Dame (ACC),12,7-5,171,121,292,0.586,04/26/2019,2019.0
20,Maryland (Big Ten),13,11-2,200,144,344,0.581,04/26/2019,2019.0
21,Syracuse (ACC),13,9-4,194,141,335,0.579,04/26/2019,2019.0
22,Virginia (ACC),14,11-3,221,162,383,0.577,04/26/2019,2019.0
23,Johns Hopkins (Big Ten),12,6-6,185,145,330,0.561,04/26/2019,2019.0
24,Boston U. (Patriot),15,10-5,223,175,398,0.560,04/26/2019,2019.0
25,Hofstra (CAA),14,5-9,173,137,310,0.558,04/26/2019,2019.0
26,High Point (SoCon),13,11-2,213,170,383,0.556,04/26/2019,2019.0
27,Drexel (CAA),12,6-6,194,156,350,0.554,04/26/2019,2019.0
28,Bryant (NEC),14,3-11,175,151,326,0.537,04/26/2019,2019.0
29,Duke (ACC),14,11-3,180,159,339,0.531,04/26/2019,2019.0
30,Loyola Maryland (Patriot),14,11-3,204,188,392,0.520,04/26/2019,2019.0
31,Mount St. Mary's (NEC),14,8-6,177,165,342,0.518,04/26/2019,2019.0
32,Monmouth (MAAC),11,3-8,107,100,207,0.517,04/26/2019,2019.0
33,Vermont (America East),12,7-5,152,143,295,0.515,04/26/2019,2019.0
34,Quinnipiac (MAAC),13,7-6,180,171,351,0.513,04/26/2019,2019.0
35,Navy (Patriot),13,6-7,172,168,340,0.506,04/26/2019,2019.0
36,Villanova (Big East),13,8-5,172,170,342,0.503,04/26/2019,2019.0
37,Brown (Ivy League),14,6-8,184,191,375,0.491,04/26/2019,2019.0
38,Stony Brook (America East),14,9-5,167,175,342,0.488,04/26/2019,2019.0
39,North Carolina (ACC),14,8-6,177,186,363,0.488,04/26/2019,2019.0
40,Georgetown (Big East),14,10-4,193,205,398,0.485,04/26/2019,2019.0
41,Providence (Big East),14,6-8,162,176,338,0.479,04/26/2019,2019.0
42,Canisius (MAAC),15,8-7,173,188,361,0.479,04/26/2019,2019.0
43,Marquette (Big East),14,6-8,172,188,360,0.478,04/26/2019,2019.0
44,Colgate (Patriot),13,4-9,145,159,304,0.477,04/26/2019,2019.0
45,Robert Morris (NEC),13,6-7,191,210,401,0.476,04/26/2019,2019.0
46,Bucknell (Patriot),14,6-8,160,178,338,0.473,04/26/2019,2019.0
47,Hartford (America East),14,4-10,188,214,402,0.468,04/26/2019,2019.0
48,Fairfield (CAA),14,5-9,175,202,377,0.464,04/26/2019,2019.0
49,Harvard (Ivy League),12,5-7,165,192,357,0.462,04/26/2019,2019.0
50,Princeton (Ivy League),13,7-6,169,199,368,0.459,04/26/2019,2019.0
51,Wagner (NEC),13,2-11,135,161,296,0.456,04/26/2019,2019.0
52,St. John's (NY) (Big East),13,4-9,159,192,351,0.453,04/26/2019,2019.0
53,UAlbany (America East),13,5-8,148,185,333,0.444,04/26/2019,2019.0
54,Manhattan (MAAC),13,6-7,121,155,276,0.438,04/26/2019,2019.0
55,Rutgers (Big Ten),13,7-6,147,192,339,0.434,04/26/2019,2019.0
56,Jacksonville (SoCon),13,5-8,151,203,354,0.427,04/26/2019,2019.0
57,Siena (MAAC),12,6-6,156,212,368,0.424,04/26/2019,2019.0
58,UMBC (America East),11,3-8,128,176,304,0.421,04/26/2019,2019.0
59,Binghamton (America East),13,2-11,133,183,316,0.421,04/26/2019,2019.0
60,Bellarmine (SoCon),12,3-9,140,194,334,0.419,04/26/2019,2019.0
61,Sacred Heart (NEC),13,8-5,153,221,374,0.409,04/26/2019,2019.0
62,Delaware (CAA),14,10-4,138,203,341,0.405,04/26/2019,2019.0
63,NJIT (DI Independent),15,2-13,171,254,425,0.402,04/26/2019,2019.0
64,Richmond (SoCon),13,8-5,127,206,333,0.381,04/26/2019,2019.0
65,Furman (SoCon),13,3-10,136,223,359,0.379,04/26/2019,2019.0
66,Cornell (Ivy League),13,9-4,145,243,388,0.374,04/26/2019,2019.0
67,Army West Point (Patriot),14,10-4,123,212,335,0.367,04/26/2019,2019.0
68,VMI (SoCon),12,4-8,116,213,329,0.353,04/26/2019,2019.0
69,Michigan (Big Ten),13,4-9,118,248,366,0.322,04/26/2019,2019.0
70,Dartmouth (Ivy League),12,2-10,91,195,286,0.318,04/26/2019,2019.0
71,Utah (DI Independent),14,4-10,108,246,354,0.305,04/26/2019,2019.0
72,Lafayette (Patriot),15,4-11,109,263,372,0.293,04/26/2019,2019.0
73,St. Bonaventure (MAAC),13,0-13,76,240,316,0.241,04/26/2019,2019.0
1,Yale (Ivy League),12,10-2,262,75,337,0.777,04/25/2019,2019.0
2,Towson (CAA),12,8-4,226,81,307,0.736,04/25/2019,2019.0
3,Lehigh (Patriot),14,8-6,227,106,333,0.682,04/25/2019,2019.0
4,Hampton (DI Independent),10,6-4,200,98,298,0.671,04/25/2019,2019.0
5,Holy Cross (Patriot),12,6-6,184,104,288,0.639,04/25/2019,2019.0
6,Cleveland St. (DI Independent),15,8-7,239,140,379,0.631,04/25/2019,2019.0
7,Marist (MAAC),13,7-6,188,111,299,0.629,04/25/2019,2019.0
8,Penn (Ivy League),11,8-3,206,125,331,0.622,04/25/2019,2019.0
9,Saint Joseph's (NEC),13,7-6,198,121,319,0.621,04/25/2019,2019.0
10,Hobart (NEC),13,10-3,227,140,367,0.619,04/25/2019,2019.0
11,Massachusetts (CAA),13,9-4,195,127,322,0.606,04/25/2019,2019.0
12,Air Force (SoCon),13,9-4,179,120,299,0.599,04/25/2019,2019.0
13,Mercer (SoCon),12,1-11,203,139,342,0.594,04/25/2019,2019.0
14,Denver (Big East),12,8-4,176,121,297,0.593,04/25/2019,2019.0
15,Ohio St. (Big Ten),11,8-3,166,115,281,0.591,04/25/2019,2019.0
16,Penn St. (Big Ten),12,11-1,217,151,368,0.590,04/25/2019,2019.0
17,Detroit Mercy (MAAC),13,8-5,189,133,322,0.587,04/25/2019,2019.0
18,UMass Lowell (America East),13,5-8,194,137,331,0.586,04/25/2019,2019.0
19,Notre Dame (ACC),12,7-5,171,121,292,0.586,04/25/2019,2019.0
20,Maryland (Big Ten),13,11-2,200,144,344,0.581,04/25/2019,2019.0
21,Syracuse (ACC),13,9-4,194,141,335,0.579,04/25/2019,2019.0
22,Virginia (ACC),14,11-3,221,162,383,0.577,04/25/2019,2019.0
23,Boston U. (Patriot),14,10-4,209,160,369,0.566,04/25/2019,2019.0
24,Johns Hopkins (Big Ten),12,6-6,185,145,330,0.561,04/25/2019,2019.0
25,High Point (SoCon),13,11-2,213,170,383,0.556,04/25/2019,2019.0
26,Drexel (CAA),12,6-6,194,156,350,0.554,04/25/2019,2019.0
27,Hofstra (CAA),13,4-9,157,130,287,0.547,04/25/2019,2019.0
28,Bryant (NEC),14,3-11,175,151,326,0.537,04/25/2019,2019.0
29,Duke (ACC),14,11-3,180,159,339,0.531,04/25/2019,2019.0
30,Mount St. Mary's (NEC),14,8-6,177,165,342,0.518,04/25/2019,2019.0
31,Monmouth (MAAC),11,3-8,107,100,207,0.517,04/25/2019,2019.0
32,Vermont (America East),12,7-5,152,143,295,0.515,04/25/2019,2019.0
33,Quinnipiac (MAAC),13,7-6,180,171,351,0.513,04/25/2019,2019.0
34,Loyola Maryland (Patriot),13,10-3,188,181,369,0.509,04/25/2019,2019.0
35,Navy (Patriot),12,5-7,157,154,311,0.505,04/25/2019,2019.0
36,Villanova (Big East),13,8-5,172,170,342,0.503,04/25/2019,2019.0
37,Canisius (MAAC),14,8-6,169,171,340,0.497,04/25/2019,2019.0
38,Brown (Ivy League),14,6-8,184,191,375,0.491,04/25/2019,2019.0
39,Marquette (Big East),13,6-7,166,174,340,0.488,04/25/2019,2019.0
40,North Carolina (ACC),14,8-6,177,186,363,0.488,04/25/2019,2019.0
41,Georgetown (Big East),14,10-4,193,205,398,0.485,04/25/2019,2019.0
42,Colgate (Patriot),12,4-8,136,146,282,0.482,04/25/2019,2019.0
43,Providence (Big East),14,6-8,162,176,338,0.479,04/25/2019,2019.0
44,Robert Morris (NEC),13,6-7,191,210,401,0.476,04/25/2019,2019.0
45,Fairfield (CAA),13,5-8,168,186,354,0.475,04/25/2019,2019.0
46,Stony Brook (America East),13,8-5,148,168,316,0.468,04/25/2019,2019.0
47,Hartford (America East),14,4-10,188,214,402,0.468,04/25/2019,2019.0
48,Bucknell (Patriot),13,5-8,147,169,316,0.465,04/25/2019,2019.0
49,Harvard (Ivy League),12,5-7,165,192,357,0.462,04/25/2019,2019.0
50,UAlbany (America East),12,5-7,141,166,307,0.459,04/25/2019,2019.0
51,Princeton (Ivy League),13,7-6,169,199,368,0.459,04/25/2019,2019.0
52,Wagner (NEC),13,2-11,135,161,296,0.456,04/25/2019,2019.0
53,St. John's (NY) (Big East),13,4-9,159,192,351,0.453,04/25/2019,2019.0
54,Manhattan (MAAC),13,6-7,121,155,276,0.438,04/25/2019,2019.0
55,Rutgers (Big Ten),13,7-6,147,192,339,0.434,04/25/2019,2019.0
56,Jacksonville (SoCon),13,5-8,151,203,354,0.427,04/25/2019,2019.0
57,Siena (MAAC),12,6-6,156,212,368,0.424,04/25/2019,2019.0
58,Binghamton (America East),12,1-11,125,171,296,0.422,04/25/2019,2019.0
59,UMBC (America East),11,3-8,128,176,304,0.421,04/25/2019,2019.0
60,Bellarmine (SoCon),12,3-9,140,194,334,0.419,04/25/2019,2019.0
61,Delaware (CAA),13,10-3,132,185,317,0.416,04/25/2019,2019.0
62,Sacred Heart (NEC),13,8-5,153,221,374,0.409,04/25/2019,2019.0
63,NJIT (DI Independent),14,2-12,160,236,396,0.404,04/25/2019,2019.0
64,Richmond (SoCon),13,8-5,127,206,333,0.381,04/25/2019,2019.0
65,Furman (SoCon),13,3-10,136,223,359,0.379,04/25/2019,2019.0
66,Cornell (Ivy League),13,9-4,145,243,388,0.374,04/25/2019,2019.0
67,VMI (SoCon),12,4-8,116,213,329,0.353,04/25/2019,2019.0
68,Army West Point (Patriot),13,9-4,105,201,306,0.343,04/25/2019,2019.0
69,Michigan (Big Ten),12,3-9,116,224,340,0.341,04/25/2019,2019.0
70,Dartmouth (Ivy League),12,2-10,91,195,286,0.318,04/25/2019,2019.0
71,Utah (DI Independent),14,4-10,108,246,354,0.305,04/25/2019,2019.0
72,Lafayette (Patriot),14,4-10,102,247,349,0.292,04/25/2019,2019.0
73,St. Bonaventure (MAAC),13,0-13,76,240,316,0.241,04/25/2019,2019.0
1,Yale (Ivy League),12,10-2,262,75,337,0.777,04/24/2019,2019.0
2,Towson (CAA),12,8-4,226,81,307,0.736,04/24/2019,2019.0
3,Lehigh (Patriot),14,8-6,227,106,333,0.682,04/24/2019,2019.0
4,Hampton (DI Independent),10,6-4,200,98,298,0.671,04/24/2019,2019.0
5,Holy Cross (Patriot),12,6-6,184,104,288,0.639,04/24/2019,2019.0
6,Cleveland St. (DI Independent),15,8-7,239,140,379,0.631,04/24/2019,2019.0
7,Marist (MAAC),13,7-6,188,111,299,0.629,04/24/2019,2019.0
8,Penn (Ivy League),11,8-3,206,125,331,0.622,04/24/2019,2019.0
9,Saint Joseph's (NEC),13,7-6,198,121,319,0.621,04/24/2019,2019.0
10,Hobart (NEC),13,10-3,227,140,367,0.619,04/24/2019,2019.0
11,Massachusetts (CAA),13,9-4,195,127,322,0.606,04/24/2019,2019.0
12,Air Force (SoCon),13,9-4,179,120,299,0.599,04/24/2019,2019.0
13,Mercer (SoCon),12,1-11,203,139,342,0.594,04/24/2019,2019.0
14,Denver (Big East),12,8-4,176,121,297,0.593,04/24/2019,2019.0
15,Syracuse (ACC),12,9-3,184,127,311,0.592,04/24/2019,2019.0
16,Ohio St. (Big Ten),11,8-3,166,115,281,0.591,04/24/2019,2019.0
17,Penn St. (Big Ten),12,11-1,217,151,368,0.590,04/24/2019,2019.0
18,Detroit Mercy (MAAC),13,8-5,189,133,322,0.587,04/24/2019,2019.0
19,UMass Lowell (America East),13,5-8,194,137,331,0.586,04/24/2019,2019.0
20,Notre Dame (ACC),12,7-5,171,121,292,0.586,04/24/2019,2019.0
21,Maryland (Big Ten),13,11-2,200,144,344,0.581,04/24/2019,2019.0
22,Virginia (ACC),14,11-3,221,162,383,0.577,04/24/2019,2019.0
23,Boston U. (Patriot),14,10-4,209,160,369,0.566,04/24/2019,2019.0
24,Johns Hopkins (Big Ten),12,6-6,185,145,330,0.561,04/24/2019,2019.0
25,High Point (SoCon),13,11-2,213,170,383,0.556,04/24/2019,2019.0
26,Drexel (CAA),12,6-6,194,156,350,0.554,04/24/2019,2019.0
27,Hofstra (CAA),13,4-9,157,130,287,0.547,04/24/2019,2019.0
28,Bryant (NEC),14,3-11,175,151,326,0.537,04/24/2019,2019.0
29,Duke (ACC),14,11-3,180,159,339,0.531,04/24/2019,2019.0
30,Mount St. Mary's (NEC),14,8-6,177,165,342,0.518,04/24/2019,2019.0
31,Monmouth (MAAC),11,3-8,107,100,207,0.517,04/24/2019,2019.0
32,Vermont (America East),12,7-5,152,143,295,0.515,04/24/2019,2019.0
33,Quinnipiac (MAAC),13,7-6,180,171,351,0.513,04/24/2019,2019.0
34,Loyola Maryland (Patriot),13,10-3,188,181,369,0.509,04/24/2019,2019.0
35,Navy (Patriot),12,5-7,157,154,311,0.505,04/24/2019,2019.0
36,Villanova (Big East),13,8-5,172,170,342,0.503,04/24/2019,2019.0
37,Canisius (MAAC),14,8-6,169,171,340,0.497,04/24/2019,2019.0
38,Brown (Ivy League),14,6-8,184,191,375,0.491,04/24/2019,2019.0
39,Marquette (Big East),13,6-7,166,174,340,0.488,04/24/2019,2019.0
40,Georgetown (Big East),14,10-4,193,205,398,0.485,04/24/2019,2019.0
41,Colgate (Patriot),12,4-8,136,146,282,0.482,04/24/2019,2019.0
42,North Carolina (ACC),13,7-6,163,176,339,0.481,04/24/2019,2019.0
43,Providence (Big East),14,6-8,162,176,338,0.479,04/24/2019,2019.0
44,Robert Morris (NEC),13,6-7,191,210,401,0.476,04/24/2019,2019.0
45,Fairfield (CAA),13,5-8,168,186,354,0.475,04/24/2019,2019.0
46,Stony Brook (America East),13,8-5,148,168,316,0.468,04/24/2019,2019.0
47,Hartford (America East),14,4-10,188,214,402,0.468,04/24/2019,2019.0
48,Bucknell (Patriot),13,5-8,147,169,316,0.465,04/24/2019,2019.0
49,Harvard (Ivy League),12,5-7,165,192,357,0.462,04/24/2019,2019.0
50,UAlbany (America East),12,5-7,141,166,307,0.459,04/24/2019,2019.0
51,Princeton (Ivy League),13,7-6,169,199,368,0.459,04/24/2019,2019.0
52,Wagner (NEC),13,2-11,135,161,296,0.456,04/24/2019,2019.0
53,St. John's (NY) (Big East),13,4-9,159,192,351,0.453,04/24/2019,2019.0
54,Manhattan (MAAC),13,6-7,121,155,276,0.438,04/24/2019,2019.0
55,Rutgers (Big Ten),13,7-6,147,192,339,0.434,04/24/2019,2019.0
56,Jacksonville (SoCon),13,5-8,151,203,354,0.427,04/24/2019,2019.0
57,Siena (MAAC),12,6-6,156,212,368,0.424,04/24/2019,2019.0
58,Binghamton (America East),12,1-11,125,171,296,0.422,04/24/2019,2019.0
59,UMBC (America East),11,3-8,128,176,304,0.421,04/24/2019,2019.0
60,Bellarmine (SoCon),12,3-9,140,194,334,0.419,04/24/2019,2019.0
61,Delaware (CAA),13,10-3,132,185,317,0.416,04/24/2019,2019.0
62,Sacred Heart (NEC),13,8-5,153,221,374,0.409,04/24/2019,2019.0
63,NJIT (DI Independent),14,2-12,160,236,396,0.404,04/24/2019,2019.0
64,Richmond (SoCon),13,8-5,127,206,333,0.381,04/24/2019,2019.0
65,Furman (SoCon),13,3-10,136,223,359,0.379,04/24/2019,2019.0
66,Cornell (Ivy League),13,9-4,145,243,388,0.374,04/24/2019,2019.0
67,VMI (SoCon),12,4-8,116,213,329,0.353,04/24/2019,2019.0
68,Army West Point (Patriot),13,9-4,105,201,306,0.343,04/24/2019,2019.0
69,Michigan (Big Ten),12,3-9,116,224,340,0.341,04/24/2019,2019.0
70,Dartmouth (Ivy League),12,2-10,91,195,286,0.318,04/24/2019,2019.0
71,Utah (DI Independent),14,4-10,108,246,354,0.305,04/24/2019,2019.0
72,Lafayette (Patriot),14,4-10,102,247,349,0.292,04/24/2019,2019.0
73,St. Bonaventure (MAAC),13,0-13,76,240,316,0.241,04/24/2019,2019.0
1,Yale (Ivy League),12,10-2,262,75,337,0.777,04/23/2019,2019.0
2,Towson (CAA),12,8-4,226,81,307,0.736,04/23/2019,2019.0
3,Lehigh (Patriot),14,8-6,227,106,333,0.682,04/23/2019,2019.0
4,Hampton (DI Independent),10,6-4,200,98,298,0.671,04/23/2019,2019.0
5,Holy Cross (Patriot),12,6-6,184,104,288,0.639,04/23/2019,2019.0
6,Marist (MAAC),13,7-6,188,111,299,0.629,04/23/2019,2019.0
7,Cleveland St. (DI Independent),14,7-7,223,132,355,0.628,04/23/2019,2019.0
8,Penn (Ivy League),11,8-3,206,125,331,0.622,04/23/2019,2019.0
9,Saint Joseph's (NEC),13,7-6,198,121,319,0.621,04/23/2019,2019.0
10,Hobart (NEC),13,10-3,227,140,367,0.619,04/23/2019,2019.0
11,Detroit Mercy (MAAC),12,8-4,181,117,298,0.607,04/23/2019,2019.0
12,Massachusetts (CAA),13,9-4,195,127,322,0.606,04/23/2019,2019.0
13,Air Force (SoCon),13,9-4,179,120,299,0.599,04/23/2019,2019.0
14,Mercer (SoCon),12,1-11,203,139,342,0.594,04/23/2019,2019.0
15,Denver (Big East),12,8-4,176,121,297,0.593,04/23/2019,2019.0
16,Syracuse (ACC),12,9-3,184,127,311,0.592,04/23/2019,2019.0
17,Ohio St. (Big Ten),11,8-3,166,115,281,0.591,04/23/2019,2019.0
18,Penn St. (Big Ten),12,11-1,217,151,368,0.590,04/23/2019,2019.0
19,UMass Lowell (America East),13,5-8,194,137,331,0.586,04/23/2019,2019.0
20,Notre Dame (ACC),12,7-5,171,121,292,0.586,04/23/2019,2019.0
21,Maryland (Big Ten),13,11-2,200,144,344,0.581,04/23/2019,2019.0
22,Virginia (ACC),14,11-3,221,162,383,0.577,04/23/2019,2019.0
23,Boston U. (Patriot),14,10-4,209,160,369,0.566,04/23/2019,2019.0
24,Johns Hopkins (Big Ten),12,6-6,185,145,330,0.561,04/23/2019,2019.0
25,High Point (SoCon),13,11-2,213,170,383,0.556,04/23/2019,2019.0
26,Drexel (CAA),12,6-6,194,156,350,0.554,04/23/2019,2019.0
27,Hofstra (CAA),13,4-9,157,130,287,0.547,04/23/2019,2019.0
28,Bryant (NEC),14,3-11,175,151,326,0.537,04/23/2019,2019.0
29,Duke (ACC),14,11-3,180,159,339,0.531,04/23/2019,2019.0
30,Mount St. Mary's (NEC),14,8-6,177,165,342,0.518,04/23/2019,2019.0
31,Monmouth (MAAC),11,3-8,107,100,207,0.517,04/23/2019,2019.0
32,Vermont (America East),12,7-5,152,143,295,0.515,04/23/2019,2019.0
33,Quinnipiac (MAAC),13,7-6,180,171,351,0.513,04/23/2019,2019.0
34,Loyola Maryland (Patriot),13,10-3,188,181,369,0.509,04/23/2019,2019.0
35,Navy (Patriot),12,5-7,157,154,311,0.505,04/23/2019,2019.0
36,Villanova (Big East),13,8-5,172,170,342,0.503,04/23/2019,2019.0
37,Canisius (MAAC),14,8-6,169,171,340,0.497,04/23/2019,2019.0
38,Brown (Ivy League),14,6-8,184,191,375,0.491,04/23/2019,2019.0
39,Marquette (Big East),13,6-7,166,174,340,0.488,04/23/2019,2019.0
40,Georgetown (Big East),14,10-4,193,205,398,0.485,04/23/2019,2019.0
41,Colgate (Patriot),12,4-8,136,146,282,0.482,04/23/2019,2019.0
42,North Carolina (ACC),13,7-6,163,176,339,0.481,04/23/2019,2019.0
43,Providence (Big East),14,6-8,162,176,338,0.479,04/23/2019,2019.0
44,Robert Morris (NEC),13,6-7,191,210,401,0.476,04/23/2019,2019.0
45,Fairfield (CAA),13,5-8,168,186,354,0.475,04/23/2019,2019.0
46,Stony Brook (America East),13,8-5,148,168,316,0.468,04/23/2019,2019.0
47,Hartford (America East),14,4-10,188,214,402,0.468,04/23/2019,2019.0
48,Bucknell (Patriot),13,5-8,147,169,316,0.465,04/23/2019,2019.0
49,Harvard (Ivy League),12,5-7,165,192,357,0.462,04/23/2019,2019.0
50,UAlbany (America East),12,5-7,141,166,307,0.459,04/23/2019,2019.0
51,Princeton (Ivy League),13,7-6,169,199,368,0.459,04/23/2019,2019.0
52,Wagner (NEC),13,2-11,135,161,296,0.456,04/23/2019,2019.0
53,St. John's (NY) (Big East),13,4-9,159,192,351,0.453,04/23/2019,2019.0
54,Manhattan (MAAC),13,6-7,121,155,276,0.438,04/23/2019,2019.0
55,Rutgers (Big Ten),13,7-6,147,192,339,0.434,04/23/2019,2019.0
56,Jacksonville (SoCon),13,5-8,151,203,354,0.427,04/23/2019,2019.0
57,Siena (MAAC),12,6-6,156,212,368,0.424,04/23/2019,2019.0
58,Binghamton (America East),12,1-11,125,171,296,0.422,04/23/2019,2019.0
59,UMBC (America East),11,3-8,128,176,304,0.421,04/23/2019,2019.0
60,Bellarmine (SoCon),12,3-9,140,194,334,0.419,04/23/2019,2019.0
61,Delaware (CAA),13,10-3,132,185,317,0.416,04/23/2019,2019.0
62,Sacred Heart (NEC),13,8-5,153,221,374,0.409,04/23/2019,2019.0
63,NJIT (DI Independent),14,2-12,160,236,396,0.404,04/23/2019,2019.0
64,Richmond (SoCon),13,8-5,127,206,333,0.381,04/23/2019,2019.0
65,Furman (SoCon),13,3-10,136,223,359,0.379,04/23/2019,2019.0
66,Cornell (Ivy League),13,9-4,145,243,388,0.374,04/23/2019,2019.0
67,VMI (SoCon),12,4-8,116,213,329,0.353,04/23/2019,2019.0
68,Army West Point (Patriot),13,9-4,105,201,306,0.343,04/23/2019,2019.0
69,Michigan (Big Ten),12,3-9,116,224,340,0.341,04/23/2019,2019.0
70,Dartmouth (Ivy League),12,2-10,91,195,286,0.318,04/23/2019,2019.0
71,Utah (DI Independent),14,4-10,108,246,354,0.305,04/23/2019,2019.0
72,Lafayette (Patriot),14,4-10,102,247,349,0.292,04/23/2019,2019.0
73,St. Bonaventure (MAAC),13,0-13,76,240,316,0.241,04/23/2019,2019.0
1,Yale (Ivy League),11,9-2,235,66,301,0.781,04/21/2019,2019.0
2,Towson (CAA),12,8-4,226,81,307,0.736,04/21/2019,2019.0
3,Lehigh (Patriot),14,8-6,227,106,333,0.682,04/21/2019,2019.0
4,Hampton (DI Independent),10,6-4,200,98,298,0.671,04/21/2019,2019.0
5,Holy Cross (Patriot),12,6-6,184,104,288,0.639,04/21/2019,2019.0
6,Marist (MAAC),13,7-6,188,111,299,0.629,04/21/2019,2019.0
7,Cleveland St. (DI Independent),14,7-7,223,132,355,0.628,04/21/2019,2019.0
8,Penn (Ivy League),11,8-3,206,125,331,0.622,04/21/2019,2019.0
9,Saint Joseph's (NEC),13,7-6,198,121,319,0.621,04/21/2019,2019.0
10,Hobart (NEC),13,10-3,227,140,367,0.619,04/21/2019,2019.0
11,Detroit Mercy (MAAC),12,8-4,181,117,298,0.607,04/21/2019,2019.0
12,Massachusetts (CAA),13,9-4,195,127,322,0.606,04/21/2019,2019.0
13,Air Force (SoCon),13,9-4,179,120,299,0.599,04/21/2019,2019.0
14,Mercer (SoCon),12,1-11,203,139,342,0.594,04/21/2019,2019.0
15,Denver (Big East),12,8-4,176,121,297,0.593,04/21/2019,2019.0
16,Syracuse (ACC),12,9-3,184,127,311,0.592,04/21/2019,2019.0
17,Ohio St. (Big Ten),11,8-3,166,115,281,0.591,04/21/2019,2019.0
18,Penn St. (Big Ten),12,11-1,217,151,368,0.590,04/21/2019,2019.0
19,UMass Lowell (America East),13,5-8,194,137,331,0.586,04/21/2019,2019.0
20,Notre Dame (ACC),12,7-5,171,121,292,0.586,04/21/2019,2019.0
21,Maryland (Big Ten),13,11-2,200,144,344,0.581,04/21/2019,2019.0
22,Virginia (ACC),14,11-3,221,162,383,0.577,04/21/2019,2019.0
23,Boston U. (Patriot),14,10-4,209,160,369,0.566,04/21/2019,2019.0
24,Johns Hopkins (Big Ten),12,6-6,185,145,330,0.561,04/21/2019,2019.0
25,High Point (SoCon),13,11-2,213,170,383,0.556,04/21/2019,2019.0
26,Drexel (CAA),12,6-6,194,156,350,0.554,04/21/2019,2019.0
27,Hofstra (CAA),13,4-9,157,130,287,0.547,04/21/2019,2019.0
28,Bryant (NEC),13,3-10,162,136,298,0.544,04/21/2019,2019.0
29,Quinnipiac (MAAC),12,7-5,171,144,315,0.543,04/21/2019,2019.0
30,Duke (ACC),14,11-3,180,159,339,0.531,04/21/2019,2019.0
31,Mount St. Mary's (NEC),14,8-6,177,165,342,0.518,04/21/2019,2019.0
32,Monmouth (MAAC),11,3-8,107,100,207,0.517,04/21/2019,2019.0
33,Vermont (America East),12,7-5,152,143,295,0.515,04/21/2019,2019.0
34,Loyola Maryland (Patriot),13,10-3,188,181,369,0.509,04/21/2019,2019.0
35,Navy (Patriot),12,5-7,157,154,311,0.505,04/21/2019,2019.0
36,Villanova (Big East),13,8-5,172,170,342,0.503,04/21/2019,2019.0
37,Canisius (MAAC),14,8-6,169,171,340,0.497,04/21/2019,2019.0
38,Marquette (Big East),13,6-7,166,174,340,0.488,04/21/2019,2019.0
39,Brown (Ivy League),13,5-8,169,178,347,0.487,04/21/2019,2019.0
40,Georgetown (Big East),14,10-4,193,205,398,0.485,04/21/2019,2019.0
41,Colgate (Patriot),12,4-8,136,146,282,0.482,04/21/2019,2019.0
42,North Carolina (ACC),13,7-6,163,176,339,0.481,04/21/2019,2019.0
43,Providence (Big East),14,6-8,162,176,338,0.479,04/21/2019,2019.0
44,Robert Morris (NEC),13,6-7,191,210,401,0.476,04/21/2019,2019.0
45,Fairfield (CAA),13,5-8,168,186,354,0.475,04/21/2019,2019.0
46,Stony Brook (America East),13,8-5,148,168,316,0.468,04/21/2019,2019.0
47,Hartford (America East),14,4-10,188,214,402,0.468,04/21/2019,2019.0
48,Bucknell (Patriot),13,5-8,147,169,316,0.465,04/21/2019,2019.0
49,Harvard (Ivy League),12,5-7,165,192,357,0.462,04/21/2019,2019.0
50,UAlbany (America East),12,5-7,141,166,307,0.459,04/21/2019,2019.0
51,Princeton (Ivy League),13,7-6,169,199,368,0.459,04/21/2019,2019.0
52,Wagner (NEC),13,2-11,135,161,296,0.456,04/21/2019,2019.0
53,St. John's (NY) (Big East),13,4-9,159,192,351,0.453,04/21/2019,2019.0
54,Manhattan (MAAC),13,6-7,121,155,276,0.438,04/21/2019,2019.0
55,Rutgers (Big Ten),13,7-6,147,192,339,0.434,04/21/2019,2019.0
56,Jacksonville (SoCon),13,5-8,151,203,354,0.427,04/21/2019,2019.0
57,Siena (MAAC),12,6-6,156,212,368,0.424,04/21/2019,2019.0
58,Binghamton (America East),12,1-11,125,171,296,0.422,04/21/2019,2019.0
59,UMBC (America East),11,3-8,128,176,304,0.421,04/21/2019,2019.0
60,Bellarmine (SoCon),12,3-9,140,194,334,0.419,04/21/2019,2019.0
61,Delaware (CAA),13,10-3,132,185,317,0.416,04/21/2019,2019.0
62,Sacred Heart (NEC),13,8-5,153,221,374,0.409,04/21/2019,2019.0
63,NJIT (DI Independent),14,2-12,160,236,396,0.404,04/21/2019,2019.0
64,Richmond (SoCon),13,8-5,127,206,333,0.381,04/21/2019,2019.0
65,Furman (SoCon),13,3-10,136,223,359,0.379,04/21/2019,2019.0
66,Cornell (Ivy League),13,9-4,145,243,388,0.374,04/21/2019,2019.0
67,VMI (SoCon),12,4-8,116,213,329,0.353,04/21/2019,2019.0
68,Army West Point (Patriot),13,9-4,105,201,306,0.343,04/21/2019,2019.0
69,Michigan (Big Ten),12,3-9,116,224,340,0.341,04/21/2019,2019.0
70,Dartmouth (Ivy League),12,2-10,91,195,286,0.318,04/21/2019,2019.0
71,Utah (DI Independent),14,4-10,108,246,354,0.305,04/21/2019,2019.0
72,Lafayette (Patriot),14,4-10,102,247,349,0.292,04/21/2019,2019.0
73,St. Bonaventure (MAAC),13,0-13,76,240,316,0.241,04/21/2019,2019.0
1,Yale (Ivy League),11,9-2,235,66,301,0.781,04/19/2019,2019.0
2,Towson (CAA),11,7-4,207,72,279,0.742,04/19/2019,2019.0
3,Lehigh (Patriot),13,8-5,210,98,308,0.682,04/19/2019,2019.0
4,Marist (MAAC),12,7-5,174,94,268,0.649,04/19/2019,2019.0
5,Hampton (DI Independent),9,5-4,171,95,266,0.643,04/19/2019,2019.0
6,Holy Cross (Patriot),11,6-5,166,93,259,0.641,04/19/2019,2019.0
7,Cleveland St. (DI Independent),13,6-7,204,123,327,0.624,04/19/2019,2019.0
8,Hobart (NEC),12,9-3,214,130,344,0.622,04/19/2019,2019.0
9,Massachusetts (CAA),12,8-4,182,113,295,0.617,04/19/2019,2019.0
9,Saint Joseph's (NEC),12,6-6,182,113,295,0.617,04/19/2019,2019.0
11,Syracuse (ACC),11,8-3,170,110,280,0.607,04/19/2019,2019.0
12,Penn (Ivy League),10,7-3,180,120,300,0.600,04/19/2019,2019.0
13,Maryland (Big Ten),12,10-2,192,129,321,0.598,04/19/2019,2019.0
14,Detroit Mercy (MAAC),11,7-4,163,110,273,0.597,04/19/2019,2019.0
15,Penn St. (Big Ten),11,10-1,199,136,335,0.594,04/19/2019,2019.0
16,Denver (Big East),11,7-4,161,112,273,0.590,04/19/2019,2019.0
17,Ohio St. (Big Ten),10,8-2,151,107,258,0.585,04/19/2019,2019.0
18,Air Force (SoCon),12,8-4,163,116,279,0.584,04/19/2019,2019.0
19,Boston U. (Patriot),13,9-4,198,142,340,0.582,04/19/2019,2019.0
20,Virginia (ACC),13,10-3,204,148,352,0.580,04/19/2019,2019.0
21,Notre Dame (ACC),11,6-5,154,113,267,0.577,04/19/2019,2019.0
22,Mercer (SoCon),11,1-10,181,133,314,0.576,04/19/2019,2019.0
23,Johns Hopkins (Big Ten),11,6-5,170,127,297,0.572,04/19/2019,2019.0
24,UMass Lowell (America East),12,4-8,172,130,302,0.570,04/19/2019,2019.0
25,Hofstra (CAA),12,4-8,146,115,261,0.559,04/19/2019,2019.0
26,High Point (SoCon),12,10-2,194,154,348,0.557,04/19/2019,2019.0
27,Bryant (NEC),12,3-9,144,115,259,0.556,04/19/2019,2019.0
28,Drexel (CAA),11,5-6,179,145,324,0.552,04/19/2019,2019.0
29,Quinnipiac (MAAC),11,6-5,159,134,293,0.543,04/19/2019,2019.0
30,Duke (ACC),13,10-3,168,149,317,0.530,04/19/2019,2019.0
31,Monmouth (MAAC),10,3-7,97,88,185,0.524,04/19/2019,2019.0
32,Mount St. Mary's (NEC),13,8-5,167,152,319,0.524,04/19/2019,2019.0
33,Vermont (America East),11,7-4,140,132,272,0.515,04/19/2019,2019.0
34,Navy (Patriot),11,5-6,140,140,280,0.500,04/19/2019,2019.0
35,Canisius (MAAC),14,8-6,169,171,340,0.497,04/19/2019,2019.0
36,Loyola Maryland (Patriot),12,9-3,170,173,343,0.496,04/19/2019,2019.0
37,North Carolina (ACC),12,7-5,155,159,314,0.494,04/19/2019,2019.0
38,Marquette (Big East),12,6-6,156,162,318,0.491,04/19/2019,2019.0
39,Villanova (Big East),12,7-5,155,163,318,0.487,04/19/2019,2019.0
40,Providence (Big East),13,6-7,153,161,314,0.487,04/19/2019,2019.0
41,Brown (Ivy League),12,5-7,157,166,323,0.486,04/19/2019,2019.0
42,Bucknell (Patriot),12,4-8,139,152,291,0.478,04/19/2019,2019.0
43,Fairfield (CAA),12,5-7,154,173,327,0.471,04/19/2019,2019.0
44,Robert Morris (NEC),12,5-7,170,192,362,0.470,04/19/2019,2019.0
45,Hartford (America East),13,4-9,174,197,371,0.469,04/19/2019,2019.0
46,Stony Brook (America East),12,7-5,137,156,293,0.468,04/19/2019,2019.0
47,Georgetown (Big East),13,9-4,170,194,364,0.467,04/19/2019,2019.0
48,Wagner (NEC),12,2-10,127,145,272,0.467,04/19/2019,2019.0
49,Colgate (Patriot),11,3-8,119,137,256,0.465,04/19/2019,2019.0
50,St. John's (NY) (Big East),12,4-8,152,175,327,0.465,04/19/2019,2019.0
51,UAlbany (America East),12,5-7,141,166,307,0.459,04/19/2019,2019.0
52,Harvard (Ivy League),11,5-6,146,174,320,0.456,04/19/2019,2019.0
53,Princeton (Ivy League),12,6-6,151,180,331,0.456,04/19/2019,2019.0
54,UMBC (America East),10,3-7,121,154,275,0.440,04/19/2019,2019.0
55,Manhattan (MAAC),13,6-7,121,155,276,0.438,04/19/2019,2019.0
56,Siena (MAAC),11,6-5,149,194,343,0.434,04/19/2019,2019.0
57,Delaware (CAA),12,10-2,123,166,289,0.426,04/19/2019,2019.0
58,Bellarmine (SoCon),11,3-8,124,175,299,0.415,04/19/2019,2019.0
59,NJIT (DI Independent),13,2-11,149,213,362,0.412,04/19/2019,2019.0
60,Rutgers (Big Ten),12,6-6,129,186,315,0.410,04/19/2019,2019.0
61,Sacred Heart (NEC),13,8-5,153,221,374,0.409,04/19/2019,2019.0
62,Binghamton (America East),11,0-11,108,157,265,0.408,04/19/2019,2019.0
63,Jacksonville (SoCon),12,4-8,132,196,328,0.402,04/19/2019,2019.0
64,Richmond (SoCon),12,7-5,121,184,305,0.397,04/19/2019,2019.0
65,Furman (SoCon),12,3-9,129,204,333,0.387,04/19/2019,2019.0
66,Cornell (Ivy League),12,8-4,133,231,364,0.365,04/19/2019,2019.0
67,VMI (SoCon),11,4-7,112,197,309,0.362,04/19/2019,2019.0
68,Michigan (Big Ten),11,3-8,110,206,316,0.348,04/19/2019,2019.0
69,Army West Point (Patriot),12,9-3,97,183,280,0.346,04/19/2019,2019.0
70,Dartmouth (Ivy League),11,2-9,86,169,255,0.337,04/19/2019,2019.0
71,Utah (DI Independent),13,4-9,99,227,326,0.304,04/19/2019,2019.0
72,Lafayette (Patriot),13,4-9,93,230,323,0.288,04/19/2019,2019.0
73,St. Bonaventure (MAAC),13,0-13,76,240,316,0.241,04/19/2019,2019.0
1,Yale (Ivy League),10,8-2,219,65,284,0.771,04/17/2019,2019.0
2,Towson (CAA),11,7-4,207,72,279,0.742,04/17/2019,2019.0
3,Lehigh (Patriot),13,8-5,210,98,308,0.682,04/17/2019,2019.0
4,Marist (MAAC),12,7-5,174,94,268,0.649,04/17/2019,2019.0
5,Hampton (DI Independent),9,5-4,171,95,266,0.643,04/17/2019,2019.0
6,Holy Cross (Patriot),11,6-5,166,93,259,0.641,04/17/2019,2019.0
7,Cleveland St. (DI Independent),13,6-7,204,123,327,0.624,04/17/2019,2019.0
8,Hobart (NEC),12,9-3,214,130,344,0.622,04/17/2019,2019.0
9,Saint Joseph's (NEC),12,6-6,182,113,295,0.617,04/17/2019,2019.0
9,Massachusetts (CAA),12,8-4,182,113,295,0.617,04/17/2019,2019.0
11,Syracuse (ACC),11,8-3,170,110,280,0.607,04/17/2019,2019.0
12,Penn (Ivy League),10,7-3,180,120,300,0.600,04/17/2019,2019.0
13,Maryland (Big Ten),12,10-2,192,129,321,0.598,04/17/2019,2019.0
14,Detroit Mercy (MAAC),11,7-4,163,110,273,0.597,04/17/2019,2019.0
15,Penn St. (Big Ten),11,10-1,199,136,335,0.594,04/17/2019,2019.0
16,Denver (Big East),11,7-4,161,112,273,0.590,04/17/2019,2019.0
17,Ohio St. (Big Ten),10,8-2,151,107,258,0.585,04/17/2019,2019.0
18,Air Force (SoCon),12,8-4,163,116,279,0.584,04/17/2019,2019.0
19,Boston U. (Patriot),13,9-4,198,142,340,0.582,04/17/2019,2019.0
20,Virginia (ACC),13,10-3,204,148,352,0.580,04/17/2019,2019.0
21,Notre Dame (ACC),11,6-5,154,113,267,0.577,04/17/2019,2019.0
22,Mercer (SoCon),11,1-10,181,133,314,0.576,04/17/2019,2019.0
23,Johns Hopkins (Big Ten),11,6-5,170,127,297,0.572,04/17/2019,2019.0
24,UMass Lowell (America East),12,4-8,172,130,302,0.570,04/17/2019,2019.0
25,Hofstra (CAA),12,4-8,146,115,261,0.559,04/17/2019,2019.0
26,High Point (SoCon),12,10-2,194,154,348,0.557,04/17/2019,2019.0
27,Bryant (NEC),12,3-9,144,115,259,0.556,04/17/2019,2019.0
28,Drexel (CAA),11,5-6,179,145,324,0.552,04/17/2019,2019.0
29,Quinnipiac (MAAC),11,6-5,159,134,293,0.543,04/17/2019,2019.0
30,Duke (ACC),13,10-3,168,149,317,0.530,04/17/2019,2019.0
31,Monmouth (MAAC),10,3-7,97,88,185,0.524,04/17/2019,2019.0
32,Mount St. Mary's (NEC),13,8-5,167,152,319,0.524,04/17/2019,2019.0
33,Vermont (America East),11,7-4,137,135,272,0.504,04/17/2019,2019.0
34,Navy (Patriot),11,5-6,140,140,280,0.500,04/17/2019,2019.0
35,Loyola Maryland (Patriot),12,9-3,170,173,343,0.496,04/17/2019,2019.0
36,North Carolina (ACC),12,7-5,155,159,314,0.494,04/17/2019,2019.0
37,Marquette (Big East),12,6-6,156,162,318,0.491,04/17/2019,2019.0
38,Villanova (Big East),12,7-5,155,163,318,0.487,04/17/2019,2019.0
39,Providence (Big East),13,6-7,153,161,314,0.487,04/17/2019,2019.0
40,Brown (Ivy League),12,5-7,157,166,323,0.486,04/17/2019,2019.0
41,Canisius (MAAC),13,8-5,157,167,324,0.485,04/17/2019,2019.0
42,UAlbany (America East),11,5-6,140,150,290,0.483,04/17/2019,2019.0
43,Bucknell (Patriot),12,4-8,139,152,291,0.478,04/17/2019,2019.0
44,Fairfield (CAA),12,5-7,154,173,327,0.471,04/17/2019,2019.0
45,Robert Morris (NEC),12,5-7,170,192,362,0.470,04/17/2019,2019.0
46,Hartford (America East),13,4-9,174,197,371,0.469,04/17/2019,2019.0
47,Stony Brook (America East),12,7-5,137,156,293,0.468,04/17/2019,2019.0
48,Georgetown (Big East),13,9-4,170,194,364,0.467,04/17/2019,2019.0
49,Wagner (NEC),12,2-10,127,145,272,0.467,04/17/2019,2019.0
50,Colgate (Patriot),11,3-8,119,137,256,0.465,04/17/2019,2019.0
51,St. John's (NY) (Big East),12,4-8,152,175,327,0.465,04/17/2019,2019.0
52,Harvard (Ivy League),11,5-6,146,174,320,0.456,04/17/2019,2019.0
53,Princeton (Ivy League),12,6-6,151,180,331,0.456,04/17/2019,2019.0
54,Manhattan (MAAC),12,5-7,117,143,260,0.450,04/17/2019,2019.0
55,UMBC (America East),10,3-7,121,154,275,0.440,04/17/2019,2019.0
56,Siena (MAAC),11,6-5,149,194,343,0.434,04/17/2019,2019.0
57,Delaware (CAA),12,10-2,123,166,289,0.426,04/17/2019,2019.0
58,Binghamton (America East),11,0-11,111,154,265,0.419,04/17/2019,2019.0
59,Bellarmine (SoCon),11,3-8,124,175,299,0.415,04/17/2019,2019.0
60,NJIT (DI Independent),13,2-11,149,213,362,0.412,04/17/2019,2019.0
61,Rutgers (Big Ten),12,6-6,129,186,315,0.410,04/17/2019,2019.0
62,Sacred Heart (NEC),13,8-5,153,221,374,0.409,04/17/2019,2019.0
63,Jacksonville (SoCon),12,4-8,132,196,328,0.402,04/17/2019,2019.0
64,Richmond (SoCon),12,7-5,121,184,305,0.397,04/17/2019,2019.0
65,Furman (SoCon),12,3-9,129,204,333,0.387,04/17/2019,2019.0
66,Cornell (Ivy League),12,8-4,133,231,364,0.365,04/17/2019,2019.0
67,VMI (SoCon),11,4-7,112,197,309,0.362,04/17/2019,2019.0
68,Michigan (Big Ten),11,3-8,110,206,316,0.348,04/17/2019,2019.0
69,Army West Point (Patriot),12,9-3,97,183,280,0.346,04/17/2019,2019.0
70,Dartmouth (Ivy League),11,2-9,86,169,255,0.337,04/17/2019,2019.0
71,Utah (DI Independent),13,4-9,99,227,326,0.304,04/17/2019,2019.0
72,Lafayette (Patriot),13,4-9,93,230,323,0.288,04/17/2019,2019.0
73,St. Bonaventure (MAAC),13,0-13,76,240,316,0.241,04/17/2019,2019.0
1,Yale (Ivy League),10,8-2,219,65,284,0.771,04/16/2019,2019.0
2,Towson (CAA),11,7-4,207,72,279,0.742,04/16/2019,2019.0
3,Lehigh (Patriot),13,8-5,210,98,308,0.682,04/16/2019,2019.0
4,Marist (MAAC),12,7-5,174,94,268,0.649,04/16/2019,2019.0
5,Holy Cross (Patriot),11,6-5,166,93,259,0.641,04/16/2019,2019.0
6,Cleveland St. (DI Independent),13,6-7,204,123,327,0.624,04/16/2019,2019.0
7,Hobart (NEC),12,9-3,214,130,344,0.622,04/16/2019,2019.0
8,Saint Joseph's (NEC),12,6-6,182,113,295,0.617,04/16/2019,2019.0
8,Massachusetts (CAA),12,8-4,182,113,295,0.617,04/16/2019,2019.0
10,Hampton (DI Independent),8,4-4,140,89,229,0.611,04/16/2019,2019.0
11,Syracuse (ACC),11,8-3,170,110,280,0.607,04/16/2019,2019.0
12,Penn (Ivy League),10,7-3,180,120,300,0.600,04/16/2019,2019.0
13,Maryland (Big Ten),12,10-2,192,129,321,0.598,04/16/2019,2019.0
14,Detroit Mercy (MAAC),11,7-4,163,110,273,0.597,04/16/2019,2019.0
15,Penn St. (Big Ten),11,10-1,199,136,335,0.594,04/16/2019,2019.0
16,Denver (Big East),11,7-4,161,112,273,0.590,04/16/2019,2019.0
17,Ohio St. (Big Ten),10,8-2,151,107,258,0.585,04/16/2019,2019.0
18,Air Force (SoCon),12,8-4,163,116,279,0.584,04/16/2019,2019.0
19,Boston U. (Patriot),13,9-4,198,142,340,0.582,04/16/2019,2019.0
20,Virginia (ACC),13,10-3,204,148,352,0.580,04/16/2019,2019.0
21,Notre Dame (ACC),11,6-5,154,113,267,0.577,04/16/2019,2019.0
22,Mercer (SoCon),11,1-10,181,133,314,0.576,04/16/2019,2019.0
23,Johns Hopkins (Big Ten),11,6-5,170,127,297,0.572,04/16/2019,2019.0
24,UMass Lowell (America East),12,4-8,172,130,302,0.570,04/16/2019,2019.0
25,Hofstra (CAA),12,4-8,146,115,261,0.559,04/16/2019,2019.0
26,High Point (SoCon),12,10-2,194,154,348,0.557,04/16/2019,2019.0
27,Bryant (NEC),12,3-9,144,115,259,0.556,04/16/2019,2019.0
28,Drexel (CAA),11,5-6,179,145,324,0.552,04/16/2019,2019.0
29,Quinnipiac (MAAC),11,6-5,159,134,293,0.543,04/16/2019,2019.0
30,Duke (ACC),13,10-3,168,149,317,0.530,04/16/2019,2019.0
31,Monmouth (MAAC),10,3-7,97,88,185,0.524,04/16/2019,2019.0
32,Mount St. Mary's (NEC),13,8-5,167,152,319,0.524,04/16/2019,2019.0
33,Vermont (America East),11,7-4,137,135,272,0.504,04/16/2019,2019.0
34,Navy (Patriot),11,5-6,140,140,280,0.500,04/16/2019,2019.0
35,Loyola Maryland (Patriot),12,9-3,170,173,343,0.496,04/16/2019,2019.0
36,North Carolina (ACC),12,7-5,155,159,314,0.494,04/16/2019,2019.0
37,Marquette (Big East),12,6-6,156,162,318,0.491,04/16/2019,2019.0
38,Villanova (Big East),12,7-5,155,163,318,0.487,04/16/2019,2019.0
39,Providence (Big East),13,6-7,153,161,314,0.487,04/16/2019,2019.0
40,Brown (Ivy League),12,5-7,157,166,323,0.486,04/16/2019,2019.0
41,Canisius (MAAC),13,8-5,157,167,324,0.485,04/16/2019,2019.0
42,UAlbany (America East),11,5-6,140,150,290,0.483,04/16/2019,2019.0
43,Bucknell (Patriot),12,4-8,139,152,291,0.478,04/16/2019,2019.0
44,Fairfield (CAA),12,5-7,154,173,327,0.471,04/16/2019,2019.0
45,Robert Morris (NEC),12,5-7,170,192,362,0.470,04/16/2019,2019.0
46,Hartford (America East),13,4-9,174,197,371,0.469,04/16/2019,2019.0
47,Stony Brook (America East),12,7-5,137,156,293,0.468,04/16/2019,2019.0
48,Georgetown (Big East),13,9-4,170,194,364,0.467,04/16/2019,2019.0
49,Wagner (NEC),12,2-10,127,145,272,0.467,04/16/2019,2019.0
50,Colgate (Patriot),11,3-8,119,137,256,0.465,04/16/2019,2019.0
51,St. John's (NY) (Big East),12,4-8,152,175,327,0.465,04/16/2019,2019.0
52,Harvard (Ivy League),11,5-6,146,174,320,0.456,04/16/2019,2019.0
53,Princeton (Ivy League),12,6-6,151,180,331,0.456,04/16/2019,2019.0
54,Manhattan (MAAC),12,5-7,117,143,260,0.450,04/16/2019,2019.0
55,UMBC (America East),10,3-7,121,154,275,0.440,04/16/2019,2019.0
56,Siena (MAAC),11,6-5,149,194,343,0.434,04/16/2019,2019.0
57,Delaware (CAA),12,10-2,123,166,289,0.426,04/16/2019,2019.0
58,Binghamton (America East),11,0-11,111,154,265,0.419,04/16/2019,2019.0
59,Bellarmine (SoCon),11,3-8,124,175,299,0.415,04/16/2019,2019.0
60,NJIT (DI Independent),13,2-11,149,213,362,0.412,04/16/2019,2019.0
61,Rutgers (Big Ten),12,6-6,129,186,315,0.410,04/16/2019,2019.0
62,Sacred Heart (NEC),13,8-5,153,221,374,0.409,04/16/2019,2019.0
63,Jacksonville (SoCon),12,4-8,132,196,328,0.402,04/16/2019,2019.0
64,Richmond (SoCon),12,7-5,121,184,305,0.397,04/16/2019,2019.0
65,Furman (SoCon),12,3-9,129,204,333,0.387,04/16/2019,2019.0
66,Cornell (Ivy League),12,8-4,133,231,364,0.365,04/16/2019,2019.0
67,VMI (SoCon),11,4-7,112,197,309,0.362,04/16/2019,2019.0
68,Michigan (Big Ten),11,3-8,110,206,316,0.348,04/16/2019,2019.0
69,Army West Point (Patriot),12,9-3,97,183,280,0.346,04/16/2019,2019.0
70,Dartmouth (Ivy League),11,2-9,86,169,255,0.337,04/16/2019,2019.0
71,Utah (DI Independent),13,4-9,99,227,326,0.304,04/16/2019,2019.0
72,Lafayette (Patriot),13,4-9,93,230,323,0.288,04/16/2019,2019.0
73,St. Bonaventure (MAAC),13,0-13,76,240,316,0.241,04/16/2019,2019.0
1,Yale (Ivy League),10,8-2,219,65,284,0.771,04/14/2019,2019.0
2,Towson (CAA),11,7-4,207,72,279,0.742,04/14/2019,2019.0
3,Lehigh (Patriot),13,8-5,210,98,308,0.682,04/14/2019,2019.0
4,Marist (MAAC),11,6-5,159,89,248,0.641,04/14/2019,2019.0
5,Holy Cross (Patriot),11,6-5,166,93,259,0.641,04/14/2019,2019.0
6,Cleveland St. (DI Independent),13,6-7,204,123,327,0.624,04/14/2019,2019.0
7,Hobart (NEC),12,9-3,214,130,344,0.622,04/14/2019,2019.0
8,Saint Joseph's (NEC),12,6-6,182,113,295,0.617,04/14/2019,2019.0
8,Massachusetts (CAA),12,8-4,182,113,295,0.617,04/14/2019,2019.0
10,Hampton (DI Independent),8,4-4,140,89,229,0.611,04/14/2019,2019.0
11,Syracuse (ACC),11,8-3,170,110,280,0.607,04/14/2019,2019.0
12,Penn (Ivy League),10,7-3,180,120,300,0.600,04/14/2019,2019.0
13,Maryland (Big Ten),12,10-2,192,129,321,0.598,04/14/2019,2019.0
14,Detroit Mercy (MAAC),11,7-4,163,110,273,0.597,04/14/2019,2019.0
15,Penn St. (Big Ten),11,10-1,199,136,335,0.594,04/14/2019,2019.0
16,Denver (Big East),11,7-4,161,112,273,0.590,04/14/2019,2019.0
17,Ohio St. (Big Ten),10,8-2,151,107,258,0.585,04/14/2019,2019.0
18,Air Force (SoCon),12,8-4,163,116,279,0.584,04/14/2019,2019.0
19,Boston U. (Patriot),13,9-4,198,142,340,0.582,04/14/2019,2019.0
20,Notre Dame (ACC),11,6-5,154,113,267,0.577,04/14/2019,2019.0
21,Mercer (SoCon),11,1-10,181,133,314,0.576,04/14/2019,2019.0
22,Johns Hopkins (Big Ten),11,6-5,170,127,297,0.572,04/14/2019,2019.0
23,UMass Lowell (America East),12,4-8,172,130,302,0.570,04/14/2019,2019.0
24,Hofstra (CAA),12,4-8,146,115,261,0.559,04/14/2019,2019.0
25,High Point (SoCon),12,10-2,194,154,348,0.557,04/14/2019,2019.0
26,Bryant (NEC),12,3-9,144,115,259,0.556,04/14/2019,2019.0
27,Drexel (CAA),11,5-6,179,145,324,0.552,04/14/2019,2019.0
28,Virginia (ACC),12,9-3,176,143,319,0.552,04/14/2019,2019.0
29,Quinnipiac (MAAC),11,6-5,159,134,293,0.543,04/14/2019,2019.0
30,Duke (ACC),13,10-3,168,149,317,0.530,04/14/2019,2019.0
31,Monmouth (MAAC),10,3-7,97,88,185,0.524,04/14/2019,2019.0
32,Mount St. Mary's (NEC),13,8-5,167,152,319,0.524,04/14/2019,2019.0
33,Vermont (America East),11,7-4,137,135,272,0.504,04/14/2019,2019.0
34,Navy (Patriot),11,5-6,140,140,280,0.500,04/14/2019,2019.0
35,Loyola Maryland (Patriot),12,9-3,170,173,343,0.496,04/14/2019,2019.0
36,North Carolina (ACC),12,7-5,155,159,314,0.494,04/14/2019,2019.0
37,Marquette (Big East),12,6-6,156,162,318,0.491,04/14/2019,2019.0
38,Brown (Ivy League),11,4-7,149,156,305,0.489,04/14/2019,2019.0
39,Villanova (Big East),12,7-5,155,163,318,0.487,04/14/2019,2019.0
40,Canisius (MAAC),13,8-5,157,167,324,0.485,04/14/2019,2019.0
41,Providence (Big East),12,6-6,143,153,296,0.483,04/14/2019,2019.0
42,UAlbany (America East),11,5-6,140,150,290,0.483,04/14/2019,2019.0
43,Bucknell (Patriot),12,4-8,139,152,291,0.478,04/14/2019,2019.0
44,Fairfield (CAA),12,5-7,154,173,327,0.471,04/14/2019,2019.0
45,Robert Morris (NEC),12,5-7,170,192,362,0.470,04/14/2019,2019.0
46,Hartford (America East),13,4-9,174,197,371,0.469,04/14/2019,2019.0
47,Stony Brook (America East),12,7-5,137,156,293,0.468,04/14/2019,2019.0
48,Georgetown (Big East),13,9-4,170,194,364,0.467,04/14/2019,2019.0
49,Wagner (NEC),12,2-10,127,145,272,0.467,04/14/2019,2019.0
50,Colgate (Patriot),11,3-8,119,137,256,0.465,04/14/2019,2019.0
51,St. John's (NY) (Big East),12,4-8,152,175,327,0.465,04/14/2019,2019.0
52,Harvard (Ivy League),11,5-6,146,174,320,0.456,04/14/2019,2019.0
53,Princeton (Ivy League),12,6-6,151,180,331,0.456,04/14/2019,2019.0
54,Manhattan (MAAC),12,5-7,117,143,260,0.450,04/14/2019,2019.0
55,UMBC (America East),10,3-7,121,154,275,0.440,04/14/2019,2019.0
56,Siena (MAAC),11,6-5,149,194,343,0.434,04/14/2019,2019.0
57,Delaware (CAA),12,10-2,123,166,289,0.426,04/14/2019,2019.0
58,Bellarmine (SoCon),11,3-8,124,175,299,0.415,04/14/2019,2019.0
59,Binghamton (America East),10,0-10,98,139,237,0.414,04/14/2019,2019.0
60,NJIT (DI Independent),13,2-11,149,213,362,0.412,04/14/2019,2019.0
61,Rutgers (Big Ten),12,6-6,129,186,315,0.410,04/14/2019,2019.0
62,Jacksonville (SoCon),12,4-8,132,196,328,0.402,04/14/2019,2019.0
63,Sacred Heart (NEC),12,7-5,138,208,346,0.399,04/14/2019,2019.0
64,Richmond (SoCon),12,7-5,121,184,305,0.397,04/14/2019,2019.0
65,VMI (SoCon),10,4-6,107,169,276,0.388,04/14/2019,2019.0
66,Furman (SoCon),12,3-9,129,204,333,0.387,04/14/2019,2019.0
67,Cornell (Ivy League),12,8-4,133,231,364,0.365,04/14/2019,2019.0
68,Michigan (Big Ten),11,3-8,110,206,316,0.348,04/14/2019,2019.0
69,Army West Point (Patriot),12,9-3,97,183,280,0.346,04/14/2019,2019.0
70,Dartmouth (Ivy League),11,2-9,86,169,255,0.337,04/14/2019,2019.0
71,Utah (DI Independent),13,4-9,99,227,326,0.304,04/14/2019,2019.0
72,Lafayette (Patriot),13,4-9,93,230,323,0.288,04/14/2019,2019.0
73,St. Bonaventure (MAAC),12,0-12,71,225,296,0.240,04/14/2019,2019.0
1,Yale (Ivy League),9,7-2,196,58,254,0.772,04/11/2019,2019.0
2,Towson (CAA),10,7-3,189,62,251,0.753,04/11/2019,2019.0
3,Lehigh (Patriot),12,7-5,190,95,285,0.667,04/11/2019,2019.0
4,Marist (MAAC),10,5-5,148,76,224,0.661,04/11/2019,2019.0
5,Massachusetts (CAA),11,7-4,172,95,267,0.644,04/11/2019,2019.0
6,Cleveland St. (DI Independent),12,6-6,191,111,302,0.632,04/11/2019,2019.0
7,Hobart (NEC),11,8-3,200,120,320,0.625,04/11/2019,2019.0
8,Holy Cross (Patriot),10,5-5,149,90,239,0.623,04/11/2019,2019.0
9,Saint Joseph's (NEC),11,6-5,164,104,268,0.612,04/11/2019,2019.0
10,Hampton (DI Independent),8,4-4,140,89,229,0.611,04/11/2019,2019.0
11,Detroit Mercy (MAAC),10,7-3,152,99,251,0.606,04/11/2019,2019.0
12,Syracuse (ACC),10,7-3,155,101,256,0.605,04/11/2019,2019.0
13,Maryland (Big Ten),11,9-2,174,114,288,0.604,04/11/2019,2019.0
14,Ohio St. (Big Ten),9,7-2,137,93,230,0.596,04/11/2019,2019.0
15,Penn (Ivy League),9,6-3,151,106,257,0.588,04/11/2019,2019.0
16,High Point (SoCon),11,9-2,181,131,312,0.580,04/11/2019,2019.0
17,Johns Hopkins (Big Ten),10,6-4,156,113,269,0.580,04/11/2019,2019.0
18,Boston U. (Patriot),12,8-4,178,129,307,0.580,04/11/2019,2019.0
19,Penn St. (Big Ten),10,9-1,177,130,307,0.577,04/11/2019,2019.0
20,UMass Lowell (America East),11,4-7,156,115,271,0.576,04/11/2019,2019.0
21,Denver (Big East),10,6-4,138,104,242,0.570,04/11/2019,2019.0
22,Bryant (NEC),11,3-8,134,101,235,0.570,04/11/2019,2019.0
23,Mercer (SoCon),10,1-9,158,120,278,0.568,04/11/2019,2019.0
24,Air Force (SoCon),11,7-4,145,111,256,0.566,04/11/2019,2019.0
25,Notre Dame (ACC),10,6-4,134,110,244,0.549,04/11/2019,2019.0
26,Duke (ACC),12,9-3,161,134,295,0.546,04/11/2019,2019.0
27,Quinnipiac (MAAC),10,6-4,146,123,269,0.543,04/11/2019,2019.0
28,Virginia (ACC),11,9-2,161,136,297,0.542,04/11/2019,2019.0
29,Mount St. Mary's (NEC),12,7-5,158,137,295,0.536,04/11/2019,2019.0
30,Hofstra (CAA),11,4-7,126,112,238,0.529,04/11/2019,2019.0
31,Drexel (CAA),10,4-6,152,138,290,0.524,04/11/2019,2019.0
32,Brown (Ivy League),10,4-6,142,133,275,0.516,04/11/2019,2019.0
33,Villanova (Big East),11,7-4,145,141,286,0.507,04/11/2019,2019.0
34,Loyola Maryland (Patriot),11,9-2,157,153,310,0.506,04/11/2019,2019.0
35,Monmouth (MAAC),9,2-7,83,81,164,0.506,04/11/2019,2019.0
36,Vermont (America East),10,6-4,126,123,249,0.506,04/11/2019,2019.0
37,North Carolina (ACC),11,7-4,146,144,290,0.503,04/11/2019,2019.0
38,Fairfield (CAA),11,5-6,147,146,293,0.502,04/11/2019,2019.0
39,Colgate (Patriot),10,3-7,116,120,236,0.492,04/11/2019,2019.0
40,Marquette (Big East),11,6-5,143,149,292,0.490,04/11/2019,2019.0
41,St. John's (NY) (Big East),11,4-7,144,152,296,0.486,04/11/2019,2019.0
42,Navy (Patriot),10,5-5,126,134,260,0.485,04/11/2019,2019.0
43,Canisius (MAAC),12,7-5,146,156,302,0.483,04/11/2019,2019.0
44,Providence (Big East),11,5-6,130,140,270,0.481,04/11/2019,2019.0
45,Harvard (Ivy League),10,5-5,132,145,277,0.477,04/11/2019,2019.0
46,Bucknell (Patriot),11,3-8,126,141,267,0.472,04/11/2019,2019.0
47,Robert Morris (NEC),11,4-7,158,179,337,0.469,04/11/2019,2019.0
48,UAlbany (America East),10,4-6,127,144,271,0.469,04/11/2019,2019.0
49,Stony Brook (America East),11,6-5,122,140,262,0.466,04/11/2019,2019.0
50,Manhattan (MAAC),11,5-6,110,129,239,0.460,04/11/2019,2019.0
51,Hartford (America East),12,3-9,157,185,342,0.459,04/11/2019,2019.0
52,Princeton (Ivy League),11,5-6,142,168,310,0.458,04/11/2019,2019.0
53,Wagner (NEC),11,2-9,112,136,248,0.452,04/11/2019,2019.0
54,Delaware (CAA),11,9-2,120,146,266,0.451,04/11/2019,2019.0
55,UMBC (America East),9,3-6,115,141,256,0.449,04/11/2019,2019.0
56,Georgetown (Big East),12,8-4,148,184,332,0.446,04/11/2019,2019.0
57,Siena (MAAC),10,5-5,125,177,302,0.414,04/11/2019,2019.0
58,Richmond (SoCon),11,7-4,116,166,282,0.411,04/11/2019,2019.0
59,NJIT (DI Independent),12,2-10,132,189,321,0.411,04/11/2019,2019.0
60,Sacred Heart (NEC),11,6-5,129,190,319,0.404,04/11/2019,2019.0
61,Rutgers (Big Ten),11,6-5,114,168,282,0.404,04/11/2019,2019.0
62,Bellarmine (SoCon),10,2-8,108,160,268,0.403,04/11/2019,2019.0
63,Binghamton (America East),9,0-9,86,128,214,0.402,04/11/2019,2019.0
64,VMI (SoCon),9,4-5,98,148,246,0.398,04/11/2019,2019.0
65,Cornell (Ivy League),11,7-4,130,211,341,0.381,04/11/2019,2019.0
66,Furman (SoCon),11,3-8,114,188,302,0.377,04/11/2019,2019.0
67,Jacksonville (SoCon),11,3-8,111,187,298,0.372,04/11/2019,2019.0
68,Michigan (Big Ten),10,3-7,104,184,288,0.361,04/11/2019,2019.0
69,Army West Point (Patriot),11,8-3,91,169,260,0.350,04/11/2019,2019.0
70,Dartmouth (Ivy League),10,2-8,74,160,234,0.316,04/11/2019,2019.0
71,Utah (DI Independent),12,4-8,87,210,297,0.293,04/11/2019,2019.0
72,Lafayette (Patriot),12,4-8,82,217,299,0.274,04/11/2019,2019.0
73,St. Bonaventure (MAAC),11,0-11,68,205,273,0.249,04/11/2019,2019.0
1,Yale (Ivy League),9,7-2,196,58,254,0.772,04/10/2019,2019.0
2,Towson (CAA),10,7-3,189,62,251,0.753,04/10/2019,2019.0
3,Lehigh (Patriot),12,7-5,190,95,285,0.667,04/10/2019,2019.0
4,Marist (MAAC),10,5-5,148,76,224,0.661,04/10/2019,2019.0
5,Massachusetts (CAA),11,7-4,172,95,267,0.644,04/10/2019,2019.0
6,Cleveland St. (DI Independent),12,6-6,191,111,302,0.632,04/10/2019,2019.0
7,Holy Cross (Patriot),10,5-5,150,89,239,0.628,04/10/2019,2019.0
8,Hobart (NEC),11,8-3,200,120,320,0.625,04/10/2019,2019.0
9,Saint Joseph's (NEC),11,6-5,164,104,268,0.612,04/10/2019,2019.0
10,Hampton (DI Independent),8,4-4,140,89,229,0.611,04/10/2019,2019.0
11,Detroit Mercy (MAAC),10,7-3,152,99,251,0.606,04/10/2019,2019.0
12,Syracuse (ACC),10,7-3,155,101,256,0.605,04/10/2019,2019.0
13,Maryland (Big Ten),11,9-2,174,114,288,0.604,04/10/2019,2019.0
14,Ohio St. (Big Ten),9,7-2,137,93,230,0.596,04/10/2019,2019.0
15,Penn (Ivy League),9,6-3,151,106,257,0.588,04/10/2019,2019.0
16,High Point (SoCon),11,9-2,181,131,312,0.580,04/10/2019,2019.0
17,Johns Hopkins (Big Ten),10,6-4,156,113,269,0.580,04/10/2019,2019.0
18,Boston U. (Patriot),12,8-4,178,129,307,0.580,04/10/2019,2019.0
19,Penn St. (Big Ten),10,9-1,177,130,307,0.577,04/10/2019,2019.0
20,UMass Lowell (America East),11,4-7,156,115,271,0.576,04/10/2019,2019.0
21,Denver (Big East),10,6-4,138,104,242,0.570,04/10/2019,2019.0
22,Bryant (NEC),11,3-8,134,101,235,0.570,04/10/2019,2019.0
23,Air Force (SoCon),11,7-4,145,111,256,0.566,04/10/2019,2019.0
24,Mercer (SoCon),10,1-9,155,123,278,0.558,04/10/2019,2019.0
25,Notre Dame (ACC),10,6-4,134,110,244,0.549,04/10/2019,2019.0
26,Duke (ACC),12,9-3,161,134,295,0.546,04/10/2019,2019.0
27,Quinnipiac (MAAC),10,6-4,146,123,269,0.543,04/10/2019,2019.0
28,Virginia (ACC),11,9-2,161,136,297,0.542,04/10/2019,2019.0
29,Mount St. Mary's (NEC),12,7-5,158,137,295,0.536,04/10/2019,2019.0
30,Hofstra (CAA),11,4-7,126,112,238,0.529,04/10/2019,2019.0
31,Drexel (CAA),10,4-6,152,138,290,0.524,04/10/2019,2019.0
32,Brown (Ivy League),10,4-6,142,133,275,0.516,04/10/2019,2019.0
33,Villanova (Big East),11,7-4,145,141,286,0.507,04/10/2019,2019.0
34,Loyola Maryland (Patriot),11,9-2,157,153,310,0.506,04/10/2019,2019.0
35,Monmouth (MAAC),9,2-7,83,81,164,0.506,04/10/2019,2019.0
36,North Carolina (ACC),11,7-4,146,144,290,0.503,04/10/2019,2019.0
37,Vermont (America East),10,6-4,125,124,249,0.502,04/10/2019,2019.0
38,Fairfield (CAA),11,5-6,147,146,293,0.502,04/10/2019,2019.0
39,Colgate (Patriot),10,3-7,116,120,236,0.492,04/10/2019,2019.0
40,Marquette (Big East),11,6-5,143,149,292,0.490,04/10/2019,2019.0
41,St. John's (NY) (Big East),11,4-7,144,152,296,0.486,04/10/2019,2019.0
42,Navy (Patriot),10,5-5,126,134,260,0.485,04/10/2019,2019.0
43,Canisius (MAAC),12,7-5,146,156,302,0.483,04/10/2019,2019.0
44,Providence (Big East),11,5-6,130,140,270,0.481,04/10/2019,2019.0
45,Harvard (Ivy League),10,5-5,132,145,277,0.477,04/10/2019,2019.0
46,Bucknell (Patriot),11,3-8,126,141,267,0.472,04/10/2019,2019.0
47,Robert Morris (NEC),11,4-7,158,179,337,0.469,04/10/2019,2019.0
48,UAlbany (America East),10,4-6,127,144,271,0.469,04/10/2019,2019.0
49,Stony Brook (America East),11,6-5,122,140,262,0.466,04/10/2019,2019.0
50,Manhattan (MAAC),11,5-6,110,129,239,0.460,04/10/2019,2019.0
51,Hartford (America East),12,3-9,157,185,342,0.459,04/10/2019,2019.0
52,Princeton (Ivy League),11,5-6,142,168,310,0.458,04/10/2019,2019.0
53,Wagner (NEC),11,2-9,112,136,248,0.452,04/10/2019,2019.0
54,Delaware (CAA),11,9-2,120,146,266,0.451,04/10/2019,2019.0
55,UMBC (America East),9,3-6,115,141,256,0.449,04/10/2019,2019.0
56,Georgetown (Big East),12,8-4,148,184,332,0.446,04/10/2019,2019.0
57,Bellarmine (SoCon),10,2-8,111,157,268,0.414,04/10/2019,2019.0
58,Siena (MAAC),10,5-5,125,177,302,0.414,04/10/2019,2019.0
59,Richmond (SoCon),11,7-4,116,166,282,0.411,04/10/2019,2019.0
60,NJIT (DI Independent),12,2-10,132,189,321,0.411,04/10/2019,2019.0
61,Sacred Heart (NEC),11,6-5,129,190,319,0.404,04/10/2019,2019.0
62,Rutgers (Big Ten),11,6-5,114,168,282,0.404,04/10/2019,2019.0
63,Binghamton (America East),9,0-9,86,128,214,0.402,04/10/2019,2019.0
64,VMI (SoCon),9,4-5,98,148,246,0.398,04/10/2019,2019.0
65,Cornell (Ivy League),11,7-4,130,211,341,0.381,04/10/2019,2019.0
66,Furman (SoCon),11,3-8,114,188,302,0.377,04/10/2019,2019.0
67,Jacksonville (SoCon),11,3-8,111,187,298,0.372,04/10/2019,2019.0
68,Michigan (Big Ten),10,3-7,104,184,288,0.361,04/10/2019,2019.0
69,Army West Point (Patriot),11,8-3,91,169,260,0.350,04/10/2019,2019.0
70,Dartmouth (Ivy League),10,2-8,74,160,234,0.316,04/10/2019,2019.0
71,Utah (DI Independent),12,4-8,87,210,297,0.293,04/10/2019,2019.0
72,Lafayette (Patriot),12,4-8,82,217,299,0.274,04/10/2019,2019.0
73,St. Bonaventure (MAAC),11,0-11,68,205,273,0.249,04/10/2019,2019.0
1,Yale (Ivy League),9,7-2,196,58,254,0.772,04/09/2019,2019.0
2,Towson (CAA),10,7-3,189,62,251,0.753,04/09/2019,2019.0
3,Marist (MAAC),10,5-5,148,76,224,0.661,04/09/2019,2019.0
4,Lehigh (Patriot),11,7-4,166,90,256,0.648,04/09/2019,2019.0
5,Massachusetts (CAA),11,7-4,172,95,267,0.644,04/09/2019,2019.0
6,Cleveland St. (DI Independent),12,6-6,191,111,302,0.632,04/09/2019,2019.0
7,Holy Cross (Patriot),10,5-5,150,89,239,0.628,04/09/2019,2019.0
8,Hobart (NEC),11,8-3,200,120,320,0.625,04/09/2019,2019.0
9,Saint Joseph's (NEC),11,6-5,164,104,268,0.612,04/09/2019,2019.0
10,Hampton (DI Independent),8,4-4,140,89,229,0.611,04/09/2019,2019.0
11,Detroit Mercy (MAAC),10,7-3,152,99,251,0.606,04/09/2019,2019.0
12,Syracuse (ACC),10,7-3,155,101,256,0.605,04/09/2019,2019.0
13,Maryland (Big Ten),11,9-2,174,114,288,0.604,04/09/2019,2019.0
14,Ohio St. (Big Ten),9,7-2,137,93,230,0.596,04/09/2019,2019.0
15,Penn (Ivy League),9,6-3,151,106,257,0.588,04/09/2019,2019.0
16,High Point (SoCon),11,9-2,181,131,312,0.580,04/09/2019,2019.0
17,Johns Hopkins (Big Ten),10,6-4,156,113,269,0.580,04/09/2019,2019.0
18,Boston U. (Patriot),12,8-4,178,129,307,0.580,04/09/2019,2019.0
19,Penn St. (Big Ten),10,9-1,177,130,307,0.577,04/09/2019,2019.0
20,UMass Lowell (America East),11,4-7,156,115,271,0.576,04/09/2019,2019.0
21,Denver (Big East),10,6-4,138,104,242,0.570,04/09/2019,2019.0
22,Bryant (NEC),11,3-8,134,101,235,0.570,04/09/2019,2019.0
23,Air Force (SoCon),11,7-4,145,111,256,0.566,04/09/2019,2019.0
24,Mercer (SoCon),10,1-9,155,123,278,0.558,04/09/2019,2019.0
25,Duke (ACC),12,9-3,161,134,295,0.546,04/09/2019,2019.0
26,Quinnipiac (MAAC),10,6-4,146,123,269,0.543,04/09/2019,2019.0
27,Virginia (ACC),11,9-2,161,136,297,0.542,04/09/2019,2019.0
28,Mount St. Mary's (NEC),12,7-5,158,137,295,0.536,04/09/2019,2019.0
29,Notre Dame (ACC),9,5-4,118,103,221,0.534,04/09/2019,2019.0
30,Hofstra (CAA),11,4-7,126,112,238,0.529,04/09/2019,2019.0
31,Drexel (CAA),10,4-6,152,138,290,0.524,04/09/2019,2019.0
32,Brown (Ivy League),10,4-6,142,133,275,0.516,04/09/2019,2019.0
33,Villanova (Big East),11,7-4,145,141,286,0.507,04/09/2019,2019.0
34,Loyola Maryland (Patriot),11,9-2,157,153,310,0.506,04/09/2019,2019.0
35,Monmouth (MAAC),9,2-7,83,81,164,0.506,04/09/2019,2019.0
36,Marquette (Big East),10,6-4,136,133,269,0.506,04/09/2019,2019.0
37,North Carolina (ACC),11,7-4,146,144,290,0.503,04/09/2019,2019.0
38,Vermont (America East),10,6-4,125,124,249,0.502,04/09/2019,2019.0
39,Fairfield (CAA),11,5-6,147,146,293,0.502,04/09/2019,2019.0
40,Robert Morris (NEC),10,3-7,153,155,308,0.497,04/09/2019,2019.0
41,Colgate (Patriot),10,3-7,116,120,236,0.492,04/09/2019,2019.0
42,St. John's (NY) (Big East),11,4-7,144,152,296,0.486,04/09/2019,2019.0
43,Navy (Patriot),10,5-5,126,134,260,0.485,04/09/2019,2019.0
44,Canisius (MAAC),12,7-5,146,156,302,0.483,04/09/2019,2019.0
45,Providence (Big East),11,5-6,130,140,270,0.481,04/09/2019,2019.0
46,Harvard (Ivy League),10,5-5,132,145,277,0.477,04/09/2019,2019.0
47,Bucknell (Patriot),11,3-8,126,141,267,0.472,04/09/2019,2019.0
48,UAlbany (America East),10,4-6,127,144,271,0.469,04/09/2019,2019.0
49,Stony Brook (America East),11,6-5,122,140,262,0.466,04/09/2019,2019.0
50,Manhattan (MAAC),11,5-6,110,129,239,0.460,04/09/2019,2019.0
51,Hartford (America East),12,3-9,157,185,342,0.459,04/09/2019,2019.0
52,Princeton (Ivy League),11,5-6,142,168,310,0.458,04/09/2019,2019.0
53,Wagner (NEC),11,2-9,112,136,248,0.452,04/09/2019,2019.0
54,Delaware (CAA),11,9-2,120,146,266,0.451,04/09/2019,2019.0
55,UMBC (America East),9,3-6,115,141,256,0.449,04/09/2019,2019.0
56,Georgetown (Big East),12,8-4,148,184,332,0.446,04/09/2019,2019.0
57,Bellarmine (SoCon),10,2-8,111,157,268,0.414,04/09/2019,2019.0
58,Siena (MAAC),10,5-5,125,177,302,0.414,04/09/2019,2019.0
59,Richmond (SoCon),11,7-4,116,166,282,0.411,04/09/2019,2019.0
60,NJIT (DI Independent),12,2-10,132,189,321,0.411,04/09/2019,2019.0
61,Sacred Heart (NEC),11,6-5,129,190,319,0.404,04/09/2019,2019.0
62,Rutgers (Big Ten),11,6-5,114,168,282,0.404,04/09/2019,2019.0
63,Binghamton (America East),9,0-9,86,128,214,0.402,04/09/2019,2019.0
64,VMI (SoCon),9,4-5,98,148,246,0.398,04/09/2019,2019.0
65,Cornell (Ivy League),11,7-4,130,211,341,0.381,04/09/2019,2019.0
66,Furman (SoCon),11,3-8,114,188,302,0.377,04/09/2019,2019.0
67,Jacksonville (SoCon),11,3-8,111,187,298,0.372,04/09/2019,2019.0
68,Michigan (Big Ten),10,3-7,104,184,288,0.361,04/09/2019,2019.0
69,Army West Point (Patriot),11,8-3,91,169,260,0.350,04/09/2019,2019.0
70,Dartmouth (Ivy League),10,2-8,74,160,234,0.316,04/09/2019,2019.0
71,Utah (DI Independent),12,4-8,87,210,297,0.293,04/09/2019,2019.0
72,Lafayette (Patriot),12,4-8,82,217,299,0.274,04/09/2019,2019.0
73,St. Bonaventure (MAAC),11,0-11,68,205,273,0.249,04/09/2019,2019.0
1,Yale (Ivy League),9,7-2,196,58,254,0.772,04/08/2019,2019.0
2,Towson (CAA),10,7-3,189,62,251,0.753,04/08/2019,2019.0
3,Marist (MAAC),10,5-5,148,76,224,0.661,04/08/2019,2019.0
4,Lehigh (Patriot),11,7-4,166,90,256,0.648,04/08/2019,2019.0
5,Massachusetts (CAA),11,7-4,172,95,267,0.644,04/08/2019,2019.0
6,Cleveland St. (DI Independent),12,6-6,191,111,302,0.632,04/08/2019,2019.0
7,Holy Cross (Patriot),10,5-5,150,89,239,0.628,04/08/2019,2019.0
8,Hobart (NEC),11,8-3,200,120,320,0.625,04/08/2019,2019.0
9,Saint Joseph's (NEC),11,6-5,164,104,268,0.612,04/08/2019,2019.0
10,Hampton (DI Independent),8,4-4,140,89,229,0.611,04/08/2019,2019.0
11,Detroit Mercy (MAAC),10,7-3,152,99,251,0.606,04/08/2019,2019.0
12,Maryland (Big Ten),11,9-2,174,114,288,0.604,04/08/2019,2019.0
13,Syracuse (ACC),9,6-3,138,93,231,0.597,04/08/2019,2019.0
14,Ohio St. (Big Ten),9,7-2,137,93,230,0.596,04/08/2019,2019.0
15,Penn (Ivy League),9,6-3,151,106,257,0.588,04/08/2019,2019.0
16,High Point (SoCon),11,9-2,181,131,312,0.580,04/08/2019,2019.0
17,Johns Hopkins (Big Ten),10,6-4,156,113,269,0.580,04/08/2019,2019.0
18,Boston U. (Patriot),12,8-4,178,129,307,0.580,04/08/2019,2019.0
19,Penn St. (Big Ten),10,9-1,177,130,307,0.577,04/08/2019,2019.0
20,UMass Lowell (America East),11,4-7,156,115,271,0.576,04/08/2019,2019.0
21,Denver (Big East),10,6-4,138,104,242,0.570,04/08/2019,2019.0
22,Bryant (NEC),11,3-8,134,101,235,0.570,04/08/2019,2019.0
23,Air Force (SoCon),11,7-4,145,111,256,0.566,04/08/2019,2019.0
24,Mercer (SoCon),10,1-9,155,123,278,0.558,04/08/2019,2019.0
25,Duke (ACC),12,9-3,161,134,295,0.546,04/08/2019,2019.0
26,Quinnipiac (MAAC),10,6-4,146,123,269,0.543,04/08/2019,2019.0
27,Virginia (ACC),11,9-2,161,136,297,0.542,04/08/2019,2019.0
28,Mount St. Mary's (NEC),12,7-5,158,137,295,0.536,04/08/2019,2019.0
29,Notre Dame (ACC),9,5-4,118,103,221,0.534,04/08/2019,2019.0
30,Hofstra (CAA),11,4-7,126,112,238,0.529,04/08/2019,2019.0
31,Drexel (CAA),10,4-6,152,138,290,0.524,04/08/2019,2019.0
32,Brown (Ivy League),10,4-6,142,133,275,0.516,04/08/2019,2019.0
33,Villanova (Big East),11,7-4,145,141,286,0.507,04/08/2019,2019.0
34,Monmouth (MAAC),9,2-7,83,81,164,0.506,04/08/2019,2019.0
35,Marquette (Big East),10,6-4,136,133,269,0.506,04/08/2019,2019.0
36,North Carolina (ACC),11,7-4,146,144,290,0.503,04/08/2019,2019.0
37,Vermont (America East),10,6-4,125,124,249,0.502,04/08/2019,2019.0
38,Loyola Maryland (Patriot),10,8-2,139,138,277,0.502,04/08/2019,2019.0
39,Fairfield (CAA),11,5-6,147,146,293,0.502,04/08/2019,2019.0
40,Robert Morris (NEC),10,3-7,153,155,308,0.497,04/08/2019,2019.0
41,Colgate (Patriot),10,3-7,116,120,236,0.492,04/08/2019,2019.0
42,St. John's (NY) (Big East),11,4-7,144,152,296,0.486,04/08/2019,2019.0
43,Navy (Patriot),10,5-5,126,134,260,0.485,04/08/2019,2019.0
44,Providence (Big East),11,5-6,130,140,270,0.481,04/08/2019,2019.0
45,Harvard (Ivy League),10,5-5,132,145,277,0.477,04/08/2019,2019.0
46,Bucknell (Patriot),11,3-8,126,141,267,0.472,04/08/2019,2019.0
47,Canisius (MAAC),11,6-5,129,146,275,0.469,04/08/2019,2019.0
48,UAlbany (America East),10,4-6,127,144,271,0.469,04/08/2019,2019.0
49,Stony Brook (America East),11,6-5,122,140,262,0.466,04/08/2019,2019.0
50,Manhattan (MAAC),11,5-6,110,129,239,0.460,04/08/2019,2019.0
51,Wagner (NEC),11,2-9,112,136,248,0.452,04/08/2019,2019.0
52,Delaware (CAA),11,9-2,120,146,266,0.451,04/08/2019,2019.0
53,UMBC (America East),9,3-6,115,141,256,0.449,04/08/2019,2019.0
54,Georgetown (Big East),11,8-3,133,166,299,0.445,04/08/2019,2019.0
55,Hartford (America East),11,2-9,139,176,315,0.441,04/08/2019,2019.0
56,Princeton (Ivy League),10,4-6,123,157,280,0.439,04/08/2019,2019.0
57,Siena (MAAC),9,5-4,114,158,272,0.419,04/08/2019,2019.0
58,Bellarmine (SoCon),10,2-8,111,157,268,0.414,04/08/2019,2019.0
59,Richmond (SoCon),11,7-4,116,166,282,0.411,04/08/2019,2019.0
60,NJIT (DI Independent),12,2-10,132,189,321,0.411,04/08/2019,2019.0
61,Sacred Heart (NEC),11,6-5,129,190,319,0.404,04/08/2019,2019.0
62,Rutgers (Big Ten),11,6-5,114,168,282,0.404,04/08/2019,2019.0
63,Binghamton (America East),9,0-9,86,128,214,0.402,04/08/2019,2019.0
64,VMI (SoCon),9,4-5,98,148,246,0.398,04/08/2019,2019.0
65,Cornell (Ivy League),10,7-3,122,194,316,0.386,04/08/2019,2019.0
66,Furman (SoCon),11,3-8,114,188,302,0.377,04/08/2019,2019.0
67,Jacksonville (SoCon),11,3-8,111,187,298,0.372,04/08/2019,2019.0
68,Michigan (Big Ten),10,3-7,104,184,288,0.361,04/08/2019,2019.0
69,Army West Point (Patriot),11,8-3,91,169,260,0.350,04/08/2019,2019.0
70,Dartmouth (Ivy League),9,2-7,65,142,207,0.314,04/08/2019,2019.0
71,Utah (DI Independent),12,4-8,87,210,297,0.293,04/08/2019,2019.0
72,Lafayette (Patriot),12,4-8,82,217,299,0.274,04/08/2019,2019.0
73,St. Bonaventure (MAAC),10,0-10,58,188,246,0.236,04/08/2019,2019.0
1,Yale (Ivy League),9,7-2,196,58,254,0.772,04/07/2019,2019.0
2,Towson (CAA),10,7-3,189,62,251,0.753,04/07/2019,2019.0
3,Marist (MAAC),10,5-5,148,76,224,0.661,04/07/2019,2019.0
4,Lehigh (Patriot),11,7-4,166,90,256,0.648,04/07/2019,2019.0
5,Massachusetts (CAA),11,7-4,172,95,267,0.644,04/07/2019,2019.0
6,Cleveland St. (DI Independent),12,6-6,191,111,302,0.632,04/07/2019,2019.0
7,Holy Cross (Patriot),10,5-5,150,89,239,0.628,04/07/2019,2019.0
8,Hobart (NEC),11,8-3,200,120,320,0.625,04/07/2019,2019.0
9,Saint Joseph's (NEC),11,6-5,164,104,268,0.612,04/07/2019,2019.0
10,Hampton (DI Independent),8,4-4,140,89,229,0.611,04/07/2019,2019.0
11,Detroit Mercy (MAAC),10,7-3,152,99,251,0.606,04/07/2019,2019.0
12,Maryland (Big Ten),11,9-2,174,114,288,0.604,04/07/2019,2019.0
13,Syracuse (ACC),9,6-3,138,93,231,0.597,04/07/2019,2019.0
14,Ohio St. (Big Ten),9,7-2,137,93,230,0.596,04/07/2019,2019.0
15,Penn (Ivy League),9,6-3,151,106,257,0.588,04/07/2019,2019.0
16,High Point (SoCon),11,9-2,181,131,312,0.580,04/07/2019,2019.0
17,Johns Hopkins (Big Ten),10,6-4,156,113,269,0.580,04/07/2019,2019.0
18,Boston U. (Patriot),12,8-4,178,129,307,0.580,04/07/2019,2019.0
19,Penn St. (Big Ten),10,9-1,177,130,307,0.577,04/07/2019,2019.0
20,UMass Lowell (America East),11,4-7,156,115,271,0.576,04/07/2019,2019.0
21,Denver (Big East),10,6-4,138,104,242,0.570,04/07/2019,2019.0
22,Bryant (NEC),11,3-8,134,101,235,0.570,04/07/2019,2019.0
23,Air Force (SoCon),11,7-4,145,111,256,0.566,04/07/2019,2019.0
24,Mercer (SoCon),10,1-9,155,123,278,0.558,04/07/2019,2019.0
25,Duke (ACC),12,9-3,161,134,295,0.546,04/07/2019,2019.0
26,Quinnipiac (MAAC),10,6-4,146,123,269,0.543,04/07/2019,2019.0
27,Virginia (ACC),11,9-2,161,136,297,0.542,04/07/2019,2019.0
28,Mount St. Mary's (NEC),12,7-5,158,137,295,0.536,04/07/2019,2019.0
29,Notre Dame (ACC),9,5-4,118,103,221,0.534,04/07/2019,2019.0
30,Hofstra (CAA),11,4-7,126,112,238,0.529,04/07/2019,2019.0
31,Drexel (CAA),10,4-6,152,138,290,0.524,04/07/2019,2019.0
32,Brown (Ivy League),10,4-6,142,133,275,0.516,04/07/2019,2019.0
33,Villanova (Big East),11,7-4,145,141,286,0.507,04/07/2019,2019.0
34,Monmouth (MAAC),9,2-7,83,81,164,0.506,04/07/2019,2019.0
35,Marquette (Big East),10,6-4,136,133,269,0.506,04/07/2019,2019.0
36,North Carolina (ACC),11,7-4,146,144,290,0.503,04/07/2019,2019.0
37,Vermont (America East),10,6-4,125,124,249,0.502,04/07/2019,2019.0
38,Loyola Maryland (Patriot),10,8-2,139,138,277,0.502,04/07/2019,2019.0
39,Fairfield (CAA),11,5-6,147,146,293,0.502,04/07/2019,2019.0
40,Robert Morris (NEC),10,3-7,153,155,308,0.497,04/07/2019,2019.0
41,Colgate (Patriot),10,3-7,116,120,236,0.492,04/07/2019,2019.0
42,St. John's (NY) (Big East),11,4-7,144,152,296,0.486,04/07/2019,2019.0
43,Navy (Patriot),10,5-5,126,134,260,0.485,04/07/2019,2019.0
44,Providence (Big East),11,5-6,130,140,270,0.481,04/07/2019,2019.0
45,Harvard (Ivy League),10,5-5,132,145,277,0.477,04/07/2019,2019.0
46,Bucknell (Patriot),11,3-8,126,141,267,0.472,04/07/2019,2019.0
47,Canisius (MAAC),11,6-5,129,146,275,0.469,04/07/2019,2019.0
48,UAlbany (America East),10,4-6,127,144,271,0.469,04/07/2019,2019.0
49,Stony Brook (America East),11,6-5,122,140,262,0.466,04/07/2019,2019.0
50,Manhattan (MAAC),11,5-6,110,129,239,0.460,04/07/2019,2019.0
51,Wagner (NEC),11,2-9,112,136,248,0.452,04/07/2019,2019.0
52,Delaware (CAA),11,9-2,120,146,266,0.451,04/07/2019,2019.0
53,UMBC (America East),9,3-6,115,141,256,0.449,04/07/2019,2019.0
54,Georgetown (Big East),11,8-3,133,166,299,0.445,04/07/2019,2019.0
55,Hartford (America East),11,2-9,139,176,315,0.441,04/07/2019,2019.0
56,Princeton (Ivy League),10,4-6,123,157,280,0.439,04/07/2019,2019.0
57,Siena (MAAC),9,5-4,114,158,272,0.419,04/07/2019,2019.0
58,Bellarmine (SoCon),10,2-8,111,157,268,0.414,04/07/2019,2019.0
59,Richmond (SoCon),11,7-4,116,166,282,0.411,04/07/2019,2019.0
60,NJIT (DI Independent),12,2-10,132,189,321,0.411,04/07/2019,2019.0
61,Sacred Heart (NEC),11,6-5,129,190,319,0.404,04/07/2019,2019.0
62,Rutgers (Big Ten),11,6-5,114,168,282,0.404,04/07/2019,2019.0
63,Binghamton (America East),9,0-9,86,128,214,0.402,04/07/2019,2019.0
64,VMI (SoCon),9,4-5,98,148,246,0.398,04/07/2019,2019.0
65,Cornell (Ivy League),10,7-3,122,194,316,0.386,04/07/2019,2019.0
66,Furman (SoCon),11,3-8,114,188,302,0.377,04/07/2019,2019.0
67,Jacksonville (SoCon),11,3-8,111,187,298,0.372,04/07/2019,2019.0
68,Michigan (Big Ten),10,3-7,104,184,288,0.361,04/07/2019,2019.0
69,Army West Point (Patriot),11,8-3,91,169,260,0.350,04/07/2019,2019.0
70,Dartmouth (Ivy League),9,2-7,65,142,207,0.314,04/07/2019,2019.0
71,Utah (DI Independent),12,4-8,87,210,297,0.293,04/07/2019,2019.0
72,Lafayette (Patriot),12,4-8,82,217,299,0.274,04/07/2019,2019.0
73,St. Bonaventure (MAAC),10,0-10,58,188,246,0.236,04/07/2019,2019.0
1,Yale (Ivy League),9,7-2,196,58,254,0.772,04/06/2019,2019.0
2,Towson (CAA),10,7-3,189,62,251,0.753,04/06/2019,2019.0
3,Marist (MAAC),10,5-5,148,76,224,0.661,04/06/2019,2019.0
4,Lehigh (Patriot),11,7-4,166,90,256,0.648,04/06/2019,2019.0
5,Massachusetts (CAA),11,7-4,172,95,267,0.644,04/06/2019,2019.0
6,Cleveland St. (DI Independent),12,6-6,191,111,302,0.632,04/06/2019,2019.0
7,Holy Cross (Patriot),10,5-5,150,89,239,0.628,04/06/2019,2019.0
8,Hobart (NEC),11,8-3,200,120,320,0.625,04/06/2019,2019.0
9,Saint Joseph's (NEC),11,6-5,164,104,268,0.612,04/06/2019,2019.0
10,Hampton (DI Independent),8,4-4,140,89,229,0.611,04/06/2019,2019.0
11,Detroit Mercy (MAAC),10,7-3,152,99,251,0.606,04/06/2019,2019.0
12,Ohio St. (Big Ten),8,7-1,125,82,207,0.604,04/06/2019,2019.0
13,Syracuse (ACC),9,6-3,138,93,231,0.597,04/06/2019,2019.0
14,Penn (Ivy League),9,6-3,151,106,257,0.588,04/06/2019,2019.0
15,Penn St. (Big Ten),9,8-1,166,118,284,0.585,04/06/2019,2019.0
16,Maryland (Big Ten),10,8-2,149,107,256,0.582,04/06/2019,2019.0
17,High Point (SoCon),11,9-2,181,131,312,0.580,04/06/2019,2019.0
18,Johns Hopkins (Big Ten),10,6-4,156,113,269,0.580,04/06/2019,2019.0
19,Boston U. (Patriot),12,8-4,178,129,307,0.580,04/06/2019,2019.0
20,UMass Lowell (America East),11,4-7,156,115,271,0.576,04/06/2019,2019.0
21,Denver (Big East),10,6-4,138,104,242,0.570,04/06/2019,2019.0
22,Bryant (NEC),11,3-8,134,101,235,0.570,04/06/2019,2019.0
23,Air Force (SoCon),11,7-4,145,111,256,0.566,04/06/2019,2019.0
24,Mercer (SoCon),10,1-9,155,123,278,0.558,04/06/2019,2019.0
25,Duke (ACC),12,9-3,161,134,295,0.546,04/06/2019,2019.0
26,Quinnipiac (MAAC),10,6-4,146,123,269,0.543,04/06/2019,2019.0
27,Virginia (ACC),11,9-2,161,136,297,0.542,04/06/2019,2019.0
28,Mount St. Mary's (NEC),12,7-5,158,137,295,0.536,04/06/2019,2019.0
29,Notre Dame (ACC),9,5-4,118,103,221,0.534,04/06/2019,2019.0
30,Hofstra (CAA),11,4-7,126,112,238,0.529,04/06/2019,2019.0
31,Drexel (CAA),10,4-6,152,138,290,0.524,04/06/2019,2019.0
32,Brown (Ivy League),10,4-6,142,133,275,0.516,04/06/2019,2019.0
33,Villanova (Big East),11,7-4,145,141,286,0.507,04/06/2019,2019.0
34,Monmouth (MAAC),9,2-7,83,81,164,0.506,04/06/2019,2019.0
35,Marquette (Big East),10,6-4,136,133,269,0.506,04/06/2019,2019.0
36,North Carolina (ACC),11,7-4,146,144,290,0.503,04/06/2019,2019.0
37,Vermont (America East),10,6-4,125,124,249,0.502,04/06/2019,2019.0
38,Loyola Maryland (Patriot),10,8-2,139,138,277,0.502,04/06/2019,2019.0
39,Fairfield (CAA),11,5-6,147,146,293,0.502,04/06/2019,2019.0
40,Robert Morris (NEC),10,3-7,153,155,308,0.497,04/06/2019,2019.0
41,Colgate (Patriot),10,3-7,116,120,236,0.492,04/06/2019,2019.0
42,St. John's (NY) (Big East),11,4-7,144,152,296,0.486,04/06/2019,2019.0
43,Navy (Patriot),10,5-5,126,134,260,0.485,04/06/2019,2019.0
44,Providence (Big East),11,5-6,130,140,270,0.481,04/06/2019,2019.0
45,Harvard (Ivy League),10,5-5,132,145,277,0.477,04/06/2019,2019.0
46,Bucknell (Patriot),11,3-8,126,141,267,0.472,04/06/2019,2019.0
47,Canisius (MAAC),11,6-5,129,146,275,0.469,04/06/2019,2019.0
48,UAlbany (America East),10,4-6,127,144,271,0.469,04/06/2019,2019.0
49,Stony Brook (America East),11,6-5,122,140,262,0.466,04/06/2019,2019.0
50,Manhattan (MAAC),11,5-6,110,129,239,0.460,04/06/2019,2019.0
51,Wagner (NEC),11,2-9,112,136,248,0.452,04/06/2019,2019.0
52,Delaware (CAA),11,9-2,120,146,266,0.451,04/06/2019,2019.0
53,UMBC (America East),9,3-6,115,141,256,0.449,04/06/2019,2019.0
54,Georgetown (Big East),11,8-3,133,166,299,0.445,04/06/2019,2019.0
55,Hartford (America East),11,2-9,139,176,315,0.441,04/06/2019,2019.0
56,Princeton (Ivy League),10,4-6,123,157,280,0.439,04/06/2019,2019.0
57,Siena (MAAC),9,5-4,114,158,272,0.419,04/06/2019,2019.0
58,Bellarmine (SoCon),10,2-8,111,157,268,0.414,04/06/2019,2019.0
59,Richmond (SoCon),11,7-4,116,166,282,0.411,04/06/2019,2019.0
60,NJIT (DI Independent),12,2-10,132,189,321,0.411,04/06/2019,2019.0
61,Sacred Heart (NEC),11,6-5,129,190,319,0.404,04/06/2019,2019.0
62,Rutgers (Big Ten),11,6-5,114,168,282,0.404,04/06/2019,2019.0
63,Binghamton (America East),9,0-9,86,128,214,0.402,04/06/2019,2019.0
64,VMI (SoCon),9,4-5,98,148,246,0.398,04/06/2019,2019.0
65,Cornell (Ivy League),10,7-3,122,194,316,0.386,04/06/2019,2019.0
66,Michigan (Big Ten),9,3-6,97,159,256,0.379,04/06/2019,2019.0
67,Furman (SoCon),11,3-8,114,188,302,0.377,04/06/2019,2019.0
68,Jacksonville (SoCon),11,3-8,111,187,298,0.372,04/06/2019,2019.0
69,Army West Point (Patriot),11,8-3,91,169,260,0.350,04/06/2019,2019.0
70,Dartmouth (Ivy League),9,2-7,65,142,207,0.314,04/06/2019,2019.0
71,Utah (DI Independent),12,4-8,87,210,297,0.293,04/06/2019,2019.0
72,Lafayette (Patriot),12,4-8,82,217,299,0.274,04/06/2019,2019.0
73,St. Bonaventure (MAAC),10,0-10,58,188,246,0.236,04/06/2019,2019.0
1,Yale (Ivy League),8,6-2,168,56,224,0.750,04/02/2019,2019.0
2,Towson (CAA),9,6-3,166,60,226,0.735,04/02/2019,2019.0
3,Lehigh (Patriot),10,7-3,155,74,229,0.677,04/02/2019,2019.0
4,Hobart (NEC),10,8-2,191,103,294,0.650,04/02/2019,2019.0
5,Marist (MAAC),9,4-5,127,69,196,0.648,04/02/2019,2019.0
6,Massachusetts (CAA),10,7-3,156,88,244,0.639,04/02/2019,2019.0
7,Cleveland St. (DI Independent),11,5-6,170,105,275,0.618,04/02/2019,2019.0
8,Hampton (DI Independent),7,4-3,116,74,190,0.611,04/02/2019,2019.0
9,Saint Joseph's (NEC),10,5-5,147,95,242,0.607,04/02/2019,2019.0
10,Ohio St. (Big Ten),8,7-1,125,82,207,0.604,04/02/2019,2019.0
11,Detroit Mercy (MAAC),9,6-3,139,93,232,0.599,04/02/2019,2019.0
12,Syracuse (ACC),9,6-3,138,93,231,0.597,04/02/2019,2019.0
13,Holy Cross (Patriot),9,4-5,128,87,215,0.595,04/02/2019,2019.0
14,UMass Lowell (America East),10,4-6,144,98,242,0.595,04/02/2019,2019.0
15,High Point (SoCon),10,8-2,170,117,287,0.592,04/02/2019,2019.0
16,Penn (Ivy League),8,5-3,135,93,228,0.592,04/02/2019,2019.0
17,Penn St. (Big Ten),9,8-1,166,118,284,0.585,04/02/2019,2019.0
18,Maryland (Big Ten),10,8-2,149,107,256,0.582,04/02/2019,2019.0
19,Bryant (NEC),10,3-7,122,90,212,0.575,04/02/2019,2019.0
20,Boston U. (Patriot),11,7-4,156,119,275,0.567,04/02/2019,2019.0
21,Air Force (SoCon),10,7-3,131,100,231,0.567,04/02/2019,2019.0
22,Johns Hopkins (Big Ten),9,5-4,135,104,239,0.565,04/02/2019,2019.0
23,Hofstra (CAA),10,3-7,120,95,215,0.558,04/02/2019,2019.0
24,Duke (ACC),11,8-3,150,119,269,0.558,04/02/2019,2019.0
25,Denver (Big East),9,6-3,118,97,215,0.549,04/02/2019,2019.0
26,Quinnipiac (MAAC),9,6-3,136,113,249,0.546,04/02/2019,2019.0
27,Fairfield (CAA),10,5-5,144,124,268,0.537,04/02/2019,2019.0
28,Villanova (Big East),10,6-4,138,121,259,0.533,04/02/2019,2019.0
29,Notre Dame (ACC),8,5-3,103,92,195,0.528,04/02/2019,2019.0
30,Virginia (ACC),10,8-2,144,130,274,0.526,04/02/2019,2019.0
31,Brown (Ivy League),9,4-5,129,117,246,0.524,04/02/2019,2019.0
32,North Carolina (ACC),10,7-3,140,127,267,0.524,04/02/2019,2019.0
33,Mercer (SoCon),9,1-8,126,119,245,0.514,04/02/2019,2019.0
34,Mount St. Mary's (NEC),11,6-5,134,127,261,0.513,04/02/2019,2019.0
35,Drexel (CAA),9,4-5,132,127,259,0.510,04/02/2019,2019.0
36,Monmouth (MAAC),9,2-7,83,81,164,0.506,04/02/2019,2019.0
37,St. John's (NY) (Big East),10,4-6,137,137,274,0.500,04/02/2019,2019.0
38,Robert Morris (NEC),9,2-7,139,142,281,0.495,04/02/2019,2019.0
39,Loyola Maryland (Patriot),9,7-2,123,127,250,0.492,04/02/2019,2019.0
40,Colgate (Patriot),9,3-6,101,105,206,0.490,04/02/2019,2019.0
41,Marquette (Big East),9,5-4,121,126,247,0.490,04/02/2019,2019.0
42,UAlbany (America East),9,4-5,121,127,248,0.488,04/02/2019,2019.0
43,Navy (Patriot),9,4-5,111,119,230,0.483,04/02/2019,2019.0
44,Vermont (America East),9,5-4,108,118,226,0.478,04/02/2019,2019.0
45,Manhattan (MAAC),10,5-5,104,116,220,0.473,04/02/2019,2019.0
46,Bucknell (Patriot),11,3-8,126,141,267,0.472,04/02/2019,2019.0
47,Providence (Big East),10,5-5,110,124,234,0.470,04/02/2019,2019.0
48,Canisius (MAAC),10,5-5,119,136,255,0.467,04/02/2019,2019.0
49,Delaware (CAA),10,8-2,109,126,235,0.464,04/02/2019,2019.0
50,Harvard (Ivy League),9,5-4,111,133,244,0.455,04/02/2019,2019.0
51,Stony Brook (America East),10,6-4,108,132,240,0.450,04/02/2019,2019.0
52,Wagner (NEC),10,2-8,99,122,221,0.448,04/02/2019,2019.0
53,Princeton (Ivy League),9,3-6,115,143,258,0.446,04/02/2019,2019.0
54,Georgetown (Big East),10,7-3,117,146,263,0.445,04/02/2019,2019.0
55,UMBC (America East),8,2-6,103,131,234,0.440,04/02/2019,2019.0
56,Siena (MAAC),8,5-3,107,137,244,0.439,04/02/2019,2019.0
57,Hartford (America East),10,1-9,122,164,286,0.427,04/02/2019,2019.0
58,Rutgers (Big Ten),10,6-4,105,147,252,0.417,04/02/2019,2019.0
59,Richmond (SoCon),10,6-4,107,150,257,0.416,04/02/2019,2019.0
60,NJIT (DI Independent),11,1-10,117,165,282,0.415,04/02/2019,2019.0
61,Furman (SoCon),10,2-8,110,159,269,0.409,04/02/2019,2019.0
62,Bellarmine (SoCon),9,1-8,96,143,239,0.402,04/02/2019,2019.0
63,Sacred Heart (NEC),10,5-5,118,178,296,0.399,04/02/2019,2019.0
64,Binghamton (America East),8,0-8,76,116,192,0.396,04/02/2019,2019.0
65,Cornell (Ivy League),9,6-3,110,173,283,0.389,04/02/2019,2019.0
66,VMI (SoCon),8,4-4,84,133,217,0.387,04/02/2019,2019.0
67,Michigan (Big Ten),9,3-6,97,159,256,0.379,04/02/2019,2019.0
68,Dartmouth (Ivy League),8,2-6,63,114,177,0.356,04/02/2019,2019.0
69,Army West Point (Patriot),10,8-2,81,147,228,0.355,04/02/2019,2019.0
70,Jacksonville (SoCon),10,3-7,95,178,273,0.348,04/02/2019,2019.0
71,Utah (DI Independent),11,4-7,77,186,263,0.293,04/02/2019,2019.0
72,Lafayette (Patriot),11,4-7,80,195,275,0.291,04/02/2019,2019.0
73,St. Bonaventure (MAAC),9,0-9,52,167,219,0.237,04/02/2019,2019.0
1,Yale (Ivy League),8,6-2,168,56,224,0.750,03/31/2019,2019.0
2,Towson (CAA),9,6-3,166,60,226,0.735,03/31/2019,2019.0
3,Lehigh (Patriot),10,7-3,155,74,229,0.677,03/31/2019,2019.0
4,Hobart (NEC),9,8-1,178,90,268,0.664,03/31/2019,2019.0
5,Marist (MAAC),8,4-4,116,60,176,0.659,03/31/2019,2019.0
6,Massachusetts (CAA),10,7-3,156,88,244,0.639,03/31/2019,2019.0
7,Cleveland St. (DI Independent),10,4-6,149,94,243,0.613,03/31/2019,2019.0
8,Hampton (DI Independent),7,4-3,116,74,190,0.611,03/31/2019,2019.0
9,Syracuse (ACC),8,5-3,125,80,205,0.610,03/31/2019,2019.0
10,Saint Joseph's (NEC),10,5-5,147,95,242,0.607,03/31/2019,2019.0
11,Ohio St. (Big Ten),8,7-1,125,82,207,0.604,03/31/2019,2019.0
12,Detroit Mercy (MAAC),9,6-3,139,93,232,0.599,03/31/2019,2019.0
13,Holy Cross (Patriot),9,4-5,128,87,215,0.595,03/31/2019,2019.0
14,UMass Lowell (America East),10,4-6,144,98,242,0.595,03/31/2019,2019.0
15,High Point (SoCon),10,8-2,170,117,287,0.592,03/31/2019,2019.0
16,Penn (Ivy League),8,5-3,135,93,228,0.592,03/31/2019,2019.0
17,Penn St. (Big Ten),9,8-1,166,118,284,0.585,03/31/2019,2019.0
18,Maryland (Big Ten),10,8-2,149,107,256,0.582,03/31/2019,2019.0
19,Bryant (NEC),10,3-7,122,90,212,0.575,03/31/2019,2019.0
20,Boston U. (Patriot),11,7-4,156,119,275,0.567,03/31/2019,2019.0
21,Air Force (SoCon),10,7-3,131,100,231,0.567,03/31/2019,2019.0
22,Johns Hopkins (Big Ten),9,5-4,135,104,239,0.565,03/31/2019,2019.0
23,Hofstra (CAA),10,3-7,120,95,215,0.558,03/31/2019,2019.0
24,Duke (ACC),11,8-3,150,119,269,0.558,03/31/2019,2019.0
25,Denver (Big East),9,6-3,118,97,215,0.549,03/31/2019,2019.0
26,Quinnipiac (MAAC),9,6-3,136,113,249,0.546,03/31/2019,2019.0
27,Fairfield (CAA),10,5-5,144,124,268,0.537,03/31/2019,2019.0
28,Villanova (Big East),10,6-4,138,121,259,0.533,03/31/2019,2019.0
29,Notre Dame (ACC),8,5-3,103,92,195,0.528,03/31/2019,2019.0
30,Virginia (ACC),10,8-2,144,130,274,0.526,03/31/2019,2019.0
31,Brown (Ivy League),9,4-5,129,117,246,0.524,03/31/2019,2019.0
32,North Carolina (ACC),10,7-3,140,127,267,0.524,03/31/2019,2019.0
33,Mercer (SoCon),9,1-8,126,119,245,0.514,03/31/2019,2019.0
34,Mount St. Mary's (NEC),11,6-5,134,127,261,0.513,03/31/2019,2019.0
35,Drexel (CAA),9,4-5,132,127,259,0.510,03/31/2019,2019.0
36,St. John's (NY) (Big East),9,4-5,124,124,248,0.500,03/31/2019,2019.0
37,Robert Morris (NEC),9,2-7,139,142,281,0.495,03/31/2019,2019.0
38,Loyola Maryland (Patriot),9,7-2,123,127,250,0.492,03/31/2019,2019.0
39,Colgate (Patriot),9,3-6,101,105,206,0.490,03/31/2019,2019.0
40,Marquette (Big East),9,5-4,121,126,247,0.490,03/31/2019,2019.0
41,UAlbany (America East),9,4-5,121,127,248,0.488,03/31/2019,2019.0
42,Canisius (MAAC),9,5-4,108,115,223,0.484,03/31/2019,2019.0
43,Monmouth (MAAC),8,1-7,72,77,149,0.483,03/31/2019,2019.0
44,Navy (Patriot),9,4-5,111,119,230,0.483,03/31/2019,2019.0
45,Vermont (America East),9,5-4,108,118,226,0.478,03/31/2019,2019.0
46,Bucknell (Patriot),10,2-8,117,130,247,0.474,03/31/2019,2019.0
47,Manhattan (MAAC),10,5-5,104,116,220,0.473,03/31/2019,2019.0
48,Providence (Big East),10,5-5,110,124,234,0.470,03/31/2019,2019.0
49,Delaware (CAA),10,8-2,109,126,235,0.464,03/31/2019,2019.0
50,Harvard (Ivy League),9,5-4,111,133,244,0.455,03/31/2019,2019.0
51,Wagner (NEC),10,2-8,99,122,221,0.448,03/31/2019,2019.0
52,Princeton (Ivy League),9,3-6,115,143,258,0.446,03/31/2019,2019.0
53,Georgetown (Big East),10,7-3,117,146,263,0.445,03/31/2019,2019.0
54,Stony Brook (America East),9,5-4,95,119,214,0.444,03/31/2019,2019.0
55,UMBC (America East),8,2-6,103,131,234,0.440,03/31/2019,2019.0
56,Siena (MAAC),8,5-3,107,137,244,0.439,03/31/2019,2019.0
57,Hartford (America East),10,1-9,122,164,286,0.427,03/31/2019,2019.0
58,Rutgers (Big Ten),10,6-4,105,147,252,0.417,03/31/2019,2019.0
59,Richmond (SoCon),10,6-4,107,150,257,0.416,03/31/2019,2019.0
60,NJIT (DI Independent),11,1-10,117,165,282,0.415,03/31/2019,2019.0
61,Furman (SoCon),10,2-8,110,159,269,0.409,03/31/2019,2019.0
62,Bellarmine (SoCon),9,1-8,96,143,239,0.402,03/31/2019,2019.0
63,Sacred Heart (NEC),10,5-5,118,178,296,0.399,03/31/2019,2019.0
64,Binghamton (America East),8,0-8,76,116,192,0.396,03/31/2019,2019.0
65,Cornell (Ivy League),9,6-3,110,173,283,0.389,03/31/2019,2019.0
66,VMI (SoCon),8,4-4,84,133,217,0.387,03/31/2019,2019.0
67,Michigan (Big Ten),9,3-6,97,159,256,0.379,03/31/2019,2019.0
68,Dartmouth (Ivy League),8,2-6,63,114,177,0.356,03/31/2019,2019.0
69,Army West Point (Patriot),10,8-2,81,147,228,0.355,03/31/2019,2019.0
70,Jacksonville (SoCon),10,3-7,95,178,273,0.348,03/31/2019,2019.0
71,Utah (DI Independent),11,4-7,77,186,263,0.293,03/31/2019,2019.0
72,Lafayette (Patriot),11,4-7,80,195,275,0.291,03/31/2019,2019.0
73,St. Bonaventure (MAAC),8,0-8,48,156,204,0.235,03/31/2019,2019.0
1,Yale (Ivy League),7,6-1,153,42,195,0.785,03/27/2019,2019.0
2,Towson (CAA),8,5-3,155,50,205,0.756,03/27/2019,2019.0
3,Lehigh (Patriot),9,6-3,141,66,207,0.681,03/27/2019,2019.0
4,Marist (MAAC),7,4-3,101,48,149,0.678,03/27/2019,2019.0
5,Hobart (NEC),9,8-1,178,90,268,0.664,03/27/2019,2019.0
6,Massachusetts (CAA),9,6-3,141,80,221,0.638,03/27/2019,2019.0
7,Detroit Mercy (MAAC),8,5-3,127,78,205,0.620,03/27/2019,2019.0
8,Cleveland St. (DI Independent),10,4-6,149,94,243,0.613,03/27/2019,2019.0
9,Maryland (Big Ten),9,8-1,141,89,230,0.613,03/27/2019,2019.0
10,Holy Cross (Patriot),8,3-5,116,74,190,0.611,03/27/2019,2019.0
11,Syracuse (ACC),7,5-2,109,70,179,0.609,03/27/2019,2019.0
12,Penn (Ivy League),7,4-3,121,78,199,0.608,03/27/2019,2019.0
13,Hampton (DI Independent),6,4-2,94,61,155,0.606,03/27/2019,2019.0
14,UMass Lowell (America East),9,3-6,137,91,228,0.601,03/27/2019,2019.0
15,High Point (SoCon),9,7-2,153,104,257,0.595,03/27/2019,2019.0
16,Saint Joseph's (NEC),9,5-4,127,88,215,0.591,03/27/2019,2019.0
17,Boston U. (Patriot),10,7-3,148,105,253,0.585,03/27/2019,2019.0
18,Ohio St. (Big Ten),7,7-0,108,77,185,0.584,03/27/2019,2019.0
19,Bryant (NEC),9,2-7,110,81,191,0.576,03/27/2019,2019.0
20,Penn St. (Big Ten),8,7-1,148,110,258,0.574,03/27/2019,2019.0
21,Duke (ACC),10,8-2,141,106,247,0.571,03/27/2019,2019.0
22,Hofstra (CAA),9,3-6,110,84,194,0.567,03/27/2019,2019.0
23,Notre Dame (ACC),7,4-3,93,76,169,0.550,03/27/2019,2019.0
24,Johns Hopkins (Big Ten),8,4-4,116,98,214,0.542,03/27/2019,2019.0
25,Fairfield (CAA),9,5-4,131,112,243,0.539,03/27/2019,2019.0
26,Denver (Big East),8,5-3,100,86,186,0.538,03/27/2019,2019.0
27,Villanova (Big East),9,5-4,123,106,229,0.537,03/27/2019,2019.0
28,Quinnipiac (MAAC),8,5-3,118,104,222,0.532,03/27/2019,2019.0
29,Air Force (SoCon),9,6-3,110,97,207,0.531,03/27/2019,2019.0
30,Drexel (CAA),8,4-4,124,112,236,0.525,03/27/2019,2019.0
31,Mount St. Mary's (NEC),10,5-5,122,112,234,0.521,03/27/2019,2019.0
32,Robert Morris (NEC),8,1-7,132,122,254,0.520,03/27/2019,2019.0
33,North Carolina (ACC),9,6-3,127,118,245,0.518,03/27/2019,2019.0
34,Brown (Ivy League),8,3-5,113,106,219,0.516,03/27/2019,2019.0
35,Mercer (SoCon),8,1-7,109,103,212,0.514,03/27/2019,2019.0
36,Monmouth (MAAC),7,1-6,66,66,132,0.500,03/27/2019,2019.0
37,Loyola Maryland (Patriot),8,6-2,109,110,219,0.498,03/27/2019,2019.0
38,St. John's (NY) (Big East),8,4-4,113,116,229,0.493,03/27/2019,2019.0
39,Marquette (Big East),8,5-3,106,111,217,0.488,03/27/2019,2019.0
40,Manhattan (MAAC),9,4-5,95,101,196,0.485,03/27/2019,2019.0
41,Colgate (Patriot),8,3-5,84,91,175,0.480,03/27/2019,2019.0
42,Navy (Patriot),8,4-4,98,107,205,0.478,03/27/2019,2019.0
43,Virginia (ACC),8,6-2,106,116,222,0.477,03/27/2019,2019.0
44,Vermont (America East),8,5-3,101,111,212,0.476,03/27/2019,2019.0
45,Providence (Big East),9,4-5,102,113,215,0.474,03/27/2019,2019.0
46,Canisius (MAAC),8,4-4,97,109,206,0.471,03/27/2019,2019.0
47,Delaware (CAA),9,7-2,97,113,210,0.462,03/27/2019,2019.0
48,UAlbany (America East),8,3-5,102,119,221,0.462,03/27/2019,2019.0
49,Harvard (Ivy League),9,5-4,111,133,244,0.455,03/27/2019,2019.0
50,Georgetown (Big East),9,7-2,106,128,234,0.453,03/27/2019,2019.0
51,Siena (MAAC),7,5-2,98,119,217,0.452,03/27/2019,2019.0
52,Princeton (Ivy League),8,3-5,104,127,231,0.450,03/27/2019,2019.0
53,Wagner (NEC),9,2-7,90,110,200,0.450,03/27/2019,2019.0
54,Bucknell (Patriot),9,2-7,97,119,216,0.449,03/27/2019,2019.0
55,Hartford (America East),9,1-8,114,145,259,0.440,03/27/2019,2019.0
56,Stony Brook (America East),8,4-4,84,109,193,0.435,03/27/2019,2019.0
57,Rutgers (Big Ten),9,5-4,100,130,230,0.435,03/27/2019,2019.0
58,Richmond (SoCon),9,6-3,98,132,230,0.426,03/27/2019,2019.0
59,Furman (SoCon),9,2-7,97,142,239,0.406,03/27/2019,2019.0
60,NJIT (DI Independent),10,1-9,102,156,258,0.395,03/27/2019,2019.0
61,Michigan (Big Ten),8,3-5,91,140,231,0.394,03/27/2019,2019.0
62,VMI (SoCon),7,3-4,71,111,182,0.390,03/27/2019,2019.0
63,Bellarmine (SoCon),8,0-8,80,126,206,0.388,03/27/2019,2019.0
64,Binghamton (America East),7,0-7,66,105,171,0.386,03/27/2019,2019.0
65,Sacred Heart (NEC),9,5-4,103,166,269,0.383,03/27/2019,2019.0
66,UMBC (America East),7,1-6,78,126,204,0.382,03/27/2019,2019.0
67,Jacksonville (SoCon),9,3-6,92,157,249,0.369,03/27/2019,2019.0
68,Cornell (Ivy League),8,5-3,94,165,259,0.363,03/27/2019,2019.0
69,Dartmouth (Ivy League),7,2-5,55,98,153,0.359,03/27/2019,2019.0
70,Army West Point (Patriot),9,7-2,70,127,197,0.355,03/27/2019,2019.0
71,Lafayette (Patriot),10,4-6,75,170,245,0.306,03/27/2019,2019.0
72,Utah (DI Independent),10,4-6,72,166,238,0.303,03/27/2019,2019.0
73,St. Bonaventure (MAAC),8,0-8,48,156,204,0.235,03/27/2019,2019.0
1,Yale (Ivy League),7,6-1,153,42,195,0.785,03/26/2019,2019.0
2,Towson (CAA),8,5-3,155,50,205,0.756,03/26/2019,2019.0
3,Lehigh (Patriot),9,6-3,141,66,207,0.681,03/26/2019,2019.0
4,Marist (MAAC),7,4-3,101,48,149,0.678,03/26/2019,2019.0
5,Hobart (NEC),8,7-1,155,83,238,0.651,03/26/2019,2019.0
6,Massachusetts (CAA),9,6-3,141,80,221,0.638,03/26/2019,2019.0
7,Detroit Mercy (MAAC),8,5-3,127,78,205,0.620,03/26/2019,2019.0
8,Cleveland St. (DI Independent),10,4-6,149,94,243,0.613,03/26/2019,2019.0
9,Maryland (Big Ten),9,8-1,141,89,230,0.613,03/26/2019,2019.0
10,Holy Cross (Patriot),8,3-5,116,74,190,0.611,03/26/2019,2019.0
11,Syracuse (ACC),7,5-2,109,70,179,0.609,03/26/2019,2019.0
12,Penn (Ivy League),7,4-3,121,78,199,0.608,03/26/2019,2019.0
13,Hampton (DI Independent),6,4-2,94,61,155,0.606,03/26/2019,2019.0
14,UMass Lowell (America East),9,3-6,137,91,228,0.601,03/26/2019,2019.0
15,High Point (SoCon),9,7-2,153,104,257,0.595,03/26/2019,2019.0
16,Saint Joseph's (NEC),9,5-4,127,88,215,0.591,03/26/2019,2019.0
17,Boston U. (Patriot),10,7-3,148,105,253,0.585,03/26/2019,2019.0
18,Ohio St. (Big Ten),7,7-0,108,77,185,0.584,03/26/2019,2019.0
19,Bryant (NEC),9,2-7,110,81,191,0.576,03/26/2019,2019.0
20,Penn St. (Big Ten),8,7-1,148,110,258,0.574,03/26/2019,2019.0
21,Duke (ACC),10,8-2,141,106,247,0.571,03/26/2019,2019.0
22,Hofstra (CAA),9,3-6,110,84,194,0.567,03/26/2019,2019.0
23,Notre Dame (ACC),7,4-3,93,76,169,0.550,03/26/2019,2019.0
24,Johns Hopkins (Big Ten),8,4-4,116,98,214,0.542,03/26/2019,2019.0
25,Fairfield (CAA),9,5-4,131,112,243,0.539,03/26/2019,2019.0
26,Denver (Big East),8,5-3,100,86,186,0.538,03/26/2019,2019.0
27,Villanova (Big East),9,5-4,123,106,229,0.537,03/26/2019,2019.0
28,Quinnipiac (MAAC),8,5-3,118,104,222,0.532,03/26/2019,2019.0
29,Air Force (SoCon),9,6-3,110,97,207,0.531,03/26/2019,2019.0
30,Drexel (CAA),8,4-4,124,112,236,0.525,03/26/2019,2019.0
31,Mount St. Mary's (NEC),10,5-5,122,112,234,0.521,03/26/2019,2019.0
32,Robert Morris (NEC),8,1-7,132,122,254,0.520,03/26/2019,2019.0
33,North Carolina (ACC),9,6-3,127,118,245,0.518,03/26/2019,2019.0
34,Brown (Ivy League),8,3-5,113,106,219,0.516,03/26/2019,2019.0
35,Mercer (SoCon),8,1-7,109,103,212,0.514,03/26/2019,2019.0
36,Monmouth (MAAC),7,1-6,66,66,132,0.500,03/26/2019,2019.0
37,Loyola Maryland (Patriot),8,6-2,109,110,219,0.498,03/26/2019,2019.0
38,St. John's (NY) (Big East),8,4-4,113,116,229,0.493,03/26/2019,2019.0
39,Marquette (Big East),8,5-3,106,111,217,0.488,03/26/2019,2019.0
40,Manhattan (MAAC),9,4-5,95,101,196,0.485,03/26/2019,2019.0
41,Colgate (Patriot),8,3-5,84,91,175,0.480,03/26/2019,2019.0
42,Navy (Patriot),8,4-4,98,107,205,0.478,03/26/2019,2019.0
43,Virginia (ACC),8,6-2,106,116,222,0.477,03/26/2019,2019.0
44,Vermont (America East),8,5-3,101,111,212,0.476,03/26/2019,2019.0
45,Providence (Big East),9,4-5,102,113,215,0.474,03/26/2019,2019.0
46,Canisius (MAAC),8,4-4,97,109,206,0.471,03/26/2019,2019.0
47,Delaware (CAA),9,7-2,97,113,210,0.462,03/26/2019,2019.0
48,Harvard (Ivy League),8,4-4,99,116,215,0.460,03/26/2019,2019.0
49,Georgetown (Big East),9,7-2,106,128,234,0.453,03/26/2019,2019.0
50,Siena (MAAC),7,5-2,98,119,217,0.452,03/26/2019,2019.0
51,Princeton (Ivy League),8,3-5,104,127,231,0.450,03/26/2019,2019.0
52,Wagner (NEC),9,2-7,90,110,200,0.450,03/26/2019,2019.0
53,Bucknell (Patriot),9,2-7,97,119,216,0.449,03/26/2019,2019.0
54,UAlbany (America East),7,3-4,85,107,192,0.443,03/26/2019,2019.0
55,Hartford (America East),9,1-8,114,145,259,0.440,03/26/2019,2019.0
56,Stony Brook (America East),8,4-4,84,109,193,0.435,03/26/2019,2019.0
57,Rutgers (Big Ten),9,5-4,100,130,230,0.435,03/26/2019,2019.0
58,Richmond (SoCon),9,6-3,98,132,230,0.426,03/26/2019,2019.0
59,Furman (SoCon),9,2-7,97,142,239,0.406,03/26/2019,2019.0
60,NJIT (DI Independent),10,1-9,102,156,258,0.395,03/26/2019,2019.0
61,Michigan (Big Ten),8,3-5,91,140,231,0.394,03/26/2019,2019.0
62,VMI (SoCon),7,3-4,71,111,182,0.390,03/26/2019,2019.0
63,Bellarmine (SoCon),8,0-8,80,126,206,0.388,03/26/2019,2019.0
64,Binghamton (America East),7,0-7,66,105,171,0.386,03/26/2019,2019.0
65,Sacred Heart (NEC),9,5-4,103,166,269,0.383,03/26/2019,2019.0
66,UMBC (America East),7,1-6,78,126,204,0.382,03/26/2019,2019.0
67,Jacksonville (SoCon),9,3-6,92,157,249,0.369,03/26/2019,2019.0
68,Cornell (Ivy League),8,5-3,94,165,259,0.363,03/26/2019,2019.0
69,Dartmouth (Ivy League),7,2-5,55,98,153,0.359,03/26/2019,2019.0
70,Army West Point (Patriot),9,7-2,70,127,197,0.355,03/26/2019,2019.0
71,Lafayette (Patriot),10,4-6,75,170,245,0.306,03/26/2019,2019.0
72,Utah (DI Independent),10,4-6,72,166,238,0.303,03/26/2019,2019.0
73,St. Bonaventure (MAAC),7,0-7,41,133,174,0.236,03/26/2019,2019.0
1,Yale (Ivy League),6,5-1,133,39,172,0.773,03/25/2019,2019.0
2,Towson (CAA),8,5-3,155,50,205,0.756,03/25/2019,2019.0
3,Lehigh (Patriot),9,6-3,141,66,207,0.681,03/25/2019,2019.0
4,Marist (MAAC),7,4-3,101,48,149,0.678,03/25/2019,2019.0
5,Hobart (NEC),8,7-1,155,83,238,0.651,03/25/2019,2019.0
6,Massachusetts (CAA),9,6-3,141,80,221,0.638,03/25/2019,2019.0
7,Detroit Mercy (MAAC),8,5-3,127,78,205,0.620,03/25/2019,2019.0
8,Cleveland St. (DI Independent),10,4-6,149,94,243,0.613,03/25/2019,2019.0
9,Maryland (Big Ten),9,8-1,141,89,230,0.613,03/25/2019,2019.0
10,Holy Cross (Patriot),8,3-5,116,74,190,0.611,03/25/2019,2019.0
11,Syracuse (ACC),7,5-2,109,70,179,0.609,03/25/2019,2019.0
12,Penn (Ivy League),7,4-3,121,78,199,0.608,03/25/2019,2019.0
13,Hampton (DI Independent),6,4-2,94,61,155,0.606,03/25/2019,2019.0
14,UMass Lowell (America East),9,3-6,137,91,228,0.601,03/25/2019,2019.0
15,High Point (SoCon),9,7-2,153,104,257,0.595,03/25/2019,2019.0
16,Saint Joseph's (NEC),9,5-4,127,88,215,0.591,03/25/2019,2019.0
17,Boston U. (Patriot),10,7-3,148,105,253,0.585,03/25/2019,2019.0
18,Ohio St. (Big Ten),7,7-0,108,77,185,0.584,03/25/2019,2019.0
19,Air Force (SoCon),8,6-2,107,77,184,0.582,03/25/2019,2019.0
20,Bryant (NEC),9,2-7,110,81,191,0.576,03/25/2019,2019.0
21,Penn St. (Big Ten),8,7-1,148,110,258,0.574,03/25/2019,2019.0
22,Duke (ACC),10,8-2,141,106,247,0.571,03/25/2019,2019.0
23,Hofstra (CAA),9,3-6,110,84,194,0.567,03/25/2019,2019.0
24,Notre Dame (ACC),7,4-3,93,76,169,0.550,03/25/2019,2019.0
25,Johns Hopkins (Big Ten),8,4-4,116,98,214,0.542,03/25/2019,2019.0
26,Fairfield (CAA),9,5-4,131,112,243,0.539,03/25/2019,2019.0
27,Villanova (Big East),9,5-4,123,106,229,0.537,03/25/2019,2019.0
28,Quinnipiac (MAAC),8,5-3,118,104,222,0.532,03/25/2019,2019.0
29,Drexel (CAA),8,4-4,124,112,236,0.525,03/25/2019,2019.0
30,Mount St. Mary's (NEC),10,5-5,122,112,234,0.521,03/25/2019,2019.0
31,Robert Morris (NEC),8,1-7,132,122,254,0.520,03/25/2019,2019.0
32,North Carolina (ACC),9,6-3,127,118,245,0.518,03/25/2019,2019.0
33,Denver (Big East),7,5-2,80,75,155,0.516,03/25/2019,2019.0
34,Brown (Ivy League),8,3-5,113,106,219,0.516,03/25/2019,2019.0
35,Mercer (SoCon),8,1-7,109,103,212,0.514,03/25/2019,2019.0
36,Monmouth (MAAC),7,1-6,66,66,132,0.500,03/25/2019,2019.0
37,Loyola Maryland (Patriot),8,6-2,109,110,219,0.498,03/25/2019,2019.0
38,St. John's (NY) (Big East),8,4-4,113,116,229,0.493,03/25/2019,2019.0
39,Marquette (Big East),8,5-3,106,111,217,0.488,03/25/2019,2019.0
40,Manhattan (MAAC),9,4-5,95,101,196,0.485,03/25/2019,2019.0
41,Colgate (Patriot),8,3-5,84,91,175,0.480,03/25/2019,2019.0
42,Navy (Patriot),8,4-4,98,107,205,0.478,03/25/2019,2019.0
43,Virginia (ACC),8,6-2,106,116,222,0.477,03/25/2019,2019.0
44,Providence (Big East),9,4-5,102,113,215,0.474,03/25/2019,2019.0
45,Vermont (America East),8,5-3,100,112,212,0.472,03/25/2019,2019.0
46,Canisius (MAAC),8,4-4,97,109,206,0.471,03/25/2019,2019.0
47,Princeton (Ivy League),7,2-5,93,107,200,0.465,03/25/2019,2019.0
48,Delaware (CAA),9,7-2,97,113,210,0.462,03/25/2019,2019.0
49,Harvard (Ivy League),8,4-4,99,116,215,0.460,03/25/2019,2019.0
50,Georgetown (Big East),9,7-2,106,128,234,0.453,03/25/2019,2019.0
51,Siena (MAAC),7,5-2,98,119,217,0.452,03/25/2019,2019.0
52,Wagner (NEC),9,2-7,90,110,200,0.450,03/25/2019,2019.0
53,Bucknell (Patriot),9,2-7,97,119,216,0.449,03/25/2019,2019.0
54,Hartford (America East),9,1-8,115,144,259,0.444,03/25/2019,2019.0
55,UAlbany (America East),7,3-4,85,107,192,0.443,03/25/2019,2019.0
56,Stony Brook (America East),8,4-4,84,109,193,0.435,03/25/2019,2019.0
57,Rutgers (Big Ten),9,5-4,100,130,230,0.435,03/25/2019,2019.0
58,Richmond (SoCon),9,6-3,98,132,230,0.426,03/25/2019,2019.0
59,Furman (SoCon),9,2-7,97,142,239,0.406,03/25/2019,2019.0
60,NJIT (DI Independent),10,1-9,102,156,258,0.395,03/25/2019,2019.0
61,Michigan (Big Ten),8,3-5,91,140,231,0.394,03/25/2019,2019.0
62,VMI (SoCon),7,3-4,71,111,182,0.390,03/25/2019,2019.0
63,Bellarmine (SoCon),8,0-8,80,126,206,0.388,03/25/2019,2019.0
64,Binghamton (America East),7,0-7,66,105,171,0.386,03/25/2019,2019.0
65,Sacred Heart (NEC),9,5-4,103,166,269,0.383,03/25/2019,2019.0
66,UMBC (America East),7,1-6,78,126,204,0.382,03/25/2019,2019.0
67,Jacksonville (SoCon),9,3-6,92,157,249,0.369,03/25/2019,2019.0
68,Cornell (Ivy League),8,5-3,94,165,259,0.363,03/25/2019,2019.0
69,Dartmouth (Ivy League),7,2-5,55,98,153,0.359,03/25/2019,2019.0
70,Army West Point (Patriot),9,7-2,70,127,197,0.355,03/25/2019,2019.0
71,Lafayette (Patriot),10,4-6,75,170,245,0.306,03/25/2019,2019.0
72,Utah (DI Independent),10,4-6,72,166,238,0.303,03/25/2019,2019.0
73,St. Bonaventure (MAAC),7,0-7,41,133,174,0.236,03/25/2019,2019.0
1,Yale (Ivy League),6,5-1,133,39,172,0.773,03/24/2019,2019.0
2,Towson (CAA),8,5-3,155,50,205,0.756,03/24/2019,2019.0
3,Lehigh (Patriot),9,6-3,141,66,207,0.681,03/24/2019,2019.0
4,Marist (MAAC),7,4-3,101,48,149,0.678,03/24/2019,2019.0
5,Hobart (NEC),8,7-1,155,83,238,0.651,03/24/2019,2019.0
6,Massachusetts (CAA),9,6-3,141,80,221,0.638,03/24/2019,2019.0
7,Detroit Mercy (MAAC),8,5-3,127,78,205,0.620,03/24/2019,2019.0
8,Cleveland St. (DI Independent),10,4-6,149,94,243,0.613,03/24/2019,2019.0
9,Maryland (Big Ten),9,8-1,141,89,230,0.613,03/24/2019,2019.0
10,Holy Cross (Patriot),8,3-5,116,74,190,0.611,03/24/2019,2019.0
11,Syracuse (ACC),7,5-2,109,70,179,0.609,03/24/2019,2019.0
12,Penn (Ivy League),7,4-3,121,78,199,0.608,03/24/2019,2019.0
13,Hampton (DI Independent),6,4-2,94,61,155,0.606,03/24/2019,2019.0
14,UMass Lowell (America East),9,3-6,137,91,228,0.601,03/24/2019,2019.0
15,High Point (SoCon),9,7-2,153,104,257,0.595,03/24/2019,2019.0
16,Saint Joseph's (NEC),9,5-4,127,88,215,0.591,03/24/2019,2019.0
17,Boston U. (Patriot),10,7-3,148,105,253,0.585,03/24/2019,2019.0
18,Ohio St. (Big Ten),7,7-0,108,77,185,0.584,03/24/2019,2019.0
19,Air Force (SoCon),8,6-2,107,77,184,0.582,03/24/2019,2019.0
20,Bryant (NEC),9,2-7,110,81,191,0.576,03/24/2019,2019.0
21,Penn St. (Big Ten),8,7-1,148,110,258,0.574,03/24/2019,2019.0
22,Duke (ACC),10,8-2,141,106,247,0.571,03/24/2019,2019.0
23,Hofstra (CAA),9,3-6,110,84,194,0.567,03/24/2019,2019.0
24,Notre Dame (ACC),7,4-3,93,76,169,0.550,03/24/2019,2019.0
25,Johns Hopkins (Big Ten),8,4-4,116,98,214,0.542,03/24/2019,2019.0
26,Fairfield (CAA),9,5-4,131,112,243,0.539,03/24/2019,2019.0
27,Villanova (Big East),8,4-4,112,96,208,0.538,03/24/2019,2019.0
28,Quinnipiac (MAAC),8,5-3,118,104,222,0.532,03/24/2019,2019.0
29,Drexel (CAA),8,4-4,124,112,236,0.525,03/24/2019,2019.0
30,Mount St. Mary's (NEC),10,5-5,122,112,234,0.521,03/24/2019,2019.0
31,Brown (Ivy League),7,3-4,103,95,198,0.520,03/24/2019,2019.0
32,Robert Morris (NEC),8,1-7,132,122,254,0.520,03/24/2019,2019.0
33,North Carolina (ACC),9,6-3,127,118,245,0.518,03/24/2019,2019.0
34,Denver (Big East),7,5-2,80,75,155,0.516,03/24/2019,2019.0
35,Mercer (SoCon),8,1-7,109,103,212,0.514,03/24/2019,2019.0
36,Monmouth (MAAC),7,1-6,66,66,132,0.500,03/24/2019,2019.0
37,Loyola Maryland (Patriot),8,6-2,109,110,219,0.498,03/24/2019,2019.0
38,St. John's (NY) (Big East),8,4-4,113,116,229,0.493,03/24/2019,2019.0
39,Marquette (Big East),8,5-3,106,111,217,0.488,03/24/2019,2019.0
40,Manhattan (MAAC),9,4-5,95,101,196,0.485,03/24/2019,2019.0
41,Colgate (Patriot),8,3-5,84,91,175,0.480,03/24/2019,2019.0
42,Navy (Patriot),8,4-4,98,107,205,0.478,03/24/2019,2019.0
43,Virginia (ACC),8,6-2,106,116,222,0.477,03/24/2019,2019.0
44,Providence (Big East),9,4-5,102,113,215,0.474,03/24/2019,2019.0
45,Vermont (America East),8,5-3,100,112,212,0.472,03/24/2019,2019.0
46,Canisius (MAAC),8,4-4,97,109,206,0.471,03/24/2019,2019.0
47,Princeton (Ivy League),7,2-5,93,107,200,0.465,03/24/2019,2019.0
48,Delaware (CAA),9,7-2,97,113,210,0.462,03/24/2019,2019.0
49,Harvard (Ivy League),8,4-4,99,116,215,0.460,03/24/2019,2019.0
50,Georgetown (Big East),9,7-2,106,128,234,0.453,03/24/2019,2019.0
51,Siena (MAAC),7,5-2,98,119,217,0.452,03/24/2019,2019.0
52,Wagner (NEC),9,2-7,90,110,200,0.450,03/24/2019,2019.0
53,Bucknell (Patriot),9,2-7,97,119,216,0.449,03/24/2019,2019.0
54,Hartford (America East),9,1-8,115,144,259,0.444,03/24/2019,2019.0
55,UAlbany (America East),7,3-4,85,107,192,0.443,03/24/2019,2019.0
56,Stony Brook (America East),8,4-4,84,109,193,0.435,03/24/2019,2019.0
57,Rutgers (Big Ten),9,5-4,100,130,230,0.435,03/24/2019,2019.0
58,Richmond (SoCon),9,6-3,98,132,230,0.426,03/24/2019,2019.0
59,Furman (SoCon),9,2-7,97,142,239,0.406,03/24/2019,2019.0
60,NJIT (DI Independent),10,1-9,102,156,258,0.395,03/24/2019,2019.0
61,Michigan (Big Ten),8,3-5,91,140,231,0.394,03/24/2019,2019.0
62,VMI (SoCon),7,3-4,71,111,182,0.390,03/24/2019,2019.0
63,Bellarmine (SoCon),8,0-8,80,126,206,0.388,03/24/2019,2019.0
64,Binghamton (America East),7,0-7,66,105,171,0.386,03/24/2019,2019.0
65,Sacred Heart (NEC),9,5-4,103,166,269,0.383,03/24/2019,2019.0
66,UMBC (America East),7,1-6,78,126,204,0.382,03/24/2019,2019.0
67,Jacksonville (SoCon),9,3-6,92,157,249,0.369,03/24/2019,2019.0
68,Cornell (Ivy League),8,5-3,94,165,259,0.363,03/24/2019,2019.0
69,Dartmouth (Ivy League),7,2-5,55,98,153,0.359,03/24/2019,2019.0
70,Army West Point (Patriot),9,7-2,70,127,197,0.355,03/24/2019,2019.0
71,Lafayette (Patriot),10,4-6,75,170,245,0.306,03/24/2019,2019.0
72,Utah (DI Independent),10,4-6,72,166,238,0.303,03/24/2019,2019.0
73,St. Bonaventure (MAAC),7,0-7,41,133,174,0.236,03/24/2019,2019.0
1,Yale (Ivy League),5,4-1,112,31,143,0.783,03/20/2019,2019.0
2,Towson (CAA),7,5-2,143,45,188,0.761,03/20/2019,2019.0
3,Lehigh (Patriot),8,5-3,124,57,181,0.685,03/20/2019,2019.0
4,Marist (MAAC),6,3-3,89,45,134,0.664,03/20/2019,2019.0
5,Hobart (NEC),7,6-1,142,74,216,0.657,03/20/2019,2019.0
6,Massachusetts (CAA),8,5-3,129,69,198,0.652,03/20/2019,2019.0
7,Cleveland St. (DI Independent),9,4-5,135,79,214,0.631,03/20/2019,2019.0
8,UMass Lowell (America East),8,3-5,123,75,198,0.621,03/20/2019,2019.0
9,Holy Cross (Patriot),8,3-5,116,74,190,0.611,03/20/2019,2019.0
10,Detroit Mercy (MAAC),7,4-3,117,75,192,0.609,03/20/2019,2019.0
11,Syracuse (ACC),6,4-2,98,63,161,0.609,03/20/2019,2019.0
12,Penn (Ivy League),6,3-3,101,65,166,0.608,03/20/2019,2019.0
13,Hampton (DI Independent),6,4-2,94,61,155,0.606,03/20/2019,2019.0
14,Ohio St. (Big Ten),6,6-0,96,64,160,0.600,03/20/2019,2019.0
15,Saint Joseph's (NEC),8,4-4,116,79,195,0.595,03/20/2019,2019.0
16,High Point (SoCon),8,7-1,138,94,232,0.595,03/20/2019,2019.0
17,Maryland (Big Ten),8,7-1,119,82,201,0.592,03/20/2019,2019.0
18,Bryant (NEC),8,2-6,101,70,171,0.591,03/20/2019,2019.0
19,Duke (ACC),9,8-1,134,95,229,0.585,03/20/2019,2019.0
20,Penn St. (Big Ten),7,6-1,133,96,229,0.581,03/20/2019,2019.0
21,Fairfield (CAA),8,5-3,124,96,220,0.564,03/20/2019,2019.0
22,Air Force (SoCon),7,5-2,91,72,163,0.558,03/20/2019,2019.0
23,North Carolina (ACC),8,6-2,120,96,216,0.556,03/20/2019,2019.0
23,Notre Dame (ACC),6,4-2,80,64,144,0.556,03/20/2019,2019.0
25,Boston U. (Patriot),9,6-3,124,100,224,0.554,03/20/2019,2019.0
26,Denver (Big East),6,4-2,75,63,138,0.543,03/20/2019,2019.0
27,Hofstra (CAA),8,3-5,94,79,173,0.543,03/20/2019,2019.0
28,Johns Hopkins (Big Ten),7,4-3,99,85,184,0.538,03/20/2019,2019.0
29,Robert Morris (NEC),7,1-6,121,104,225,0.538,03/20/2019,2019.0
30,Drexel (CAA),7,3-4,111,97,208,0.534,03/20/2019,2019.0
31,Monmouth (MAAC),6,1-5,63,56,119,0.529,03/20/2019,2019.0
32,Brown (Ivy League),6,3-3,92,83,175,0.526,03/20/2019,2019.0
33,Villanova (Big East),7,3-4,96,89,185,0.519,03/20/2019,2019.0
34,Manhattan (MAAC),8,4-4,92,89,181,0.508,03/20/2019,2019.0
35,Mount St. Mary's (NEC),9,4-5,104,101,205,0.507,03/20/2019,2019.0
36,Quinnipiac (MAAC),7,4-3,100,99,199,0.503,03/20/2019,2019.0
37,Navy (Patriot),7,4-3,89,90,179,0.497,03/20/2019,2019.0
38,Princeton (Ivy League),6,2-4,85,86,171,0.497,03/20/2019,2019.0
39,Marquette (Big East),7,4-3,96,100,196,0.490,03/20/2019,2019.0
40,St. John's (NY) (Big East),7,3-4,97,102,199,0.487,03/20/2019,2019.0
41,Virginia (ACC),7,5-2,93,99,192,0.484,03/20/2019,2019.0
42,Vermont (America East),7,4-3,90,98,188,0.479,03/20/2019,2019.0
43,Canisius (MAAC),7,4-3,88,97,185,0.476,03/20/2019,2019.0
44,Bucknell (Patriot),8,2-6,91,102,193,0.472,03/20/2019,2019.0
45,Loyola Maryland (Patriot),7,5-2,92,104,196,0.469,03/20/2019,2019.0
46,Mercer (SoCon),7,0-7,86,98,184,0.467,03/20/2019,2019.0
47,Providence (Big East),8,4-4,87,100,187,0.465,03/20/2019,2019.0
48,Colgate (Patriot),7,3-4,70,81,151,0.464,03/20/2019,2019.0
49,Rutgers (Big Ten),8,4-4,95,114,209,0.455,03/20/2019,2019.0
50,Wagner (NEC),8,1-7,78,95,173,0.451,03/20/2019,2019.0
51,Georgetown (Big East),8,7-1,95,118,213,0.446,03/20/2019,2019.0
52,Delaware (CAA),8,6-2,79,99,178,0.444,03/20/2019,2019.0
53,Siena (MAAC),6,4-2,86,110,196,0.439,03/20/2019,2019.0
54,Hartford (America East),8,1-7,101,134,235,0.430,03/20/2019,2019.0
55,VMI (SoCon),6,3-3,66,88,154,0.429,03/20/2019,2019.0
56,Furman (SoCon),8,2-6,92,126,218,0.422,03/20/2019,2019.0
57,UAlbany (America East),6,2-4,71,99,170,0.418,03/20/2019,2019.0
58,Stony Brook (America East),7,3-4,70,98,168,0.417,03/20/2019,2019.0
59,Harvard (Ivy League),7,3-4,79,114,193,0.409,03/20/2019,2019.0
60,Dartmouth (Ivy League),6,2-4,53,78,131,0.405,03/20/2019,2019.0
61,Richmond (SoCon),8,5-3,80,121,201,0.398,03/20/2019,2019.0
62,Bellarmine (SoCon),7,0-7,69,108,177,0.390,03/20/2019,2019.0
63,Binghamton (America East),6,0-6,58,91,149,0.389,03/20/2019,2019.0
64,Michigan (Big Ten),7,3-4,77,122,199,0.387,03/20/2019,2019.0
65,Sacred Heart (NEC),8,5-3,94,153,247,0.381,03/20/2019,2019.0
66,NJIT (DI Independent),9,1-8,87,144,231,0.377,03/20/2019,2019.0
67,UMBC (America East),6,1-5,67,112,179,0.374,03/20/2019,2019.0
68,Jacksonville (SoCon),8,2-6,82,142,224,0.366,03/20/2019,2019.0
69,Cornell (Ivy League),7,5-2,81,145,226,0.358,03/20/2019,2019.0
70,Army West Point (Patriot),8,6-2,60,113,173,0.347,03/20/2019,2019.0
71,Lafayette (Patriot),9,4-5,70,146,216,0.324,03/20/2019,2019.0
72,Utah (DI Independent),10,4-6,72,166,238,0.303,03/20/2019,2019.0
73,St. Bonaventure (MAAC),6,0-6,36,115,151,0.238,03/20/2019,2019.0
1,Yale (Ivy League),5,4-1,112,31,143,0.783,03/19/2019,2019.0
2,Towson (CAA),7,5-2,143,45,188,0.761,03/19/2019,2019.0
3,Lehigh (Patriot),8,5-3,124,57,181,0.685,03/19/2019,2019.0
4,Marist (MAAC),6,3-3,89,45,134,0.664,03/19/2019,2019.0
5,Hobart (NEC),7,6-1,142,74,216,0.657,03/19/2019,2019.0
6,Massachusetts (CAA),8,5-3,129,69,198,0.652,03/19/2019,2019.0
7,Cleveland St. (DI Independent),9,4-5,135,79,214,0.631,03/19/2019,2019.0
8,UMass Lowell (America East),8,3-5,123,75,198,0.621,03/19/2019,2019.0
9,Holy Cross (Patriot),8,3-5,116,74,190,0.611,03/19/2019,2019.0
10,Detroit Mercy (MAAC),7,4-3,117,75,192,0.609,03/19/2019,2019.0
11,Syracuse (ACC),6,4-2,98,63,161,0.609,03/19/2019,2019.0
12,Penn (Ivy League),6,3-3,101,65,166,0.608,03/19/2019,2019.0
13,Ohio St. (Big Ten),6,6-0,96,64,160,0.600,03/19/2019,2019.0
14,Saint Joseph's (NEC),8,4-4,116,79,195,0.595,03/19/2019,2019.0
15,High Point (SoCon),8,7-1,138,94,232,0.595,03/19/2019,2019.0
16,Maryland (Big Ten),8,7-1,119,82,201,0.592,03/19/2019,2019.0
17,Bryant (NEC),8,2-6,101,70,171,0.591,03/19/2019,2019.0
18,Hampton (DI Independent),5,3-2,79,55,134,0.590,03/19/2019,2019.0
19,Duke (ACC),9,8-1,134,95,229,0.585,03/19/2019,2019.0
20,Penn St. (Big Ten),7,6-1,133,96,229,0.581,03/19/2019,2019.0
21,Fairfield (CAA),8,5-3,124,96,220,0.564,03/19/2019,2019.0
22,Air Force (SoCon),7,5-2,91,72,163,0.558,03/19/2019,2019.0
23,North Carolina (ACC),8,6-2,120,96,216,0.556,03/19/2019,2019.0
23,Notre Dame (ACC),6,4-2,80,64,144,0.556,03/19/2019,2019.0
25,Boston U. (Patriot),9,6-3,124,100,224,0.554,03/19/2019,2019.0
26,Denver (Big East),6,4-2,75,63,138,0.543,03/19/2019,2019.0
27,Hofstra (CAA),8,3-5,94,79,173,0.543,03/19/2019,2019.0
28,Johns Hopkins (Big Ten),7,4-3,99,85,184,0.538,03/19/2019,2019.0
29,Robert Morris (NEC),7,1-6,121,104,225,0.538,03/19/2019,2019.0
30,Drexel (CAA),7,3-4,111,97,208,0.534,03/19/2019,2019.0
31,Monmouth (MAAC),6,1-5,63,56,119,0.529,03/19/2019,2019.0
32,Brown (Ivy League),6,3-3,92,83,175,0.526,03/19/2019,2019.0
33,Villanova (Big East),7,3-4,96,89,185,0.519,03/19/2019,2019.0
34,Manhattan (MAAC),8,4-4,92,89,181,0.508,03/19/2019,2019.0
35,Mount St. Mary's (NEC),9,4-5,104,101,205,0.507,03/19/2019,2019.0
36,Quinnipiac (MAAC),7,4-3,100,99,199,0.503,03/19/2019,2019.0
37,Navy (Patriot),7,4-3,89,90,179,0.497,03/19/2019,2019.0
38,Princeton (Ivy League),6,2-4,85,86,171,0.497,03/19/2019,2019.0
39,Marquette (Big East),7,4-3,96,100,196,0.490,03/19/2019,2019.0
40,St. John's (NY) (Big East),7,3-4,97,102,199,0.487,03/19/2019,2019.0
41,Virginia (ACC),7,5-2,93,99,192,0.484,03/19/2019,2019.0
42,Vermont (America East),7,4-3,90,98,188,0.479,03/19/2019,2019.0
43,Canisius (MAAC),7,4-3,88,97,185,0.476,03/19/2019,2019.0
44,Bucknell (Patriot),8,2-6,91,102,193,0.472,03/19/2019,2019.0
45,Loyola Maryland (Patriot),7,5-2,92,104,196,0.469,03/19/2019,2019.0
46,Mercer (SoCon),7,0-7,86,98,184,0.467,03/19/2019,2019.0
47,Providence (Big East),8,4-4,87,100,187,0.465,03/19/2019,2019.0
48,Colgate (Patriot),7,3-4,70,81,151,0.464,03/19/2019,2019.0
49,Rutgers (Big Ten),8,4-4,95,114,209,0.455,03/19/2019,2019.0
50,Wagner (NEC),8,1-7,78,95,173,0.451,03/19/2019,2019.0
51,Georgetown (Big East),8,7-1,95,118,213,0.446,03/19/2019,2019.0
52,Delaware (CAA),8,6-2,79,99,178,0.444,03/19/2019,2019.0
53,Siena (MAAC),6,4-2,86,110,196,0.439,03/19/2019,2019.0
54,Hartford (America East),8,1-7,101,134,235,0.430,03/19/2019,2019.0
55,VMI (SoCon),6,3-3,66,88,154,0.429,03/19/2019,2019.0
56,Furman (SoCon),8,2-6,92,126,218,0.422,03/19/2019,2019.0
57,UAlbany (America East),6,2-4,71,99,170,0.418,03/19/2019,2019.0
58,Stony Brook (America East),7,3-4,70,98,168,0.417,03/19/2019,2019.0
59,Harvard (Ivy League),7,3-4,79,114,193,0.409,03/19/2019,2019.0
60,Dartmouth (Ivy League),6,2-4,53,78,131,0.405,03/19/2019,2019.0
61,Richmond (SoCon),8,5-3,80,121,201,0.398,03/19/2019,2019.0
62,Bellarmine (SoCon),7,0-7,69,108,177,0.390,03/19/2019,2019.0
63,Binghamton (America East),6,0-6,58,91,149,0.389,03/19/2019,2019.0
64,Michigan (Big Ten),7,3-4,77,122,199,0.387,03/19/2019,2019.0
65,Sacred Heart (NEC),8,5-3,94,153,247,0.381,03/19/2019,2019.0
66,NJIT (DI Independent),9,1-8,87,144,231,0.377,03/19/2019,2019.0
67,UMBC (America East),6,1-5,67,112,179,0.374,03/19/2019,2019.0
68,Jacksonville (SoCon),8,2-6,82,142,224,0.366,03/19/2019,2019.0
69,Cornell (Ivy League),7,5-2,81,145,226,0.358,03/19/2019,2019.0
70,Army West Point (Patriot),8,6-2,60,113,173,0.347,03/19/2019,2019.0
71,Lafayette (Patriot),9,4-5,70,146,216,0.324,03/19/2019,2019.0
72,Utah (DI Independent),10,4-6,72,166,238,0.303,03/19/2019,2019.0
73,St. Bonaventure (MAAC),6,0-6,36,115,151,0.238,03/19/2019,2019.0
1,Yale (Ivy League),5,4-1,112,31,143,0.783,03/17/2019,2019.0
2,Towson (CAA),7,5-2,143,45,188,0.761,03/17/2019,2019.0
3,Lehigh (Patriot),8,5-3,124,57,181,0.685,03/17/2019,2019.0
4,Hobart (NEC),6,5-1,132,63,195,0.677,03/17/2019,2019.0
5,Marist (MAAC),6,3-3,89,45,134,0.664,03/17/2019,2019.0
6,Massachusetts (CAA),8,5-3,129,69,198,0.652,03/17/2019,2019.0
7,Cleveland St. (DI Independent),9,4-5,135,79,214,0.631,03/17/2019,2019.0
8,UMass Lowell (America East),7,3-4,109,68,177,0.616,03/17/2019,2019.0
9,Detroit Mercy (MAAC),7,4-3,117,75,192,0.609,03/17/2019,2019.0
10,Syracuse (ACC),6,4-2,98,63,161,0.609,03/17/2019,2019.0
11,Penn (Ivy League),6,3-3,101,65,166,0.608,03/17/2019,2019.0
12,Holy Cross (Patriot),7,2-5,99,65,164,0.604,03/17/2019,2019.0
13,Ohio St. (Big Ten),6,6-0,96,64,160,0.600,03/17/2019,2019.0
14,Saint Joseph's (NEC),8,4-4,116,79,195,0.595,03/17/2019,2019.0
15,High Point (SoCon),8,7-1,138,94,232,0.595,03/17/2019,2019.0
16,Maryland (Big Ten),8,7-1,119,82,201,0.592,03/17/2019,2019.0
17,Bryant (NEC),8,2-6,101,70,171,0.591,03/17/2019,2019.0
18,Hampton (DI Independent),5,3-2,79,55,134,0.590,03/17/2019,2019.0
19,Duke (ACC),9,8-1,134,95,229,0.585,03/17/2019,2019.0
20,Boston U. (Patriot),8,6-2,114,81,195,0.585,03/17/2019,2019.0
21,Penn St. (Big Ten),7,6-1,133,96,229,0.581,03/17/2019,2019.0
22,Air Force (SoCon),7,5-2,91,72,163,0.558,03/17/2019,2019.0
23,Brown (Ivy League),5,3-2,83,66,149,0.557,03/17/2019,2019.0
24,North Carolina (ACC),8,6-2,120,96,216,0.556,03/17/2019,2019.0
25,Denver (Big East),6,4-2,75,63,138,0.543,03/17/2019,2019.0
26,Hofstra (CAA),8,3-5,94,79,173,0.543,03/17/2019,2019.0
27,Johns Hopkins (Big Ten),7,4-3,99,85,184,0.538,03/17/2019,2019.0
28,Robert Morris (NEC),7,1-6,121,104,225,0.538,03/17/2019,2019.0
29,Drexel (CAA),7,3-4,111,97,208,0.534,03/17/2019,2019.0
30,Fairfield (CAA),7,4-3,103,91,194,0.531,03/17/2019,2019.0
31,Monmouth (MAAC),6,1-5,63,56,119,0.529,03/17/2019,2019.0
32,Villanova (Big East),7,3-4,96,89,185,0.519,03/17/2019,2019.0
33,Manhattan (MAAC),8,4-4,92,89,181,0.508,03/17/2019,2019.0
34,Mount St. Mary's (NEC),9,4-5,104,101,205,0.507,03/17/2019,2019.0
35,Quinnipiac (MAAC),6,3-3,82,80,162,0.506,03/17/2019,2019.0
36,Notre Dame (ACC),5,3-2,60,60,120,0.500,03/17/2019,2019.0
37,Navy (Patriot),7,4-3,89,90,179,0.497,03/17/2019,2019.0
38,Princeton (Ivy League),6,2-4,85,86,171,0.497,03/17/2019,2019.0
39,Marquette (Big East),7,4-3,96,100,196,0.490,03/17/2019,2019.0
40,Virginia (ACC),7,5-2,93,99,192,0.484,03/17/2019,2019.0
41,Providence (Big East),7,3-4,80,86,166,0.482,03/17/2019,2019.0
42,Vermont (America East),7,4-3,90,98,188,0.479,03/17/2019,2019.0
43,Canisius (MAAC),7,4-3,88,97,185,0.476,03/17/2019,2019.0
44,Bucknell (Patriot),8,2-6,91,102,193,0.472,03/17/2019,2019.0
45,Loyola Maryland (Patriot),7,5-2,92,104,196,0.469,03/17/2019,2019.0
46,Mercer (SoCon),7,0-7,86,98,184,0.467,03/17/2019,2019.0
47,St. John's (NY) (Big East),6,2-4,79,94,173,0.457,03/17/2019,2019.0
48,Rutgers (Big Ten),8,4-4,95,114,209,0.455,03/17/2019,2019.0
49,Colgate (Patriot),6,3-3,59,71,130,0.454,03/17/2019,2019.0
50,Wagner (NEC),8,1-7,78,95,173,0.451,03/17/2019,2019.0
51,Georgetown (Big East),8,7-1,95,118,213,0.446,03/17/2019,2019.0
52,Delaware (CAA),8,6-2,79,99,178,0.444,03/17/2019,2019.0
53,Siena (MAAC),6,4-2,86,110,196,0.439,03/17/2019,2019.0
54,VMI (SoCon),6,3-3,66,88,154,0.429,03/17/2019,2019.0
54,Dartmouth (Ivy League),5,2-3,45,60,105,0.429,03/17/2019,2019.0
56,Furman (SoCon),8,2-6,92,126,218,0.422,03/17/2019,2019.0
57,UAlbany (America East),6,2-4,71,99,170,0.418,03/17/2019,2019.0
58,Michigan (Big Ten),6,3-3,73,102,175,0.417,03/17/2019,2019.0
59,Stony Brook (America East),7,3-4,70,98,168,0.417,03/17/2019,2019.0
60,Hartford (America East),7,1-6,82,116,198,0.414,03/17/2019,2019.0
61,NJIT (DI Independent),8,1-7,82,123,205,0.400,03/17/2019,2019.0
62,Richmond (SoCon),8,5-3,80,121,201,0.398,03/17/2019,2019.0
63,Bellarmine (SoCon),7,0-7,69,108,177,0.390,03/17/2019,2019.0
64,Binghamton (America East),6,0-6,58,91,149,0.389,03/17/2019,2019.0
65,Sacred Heart (NEC),8,5-3,94,153,247,0.381,03/17/2019,2019.0
66,UMBC (America East),6,1-5,67,112,179,0.374,03/17/2019,2019.0
67,Jacksonville (SoCon),8,2-6,82,142,224,0.366,03/17/2019,2019.0
68,Harvard (Ivy League),6,2-4,60,104,164,0.366,03/17/2019,2019.0
69,Army West Point (Patriot),8,6-2,60,113,173,0.347,03/17/2019,2019.0
70,Lafayette (Patriot),9,4-5,70,146,216,0.324,03/17/2019,2019.0
71,Cornell (Ivy League),6,4-2,61,140,201,0.303,03/17/2019,2019.0
72,Utah (DI Independent),10,4-6,72,166,238,0.303,03/17/2019,2019.0
73,St. Bonaventure (MAAC),5,0-5,31,95,126,0.246,03/17/2019,2019.0
1,Yale (Ivy League),4,3-1,88,25,113,0.779,03/15/2019,2019.0
2,Towson (CAA),6,5-1,124,40,164,0.756,03/15/2019,2019.0
3,Marist (MAAC),5,2-3,80,35,115,0.696,03/15/2019,2019.0
4,Hobart (NEC),5,4-1,118,54,172,0.686,03/15/2019,2019.0
5,Lehigh (Patriot),7,4-3,106,50,156,0.679,03/15/2019,2019.0
6,Cleveland St. (DI Independent),8,4-4,122,64,186,0.656,03/15/2019,2019.0
7,Detroit Mercy (MAAC),6,4-2,107,60,167,0.641,03/15/2019,2019.0
8,Massachusetts (CAA),7,4-3,112,64,176,0.636,03/15/2019,2019.0
9,Duke (ACC),8,7-1,129,76,205,0.629,03/15/2019,2019.0
10,Maryland (Big Ten),7,6-1,108,66,174,0.621,03/15/2019,2019.0
11,Hampton (DI Independent),4,2-2,71,47,118,0.602,03/15/2019,2019.0
12,Ohio St. (Big Ten),6,6-0,96,64,160,0.600,03/15/2019,2019.0
12,UMass Lowell (America East),6,3-3,87,58,145,0.600,03/15/2019,2019.0
14,High Point (SoCon),8,7-1,138,94,232,0.595,03/15/2019,2019.0
15,Penn (Ivy League),5,2-3,79,55,134,0.590,03/15/2019,2019.0
16,Penn St. (Big Ten),7,6-1,133,96,229,0.581,03/15/2019,2019.0
17,Bryant (NEC),7,2-5,87,63,150,0.580,03/15/2019,2019.0
18,Saint Joseph's (NEC),7,3-4,96,70,166,0.578,03/15/2019,2019.0
19,Holy Cross (Patriot),6,2-4,85,62,147,0.578,03/15/2019,2019.0
20,Syracuse (ACC),5,3-2,71,54,125,0.568,03/15/2019,2019.0
21,Boston U. (Patriot),7,5-2,95,74,169,0.562,03/15/2019,2019.0
22,North Carolina (ACC),7,5-2,105,83,188,0.559,03/15/2019,2019.0
23,Hofstra (CAA),7,3-4,83,66,149,0.557,03/15/2019,2019.0
24,Air Force (SoCon),6,4-2,72,59,131,0.550,03/15/2019,2019.0
25,Denver (Big East),6,4-2,75,63,138,0.543,03/15/2019,2019.0
26,Princeton (Ivy League),5,2-3,75,64,139,0.540,03/15/2019,2019.0
27,Robert Morris (NEC),6,1-5,100,87,187,0.535,03/15/2019,2019.0
28,Fairfield (CAA),7,4-3,103,91,194,0.531,03/15/2019,2019.0
29,Monmouth (MAAC),5,1-4,53,47,100,0.530,03/15/2019,2019.0
30,Manhattan (MAAC),7,4-3,83,74,157,0.529,03/15/2019,2019.0
31,Mount St. Mary's (NEC),8,3-5,97,87,184,0.527,03/15/2019,2019.0
32,Drexel (CAA),6,3-3,95,86,181,0.525,03/15/2019,2019.0
33,Brown (Ivy League),4,2-2,60,55,115,0.522,03/15/2019,2019.0
34,Villanova (Big East),6,3-3,80,78,158,0.506,03/15/2019,2019.0
35,Bucknell (Patriot),7,2-5,84,83,167,0.503,03/15/2019,2019.0
36,Johns Hopkins (Big Ten),6,3-3,79,79,158,0.500,03/15/2019,2019.0
37,Rutgers (Big Ten),7,4-3,86,87,173,0.497,03/15/2019,2019.0
38,Loyola Maryland (Patriot),6,4-2,84,85,169,0.497,03/15/2019,2019.0
39,Virginia (ACC),6,4-2,82,84,166,0.494,03/15/2019,2019.0
40,Quinnipiac (MAAC),5,2-3,67,70,137,0.489,03/15/2019,2019.0
41,Delaware (CAA),7,6-1,73,79,152,0.480,03/15/2019,2019.0
41,Mercer (SoCon),6,0-6,73,79,152,0.480,03/15/2019,2019.0
43,Notre Dame (ACC),4,3-1,45,49,94,0.479,03/15/2019,2019.0
44,Providence (Big East),6,2-4,67,75,142,0.472,03/15/2019,2019.0
45,Vermont (America East),6,3-3,75,85,160,0.469,03/15/2019,2019.0
46,Canisius (MAAC),6,3-3,78,90,168,0.464,03/15/2019,2019.0
47,Navy (Patriot),6,4-2,70,82,152,0.461,03/15/2019,2019.0
48,Colgate (Patriot),5,3-2,52,61,113,0.460,03/15/2019,2019.0
49,Wagner (NEC),7,1-6,69,81,150,0.460,03/15/2019,2019.0
50,St. John's (NY) (Big East),6,2-4,79,94,173,0.457,03/15/2019,2019.0
51,Georgetown (Big East),7,6-1,84,102,186,0.452,03/15/2019,2019.0
52,Michigan (Big Ten),5,3-2,64,78,142,0.451,03/15/2019,2019.0
53,UAlbany (America East),5,1-4,61,77,138,0.442,03/15/2019,2019.0
54,Marquette (Big East),6,3-3,72,91,163,0.442,03/15/2019,2019.0
55,Furman (SoCon),7,2-5,83,110,193,0.430,03/15/2019,2019.0
56,VMI (SoCon),6,3-3,66,88,154,0.429,03/15/2019,2019.0
57,NJIT (DI Independent),7,1-6,73,103,176,0.415,03/15/2019,2019.0
58,Siena (MAAC),5,3-2,71,101,172,0.413,03/15/2019,2019.0
59,Stony Brook (America East),6,3-3,57,85,142,0.401,03/15/2019,2019.0
60,Hartford (America East),6,0-6,69,103,172,0.401,03/15/2019,2019.0
61,Binghamton (America East),5,0-5,50,78,128,0.391,03/15/2019,2019.0
62,Dartmouth (Ivy League),4,1-3,32,52,84,0.381,03/15/2019,2019.0
63,Harvard (Ivy League),5,2-3,49,81,130,0.377,03/15/2019,2019.0
64,Jacksonville (SoCon),7,1-6,75,127,202,0.371,03/15/2019,2019.0
65,Sacred Heart (NEC),7,4-3,77,132,209,0.368,03/15/2019,2019.0
66,Army West Point (Patriot),7,5-2,57,99,156,0.365,03/15/2019,2019.0
67,Richmond (SoCon),7,4-3,64,112,176,0.364,03/15/2019,2019.0
68,UMBC (America East),5,1-4,54,97,151,0.358,03/15/2019,2019.0
69,Bellarmine (SoCon),6,0-6,54,101,155,0.348,03/15/2019,2019.0
70,Lafayette (Patriot),8,4-4,63,128,191,0.330,03/15/2019,2019.0
71,Cornell (Ivy League),5,4-1,55,116,171,0.322,03/15/2019,2019.0
72,Utah (DI Independent),9,4-5,67,149,216,0.310,03/15/2019,2019.0
73,St. Bonaventure (MAAC),5,0-5,31,95,126,0.246,03/15/2019,2019.0
1,Yale (Ivy League),4,3-1,88,25,113,0.779,03/12/2019,2019.0
2,Towson (CAA),6,5-1,124,40,164,0.756,03/12/2019,2019.0
3,Marist (MAAC),5,2-3,80,35,115,0.696,03/12/2019,2019.0
4,Hobart (NEC),5,4-1,118,54,172,0.686,03/12/2019,2019.0
5,Lehigh (Patriot),7,4-3,106,50,156,0.679,03/12/2019,2019.0
6,Cleveland St. (DI Independent),8,4-4,122,64,186,0.656,03/12/2019,2019.0
7,Detroit Mercy (MAAC),6,4-2,107,60,167,0.641,03/12/2019,2019.0
8,Massachusetts (CAA),7,4-3,112,64,176,0.636,03/12/2019,2019.0
9,Duke (ACC),8,7-1,129,76,205,0.629,03/12/2019,2019.0
10,Maryland (Big Ten),7,6-1,108,66,174,0.621,03/12/2019,2019.0
11,Hampton (DI Independent),4,2-2,71,47,118,0.602,03/12/2019,2019.0
12,Ohio St. (Big Ten),6,6-0,96,64,160,0.600,03/12/2019,2019.0
12,UMass Lowell (America East),6,3-3,87,58,145,0.600,03/12/2019,2019.0
14,Penn (Ivy League),5,2-3,79,55,134,0.590,03/12/2019,2019.0
15,Penn St. (Big Ten),7,6-1,133,96,229,0.581,03/12/2019,2019.0
16,Bryant (NEC),7,2-5,87,63,150,0.580,03/12/2019,2019.0
17,Saint Joseph's (NEC),7,3-4,96,70,166,0.578,03/12/2019,2019.0
18,Holy Cross (Patriot),6,2-4,84,63,147,0.571,03/12/2019,2019.0
19,Syracuse (ACC),5,3-2,71,54,125,0.568,03/12/2019,2019.0
20,Boston U. (Patriot),7,5-2,95,74,169,0.562,03/12/2019,2019.0
21,Hofstra (CAA),7,3-4,83,65,148,0.561,03/12/2019,2019.0
22,North Carolina (ACC),7,5-2,105,83,188,0.559,03/12/2019,2019.0
23,Air Force (SoCon),6,4-2,72,59,131,0.550,03/12/2019,2019.0
24,High Point (SoCon),7,6-1,111,91,202,0.550,03/12/2019,2019.0
25,Denver (Big East),6,4-2,75,63,138,0.543,03/12/2019,2019.0
26,Princeton (Ivy League),5,2-3,75,64,139,0.540,03/12/2019,2019.0
27,Robert Morris (NEC),6,1-5,100,87,187,0.535,03/12/2019,2019.0
28,Monmouth (MAAC),5,1-4,53,47,100,0.530,03/12/2019,2019.0
29,Manhattan (MAAC),7,4-3,83,74,157,0.529,03/12/2019,2019.0
30,Mount St. Mary's (NEC),8,3-5,97,87,184,0.527,03/12/2019,2019.0
31,Drexel (CAA),6,3-3,95,86,181,0.525,03/12/2019,2019.0
32,Brown (Ivy League),4,2-2,60,55,115,0.522,03/12/2019,2019.0
33,VMI (SoCon),5,3-2,63,61,124,0.508,03/12/2019,2019.0
34,Villanova (Big East),6,3-3,80,78,158,0.506,03/12/2019,2019.0
35,Bucknell (Patriot),7,2-5,84,83,167,0.503,03/12/2019,2019.0
36,Fairfield (CAA),6,3-3,86,86,172,0.500,03/12/2019,2019.0
36,Johns Hopkins (Big Ten),6,3-3,79,79,158,0.500,03/12/2019,2019.0
38,Rutgers (Big Ten),7,4-3,86,87,173,0.497,03/12/2019,2019.0
39,Loyola Maryland (Patriot),6,4-2,84,85,169,0.497,03/12/2019,2019.0
40,Virginia (ACC),6,4-2,82,84,166,0.494,03/12/2019,2019.0
41,Quinnipiac (MAAC),5,2-3,67,70,137,0.489,03/12/2019,2019.0
42,Mercer (SoCon),6,0-6,73,79,152,0.480,03/12/2019,2019.0
42,Delaware (CAA),7,6-1,73,79,152,0.480,03/12/2019,2019.0
44,Notre Dame (ACC),4,3-1,45,49,94,0.479,03/12/2019,2019.0
45,Vermont (America East),6,3-3,76,84,160,0.475,03/12/2019,2019.0
46,Providence (Big East),6,2-4,67,75,142,0.472,03/12/2019,2019.0
47,Canisius (MAAC),6,3-3,78,90,168,0.464,03/12/2019,2019.0
48,Navy (Patriot),6,4-2,70,82,152,0.461,03/12/2019,2019.0
49,Colgate (Patriot),5,3-2,52,61,113,0.460,03/12/2019,2019.0
50,Wagner (NEC),7,1-6,69,81,150,0.460,03/12/2019,2019.0
51,St. John's (NY) (Big East),6,2-4,78,94,172,0.453,03/12/2019,2019.0
52,Georgetown (Big East),7,6-1,84,102,186,0.452,03/12/2019,2019.0
53,Michigan (Big Ten),5,3-2,64,78,142,0.451,03/12/2019,2019.0
54,UAlbany (America East),5,1-4,61,77,138,0.442,03/12/2019,2019.0
55,Marquette (Big East),6,3-3,72,91,163,0.442,03/12/2019,2019.0
56,Furman (SoCon),7,2-5,83,110,193,0.430,03/12/2019,2019.0
57,NJIT (DI Independent),7,1-6,73,103,176,0.415,03/12/2019,2019.0
58,Siena (MAAC),5,3-2,71,101,172,0.413,03/12/2019,2019.0
59,Stony Brook (America East),6,3-3,57,85,142,0.401,03/12/2019,2019.0
60,Hartford (America East),6,0-6,69,103,172,0.401,03/12/2019,2019.0
61,Binghamton (America East),5,0-5,50,78,128,0.391,03/12/2019,2019.0
62,Dartmouth (Ivy League),4,1-3,32,52,84,0.381,03/12/2019,2019.0
63,Harvard (Ivy League),5,2-3,49,81,130,0.377,03/12/2019,2019.0
64,Jacksonville (SoCon),7,1-6,75,127,202,0.371,03/12/2019,2019.0
65,Sacred Heart (NEC),7,4-3,77,132,209,0.368,03/12/2019,2019.0
66,Army West Point (Patriot),7,5-2,57,99,156,0.365,03/12/2019,2019.0
67,Richmond (SoCon),7,4-3,64,112,176,0.364,03/12/2019,2019.0
68,UMBC (America East),5,1-4,54,97,151,0.358,03/12/2019,2019.0
69,Bellarmine (SoCon),6,0-6,54,101,155,0.348,03/12/2019,2019.0
70,Lafayette (Patriot),8,4-4,63,128,191,0.330,03/12/2019,2019.0
71,Cornell (Ivy League),5,4-1,55,116,171,0.322,03/12/2019,2019.0
72,Utah (DI Independent),8,4-4,62,132,194,0.320,03/12/2019,2019.0
73,St. Bonaventure (MAAC),5,0-5,31,95,126,0.246,03/12/2019,2019.0
1,Yale (Ivy League),4,3-1,88,25,113,0.779,03/10/2019,2019.0
2,Towson (CAA),6,5-1,124,40,164,0.756,03/10/2019,2019.0
3,Lehigh (Patriot),6,3-3,90,39,129,0.698,03/10/2019,2019.0
4,Marist (MAAC),5,2-3,80,35,115,0.696,03/10/2019,2019.0
5,Hobart (NEC),5,4-1,118,54,172,0.686,03/10/2019,2019.0
6,UMass Lowell (America East),5,3-2,82,41,123,0.667,03/10/2019,2019.0
7,Detroit Mercy (MAAC),6,4-2,107,60,167,0.641,03/10/2019,2019.0
8,Cleveland St. (DI Independent),7,3-4,103,60,163,0.632,03/10/2019,2019.0
9,Maryland (Big Ten),7,6-1,108,66,174,0.621,03/10/2019,2019.0
10,Massachusetts (CAA),6,3-3,95,59,154,0.617,03/10/2019,2019.0
11,Ohio St. (Big Ten),6,6-0,96,64,160,0.600,03/10/2019,2019.0
11,Hampton (DI Independent),3,1-2,54,36,90,0.600,03/10/2019,2019.0
13,Penn (Ivy League),5,2-3,79,55,134,0.590,03/10/2019,2019.0
14,Penn St. (Big Ten),7,6-1,133,96,229,0.581,03/10/2019,2019.0
15,Duke (ACC),7,6-1,101,73,174,0.580,03/10/2019,2019.0
16,Saint Joseph's (NEC),7,3-4,96,70,166,0.578,03/10/2019,2019.0
17,North Carolina (ACC),6,4-2,95,71,166,0.572,03/10/2019,2019.0
18,Holy Cross (Patriot),6,2-4,84,63,147,0.571,03/10/2019,2019.0
19,Syracuse (ACC),5,3-2,71,54,125,0.568,03/10/2019,2019.0
20,Boston U. (Patriot),7,5-2,95,74,169,0.562,03/10/2019,2019.0
21,Mount St. Mary's (NEC),7,3-4,92,75,167,0.551,03/10/2019,2019.0
22,Air Force (SoCon),6,4-2,72,59,131,0.550,03/10/2019,2019.0
23,High Point (SoCon),7,6-1,111,91,202,0.550,03/10/2019,2019.0
24,Fairfield (CAA),5,2-3,79,66,145,0.545,03/10/2019,2019.0
25,Bryant (NEC),6,2-4,67,56,123,0.545,03/10/2019,2019.0
26,Denver (Big East),6,4-2,75,63,138,0.543,03/10/2019,2019.0
27,Princeton (Ivy League),5,2-3,75,64,139,0.540,03/10/2019,2019.0
28,Robert Morris (NEC),5,1-4,82,71,153,0.536,03/10/2019,2019.0
29,Hofstra (CAA),6,2-4,69,61,130,0.531,03/10/2019,2019.0
30,Monmouth (MAAC),5,1-4,53,47,100,0.530,03/10/2019,2019.0
31,Manhattan (MAAC),7,4-3,83,74,157,0.529,03/10/2019,2019.0
32,Drexel (CAA),6,3-3,95,86,181,0.525,03/10/2019,2019.0
33,Brown (Ivy League),4,2-2,60,55,115,0.522,03/10/2019,2019.0
34,Rutgers (Big Ten),6,4-2,75,71,146,0.514,03/10/2019,2019.0
35,VMI (SoCon),5,3-2,63,61,124,0.508,03/10/2019,2019.0
36,Villanova (Big East),6,3-3,80,78,158,0.506,03/10/2019,2019.0
37,Loyola Maryland (Patriot),6,4-2,84,85,169,0.497,03/10/2019,2019.0
38,Bucknell (Patriot),6,2-4,72,73,145,0.497,03/10/2019,2019.0
39,Virginia (ACC),6,4-2,82,84,166,0.494,03/10/2019,2019.0
40,Quinnipiac (MAAC),5,2-3,67,70,137,0.489,03/10/2019,2019.0
41,St. John's (NY) (Big East),5,2-3,74,80,154,0.481,03/10/2019,2019.0
42,Delaware (CAA),7,6-1,73,79,152,0.480,03/10/2019,2019.0
42,Mercer (SoCon),6,0-6,73,79,152,0.480,03/10/2019,2019.0
44,Notre Dame (ACC),4,3-1,45,49,94,0.479,03/10/2019,2019.0
45,Johns Hopkins (Big Ten),5,2-3,67,74,141,0.475,03/10/2019,2019.0
46,Vermont (America East),6,3-3,76,84,160,0.475,03/10/2019,2019.0
47,Providence (Big East),6,2-4,67,75,142,0.472,03/10/2019,2019.0
48,Canisius (MAAC),6,3-3,78,90,168,0.464,03/10/2019,2019.0
49,Navy (Patriot),6,4-2,70,82,152,0.461,03/10/2019,2019.0
50,Colgate (Patriot),5,3-2,52,61,113,0.460,03/10/2019,2019.0
51,Wagner (NEC),7,1-6,69,81,150,0.460,03/10/2019,2019.0
52,Georgetown (Big East),7,6-1,84,102,186,0.452,03/10/2019,2019.0
53,Michigan (Big Ten),5,3-2,64,78,142,0.451,03/10/2019,2019.0
54,UAlbany (America East),5,1-4,61,77,138,0.442,03/10/2019,2019.0
55,Marquette (Big East),5,2-3,56,73,129,0.434,03/10/2019,2019.0
56,Furman (SoCon),7,2-5,83,110,193,0.430,03/10/2019,2019.0
57,NJIT (DI Independent),7,1-6,73,103,176,0.415,03/10/2019,2019.0
58,Stony Brook (America East),6,3-3,57,85,142,0.401,03/10/2019,2019.0
59,Hartford (America East),6,0-6,69,103,172,0.401,03/10/2019,2019.0
60,Dartmouth (Ivy League),4,1-3,32,52,84,0.381,03/10/2019,2019.0
61,Harvard (Ivy League),5,2-3,49,81,130,0.377,03/10/2019,2019.0
62,Jacksonville (SoCon),7,1-6,75,127,202,0.371,03/10/2019,2019.0
63,Sacred Heart (NEC),7,4-3,77,132,209,0.368,03/10/2019,2019.0
64,Richmond (SoCon),7,4-3,64,112,176,0.364,03/10/2019,2019.0
65,Utah (DI Independent),7,4-3,59,104,163,0.362,03/10/2019,2019.0
66,UMBC (America East),5,1-4,54,97,151,0.358,03/10/2019,2019.0
67,Siena (MAAC),4,2-2,50,92,142,0.352,03/10/2019,2019.0
68,Lafayette (Patriot),7,4-3,59,109,168,0.351,03/10/2019,2019.0
69,Army West Point (Patriot),6,4-2,46,85,131,0.351,03/10/2019,2019.0
70,Binghamton (America East),4,0-4,36,67,103,0.350,03/10/2019,2019.0
71,Bellarmine (SoCon),6,0-6,54,101,155,0.348,03/10/2019,2019.0
72,Cornell (Ivy League),5,4-1,55,116,171,0.322,03/10/2019,2019.0
73,St. Bonaventure (MAAC),4,0-4,22,74,96,0.229,03/10/2019,2019.0
1,Yale (Ivy League),3,2-1,61,21,82,0.744,03/08/2019,2019.0
2,Towson (CAA),5,5-0,98,34,132,0.742,03/08/2019,2019.0
3,Marist (MAAC),5,2-3,80,35,115,0.696,03/08/2019,2019.0
4,Hobart (NEC),4,3-1,98,43,141,0.695,03/08/2019,2019.0
5,UMass Lowell (America East),4,2-2,73,33,106,0.689,03/08/2019,2019.0
6,Lehigh (Patriot),5,2-3,72,34,106,0.679,03/08/2019,2019.0
7,Saint Joseph's (NEC),6,3-3,91,54,145,0.628,03/08/2019,2019.0
8,Ohio St. (Big Ten),5,5-0,84,50,134,0.627,03/08/2019,2019.0
9,Cleveland St. (DI Independent),6,2-4,92,55,147,0.626,03/08/2019,2019.0
10,Maryland (Big Ten),6,5-1,91,56,147,0.619,03/08/2019,2019.0
11,Hampton (DI Independent),3,1-2,54,36,90,0.600,03/08/2019,2019.0
12,Detroit Mercy (MAAC),5,3-2,85,57,142,0.599,03/08/2019,2019.0
13,Boston U. (Patriot),6,5-1,88,61,149,0.591,03/08/2019,2019.0
14,Holy Cross (Patriot),5,2-3,74,52,126,0.587,03/08/2019,2019.0
15,Massachusetts (CAA),5,2-3,72,52,124,0.581,03/08/2019,2019.0
16,Duke (ACC),7,6-1,101,73,174,0.580,03/08/2019,2019.0
17,North Carolina (ACC),6,4-2,95,71,166,0.572,03/08/2019,2019.0
18,Penn (Ivy League),4,1-3,63,50,113,0.558,03/08/2019,2019.0
19,Syracuse (ACC),4,2-2,54,43,97,0.557,03/08/2019,2019.0
20,Mount St. Mary's (NEC),7,3-4,92,75,167,0.551,03/08/2019,2019.0
21,Air Force (SoCon),6,4-2,72,59,131,0.550,03/08/2019,2019.0
22,Penn St. (Big Ten),6,5-1,104,86,190,0.547,03/08/2019,2019.0
23,Brown (Ivy League),3,2-1,47,39,86,0.547,03/08/2019,2019.0
24,Denver (Big East),5,4-1,66,55,121,0.545,03/08/2019,2019.0
25,Fairfield (CAA),4,2-2,63,53,116,0.543,03/08/2019,2019.0
26,Michigan (Big Ten),4,3-1,60,51,111,0.541,03/08/2019,2019.0
27,Manhattan (MAAC),6,4-2,75,65,140,0.536,03/08/2019,2019.0
28,Rutgers (Big Ten),5,3-2,67,59,126,0.532,03/08/2019,2019.0
29,Monmouth (MAAC),5,1-4,53,47,100,0.530,03/08/2019,2019.0
30,Drexel (CAA),5,2-3,81,72,153,0.529,03/08/2019,2019.0
30,Princeton (Ivy League),4,2-2,63,56,119,0.529,03/08/2019,2019.0
32,Hofstra (CAA),5,2-3,55,49,104,0.529,03/08/2019,2019.0
33,Robert Morris (NEC),4,1-3,68,61,129,0.527,03/08/2019,2019.0
34,Villanova (Big East),5,3-2,66,64,130,0.508,03/08/2019,2019.0
35,Vermont (America East),5,3-2,65,64,129,0.504,03/08/2019,2019.0
36,St. John's (NY) (Big East),4,2-2,61,61,122,0.500,03/08/2019,2019.0
36,VMI (SoCon),4,3-1,50,50,100,0.500,03/08/2019,2019.0
38,Loyola Maryland (Patriot),6,4-2,84,85,169,0.497,03/08/2019,2019.0
39,Johns Hopkins (Big Ten),4,2-2,56,57,113,0.496,03/08/2019,2019.0
40,Bryant (NEC),5,2-3,51,52,103,0.495,03/08/2019,2019.0
41,Bucknell (Patriot),5,1-4,61,63,124,0.492,03/08/2019,2019.0
42,High Point (SoCon),6,5-1,80,83,163,0.491,03/08/2019,2019.0
43,Virginia (ACC),5,3-2,66,71,137,0.482,03/08/2019,2019.0
44,Notre Dame (ACC),3,2-1,37,40,77,0.481,03/08/2019,2019.0
45,Mercer (SoCon),6,0-6,73,79,152,0.480,03/08/2019,2019.0
46,Quinnipiac (MAAC),4,1-3,57,63,120,0.475,03/08/2019,2019.0
47,Canisius (MAAC),5,2-3,68,76,144,0.472,03/08/2019,2019.0
48,Wagner (NEC),6,1-5,62,71,133,0.466,03/08/2019,2019.0
49,Providence (Big East),5,2-3,56,65,121,0.463,03/08/2019,2019.0
50,UAlbany (America East),4,1-3,51,60,111,0.459,03/08/2019,2019.0
51,Georgetown (Big East),6,5-1,71,86,157,0.452,03/08/2019,2019.0
52,NJIT (DI Independent),6,1-5,66,80,146,0.452,03/08/2019,2019.0
53,Marquette (Big East),4,2-2,51,62,113,0.451,03/08/2019,2019.0
54,Delaware (CAA),6,5-1,59,73,132,0.447,03/08/2019,2019.0
55,Stony Brook (America East),5,2-3,53,69,122,0.434,03/08/2019,2019.0
56,Furman (SoCon),7,2-5,83,110,193,0.430,03/08/2019,2019.0
57,Navy (Patriot),5,3-2,55,75,130,0.423,03/08/2019,2019.0
58,Colgate (Patriot),4,2-2,39,54,93,0.419,03/08/2019,2019.0
59,UMBC (America East),4,1-3,46,66,112,0.411,03/08/2019,2019.0
60,Jacksonville (SoCon),6,1-5,65,98,163,0.399,03/08/2019,2019.0
61,Dartmouth (Ivy League),4,1-3,32,52,84,0.381,03/08/2019,2019.0
62,Army West Point (Patriot),5,4-1,41,67,108,0.380,03/08/2019,2019.0
63,Sacred Heart (NEC),6,3-3,66,112,178,0.371,03/08/2019,2019.0
64,Binghamton (America East),3,0-3,30,53,83,0.361,03/08/2019,2019.0
65,Harvard (Ivy League),4,1-3,39,70,109,0.358,03/08/2019,2019.0
66,Lafayette (Patriot),6,4-2,52,94,146,0.356,03/08/2019,2019.0
67,Cornell (Ivy League),4,3-1,49,90,139,0.353,03/08/2019,2019.0
68,Richmond (SoCon),6,3-3,53,99,152,0.349,03/08/2019,2019.0
69,Hartford (America East),5,0-5,49,92,141,0.348,03/08/2019,2019.0
70,Utah (DI Independent),6,3-3,48,92,140,0.343,03/08/2019,2019.0
71,Bellarmine (SoCon),5,0-5,42,90,132,0.318,03/08/2019,2019.0
72,Siena (MAAC),3,1-2,31,79,110,0.282,03/08/2019,2019.0
73,St. Bonaventure (MAAC),3,0-3,19,52,71,0.268,03/08/2019,2019.0
1,Towson (CAA),4,4-0,75,25,100,0.750,03/07/2019,2019.0
2,Marist (MAAC),4,2-2,67,23,90,0.744,03/07/2019,2019.0
3,Yale (Ivy League),3,2-1,61,21,82,0.744,03/07/2019,2019.0
4,Hobart (NEC),4,3-1,98,43,141,0.695,03/07/2019,2019.0
5,UMass Lowell (America East),4,2-2,73,33,106,0.689,03/07/2019,2019.0
6,Lehigh (Patriot),5,2-3,72,34,106,0.679,03/07/2019,2019.0
7,Saint Joseph's (NEC),5,3-2,78,43,121,0.645,03/07/2019,2019.0
8,Ohio St. (Big Ten),5,5-0,84,50,134,0.627,03/07/2019,2019.0
9,Cleveland St. (DI Independent),6,2-4,92,55,147,0.626,03/07/2019,2019.0
10,Maryland (Big Ten),6,5-1,91,56,147,0.619,03/07/2019,2019.0
11,Hampton (DI Independent),2,1-1,36,23,59,0.610,03/07/2019,2019.0
12,Detroit Mercy (MAAC),5,3-2,85,57,142,0.599,03/07/2019,2019.0
13,Boston U. (Patriot),6,5-1,88,61,149,0.591,03/07/2019,2019.0
14,North Carolina (ACC),5,3-2,83,58,141,0.589,03/07/2019,2019.0
15,Holy Cross (Patriot),5,2-3,74,52,126,0.587,03/07/2019,2019.0
16,Massachusetts (CAA),5,2-3,72,52,124,0.581,03/07/2019,2019.0
17,Duke (ACC),7,6-1,101,73,174,0.580,03/07/2019,2019.0
18,Mount St. Mary's (NEC),6,2-4,82,64,146,0.562,03/07/2019,2019.0
19,Syracuse (ACC),4,2-2,54,43,97,0.557,03/07/2019,2019.0
20,Air Force (SoCon),6,4-2,72,59,131,0.550,03/07/2019,2019.0
21,Brown (Ivy League),3,2-1,47,39,86,0.547,03/07/2019,2019.0
22,Denver (Big East),5,4-1,66,55,121,0.545,03/07/2019,2019.0
23,Villanova (Big East),4,3-1,56,47,103,0.544,03/07/2019,2019.0
24,Fairfield (CAA),4,2-2,63,53,116,0.543,03/07/2019,2019.0
25,Drexel (CAA),4,1-3,70,59,129,0.543,03/07/2019,2019.0
26,Michigan (Big Ten),4,3-1,60,51,111,0.541,03/07/2019,2019.0
27,Manhattan (MAAC),6,4-2,75,65,140,0.536,03/07/2019,2019.0
28,Penn (Ivy League),3,0-3,46,40,86,0.535,03/07/2019,2019.0
29,Rutgers (Big Ten),5,3-2,67,59,126,0.532,03/07/2019,2019.0
30,Monmouth (MAAC),5,1-4,53,47,100,0.530,03/07/2019,2019.0
31,Princeton (Ivy League),4,2-2,63,56,119,0.529,03/07/2019,2019.0
32,Hofstra (CAA),5,2-3,55,49,104,0.529,03/07/2019,2019.0
33,Robert Morris (NEC),4,1-3,68,61,129,0.527,03/07/2019,2019.0
34,Penn St. (Big Ten),5,4-1,79,75,154,0.513,03/07/2019,2019.0
35,Vermont (America East),5,3-2,65,64,129,0.504,03/07/2019,2019.0
36,St. John's (NY) (Big East),4,2-2,61,61,122,0.500,03/07/2019,2019.0
36,VMI (SoCon),4,3-1,50,50,100,0.500,03/07/2019,2019.0
38,Loyola Maryland (Patriot),6,4-2,84,85,169,0.497,03/07/2019,2019.0
39,Johns Hopkins (Big Ten),4,2-2,56,57,113,0.496,03/07/2019,2019.0
40,Bryant (NEC),5,2-3,51,52,103,0.495,03/07/2019,2019.0
41,Bucknell (Patriot),5,1-4,61,63,124,0.492,03/07/2019,2019.0
42,High Point (SoCon),6,5-1,80,83,163,0.491,03/07/2019,2019.0
43,Virginia (ACC),5,3-2,66,71,137,0.482,03/07/2019,2019.0
44,Notre Dame (ACC),3,2-1,37,40,77,0.481,03/07/2019,2019.0
45,Quinnipiac (MAAC),4,1-3,57,63,120,0.475,03/07/2019,2019.0
46,Mercer (SoCon),5,0-5,62,69,131,0.473,03/07/2019,2019.0
47,Canisius (MAAC),5,2-3,68,76,144,0.472,03/07/2019,2019.0
48,Wagner (NEC),6,1-5,62,71,133,0.466,03/07/2019,2019.0
49,Providence (Big East),5,2-3,56,65,121,0.463,03/07/2019,2019.0
50,UAlbany (America East),4,1-3,51,60,111,0.459,03/07/2019,2019.0
51,Georgetown (Big East),6,5-1,71,86,157,0.452,03/07/2019,2019.0
52,NJIT (DI Independent),6,1-5,66,80,146,0.452,03/07/2019,2019.0
53,Marquette (Big East),4,2-2,51,62,113,0.451,03/07/2019,2019.0
54,Delaware (CAA),6,5-1,59,73,132,0.447,03/07/2019,2019.0
55,Stony Brook (America East),5,2-3,53,69,122,0.434,03/07/2019,2019.0
56,Furman (SoCon),7,2-5,83,110,193,0.430,03/07/2019,2019.0
57,Jacksonville (SoCon),5,1-4,56,75,131,0.427,03/07/2019,2019.0
58,Navy (Patriot),5,3-2,55,75,130,0.423,03/07/2019,2019.0
59,Colgate (Patriot),4,2-2,39,54,93,0.419,03/07/2019,2019.0
60,UMBC (America East),4,1-3,46,66,112,0.411,03/07/2019,2019.0
61,Dartmouth (Ivy League),4,1-3,32,52,84,0.381,03/07/2019,2019.0
62,Army West Point (Patriot),5,4-1,41,67,108,0.380,03/07/2019,2019.0
63,Sacred Heart (NEC),6,3-3,66,112,178,0.371,03/07/2019,2019.0
64,Cornell (Ivy League),3,3-0,38,65,103,0.369,03/07/2019,2019.0
65,Binghamton (America East),3,0-3,30,53,83,0.361,03/07/2019,2019.0
66,Harvard (Ivy League),4,1-3,39,70,109,0.358,03/07/2019,2019.0
67,Lafayette (Patriot),6,4-2,52,94,146,0.356,03/07/2019,2019.0
68,Richmond (SoCon),6,3-3,53,99,152,0.349,03/07/2019,2019.0
69,Hartford (America East),5,0-5,49,92,141,0.348,03/07/2019,2019.0
70,Utah (DI Independent),6,3-3,48,92,140,0.343,03/07/2019,2019.0
71,Bellarmine (SoCon),5,0-5,42,90,132,0.318,03/07/2019,2019.0
72,Siena (MAAC),3,1-2,31,79,110,0.282,03/07/2019,2019.0
73,St. Bonaventure (MAAC),3,0-3,19,52,71,0.268,03/07/2019,2019.0
1,Towson (CAA),4,4-0,75,25,100,0.750,03/06/2019,2019.0
2,Marist (MAAC),4,2-2,67,23,90,0.744,03/06/2019,2019.0
3,Yale (Ivy League),3,2-1,61,21,82,0.744,03/06/2019,2019.0
4,Hobart (NEC),4,3-1,98,43,141,0.695,03/06/2019,2019.0
5,UMass Lowell (America East),4,2-2,73,33,106,0.689,03/06/2019,2019.0
6,Lehigh (Patriot),5,2-3,72,34,106,0.679,03/06/2019,2019.0
7,Saint Joseph's (NEC),5,3-2,78,43,121,0.645,03/06/2019,2019.0
8,Ohio St. (Big Ten),5,5-0,84,50,134,0.627,03/06/2019,2019.0
9,Cleveland St. (DI Independent),6,2-4,92,55,147,0.626,03/06/2019,2019.0
10,Maryland (Big Ten),6,5-1,91,56,147,0.619,03/06/2019,2019.0
11,Hampton (DI Independent),2,1-1,36,23,59,0.610,03/06/2019,2019.0
12,Duke (ACC),6,5-1,92,60,152,0.605,03/06/2019,2019.0
13,Detroit Mercy (MAAC),5,3-2,85,57,142,0.599,03/06/2019,2019.0
14,Boston U. (Patriot),6,5-1,88,61,149,0.591,03/06/2019,2019.0
15,North Carolina (ACC),5,3-2,83,58,141,0.589,03/06/2019,2019.0
16,Holy Cross (Patriot),5,2-3,74,52,126,0.587,03/06/2019,2019.0
17,Massachusetts (CAA),5,2-3,72,52,124,0.581,03/06/2019,2019.0
18,Mount St. Mary's (NEC),6,2-4,82,64,146,0.562,03/06/2019,2019.0
19,Syracuse (ACC),4,2-2,54,43,97,0.557,03/06/2019,2019.0
20,Air Force (SoCon),6,4-2,72,59,131,0.550,03/06/2019,2019.0
21,Brown (Ivy League),3,2-1,47,39,86,0.547,03/06/2019,2019.0
22,Denver (Big East),5,4-1,66,55,121,0.545,03/06/2019,2019.0
23,Villanova (Big East),4,3-1,56,47,103,0.544,03/06/2019,2019.0
24,Fairfield (CAA),4,2-2,63,53,116,0.543,03/06/2019,2019.0
25,Drexel (CAA),4,1-3,70,59,129,0.543,03/06/2019,2019.0
26,Michigan (Big Ten),4,3-1,60,51,111,0.541,03/06/2019,2019.0
27,Manhattan (MAAC),6,4-2,75,65,140,0.536,03/06/2019,2019.0
28,Penn (Ivy League),3,0-3,46,40,86,0.535,03/06/2019,2019.0
29,Rutgers (Big Ten),5,3-2,67,59,126,0.532,03/06/2019,2019.0
30,Monmouth (MAAC),5,1-4,53,47,100,0.530,03/06/2019,2019.0
31,Princeton (Ivy League),4,2-2,63,56,119,0.529,03/06/2019,2019.0
32,Hofstra (CAA),5,2-3,55,49,104,0.529,03/06/2019,2019.0
33,Robert Morris (NEC),4,1-3,68,61,129,0.527,03/06/2019,2019.0
34,Penn St. (Big Ten),5,4-1,79,75,154,0.513,03/06/2019,2019.0
35,Vermont (America East),5,3-2,65,64,129,0.504,03/06/2019,2019.0
36,St. John's (NY) (Big East),4,2-2,61,61,122,0.500,03/06/2019,2019.0
36,VMI (SoCon),4,3-1,50,50,100,0.500,03/06/2019,2019.0
38,Johns Hopkins (Big Ten),4,2-2,56,57,113,0.496,03/06/2019,2019.0
39,Bryant (NEC),5,2-3,51,52,103,0.495,03/06/2019,2019.0
40,Bucknell (Patriot),5,1-4,61,63,124,0.492,03/06/2019,2019.0
41,High Point (SoCon),6,5-1,80,83,163,0.491,03/06/2019,2019.0
42,Loyola Maryland (Patriot),5,4-1,71,76,147,0.483,03/06/2019,2019.0
43,Virginia (ACC),5,3-2,66,71,137,0.482,03/06/2019,2019.0
44,Notre Dame (ACC),3,2-1,37,40,77,0.481,03/06/2019,2019.0
45,Quinnipiac (MAAC),4,1-3,57,63,120,0.475,03/06/2019,2019.0
46,Mercer (SoCon),5,0-5,62,69,131,0.473,03/06/2019,2019.0
47,Canisius (MAAC),5,2-3,68,76,144,0.472,03/06/2019,2019.0
48,Wagner (NEC),6,1-5,62,71,133,0.466,03/06/2019,2019.0
49,Providence (Big East),5,2-3,56,65,121,0.463,03/06/2019,2019.0
50,UAlbany (America East),4,1-3,51,60,111,0.459,03/06/2019,2019.0
51,Georgetown (Big East),6,5-1,71,86,157,0.452,03/06/2019,2019.0
52,NJIT (DI Independent),6,1-5,66,80,146,0.452,03/06/2019,2019.0
53,Marquette (Big East),4,2-2,51,62,113,0.451,03/06/2019,2019.0
54,Delaware (CAA),6,5-1,59,73,132,0.447,03/06/2019,2019.0
55,Stony Brook (America East),5,2-3,53,69,122,0.434,03/06/2019,2019.0
56,Furman (SoCon),7,2-5,83,110,193,0.430,03/06/2019,2019.0
57,Jacksonville (SoCon),5,1-4,56,75,131,0.427,03/06/2019,2019.0
58,Navy (Patriot),5,3-2,55,75,130,0.423,03/06/2019,2019.0
59,Colgate (Patriot),4,2-2,39,54,93,0.419,03/06/2019,2019.0
60,UMBC (America East),4,1-3,46,66,112,0.411,03/06/2019,2019.0
61,Dartmouth (Ivy League),4,1-3,32,52,84,0.381,03/06/2019,2019.0
62,Army West Point (Patriot),5,4-1,41,67,108,0.380,03/06/2019,2019.0
63,Sacred Heart (NEC),6,3-3,66,112,178,0.371,03/06/2019,2019.0
64,Cornell (Ivy League),3,3-0,38,65,103,0.369,03/06/2019,2019.0
65,Binghamton (America East),3,0-3,30,53,83,0.361,03/06/2019,2019.0
66,Harvard (Ivy League),4,1-3,39,70,109,0.358,03/06/2019,2019.0
67,Lafayette (Patriot),6,4-2,52,94,146,0.356,03/06/2019,2019.0
68,Richmond (SoCon),6,3-3,53,99,152,0.349,03/06/2019,2019.0
69,Hartford (America East),5,0-5,49,92,141,0.348,03/06/2019,2019.0
1,Towson (CAA),4,4-0,75,25,100,0.750,03/05/2019,2019.0
2,Marist (MAAC),4,2-2,67,23,90,0.744,03/05/2019,2019.0
3,Yale (Ivy League),3,2-1,61,21,82,0.744,03/05/2019,2019.0
4,Hobart (NEC),4,3-1,98,43,141,0.695,03/05/2019,2019.0
5,UMass Lowell (America East),4,2-2,73,33,106,0.689,03/05/2019,2019.0
6,Lehigh (Patriot),5,2-3,72,34,106,0.679,03/05/2019,2019.0
7,Detroit Mercy (MAAC),4,3-1,72,39,111,0.649,03/05/2019,2019.0
8,Saint Joseph's (NEC),5,3-2,78,43,121,0.645,03/05/2019,2019.0
9,Ohio St. (Big Ten),5,5-0,84,50,134,0.627,03/05/2019,2019.0
10,Cleveland St. (DI Independent),6,2-4,92,55,147,0.626,03/05/2019,2019.0
11,Maryland (Big Ten),6,5-1,91,56,147,0.619,03/05/2019,2019.0
12,Hampton (DI Independent),2,1-1,36,23,59,0.610,03/05/2019,2019.0
13,Duke (ACC),6,5-1,92,60,152,0.605,03/05/2019,2019.0
14,Boston U. (Patriot),6,5-1,88,61,149,0.591,03/05/2019,2019.0
15,North Carolina (ACC),5,3-2,83,58,141,0.589,03/05/2019,2019.0
16,Holy Cross (Patriot),5,2-3,74,52,126,0.587,03/05/2019,2019.0
17,Massachusetts (CAA),5,2-3,72,52,124,0.581,03/05/2019,2019.0
18,Mount St. Mary's (NEC),6,2-4,82,64,146,0.562,03/05/2019,2019.0
19,Syracuse (ACC),4,2-2,54,43,97,0.557,03/05/2019,2019.0
20,Brown (Ivy League),3,2-1,47,39,86,0.547,03/05/2019,2019.0
21,Denver (Big East),5,4-1,66,55,121,0.545,03/05/2019,2019.0
22,Villanova (Big East),4,3-1,56,47,103,0.544,03/05/2019,2019.0
23,Fairfield (CAA),4,2-2,63,53,116,0.543,03/05/2019,2019.0
24,Drexel (CAA),4,1-3,70,59,129,0.543,03/05/2019,2019.0
25,Michigan (Big Ten),4,3-1,60,51,111,0.541,03/05/2019,2019.0
26,Air Force (SoCon),5,3-2,54,46,100,0.540,03/05/2019,2019.0
27,Manhattan (MAAC),6,4-2,75,65,140,0.536,03/05/2019,2019.0
28,Penn (Ivy League),3,0-3,46,40,86,0.535,03/05/2019,2019.0
29,Rutgers (Big Ten),5,3-2,67,59,126,0.532,03/05/2019,2019.0
30,Monmouth (MAAC),5,1-4,53,47,100,0.530,03/05/2019,2019.0
31,Princeton (Ivy League),4,2-2,63,56,119,0.529,03/05/2019,2019.0
32,Hofstra (CAA),5,2-3,55,49,104,0.529,03/05/2019,2019.0
33,Robert Morris (NEC),4,1-3,68,61,129,0.527,03/05/2019,2019.0
34,Penn St. (Big Ten),5,4-1,79,75,154,0.513,03/05/2019,2019.0
35,Vermont (America East),5,3-2,65,64,129,0.504,03/05/2019,2019.0
36,St. John's (NY) (Big East),4,2-2,61,61,122,0.500,03/05/2019,2019.0
36,VMI (SoCon),4,3-1,50,50,100,0.500,03/05/2019,2019.0
38,Johns Hopkins (Big Ten),4,2-2,56,57,113,0.496,03/05/2019,2019.0
39,Bryant (NEC),5,2-3,51,52,103,0.495,03/05/2019,2019.0
40,Bucknell (Patriot),5,1-4,61,63,124,0.492,03/05/2019,2019.0
41,High Point (SoCon),6,5-1,80,83,163,0.491,03/05/2019,2019.0
42,Mercer (SoCon),4,0-4,53,56,109,0.486,03/05/2019,2019.0
43,Loyola Maryland (Patriot),5,4-1,71,76,147,0.483,03/05/2019,2019.0
44,Virginia (ACC),5,3-2,66,71,137,0.482,03/05/2019,2019.0
45,Notre Dame (ACC),3,2-1,37,40,77,0.481,03/05/2019,2019.0
46,Quinnipiac (MAAC),4,1-3,57,63,120,0.475,03/05/2019,2019.0
47,Canisius (MAAC),5,2-3,68,76,144,0.472,03/05/2019,2019.0
48,Wagner (NEC),6,1-5,62,71,133,0.466,03/05/2019,2019.0
49,Providence (Big East),5,2-3,56,65,121,0.463,03/05/2019,2019.0
50,UAlbany (America East),4,1-3,51,60,111,0.459,03/05/2019,2019.0
51,Georgetown (Big East),6,5-1,71,86,157,0.452,03/05/2019,2019.0
52,NJIT (DI Independent),6,1-5,66,80,146,0.452,03/05/2019,2019.0
53,Marquette (Big East),4,2-2,51,62,113,0.451,03/05/2019,2019.0
54,Stony Brook (America East),5,2-3,53,69,122,0.434,03/05/2019,2019.0
55,Furman (SoCon),7,2-5,83,110,193,0.430,03/05/2019,2019.0
56,Jacksonville (SoCon),5,1-4,56,75,131,0.427,03/05/2019,2019.0
57,Navy (Patriot),5,3-2,55,75,130,0.423,03/05/2019,2019.0
58,Colgate (Patriot),4,2-2,39,54,93,0.419,03/05/2019,2019.0
59,Delaware (CAA),5,4-1,46,64,110,0.418,03/05/2019,2019.0
60,UMBC (America East),4,1-3,46,66,112,0.411,03/05/2019,2019.0
61,Dartmouth (Ivy League),4,1-3,32,52,84,0.381,03/05/2019,2019.0
62,Army West Point (Patriot),5,4-1,41,67,108,0.380,03/05/2019,2019.0
63,Sacred Heart (NEC),6,3-3,66,112,178,0.371,03/05/2019,2019.0
64,Cornell (Ivy League),3,3-0,38,65,103,0.369,03/05/2019,2019.0
65,Binghamton (America East),3,0-3,30,53,83,0.361,03/05/2019,2019.0
66,Harvard (Ivy League),4,1-3,39,70,109,0.358,03/05/2019,2019.0
67,Lafayette (Patriot),6,4-2,52,94,146,0.356,03/05/2019,2019.0
68,Richmond (SoCon),6,3-3,53,99,152,0.349,03/05/2019,2019.0
69,Hartford (America East),5,0-5,49,92,141,0.348,03/05/2019,2019.0
1,Towson (CAA),4,4-0,75,25,100,0.750,03/03/2019,2019.0
2,Marist (MAAC),4,2-2,67,23,90,0.744,03/03/2019,2019.0
3,Yale (Ivy League),3,2-1,61,21,82,0.744,03/03/2019,2019.0
4,Hobart (NEC),4,3-1,98,43,141,0.695,03/03/2019,2019.0
5,Lehigh (Patriot),5,2-3,72,34,106,0.679,03/03/2019,2019.0
6,UMass Lowell (America East),3,1-2,55,26,81,0.679,03/03/2019,2019.0
7,Detroit Mercy (MAAC),4,3-1,72,39,111,0.649,03/03/2019,2019.0
8,Saint Joseph's (NEC),5,3-2,78,43,121,0.645,03/03/2019,2019.0
9,Ohio St. (Big Ten),5,5-0,84,50,134,0.627,03/03/2019,2019.0
10,Cleveland St. (DI Independent),6,2-4,92,55,147,0.626,03/03/2019,2019.0
11,Maryland (Big Ten),6,5-1,91,56,147,0.619,03/03/2019,2019.0
12,Hampton (DI Independent),2,1-1,36,23,59,0.610,03/03/2019,2019.0
13,Duke (ACC),6,5-1,92,60,152,0.605,03/03/2019,2019.0
14,Boston U. (Patriot),6,5-1,88,61,149,0.591,03/03/2019,2019.0
15,North Carolina (ACC),5,3-2,83,58,141,0.589,03/03/2019,2019.0
16,Holy Cross (Patriot),5,2-3,74,52,126,0.587,03/03/2019,2019.0
17,Syracuse (ACC),4,2-2,54,43,97,0.557,03/03/2019,2019.0
18,Brown (Ivy League),3,2-1,47,39,86,0.547,03/03/2019,2019.0
19,Denver (Big East),5,4-1,66,55,121,0.545,03/03/2019,2019.0
20,Villanova (Big East),4,3-1,56,47,103,0.544,03/03/2019,2019.0
21,Drexel (CAA),4,1-3,70,59,129,0.543,03/03/2019,2019.0
22,Massachusetts (CAA),4,1-3,53,45,98,0.541,03/03/2019,2019.0
23,Michigan (Big Ten),4,3-1,60,51,111,0.541,03/03/2019,2019.0
24,Air Force (SoCon),5,3-2,54,46,100,0.540,03/03/2019,2019.0
25,Mount St. Mary's (NEC),5,1-4,64,55,119,0.538,03/03/2019,2019.0
26,Penn (Ivy League),3,0-3,46,40,86,0.535,03/03/2019,2019.0
27,Rutgers (Big Ten),5,3-2,67,59,126,0.532,03/03/2019,2019.0
28,Hofstra (CAA),5,2-3,55,49,104,0.529,03/03/2019,2019.0
29,Robert Morris (NEC),4,1-3,68,61,129,0.527,03/03/2019,2019.0
30,Fairfield (CAA),3,1-2,40,37,77,0.519,03/03/2019,2019.0
31,UAlbany (America East),3,1-2,44,41,85,0.518,03/03/2019,2019.0
32,Penn St. (Big Ten),5,4-1,79,75,154,0.513,03/03/2019,2019.0
33,Princeton (Ivy League),3,1-2,44,42,86,0.512,03/03/2019,2019.0
34,Manhattan (MAAC),5,3-2,60,59,119,0.504,03/03/2019,2019.0
35,Vermont (America East),5,3-2,65,64,129,0.504,03/03/2019,2019.0
36,St. John's (NY) (Big East),4,2-2,61,61,122,0.500,03/03/2019,2019.0
37,Johns Hopkins (Big Ten),4,2-2,56,57,113,0.496,03/03/2019,2019.0
38,Bryant (NEC),5,2-3,51,52,103,0.495,03/03/2019,2019.0
39,Bucknell (Patriot),5,1-4,61,63,124,0.492,03/03/2019,2019.0
40,High Point (SoCon),6,5-1,80,83,163,0.491,03/03/2019,2019.0
41,Monmouth (MAAC),4,1-3,41,43,84,0.488,03/03/2019,2019.0
42,Mercer (SoCon),4,0-4,53,56,109,0.486,03/03/2019,2019.0
43,Loyola Maryland (Patriot),5,4-1,71,76,147,0.483,03/03/2019,2019.0
44,Virginia (ACC),5,3-2,66,71,137,0.482,03/03/2019,2019.0
45,Wagner (NEC),5,1-4,50,54,104,0.481,03/03/2019,2019.0
46,Notre Dame (ACC),3,2-1,37,40,77,0.481,03/03/2019,2019.0
47,NJIT (DI Independent),5,0-5,62,68,130,0.477,03/03/2019,2019.0
48,Quinnipiac (MAAC),4,1-3,57,63,120,0.475,03/03/2019,2019.0
49,Canisius (MAAC),5,2-3,68,76,144,0.472,03/03/2019,2019.0
50,VMI (SoCon),3,2-1,33,38,71,0.465,03/03/2019,2019.0
51,Providence (Big East),5,2-3,56,65,121,0.463,03/03/2019,2019.0
52,Marquette (Big East),4,2-2,51,62,113,0.451,03/03/2019,2019.0
53,Furman (SoCon),6,2-4,73,94,167,0.437,03/03/2019,2019.0
54,Jacksonville (SoCon),5,1-4,56,75,131,0.427,03/03/2019,2019.0
55,Dartmouth (Ivy League),3,1-2,25,34,59,0.424,03/03/2019,2019.0
56,Navy (Patriot),4,3-1,41,56,97,0.423,03/03/2019,2019.0
57,Georgetown (Big East),5,4-1,55,76,131,0.420,03/03/2019,2019.0
58,Colgate (Patriot),4,2-2,39,54,93,0.419,03/03/2019,2019.0
59,Delaware (CAA),5,4-1,46,64,110,0.418,03/03/2019,2019.0
60,UMBC (America East),4,1-3,46,66,112,0.411,03/03/2019,2019.0
61,Stony Brook (America East),4,2-2,38,57,95,0.400,03/03/2019,2019.0
62,Army West Point (Patriot),5,4-1,41,67,108,0.380,03/03/2019,2019.0
63,Cornell (Ivy League),3,3-0,38,65,103,0.369,03/03/2019,2019.0
64,Binghamton (America East),3,0-3,30,53,83,0.361,03/03/2019,2019.0
65,Hartford (America East),4,0-4,43,77,120,0.358,03/03/2019,2019.0
66,Harvard (Ivy League),4,1-3,39,70,109,0.358,03/03/2019,2019.0
67,Sacred Heart (NEC),5,2-3,54,97,151,0.358,03/03/2019,2019.0
68,Lafayette (Patriot),6,4-2,52,94,146,0.356,03/03/2019,2019.0
69,Richmond (SoCon),5,3-2,44,81,125,0.352,03/03/2019,2019.0
1,Towson (CAA),4,4-0,75,25,100,0.750,03/02/2019,2019.0
2,Marist (MAAC),4,2-2,67,23,90,0.744,03/02/2019,2019.0
3,Yale (Ivy League),3,2-1,61,21,82,0.744,03/02/2019,2019.0
4,Hobart (NEC),4,3-1,98,43,141,0.695,03/02/2019,2019.0
5,Lehigh (Patriot),5,2-3,72,34,106,0.679,03/02/2019,2019.0
6,UMass Lowell (America East),3,1-2,55,26,81,0.679,03/02/2019,2019.0
7,Detroit Mercy (MAAC),4,3-1,72,39,111,0.649,03/02/2019,2019.0
8,Saint Joseph's (NEC),5,3-2,78,43,121,0.645,03/02/2019,2019.0
9,Ohio St. (Big Ten),5,5-0,84,50,134,0.627,03/02/2019,2019.0
10,Cleveland St. (DI Independent),6,2-4,92,55,147,0.626,03/02/2019,2019.0
11,Hampton (DI Independent),2,1-1,36,23,59,0.610,03/02/2019,2019.0
12,Maryland (Big Ten),5,5-0,71,46,117,0.607,03/02/2019,2019.0
13,Duke (ACC),6,5-1,92,60,152,0.605,03/02/2019,2019.0
14,Boston U. (Patriot),6,5-1,88,61,149,0.591,03/02/2019,2019.0
15,North Carolina (ACC),5,3-2,83,58,141,0.589,03/02/2019,2019.0
16,Holy Cross (Patriot),5,2-3,74,52,126,0.587,03/02/2019,2019.0
17,Notre Dame (ACC),2,1-1,27,20,47,0.574,03/02/2019,2019.0
18,Syracuse (ACC),4,2-2,54,43,97,0.557,03/02/2019,2019.0
19,Brown (Ivy League),3,2-1,47,39,86,0.547,03/02/2019,2019.0
20,Denver (Big East),5,4-1,66,55,121,0.545,03/02/2019,2019.0
21,Villanova (Big East),4,3-1,56,47,103,0.544,03/02/2019,2019.0
22,Drexel (CAA),4,1-3,70,59,129,0.543,03/02/2019,2019.0
23,Massachusetts (CAA),4,1-3,53,45,98,0.541,03/02/2019,2019.0
24,Michigan (Big Ten),4,3-1,60,51,111,0.541,03/02/2019,2019.0
25,Air Force (SoCon),5,3-2,54,46,100,0.540,03/02/2019,2019.0
26,Mount St. Mary's (NEC),5,1-4,64,55,119,0.538,03/02/2019,2019.0
27,Penn (Ivy League),3,0-3,46,40,86,0.535,03/02/2019,2019.0
28,Rutgers (Big Ten),5,3-2,67,59,126,0.532,03/02/2019,2019.0
29,Hofstra (CAA),5,2-3,55,49,104,0.529,03/02/2019,2019.0
30,Robert Morris (NEC),4,1-3,68,61,129,0.527,03/02/2019,2019.0
31,Fairfield (CAA),3,1-2,40,37,77,0.519,03/02/2019,2019.0
32,UAlbany (America East),3,1-2,44,41,85,0.518,03/02/2019,2019.0
33,Penn St. (Big Ten),5,4-1,79,75,154,0.513,03/02/2019,2019.0
34,Princeton (Ivy League),3,1-2,44,42,86,0.512,03/02/2019,2019.0
35,Manhattan (MAAC),5,3-2,60,59,119,0.504,03/02/2019,2019.0
36,Vermont (America East),5,3-2,65,64,129,0.504,03/02/2019,2019.0
37,St. John's (NY) (Big East),4,2-2,61,61,122,0.500,03/02/2019,2019.0
38,Johns Hopkins (Big Ten),4,2-2,56,57,113,0.496,03/02/2019,2019.0
39,Bryant (NEC),5,2-3,51,52,103,0.495,03/02/2019,2019.0
40,Bucknell (Patriot),5,1-4,61,63,124,0.492,03/02/2019,2019.0
41,High Point (SoCon),6,5-1,80,83,163,0.491,03/02/2019,2019.0
42,Monmouth (MAAC),4,1-3,41,43,84,0.488,03/02/2019,2019.0
43,Mercer (SoCon),4,0-4,53,56,109,0.486,03/02/2019,2019.0
44,Loyola Maryland (Patriot),5,4-1,71,76,147,0.483,03/02/2019,2019.0
45,Virginia (ACC),5,3-2,66,71,137,0.482,03/02/2019,2019.0
46,Wagner (NEC),5,1-4,50,54,104,0.481,03/02/2019,2019.0
47,NJIT (DI Independent),5,0-5,62,68,130,0.477,03/02/2019,2019.0
48,Quinnipiac (MAAC),4,1-3,57,63,120,0.475,03/02/2019,2019.0
49,Canisius (MAAC),5,2-3,68,76,144,0.472,03/02/2019,2019.0
50,VMI (SoCon),3,2-1,33,38,71,0.465,03/02/2019,2019.0
51,Providence (Big East),5,2-3,56,65,121,0.463,03/02/2019,2019.0
52,Marquette (Big East),4,2-2,51,62,113,0.451,03/02/2019,2019.0
53,Furman (SoCon),6,2-4,73,94,167,0.437,03/02/2019,2019.0
54,Jacksonville (SoCon),5,1-4,56,75,131,0.427,03/02/2019,2019.0
55,Dartmouth (Ivy League),3,1-2,25,34,59,0.424,03/02/2019,2019.0
56,Navy (Patriot),4,3-1,41,56,97,0.423,03/02/2019,2019.0
57,Georgetown (Big East),5,4-1,55,76,131,0.420,03/02/2019,2019.0
58,Colgate (Patriot),4,2-2,39,54,93,0.419,03/02/2019,2019.0
59,Delaware (CAA),5,4-1,46,64,110,0.418,03/02/2019,2019.0
60,UMBC (America East),4,1-3,46,66,112,0.411,03/02/2019,2019.0
61,Stony Brook (America East),4,2-2,38,57,95,0.400,03/02/2019,2019.0
62,Army West Point (Patriot),5,4-1,41,67,108,0.380,03/02/2019,2019.0
63,Cornell (Ivy League),3,3-0,38,65,103,0.369,03/02/2019,2019.0
64,Binghamton (America East),3,0-3,30,53,83,0.361,03/02/2019,2019.0
65,Hartford (America East),4,0-4,43,77,120,0.358,03/02/2019,2019.0
66,Harvard (Ivy League),4,1-3,39,70,109,0.358,03/02/2019,2019.0
67,Sacred Heart (NEC),5,2-3,54,97,151,0.358,03/02/2019,2019.0
68,Lafayette (Patriot),6,4-2,52,94,146,0.356,03/02/2019,2019.0
69,Richmond (SoCon),5,3-2,44,81,125,0.352,03/02/2019,2019.0
1,Yale (Ivy League),2,1-1,43,13,56,0.768,02/27/2019,2019.0
2,Towson (CAA),4,4-0,75,25,100,0.750,02/27/2019,2019.0
3,Marist (MAAC),3,1-2,52,19,71,0.732,02/27/2019,2019.0
4,Hobart (NEC),3,2-1,78,36,114,0.684,02/27/2019,2019.0
5,UMass Lowell (America East),3,1-2,55,26,81,0.679,02/27/2019,2019.0
6,Saint Joseph's (NEC),4,2-2,69,35,104,0.663,02/27/2019,2019.0
7,Lehigh (Patriot),4,1-3,55,31,86,0.640,02/27/2019,2019.0
8,Holy Cross (Patriot),4,2-2,56,33,89,0.629,02/27/2019,2019.0
9,Massachusetts (CAA),3,1-2,45,27,72,0.625,02/27/2019,2019.0
10,Ohio St. (Big Ten),4,4-0,66,42,108,0.611,02/27/2019,2019.0
11,Cleveland St. (DI Independent),5,1-4,75,48,123,0.610,02/27/2019,2019.0
12,Maryland (Big Ten),5,5-0,71,46,117,0.607,02/27/2019,2019.0
13,Princeton (Ivy League),2,1-1,35,23,58,0.603,02/27/2019,2019.0
14,Denver (Big East),4,3-1,57,38,95,0.600,02/27/2019,2019.0
15,Syracuse (ACC),3,2-1,40,27,67,0.597,02/27/2019,2019.0
16,Duke (ACC),5,4-1,78,53,131,0.595,02/27/2019,2019.0
17,Drexel (CAA),3,1-2,56,40,96,0.583,02/27/2019,2019.0
18,Boston U. (Patriot),5,4-1,75,54,129,0.581,02/27/2019,2019.0
19,Detroit Mercy (MAAC),3,2-1,45,33,78,0.577,02/27/2019,2019.0
20,Notre Dame (ACC),2,1-1,27,20,47,0.574,02/27/2019,2019.0
21,Penn (Ivy League),2,0-2,31,23,54,0.574,02/27/2019,2019.0
22,North Carolina (ACC),4,3-1,66,49,115,0.574,02/27/2019,2019.0
23,Michigan (Big Ten),3,2-1,44,36,80,0.550,02/27/2019,2019.0
24,Mercer (SoCon),3,0-3,46,39,85,0.541,02/27/2019,2019.0
25,VMI (SoCon),2,2-0,27,23,50,0.540,02/27/2019,2019.0
26,Delaware (CAA),4,4-0,43,37,80,0.538,02/27/2019,2019.0
27,Rutgers (Big Ten),4,2-2,59,51,110,0.536,02/27/2019,2019.0
28,Vermont (America East),4,3-1,58,51,109,0.532,02/27/2019,2019.0
29,Fairfield (CAA),2,1-1,32,29,61,0.525,02/27/2019,2019.0
30,Hofstra (CAA),4,2-2,43,39,82,0.524,02/27/2019,2019.0
31,Manhattan (MAAC),4,2-2,51,47,98,0.520,02/27/2019,2019.0
32,Air Force (SoCon),4,2-2,40,37,77,0.519,02/27/2019,2019.0
33,Robert Morris (NEC),3,1-2,48,46,94,0.511,02/27/2019,2019.0
34,Penn St. (Big Ten),4,3-1,62,60,122,0.508,02/27/2019,2019.0
35,High Point (SoCon),5,4-1,65,63,128,0.508,02/27/2019,2019.0
36,St. John's (NY) (Big East),3,2-1,46,45,91,0.505,02/27/2019,2019.0
37,Mount St. Mary's (NEC),4,0-4,49,49,98,0.500,02/27/2019,2019.0
38,Marquette (Big East),3,2-1,43,44,87,0.494,02/27/2019,2019.0
39,Colgate (Patriot),3,2-1,36,37,73,0.493,02/27/2019,2019.0
40,Monmouth (MAAC),3,1-2,33,34,67,0.493,02/27/2019,2019.0
41,Canisius (MAAC),4,2-2,59,62,121,0.488,02/27/2019,2019.0
42,Hampton (DI Independent),1,0-1,17,18,35,0.486,02/27/2019,2019.0
43,NJIT (DI Independent),4,0-4,47,51,98,0.480,02/27/2019,2019.0
44,Bryant (NEC),4,2-2,39,43,82,0.476,02/27/2019,2019.0
45,Bucknell (Patriot),4,1-3,47,52,99,0.475,02/27/2019,2019.0
46,Loyola Maryland (Patriot),4,3-1,52,58,110,0.473,02/27/2019,2019.0
46,Brown (Ivy League),2,1-1,26,29,55,0.473,02/27/2019,2019.0
48,Virginia (ACC),4,2-2,50,57,107,0.467,02/27/2019,2019.0
49,Wagner (NEC),4,1-3,40,46,86,0.465,02/27/2019,2019.0
50,Quinnipiac (MAAC),3,0-3,40,48,88,0.455,02/27/2019,2019.0
51,Stony Brook (America East),3,2-1,34,42,76,0.447,02/27/2019,2019.0
52,UMBC (America East),3,1-2,36,45,81,0.444,02/27/2019,2019.0
53,Johns Hopkins (Big Ten),3,1-2,37,48,85,0.435,02/27/2019,2019.0
54,Navy (Patriot),3,2-1,30,42,72,0.417,02/27/2019,2019.0
55,Dartmouth (Ivy League),2,0-2,17,24,41,0.415,02/27/2019,2019.0
56,Georgetown (Big East),4,3-1,45,64,109,0.413,02/27/2019,2019.0
57,Binghamton (America East),2,0-2,23,33,56,0.411,02/27/2019,2019.0
58,Furman (SoCon),5,2-3,61,88,149,0.409,02/27/2019,2019.0
59,Lafayette (Patriot),5,4-1,50,75,125,0.400,02/27/2019,2019.0
60,Villanova (Big East),3,2-1,29,44,73,0.397,02/27/2019,2019.0
61,UAlbany (America East),2,1-1,19,29,48,0.396,02/27/2019,2019.0
62,Cornell (Ivy League),2,2-0,26,40,66,0.394,02/27/2019,2019.0
63,Providence (Big East),4,2-2,33,52,85,0.388,02/27/2019,2019.0
64,Jacksonville (SoCon),4,0-4,37,61,98,0.378,02/27/2019,2019.0
65,Bellarmine (SoCon),4,0-4,36,63,99,0.364,02/27/2019,2019.0
66,Sacred Heart (NEC),4,1-3,41,74,115,0.357,02/27/2019,2019.0
67,Richmond (SoCon),4,3-1,37,67,104,0.356,02/27/2019,2019.0
68,Utah (DI Independent),5,2-3,42,80,122,0.344,02/27/2019,2019.0
69,Harvard (Ivy League),3,0-3,27,55,82,0.329,02/27/2019,2019.0
1,Yale (Ivy League),2,1-1,43,13,56,0.768,02/26/2019,2019.0
2,Towson (CAA),3,3-0,55,19,74,0.743,02/26/2019,2019.0
3,Marist (MAAC),3,1-2,52,19,71,0.732,02/26/2019,2019.0
4,Hobart (NEC),3,2-1,78,36,114,0.684,02/26/2019,2019.0
5,UMass Lowell (America East),3,1-2,55,26,81,0.679,02/26/2019,2019.0
6,Saint Joseph's (NEC),4,2-2,69,35,104,0.663,02/26/2019,2019.0
7,Lehigh (Patriot),4,1-3,55,31,86,0.640,02/26/2019,2019.0
8,Holy Cross (Patriot),4,2-2,56,33,89,0.629,02/26/2019,2019.0
9,Massachusetts (CAA),3,1-2,45,27,72,0.625,02/26/2019,2019.0
10,Ohio St. (Big Ten),4,4-0,66,42,108,0.611,02/26/2019,2019.0
11,Cleveland St. (DI Independent),5,1-4,75,48,123,0.610,02/26/2019,2019.0
12,Maryland (Big Ten),5,5-0,71,46,117,0.607,02/26/2019,2019.0
13,Princeton (Ivy League),2,1-1,35,23,58,0.603,02/26/2019,2019.0
14,Denver (Big East),4,3-1,57,38,95,0.600,02/26/2019,2019.0
15,Syracuse (ACC),3,2-1,40,27,67,0.597,02/26/2019,2019.0
16,Duke (ACC),5,4-1,78,53,131,0.595,02/26/2019,2019.0
17,Drexel (CAA),3,1-2,56,40,96,0.583,02/26/2019,2019.0
18,Boston U. (Patriot),5,4-1,75,54,129,0.581,02/26/2019,2019.0
19,Detroit Mercy (MAAC),3,2-1,45,33,78,0.577,02/26/2019,2019.0
20,Notre Dame (ACC),2,1-1,27,20,47,0.574,02/26/2019,2019.0
21,Penn (Ivy League),2,0-2,31,23,54,0.574,02/26/2019,2019.0
22,North Carolina (ACC),4,3-1,66,49,115,0.574,02/26/2019,2019.0
23,Michigan (Big Ten),3,2-1,44,36,80,0.550,02/26/2019,2019.0
24,Loyola Maryland (Patriot),3,3-0,46,38,84,0.548,02/26/2019,2019.0
25,Mercer (SoCon),3,0-3,46,39,85,0.541,02/26/2019,2019.0
26,VMI (SoCon),2,2-0,27,23,50,0.540,02/26/2019,2019.0
27,Delaware (CAA),4,4-0,43,37,80,0.538,02/26/2019,2019.0
28,Rutgers (Big Ten),4,2-2,59,51,110,0.536,02/26/2019,2019.0
29,Vermont (America East),4,3-1,58,51,109,0.532,02/26/2019,2019.0
30,Fairfield (CAA),2,1-1,32,29,61,0.525,02/26/2019,2019.0
31,Hofstra (CAA),4,2-2,43,39,82,0.524,02/26/2019,2019.0
32,Manhattan (MAAC),4,2-2,51,47,98,0.520,02/26/2019,2019.0
33,Air Force (SoCon),4,2-2,40,37,77,0.519,02/26/2019,2019.0
34,Robert Morris (NEC),3,1-2,48,46,94,0.511,02/26/2019,2019.0
35,Penn St. (Big Ten),4,3-1,62,60,122,0.508,02/26/2019,2019.0
36,High Point (SoCon),5,4-1,65,63,128,0.508,02/26/2019,2019.0
37,St. John's (NY) (Big East),3,2-1,46,45,91,0.505,02/26/2019,2019.0
38,Mount St. Mary's (NEC),4,0-4,49,49,98,0.500,02/26/2019,2019.0
39,Marquette (Big East),3,2-1,43,44,87,0.494,02/26/2019,2019.0
40,Colgate (Patriot),3,2-1,36,37,73,0.493,02/26/2019,2019.0
41,Monmouth (MAAC),3,1-2,33,34,67,0.493,02/26/2019,2019.0
42,Canisius (MAAC),4,2-2,59,62,121,0.488,02/26/2019,2019.0
43,Hampton (DI Independent),1,0-1,17,18,35,0.486,02/26/2019,2019.0
44,NJIT (DI Independent),4,0-4,47,51,98,0.480,02/26/2019,2019.0
45,Bryant (NEC),4,2-2,39,43,82,0.476,02/26/2019,2019.0
46,Bucknell (Patriot),4,1-3,47,52,99,0.475,02/26/2019,2019.0
47,Brown (Ivy League),2,1-1,26,29,55,0.473,02/26/2019,2019.0
48,Virginia (ACC),4,2-2,50,57,107,0.467,02/26/2019,2019.0
49,Wagner (NEC),4,1-3,40,46,86,0.465,02/26/2019,2019.0
50,Quinnipiac (MAAC),3,0-3,40,48,88,0.455,02/26/2019,2019.0
51,Stony Brook (America East),3,2-1,34,42,76,0.447,02/26/2019,2019.0
52,UMBC (America East),3,1-2,36,45,81,0.444,02/26/2019,2019.0
53,Johns Hopkins (Big Ten),3,1-2,37,48,85,0.435,02/26/2019,2019.0
54,Navy (Patriot),3,2-1,30,42,72,0.417,02/26/2019,2019.0
55,Dartmouth (Ivy League),2,0-2,17,24,41,0.415,02/26/2019,2019.0
56,Georgetown (Big East),4,3-1,45,64,109,0.413,02/26/2019,2019.0
57,Binghamton (America East),2,0-2,23,33,56,0.411,02/26/2019,2019.0
58,Furman (SoCon),5,2-3,61,88,149,0.409,02/26/2019,2019.0
59,Lafayette (Patriot),5,4-1,50,75,125,0.400,02/26/2019,2019.0
60,Villanova (Big East),3,2-1,29,44,73,0.397,02/26/2019,2019.0
61,UAlbany (America East),2,1-1,19,29,48,0.396,02/26/2019,2019.0
62,Cornell (Ivy League),2,2-0,26,40,66,0.394,02/26/2019,2019.0
63,Providence (Big East),4,2-2,33,52,85,0.388,02/26/2019,2019.0
64,Jacksonville (SoCon),4,0-4,37,61,98,0.378,02/26/2019,2019.0
65,Bellarmine (SoCon),4,0-4,36,63,99,0.364,02/26/2019,2019.0
66,Sacred Heart (NEC),4,1-3,41,74,115,0.357,02/26/2019,2019.0
67,Richmond (SoCon),4,3-1,37,67,104,0.356,02/26/2019,2019.0
68,Utah (DI Independent),5,2-3,42,80,122,0.344,02/26/2019,2019.0
69,Harvard (Ivy League),3,0-3,27,55,82,0.329,02/26/2019,2019.0
1,Yale (Ivy League),2,1-1,43,13,56,0.768,02/24/2019,2019.0
2,Towson (CAA),3,3-0,55,19,74,0.743,02/24/2019,2019.0
3,Saint Joseph's (NEC),3,2-1,57,24,81,0.704,02/24/2019,2019.0
4,Hobart (NEC),3,2-1,78,36,114,0.684,02/24/2019,2019.0
5,UMass Lowell (America East),3,1-2,55,26,81,0.679,02/24/2019,2019.0
6,Lehigh (Patriot),4,1-3,55,31,86,0.640,02/24/2019,2019.0
7,Massachusetts (CAA),3,1-2,45,27,72,0.625,02/24/2019,2019.0
7,Marist (MAAC),2,0-2,25,15,40,0.625,02/24/2019,2019.0
9,Ohio St. (Big Ten),4,4-0,66,42,108,0.611,02/24/2019,2019.0
10,Cleveland St. (DI Independent),5,1-4,75,48,123,0.610,02/24/2019,2019.0
11,Maryland (Big Ten),5,5-0,71,46,117,0.607,02/24/2019,2019.0
12,Princeton (Ivy League),2,1-1,35,23,58,0.603,02/24/2019,2019.0
13,Denver (Big East),4,3-1,57,38,95,0.600,02/24/2019,2019.0
14,Syracuse (ACC),3,2-1,40,27,67,0.597,02/24/2019,2019.0
15,Duke (ACC),5,4-1,78,53,131,0.595,02/24/2019,2019.0
16,Drexel (CAA),3,1-2,56,40,96,0.583,02/24/2019,2019.0
17,Boston U. (Patriot),4,3-1,60,44,104,0.577,02/24/2019,2019.0
17,Detroit Mercy (MAAC),3,2-1,45,33,78,0.577,02/24/2019,2019.0
19,Notre Dame (ACC),2,1-1,27,20,47,0.574,02/24/2019,2019.0
20,Penn (Ivy League),2,0-2,31,23,54,0.574,02/24/2019,2019.0
21,North Carolina (ACC),4,3-1,66,49,115,0.574,02/24/2019,2019.0
22,Delaware (CAA),3,3-0,32,25,57,0.561,02/24/2019,2019.0
23,Michigan (Big Ten),3,2-1,44,36,80,0.550,02/24/2019,2019.0
24,Loyola Maryland (Patriot),3,3-0,46,38,84,0.548,02/24/2019,2019.0
25,Hofstra (CAA),3,2-1,31,26,57,0.544,02/24/2019,2019.0
26,Mercer (SoCon),3,0-3,46,39,85,0.541,02/24/2019,2019.0
27,VMI (SoCon),2,2-0,27,23,50,0.540,02/24/2019,2019.0
28,Holy Cross (Patriot),3,1-2,34,29,63,0.540,02/24/2019,2019.0
29,Rutgers (Big Ten),4,2-2,59,51,110,0.536,02/24/2019,2019.0
30,Vermont (America East),4,3-1,58,51,109,0.532,02/24/2019,2019.0
31,Mount St. Mary's (NEC),3,0-3,37,33,70,0.529,02/24/2019,2019.0
32,Monmouth (MAAC),2,0-2,25,23,48,0.521,02/24/2019,2019.0
33,Manhattan (MAAC),4,2-2,51,47,98,0.520,02/24/2019,2019.0
34,Air Force (SoCon),4,2-2,40,37,77,0.519,02/24/2019,2019.0
35,Robert Morris (NEC),3,1-2,48,46,94,0.511,02/24/2019,2019.0
36,Bryant (NEC),3,2-1,29,28,57,0.509,02/24/2019,2019.0
37,Penn St. (Big Ten),4,3-1,62,60,122,0.508,02/24/2019,2019.0
38,High Point (SoCon),5,4-1,65,63,128,0.508,02/24/2019,2019.0
39,St. John's (NY) (Big East),3,2-1,46,45,91,0.505,02/24/2019,2019.0
40,Marquette (Big East),3,2-1,43,44,87,0.494,02/24/2019,2019.0
41,Colgate (Patriot),3,2-1,36,37,73,0.493,02/24/2019,2019.0
42,Canisius (MAAC),4,2-2,59,62,121,0.488,02/24/2019,2019.0
43,Hampton (DI Independent),1,0-1,17,18,35,0.486,02/24/2019,2019.0
44,NJIT (DI Independent),4,0-4,47,51,98,0.480,02/24/2019,2019.0
45,Bucknell (Patriot),4,1-3,47,52,99,0.475,02/24/2019,2019.0
46,Brown (Ivy League),2,1-1,26,29,55,0.473,02/24/2019,2019.0
47,Virginia (ACC),4,2-2,50,57,107,0.467,02/24/2019,2019.0
48,Quinnipiac (MAAC),3,0-3,40,48,88,0.455,02/24/2019,2019.0
49,UMBC (America East),3,1-2,36,45,81,0.444,02/24/2019,2019.0
50,Johns Hopkins (Big Ten),3,1-2,37,48,85,0.435,02/24/2019,2019.0
51,Wagner (NEC),3,1-2,29,38,67,0.433,02/24/2019,2019.0
52,Navy (Patriot),3,2-1,30,42,72,0.417,02/24/2019,2019.0
53,Dartmouth (Ivy League),2,0-2,17,24,41,0.415,02/24/2019,2019.0
54,Stony Brook (America East),2,1-1,21,30,51,0.412,02/24/2019,2019.0
55,Harvard (Ivy League),2,0-2,23,33,56,0.411,02/24/2019,2019.0
55,Binghamton (America East),2,0-2,23,33,56,0.411,02/24/2019,2019.0
57,Furman (SoCon),5,2-3,61,88,149,0.409,02/24/2019,2019.0
58,Lafayette (Patriot),5,4-1,50,75,125,0.400,02/24/2019,2019.0
59,Sacred Heart (NEC),4,1-3,35,53,88,0.398,02/24/2019,2019.0
60,Villanova (Big East),3,2-1,29,44,73,0.397,02/24/2019,2019.0
61,UAlbany (America East),2,1-1,19,29,48,0.396,02/24/2019,2019.0
62,Cornell (Ivy League),2,2-0,26,40,66,0.394,02/24/2019,2019.0
63,Providence (Big East),4,2-2,33,52,85,0.388,02/24/2019,2019.0
64,Hartford (America East),2,0-2,24,38,62,0.387,02/24/2019,2019.0
65,Jacksonville (SoCon),4,0-4,37,61,98,0.378,02/24/2019,2019.0
66,Bellarmine (SoCon),4,0-4,36,63,99,0.364,02/24/2019,2019.0
67,Georgetown (Big East),3,2-1,29,52,81,0.358,02/24/2019,2019.0
68,Richmond (SoCon),4,3-1,37,67,104,0.356,02/24/2019,2019.0
69,Utah (DI Independent),5,2-3,42,80,122,0.344,02/24/2019,2019.0
1,Penn (Ivy League),1,0-1,21,6,27,0.778,02/22/2019,2019.0
2,Saint Joseph's (NEC),2,2-0,44,15,59,0.746,02/22/2019,2019.0
3,Yale (Ivy League),1,0-1,18,7,25,0.720,02/22/2019,2019.0
4,Towson (CAA),2,2-0,34,15,49,0.694,02/22/2019,2019.0
5,Cleveland St. (DI Independent),3,1-2,50,23,73,0.685,02/22/2019,2019.0
6,Hobart (NEC),3,2-1,78,36,114,0.684,02/22/2019,2019.0
7,Delaware (CAA),2,2-0,28,13,41,0.683,02/22/2019,2019.0
8,UMass Lowell (America East),2,1-1,32,16,48,0.667,02/22/2019,2019.0
9,Denver (Big East),2,1-1,27,15,42,0.643,02/22/2019,2019.0
10,Lehigh (Patriot),3,1-2,37,22,59,0.627,02/22/2019,2019.0
11,Marist (MAAC),2,0-2,25,15,40,0.625,02/22/2019,2019.0
12,Massachusetts (CAA),2,0-2,29,18,47,0.617,02/22/2019,2019.0
13,Penn St. (Big Ten),3,3-0,56,35,91,0.615,02/22/2019,2019.0
14,Hofstra (CAA),2,2-0,22,14,36,0.611,02/22/2019,2019.0
15,St. John's (NY) (Big East),2,1-1,41,27,68,0.603,02/22/2019,2019.0
16,Rutgers (Big Ten),3,2-1,52,35,87,0.598,02/22/2019,2019.0
17,Princeton (Ivy League),1,1-0,19,13,32,0.594,02/22/2019,2019.0
18,North Carolina (ACC),3,3-0,54,37,91,0.593,02/22/2019,2019.0
19,Notre Dame (ACC),1,1-0,16,11,27,0.593,02/22/2019,2019.0
20,Duke (ACC),4,3-1,61,43,104,0.587,02/22/2019,2019.0
21,Ohio St. (Big Ten),3,3-0,45,32,77,0.584,02/22/2019,2019.0
22,Maryland (Big Ten),4,4-0,53,38,91,0.582,02/22/2019,2019.0
23,Boston U. (Patriot),4,3-1,60,44,104,0.577,02/22/2019,2019.0
24,Marquette (Big East),2,2-0,32,25,57,0.561,02/22/2019,2019.0
25,UMBC (America East),2,0-2,30,24,54,0.556,02/22/2019,2019.0
26,Bucknell (Patriot),3,1-2,37,31,68,0.544,02/22/2019,2019.0
27,Detroit Mercy (MAAC),2,1-1,26,22,48,0.542,02/22/2019,2019.0
28,Mercer (SoCon),3,0-3,46,39,85,0.541,02/22/2019,2019.0
29,Holy Cross (Patriot),3,1-2,34,29,63,0.540,02/22/2019,2019.0
30,Drexel (CAA),2,1-1,37,32,69,0.536,02/22/2019,2019.0
31,UAlbany (America East),1,0-1,11,10,21,0.524,02/22/2019,2019.0
32,VMI (SoCon),1,1-0,12,11,23,0.522,02/22/2019,2019.0
33,Michigan (Big Ten),2,1-1,29,28,57,0.509,02/22/2019,2019.0
34,Vermont (America East),3,2-1,38,38,76,0.500,02/22/2019,2019.0
34,Robert Morris (NEC),2,0-2,34,34,68,0.500,02/22/2019,2019.0
34,Syracuse (ACC),2,1-1,23,23,46,0.500,02/22/2019,2019.0
34,Bryant (NEC),2,1-1,21,21,42,0.500,02/22/2019,2019.0
38,Virginia (ACC),3,1-2,40,41,81,0.494,02/22/2019,2019.0
39,Colgate (Patriot),3,2-1,36,37,73,0.493,02/22/2019,2019.0
40,NJIT (DI Independent),3,0-3,35,36,71,0.493,02/22/2019,2019.0
41,Loyola Maryland (Patriot),2,2-0,30,31,61,0.492,02/22/2019,2019.0
42,Quinnipiac (MAAC),2,0-2,27,28,55,0.491,02/22/2019,2019.0
43,Navy (Patriot),2,2-0,22,24,46,0.478,02/22/2019,2019.0
44,Manhattan (MAAC),3,1-2,31,37,68,0.456,02/22/2019,2019.0
45,Harvard (Ivy League),1,0-1,14,17,31,0.452,02/22/2019,2019.0
46,Canisius (MAAC),3,1-2,40,49,89,0.449,02/22/2019,2019.0
47,High Point (SoCon),4,4-0,47,58,105,0.448,02/22/2019,2019.0
48,Georgetown (Big East),2,2-0,25,31,56,0.446,02/22/2019,2019.0
49,Cornell (Ivy League),1,1-0,17,22,39,0.436,02/22/2019,2019.0
50,Wagner (NEC),3,1-2,29,38,67,0.433,02/22/2019,2019.0
51,Brown (Ivy League),1,1-0,12,17,29,0.414,02/22/2019,2019.0
52,Johns Hopkins (Big Ten),2,0-2,25,36,61,0.410,02/22/2019,2019.0
53,Monmouth (MAAC),1,0-1,13,19,32,0.406,02/22/2019,2019.0
54,Sacred Heart (NEC),3,1-2,35,53,88,0.398,02/22/2019,2019.0
55,Utah (DI Independent),3,1-2,33,50,83,0.398,02/22/2019,2019.0
56,Jacksonville (SoCon),3,0-3,29,46,75,0.387,02/22/2019,2019.0
57,Dartmouth (Ivy League),1,0-1,10,16,26,0.385,02/22/2019,2019.0
58,Providence (Big East),3,1-2,24,39,63,0.381,02/22/2019,2019.0
59,Furman (SoCon),4,1-3,43,71,114,0.377,02/22/2019,2019.0
60,Mount St. Mary's (NEC),2,0-2,16,27,43,0.372,02/22/2019,2019.0
61,Hartford (America East),1,0-1,11,19,30,0.367,02/22/2019,2019.0
62,Air Force (SoCon),2,1-1,15,26,41,0.366,02/22/2019,2019.0
63,Lafayette (Patriot),4,3-1,35,62,97,0.361,02/22/2019,2019.0
64,Stony Brook (America East),1,0-1,9,16,25,0.360,02/22/2019,2019.0
65,Binghamton (America East),1,0-1,10,18,28,0.357,02/22/2019,2019.0
66,Richmond (SoCon),3,2-1,28,56,84,0.333,02/22/2019,2019.0
67,Bellarmine (SoCon),3,0-3,24,49,73,0.329,02/22/2019,2019.0
68,Villanova (Big East),2,1-1,17,35,52,0.327,02/22/2019,2019.0
69,Fairfield (CAA),1,0-1,11,23,34,0.324,02/22/2019,2019.0
1,Penn (Ivy League),1,0-1,21,6,27,0.778,02/19/2019,2019.0
2,Hobart (NEC),2,2-0,56,19,75,0.747,02/19/2019,2019.0
3,Saint Joseph's (NEC),2,2-0,44,15,59,0.746,02/19/2019,2019.0
4,Yale (Ivy League),1,0-1,18,7,25,0.720,02/19/2019,2019.0
5,Towson (CAA),2,2-0,34,15,49,0.694,02/19/2019,2019.0
6,Cleveland St. (DI Independent),3,1-2,50,23,73,0.685,02/19/2019,2019.0
7,Delaware (CAA),2,2-0,28,13,41,0.683,02/19/2019,2019.0
8,UMass Lowell (America East),2,1-1,32,16,48,0.667,02/19/2019,2019.0
9,Denver (Big East),2,1-1,27,15,42,0.643,02/19/2019,2019.0
10,Lehigh (Patriot),3,1-2,37,22,59,0.627,02/19/2019,2019.0
11,Marist (MAAC),2,0-2,25,15,40,0.625,02/19/2019,2019.0
12,Massachusetts (CAA),2,0-2,29,18,47,0.617,02/19/2019,2019.0
13,Penn St. (Big Ten),3,3-0,56,35,91,0.615,02/19/2019,2019.0
14,Hofstra (CAA),2,2-0,22,14,36,0.611,02/19/2019,2019.0
15,St. John's (NY) (Big East),2,1-1,41,27,68,0.603,02/19/2019,2019.0
16,Rutgers (Big Ten),3,2-1,52,35,87,0.598,02/19/2019,2019.0
17,Princeton (Ivy League),1,1-0,19,13,32,0.594,02/19/2019,2019.0
18,North Carolina (ACC),3,3-0,54,37,91,0.593,02/19/2019,2019.0
19,Notre Dame (ACC),1,1-0,16,11,27,0.593,02/19/2019,2019.0
20,Duke (ACC),4,3-1,61,43,104,0.587,02/19/2019,2019.0
21,Ohio St. (Big Ten),3,3-0,45,32,77,0.584,02/19/2019,2019.0
22,Maryland (Big Ten),4,4-0,53,38,91,0.582,02/19/2019,2019.0
23,Boston U. (Patriot),4,3-1,60,44,104,0.577,02/19/2019,2019.0
24,Marquette (Big East),2,2-0,32,25,57,0.561,02/19/2019,2019.0
25,UMBC (America East),2,0-2,30,24,54,0.556,02/19/2019,2019.0
26,Detroit Mercy (MAAC),2,1-1,26,22,48,0.542,02/19/2019,2019.0
27,Mercer (SoCon),3,0-3,46,39,85,0.541,02/19/2019,2019.0
28,Holy Cross (Patriot),3,1-2,34,29,63,0.540,02/19/2019,2019.0
29,Drexel (CAA),2,1-1,37,32,69,0.536,02/19/2019,2019.0
30,Bucknell (Patriot),2,1-1,21,19,40,0.525,02/19/2019,2019.0
31,UAlbany (America East),1,0-1,11,10,21,0.524,02/19/2019,2019.0
32,VMI (SoCon),1,1-0,12,11,23,0.522,02/19/2019,2019.0
33,Michigan (Big Ten),2,1-1,29,28,57,0.509,02/19/2019,2019.0
34,Vermont (America East),3,2-1,38,38,76,0.500,02/19/2019,2019.0
34,Robert Morris (NEC),2,0-2,34,34,68,0.500,02/19/2019,2019.0
34,Syracuse (ACC),2,1-1,23,23,46,0.500,02/19/2019,2019.0
34,Bryant (NEC),2,1-1,21,21,42,0.500,02/19/2019,2019.0
38,Virginia (ACC),3,1-2,40,41,81,0.494,02/19/2019,2019.0
39,Colgate (Patriot),3,2-1,36,37,73,0.493,02/19/2019,2019.0
40,NJIT (DI Independent),3,0-3,35,36,71,0.493,02/19/2019,2019.0
41,Loyola Maryland (Patriot),2,2-0,30,31,61,0.492,02/19/2019,2019.0
42,Quinnipiac (MAAC),2,0-2,27,28,55,0.491,02/19/2019,2019.0
43,Navy (Patriot),2,2-0,22,24,46,0.478,02/19/2019,2019.0
44,Manhattan (MAAC),3,1-2,31,37,68,0.456,02/19/2019,2019.0
45,Harvard (Ivy League),1,0-1,14,17,31,0.452,02/19/2019,2019.0
46,Canisius (MAAC),3,1-2,40,49,89,0.449,02/19/2019,2019.0
47,High Point (SoCon),4,4-0,47,58,105,0.448,02/19/2019,2019.0
48,Georgetown (Big East),2,2-0,25,31,56,0.446,02/19/2019,2019.0
49,Wagner (NEC),3,1-2,29,38,67,0.433,02/19/2019,2019.0
50,Brown (Ivy League),1,1-0,12,17,29,0.414,02/19/2019,2019.0
51,Johns Hopkins (Big Ten),2,0-2,25,36,61,0.410,02/19/2019,2019.0
52,Monmouth (MAAC),1,0-1,13,19,32,0.406,02/19/2019,2019.0
53,Sacred Heart (NEC),3,1-2,35,53,88,0.398,02/19/2019,2019.0
54,Utah (DI Independent),3,1-2,33,50,83,0.398,02/19/2019,2019.0
55,Jacksonville (SoCon),3,0-3,29,46,75,0.387,02/19/2019,2019.0
56,Dartmouth (Ivy League),1,0-1,10,16,26,0.385,02/19/2019,2019.0
57,Providence (Big East),3,1-2,24,39,63,0.381,02/19/2019,2019.0
58,Furman (SoCon),4,1-3,43,71,114,0.377,02/19/2019,2019.0
59,Mount St. Mary's (NEC),2,0-2,16,27,43,0.372,02/19/2019,2019.0
60,Hartford (America East),1,0-1,11,19,30,0.367,02/19/2019,2019.0
61,Air Force (SoCon),2,1-1,15,26,41,0.366,02/19/2019,2019.0
62,Lafayette (Patriot),4,3-1,35,62,97,0.361,02/19/2019,2019.0
63,Stony Brook (America East),1,0-1,9,16,25,0.360,02/19/2019,2019.0
64,Binghamton (America East),1,0-1,10,18,28,0.357,02/19/2019,2019.0
65,Bellarmine (SoCon),3,0-3,24,49,73,0.329,02/19/2019,2019.0
66,Villanova (Big East),2,1-1,17,35,52,0.327,02/19/2019,2019.0
67,Fairfield (CAA),1,0-1,11,23,34,0.324,02/19/2019,2019.0
68,Richmond (SoCon),2,1-1,16,40,56,0.286,02/19/2019,2019.0
69,Army West Point (Patriot),3,3-0,18,48,66,0.273,02/19/2019,2019.0
1,Penn (Ivy League),1,0-1,21,6,27,0.778,02/18/2019,2019.0
2,Hobart (NEC),2,2-0,56,19,75,0.747,02/18/2019,2019.0
3,Saint Joseph's (NEC),2,2-0,44,15,59,0.746,02/18/2019,2019.0
4,Yale (Ivy League),1,0-1,18,7,25,0.720,02/18/2019,2019.0
5,Holy Cross (Patriot),2,0-2,29,12,41,0.707,02/18/2019,2019.0
6,Towson (CAA),2,2-0,34,15,49,0.694,02/18/2019,2019.0
7,Cleveland St. (DI Independent),3,1-2,50,23,73,0.685,02/18/2019,2019.0
8,Delaware (CAA),2,2-0,28,13,41,0.683,02/18/2019,2019.0
9,Drexel (CAA),1,0-1,21,11,32,0.656,02/18/2019,2019.0
10,Denver (Big East),2,1-1,27,15,42,0.643,02/18/2019,2019.0
11,Lehigh (Patriot),3,1-2,37,22,59,0.627,02/18/2019,2019.0
12,Massachusetts (CAA),2,0-2,29,18,47,0.617,02/18/2019,2019.0
13,Penn St. (Big Ten),3,3-0,56,35,91,0.615,02/18/2019,2019.0
13,UMass Lowell (America East),1,1-0,16,10,26,0.615,02/18/2019,2019.0
15,Hofstra (CAA),2,2-0,22,14,36,0.611,02/18/2019,2019.0
16,St. John's (NY) (Big East),2,1-1,41,27,68,0.603,02/18/2019,2019.0
17,Rutgers (Big Ten),3,2-1,52,35,87,0.598,02/18/2019,2019.0
18,Princeton (Ivy League),1,1-0,19,13,32,0.594,02/18/2019,2019.0
19,North Carolina (ACC),3,3-0,54,37,91,0.593,02/18/2019,2019.0
20,Notre Dame (ACC),1,1-0,16,11,27,0.593,02/18/2019,2019.0
21,Duke (ACC),4,3-1,61,43,104,0.587,02/18/2019,2019.0
22,Ohio St. (Big Ten),3,3-0,45,32,77,0.584,02/18/2019,2019.0
23,Colgate (Patriot),2,2-0,30,23,53,0.566,02/18/2019,2019.0
24,Marquette (Big East),2,2-0,32,25,57,0.561,02/18/2019,2019.0
25,Maryland (Big Ten),3,3-0,39,32,71,0.549,02/18/2019,2019.0
26,Bucknell (Patriot),3,1-2,37,31,68,0.544,02/18/2019,2019.0
27,Detroit Mercy (MAAC),2,1-1,26,22,48,0.542,02/18/2019,2019.0
28,Mercer (SoCon),3,0-3,46,39,85,0.541,02/18/2019,2019.0
29,Boston U. (Patriot),3,2-1,40,35,75,0.533,02/18/2019,2019.0
30,UAlbany (America East),1,0-1,11,10,21,0.524,02/18/2019,2019.0
31,VMI (SoCon),1,1-0,12,11,23,0.522,02/18/2019,2019.0
32,Robert Morris (NEC),2,0-2,34,34,68,0.500,02/18/2019,2019.0
32,Manhattan (MAAC),2,1-1,24,24,48,0.500,02/18/2019,2019.0
32,Syracuse (ACC),2,1-1,23,23,46,0.500,02/18/2019,2019.0
32,Bryant (NEC),2,1-1,21,21,42,0.500,02/18/2019,2019.0
32,Marist (MAAC),1,0-1,11,11,22,0.500,02/18/2019,2019.0
37,Virginia (ACC),3,1-2,40,41,81,0.494,02/18/2019,2019.0
38,NJIT (DI Independent),3,0-3,35,36,71,0.493,02/18/2019,2019.0
39,Loyola Maryland (Patriot),2,2-0,30,31,61,0.492,02/18/2019,2019.0
40,Quinnipiac (MAAC),2,0-2,27,28,55,0.491,02/18/2019,2019.0
41,Vermont (America East),3,2-1,37,39,76,0.487,02/18/2019,2019.0
42,Navy (Patriot),2,2-0,22,24,46,0.478,02/18/2019,2019.0
43,UMBC (America East),1,0-1,10,11,21,0.476,02/18/2019,2019.0
44,Sacred Heart (NEC),2,1-1,28,31,59,0.475,02/18/2019,2019.0
45,Harvard (Ivy League),1,0-1,14,17,31,0.452,02/18/2019,2019.0
46,High Point (SoCon),4,4-0,47,58,105,0.448,02/18/2019,2019.0
47,Georgetown (Big East),2,2-0,25,31,56,0.446,02/18/2019,2019.0
48,Wagner (NEC),3,1-2,29,38,67,0.433,02/18/2019,2019.0
49,Brown (Ivy League),1,1-0,12,17,29,0.414,02/18/2019,2019.0
50,Johns Hopkins (Big Ten),2,0-2,25,36,61,0.410,02/18/2019,2019.0
51,Monmouth (MAAC),1,0-1,13,19,32,0.406,02/18/2019,2019.0
52,Michigan (Big Ten),1,1-0,8,12,20,0.400,02/18/2019,2019.0
53,Utah (DI Independent),3,1-2,33,50,83,0.398,02/18/2019,2019.0
54,Jacksonville (SoCon),3,0-3,29,46,75,0.387,02/18/2019,2019.0
55,Canisius (MAAC),2,1-1,24,39,63,0.381,02/18/2019,2019.0
55,Providence (Big East),3,1-2,24,39,63,0.381,02/18/2019,2019.0
57,Furman (SoCon),3,0-3,33,55,88,0.375,02/18/2019,2019.0
58,Mount St. Mary's (NEC),2,0-2,16,27,43,0.372,02/18/2019,2019.0
59,Hartford (America East),1,0-1,11,19,30,0.367,02/18/2019,2019.0
60,Air Force (SoCon),2,1-1,15,26,41,0.366,02/18/2019,2019.0
61,Stony Brook (America East),1,0-1,9,16,25,0.360,02/18/2019,2019.0
62,Binghamton (America East),1,0-1,10,18,28,0.357,02/18/2019,2019.0
63,Bellarmine (SoCon),3,0-3,24,49,73,0.329,02/18/2019,2019.0
64,Villanova (Big East),2,1-1,17,35,52,0.327,02/18/2019,2019.0
65,Fairfield (CAA),1,0-1,11,23,34,0.324,02/18/2019,2019.0
66,Dartmouth (Ivy League),1,0-1,8,18,26,0.308,02/18/2019,2019.0
67,Richmond (SoCon),2,1-1,15,36,51,0.294,02/18/2019,2019.0
68,Army West Point (Patriot),2,2-0,14,34,48,0.292,02/18/2019,2019.0
69,Lafayette (Patriot),3,2-1,22,55,77,0.286,02/18/2019,2019.0
1,Penn (Ivy League),1,0-1,21,6,27,0.778,02/17/2019,2019.0
2,Hobart (NEC),2,2-0,56,19,75,0.747,02/17/2019,2019.0
3,Saint Joseph's (NEC),2,2-0,44,15,59,0.746,02/17/2019,2019.0
4,Yale (Ivy League),1,0-1,18,7,25,0.720,02/17/2019,2019.0
5,Towson (CAA),2,2-0,34,15,49,0.694,02/17/2019,2019.0
6,Cleveland St. (DI Independent),3,1-2,50,23,73,0.685,02/17/2019,2019.0
7,Delaware (CAA),2,2-0,28,13,41,0.683,02/17/2019,2019.0
7,Holy Cross (Patriot),2,0-2,28,13,41,0.683,02/17/2019,2019.0
9,Drexel (CAA),1,0-1,21,11,32,0.656,02/17/2019,2019.0
10,Denver (Big East),2,1-1,27,15,42,0.643,02/17/2019,2019.0
11,Lehigh (Patriot),3,1-2,37,22,59,0.627,02/17/2019,2019.0
12,Massachusetts (CAA),2,0-2,29,18,47,0.617,02/17/2019,2019.0
13,Penn St. (Big Ten),3,3-0,56,35,91,0.615,02/17/2019,2019.0
13,UMass Lowell (America East),1,1-0,16,10,26,0.615,02/17/2019,2019.0
15,Hofstra (CAA),2,2-0,22,14,36,0.611,02/17/2019,2019.0
16,St. John's (NY) (Big East),2,1-1,41,27,68,0.603,02/17/2019,2019.0
17,Rutgers (Big Ten),3,2-1,52,35,87,0.598,02/17/2019,2019.0
18,Princeton (Ivy League),1,1-0,19,13,32,0.594,02/17/2019,2019.0
19,North Carolina (ACC),3,3-0,54,37,91,0.593,02/17/2019,2019.0
20,Notre Dame (ACC),1,1-0,16,11,27,0.593,02/17/2019,2019.0
21,Duke (ACC),4,3-1,61,43,104,0.587,02/17/2019,2019.0
22,Ohio St. (Big Ten),3,3-0,45,32,77,0.584,02/17/2019,2019.0
23,Colgate (Patriot),2,2-0,30,23,53,0.566,02/17/2019,2019.0
24,Marquette (Big East),2,2-0,32,25,57,0.561,02/17/2019,2019.0
25,Maryland (Big Ten),3,3-0,39,32,71,0.549,02/17/2019,2019.0
26,Bucknell (Patriot),3,1-2,37,31,68,0.544,02/17/2019,2019.0
27,Detroit Mercy (MAAC),2,1-1,26,22,48,0.542,02/17/2019,2019.0
28,Boston U. (Patriot),3,2-1,40,35,75,0.533,02/17/2019,2019.0
29,Mercer (SoCon),3,0-3,45,40,85,0.529,02/17/2019,2019.0
30,UAlbany (America East),1,0-1,11,10,21,0.524,02/17/2019,2019.0
31,VMI (SoCon),1,1-0,12,11,23,0.522,02/17/2019,2019.0
32,Bryant (NEC),2,1-1,21,20,41,0.512,02/17/2019,2019.0
33,Vermont (America East),3,2-1,38,38,76,0.500,02/17/2019,2019.0
33,Robert Morris (NEC),2,0-2,34,34,68,0.500,02/17/2019,2019.0
33,Manhattan (MAAC),2,1-1,24,24,48,0.500,02/17/2019,2019.0
33,Syracuse (ACC),2,1-1,23,23,46,0.500,02/17/2019,2019.0
33,Marist (MAAC),1,0-1,11,11,22,0.500,02/17/2019,2019.0
38,NJIT (DI Independent),3,0-3,35,36,71,0.493,02/17/2019,2019.0
39,Loyola Maryland (Patriot),2,2-0,30,31,61,0.492,02/17/2019,2019.0
40,Quinnipiac (MAAC),2,0-2,27,28,55,0.491,02/17/2019,2019.0
41,High Point (SoCon),3,3-0,36,39,75,0.480,02/17/2019,2019.0
42,Navy (Patriot),2,2-0,22,24,46,0.478,02/17/2019,2019.0
43,UMBC (America East),1,0-1,10,11,21,0.476,02/17/2019,2019.0
44,Sacred Heart (NEC),2,1-1,28,31,59,0.475,02/17/2019,2019.0
45,Harvard (Ivy League),1,0-1,14,17,31,0.452,02/17/2019,2019.0
46,Georgetown (Big East),2,2-0,25,31,56,0.446,02/17/2019,2019.0
47,Wagner (NEC),3,1-2,29,38,67,0.433,02/17/2019,2019.0
48,Brown (Ivy League),1,1-0,12,17,29,0.414,02/17/2019,2019.0
49,Virginia (ACC),2,1-1,21,30,51,0.412,02/17/2019,2019.0
50,Johns Hopkins (Big Ten),2,0-2,25,36,61,0.410,02/17/2019,2019.0
51,Monmouth (MAAC),1,0-1,13,19,32,0.406,02/17/2019,2019.0
52,Michigan (Big Ten),1,1-0,8,12,20,0.400,02/17/2019,2019.0
53,Utah (DI Independent),3,1-2,33,50,83,0.398,02/17/2019,2019.0
54,Canisius (MAAC),2,1-1,25,38,63,0.397,02/17/2019,2019.0
55,Jacksonville (SoCon),3,0-3,29,46,75,0.387,02/17/2019,2019.0
56,Providence (Big East),3,1-2,24,39,63,0.381,02/17/2019,2019.0
57,Furman (SoCon),3,0-3,33,55,88,0.375,02/17/2019,2019.0
58,Mount St. Mary's (NEC),2,0-2,16,27,43,0.372,02/17/2019,2019.0
59,Hartford (America East),1,0-1,11,19,30,0.367,02/17/2019,2019.0
60,Air Force (SoCon),2,1-1,15,26,41,0.366,02/17/2019,2019.0
61,Stony Brook (America East),1,0-1,9,16,25,0.360,02/17/2019,2019.0
62,Binghamton (America East),1,0-1,10,18,28,0.357,02/17/2019,2019.0
63,Bellarmine (SoCon),3,0-3,24,49,73,0.329,02/17/2019,2019.0
64,Villanova (Big East),2,1-1,17,35,52,0.327,02/17/2019,2019.0
65,Fairfield (CAA),1,0-1,11,23,34,0.324,02/17/2019,2019.0
66,Dartmouth (Ivy League),1,0-1,8,18,26,0.308,02/17/2019,2019.0
67,Richmond (SoCon),2,1-1,15,36,51,0.294,02/17/2019,2019.0
68,Army West Point (Patriot),2,2-0,14,34,48,0.292,02/17/2019,2019.0
69,Lafayette (Patriot),3,2-1,22,55,77,0.286,02/17/2019,2019.0
1,Massachusetts (CAA),1,0-1,21,4,25,0.840,02/15/2019,2019.0
1,Saint Joseph's (NEC),1,1-0,21,4,25,0.840,02/15/2019,2019.0
3,Denver (Big East),1,1-0,15,4,19,0.789,02/15/2019,2019.0
4,Maryland (Big Ten),2,2-0,33,11,44,0.750,02/15/2019,2019.0
5,Detroit Mercy (MAAC),1,1-0,15,6,21,0.714,02/15/2019,2019.0
6,Towson (CAA),2,2-0,34,15,49,0.694,02/15/2019,2019.0
7,Delaware (CAA),1,1-0,14,8,22,0.636,02/15/2019,2019.0
8,Lehigh (Patriot),3,1-2,37,22,59,0.627,02/15/2019,2019.0
9,Hobart (NEC),1,1-0,23,14,37,0.622,02/15/2019,2019.0
10,Holy Cross (Patriot),1,0-1,13,8,21,0.619,02/15/2019,2019.0
11,Duke (ACC),3,2-1,50,31,81,0.617,02/15/2019,2019.0
12,North Carolina (ACC),2,2-0,37,23,60,0.617,02/15/2019,2019.0
13,UMass Lowell (America East),1,1-0,16,10,26,0.615,02/15/2019,2019.0
14,Rutgers (Big Ten),2,2-0,39,25,64,0.609,02/15/2019,2019.0
15,Penn St. (Big Ten),2,2-0,40,26,66,0.606,02/15/2019,2019.0
16,Vermont (America East),2,1-1,33,23,56,0.589,02/15/2019,2019.0
17,High Point (SoCon),2,2-0,25,18,43,0.581,02/15/2019,2019.0
18,St. John's (NY) (Big East),1,0-1,22,16,38,0.579,02/15/2019,2019.0
19,NJIT (DI Independent),2,0-2,30,22,52,0.577,02/15/2019,2019.0
20,Ohio St. (Big Ten),2,2-0,31,24,55,0.564,02/15/2019,2019.0
21,Cleveland St. (DI Independent),2,0-2,25,20,45,0.556,02/15/2019,2019.0
22,Marquette (Big East),2,2-0,32,26,58,0.552,02/15/2019,2019.0
23,Loyola Maryland (Patriot),1,1-0,15,13,28,0.536,02/15/2019,2019.0
24,Bucknell (Patriot),2,1-1,21,19,40,0.525,02/15/2019,2019.0
25,Syracuse (ACC),1,0-1,13,12,25,0.520,02/15/2019,2019.0
25,Manhattan (MAAC),1,1-0,13,12,25,0.520,02/15/2019,2019.0
27,Georgetown (Big East),1,1-0,14,13,27,0.519,02/15/2019,2019.0
28,Mercer (SoCon),2,0-2,30,29,59,0.508,02/15/2019,2019.0
29,Sacred Heart (NEC),1,0-1,13,14,27,0.481,02/15/2019,2019.0
30,Colgate (Patriot),1,1-0,12,13,25,0.480,02/15/2019,2019.0
31,Navy (Patriot),2,2-0,22,24,46,0.478,02/15/2019,2019.0
32,UMBC (America East),1,0-1,10,11,21,0.476,02/15/2019,2019.0
33,Bellarmine (SoCon),2,0-2,21,24,45,0.467,02/15/2019,2019.0
34,Boston U. (Patriot),2,1-1,22,27,49,0.449,02/15/2019,2019.0
35,Utah (DI Independent),2,1-1,25,32,57,0.439,02/15/2019,2019.0
36,Wagner (NEC),3,1-2,29,38,67,0.433,02/15/2019,2019.0
37,Virginia (ACC),2,1-1,21,30,51,0.412,02/15/2019,2019.0
38,Robert Morris (NEC),1,0-1,16,23,39,0.410,02/15/2019,2019.0
39,Providence (Big East),2,1-1,16,24,40,0.400,02/15/2019,2019.0
39,Michigan (Big Ten),1,1-0,8,12,20,0.400,02/15/2019,2019.0
39,Hofstra (CAA),1,1-0,4,6,10,0.400,02/15/2019,2019.0
42,Jacksonville (SoCon),3,0-3,30,46,76,0.395,02/15/2019,2019.0
43,Quinnipiac (MAAC),1,0-1,10,16,26,0.385,02/15/2019,2019.0
44,Canisius (MAAC),1,0-1,14,23,37,0.378,02/15/2019,2019.0
45,Mount St. Mary's (NEC),2,0-2,16,27,43,0.372,02/15/2019,2019.0
46,Villanova (Big East),1,0-1,10,17,27,0.370,02/15/2019,2019.0
47,Bryant (NEC),1,0-1,6,13,19,0.316,02/15/2019,2019.0
48,Lafayette (Patriot),3,2-1,22,55,77,0.286,02/15/2019,2019.0
48,Furman (SoCon),2,0-2,16,40,56,0.286,02/15/2019,2019.0
50,Johns Hopkins (Big Ten),1,0-1,7,21,28,0.250,02/15/2019,2019.0
51,St. Bonaventure (MAAC),2,0-2,9,32,41,0.220,02/15/2019,2019.0
52,Air Force (SoCon),1,0-1,4,15,19,0.211,02/15/2019,2019.0
53,Army West Point (Patriot),1,1-0,4,21,25,0.160,02/15/2019,2019.0
54,Richmond (SoCon),1,0-1,3,20,23,0.130,02/15/2019,2019.0
1,Saint Joseph's (NEC),1,1-0,21,4,25,0.840,02/10/2019,2019.0
1,Massachusetts (CAA),1,0-1,21,4,25,0.840,02/10/2019,2019.0
3,Denver (Big East),1,1-0,15,4,19,0.789,02/10/2019,2019.0
4,Maryland (Big Ten),2,2-0,33,11,44,0.750,02/10/2019,2019.0
4,Towson (CAA),1,1-0,21,7,28,0.750,02/10/2019,2019.0
6,Detroit Mercy (MAAC),1,1-0,15,6,21,0.714,02/10/2019,2019.0
7,Marquette (Big East),1,1-0,19,9,28,0.679,02/10/2019,2019.0
8,Delaware (CAA),1,1-0,14,8,22,0.636,02/10/2019,2019.0
9,Hobart (NEC),1,1-0,23,14,37,0.622,02/10/2019,2019.0
10,Holy Cross (Patriot),1,0-1,13,8,21,0.619,02/10/2019,2019.0
11,Duke (ACC),3,2-1,50,31,81,0.617,02/10/2019,2019.0
12,North Carolina (ACC),2,2-0,37,23,60,0.617,02/10/2019,2019.0
13,UMass Lowell (America East),1,1-0,16,10,26,0.615,02/10/2019,2019.0
14,Lehigh (Patriot),2,1-1,22,14,36,0.611,02/10/2019,2019.0
15,Rutgers (Big Ten),2,2-0,39,25,64,0.609,02/10/2019,2019.0
16,Penn St. (Big Ten),2,2-0,40,26,66,0.606,02/10/2019,2019.0
17,Vermont (America East),2,1-1,33,23,56,0.589,02/10/2019,2019.0
18,High Point (SoCon),2,2-0,25,18,43,0.581,02/10/2019,2019.0
19,St. John's (NY) (Big East),1,0-1,22,16,38,0.579,02/10/2019,2019.0
20,NJIT (DI Independent),2,0-2,30,22,52,0.577,02/10/2019,2019.0
21,Ohio St. (Big Ten),2,2-0,31,24,55,0.564,02/10/2019,2019.0
22,Cleveland St. (DI Independent),2,0-2,25,20,45,0.556,02/10/2019,2019.0
23,Loyola Maryland (Patriot),1,1-0,15,13,28,0.536,02/10/2019,2019.0
24,Bucknell (Patriot),2,1-1,21,19,40,0.525,02/10/2019,2019.0
25,Manhattan (MAAC),1,1-0,13,12,25,0.520,02/10/2019,2019.0
25,Syracuse (ACC),1,0-1,13,12,25,0.520,02/10/2019,2019.0
27,Georgetown (Big East),1,1-0,14,13,27,0.519,02/10/2019,2019.0
28,Mercer (SoCon),2,0-2,30,29,59,0.508,02/10/2019,2019.0
29,Sacred Heart (NEC),1,0-1,13,14,27,0.481,02/10/2019,2019.0
30,Colgate (Patriot),1,1-0,12,13,25,0.480,02/10/2019,2019.0
31,Bellarmine (SoCon),2,0-2,21,24,45,0.467,02/10/2019,2019.0
32,Virginia (ACC),1,0-1,13,15,28,0.464,02/10/2019,2019.0
33,Boston U. (Patriot),2,1-1,22,27,49,0.449,02/10/2019,2019.0
34,Navy (Patriot),1,1-0,11,14,25,0.440,02/10/2019,2019.0
35,Utah (DI Independent),2,1-1,25,32,57,0.439,02/10/2019,2019.0
36,Robert Morris (NEC),1,0-1,16,23,39,0.410,02/10/2019,2019.0
37,Wagner (NEC),2,1-1,17,25,42,0.405,02/10/2019,2019.0
38,Providence (Big East),2,1-1,16,24,40,0.400,02/10/2019,2019.0
38,Michigan (Big Ten),1,1-0,8,12,20,0.400,02/10/2019,2019.0
38,Hofstra (CAA),1,1-0,4,6,10,0.400,02/10/2019,2019.0
41,Quinnipiac (MAAC),1,0-1,10,16,26,0.385,02/10/2019,2019.0
42,Canisius (MAAC),1,0-1,14,23,37,0.378,02/10/2019,2019.0
43,Villanova (Big East),1,0-1,10,17,27,0.370,02/10/2019,2019.0
44,Mount St. Mary's (NEC),1,0-1,8,14,22,0.364,02/10/2019,2019.0
45,Bryant (NEC),1,0-1,6,13,19,0.316,02/10/2019,2019.0
46,Furman (SoCon),2,0-2,16,40,56,0.286,02/10/2019,2019.0
47,Jacksonville (SoCon),2,0-2,13,33,46,0.283,02/10/2019,2019.0
48,Johns Hopkins (Big Ten),1,0-1,7,21,28,0.250,02/10/2019,2019.0
49,St. Bonaventure (MAAC),2,0-2,9,32,41,0.220,02/10/2019,2019.0
50,Air Force (SoCon),1,0-1,4,15,19,0.211,02/10/2019,2019.0
51,Lafayette (Patriot),2,1-1,9,43,52,0.173,02/10/2019,2019.0
52,Army West Point (Patriot),1,1-0,4,21,25,0.160,02/10/2019,2019.0
53,Richmond (SoCon),1,0-1,3,20,23,0.130,02/10/2019,2019.0
1,Massachusetts (CAA),1,0-1,21,4,25,0.840,02/09/2019,2019.0
1,Saint Joseph's (NEC),1,1-0,21,4,25,0.840,02/09/2019,2019.0
3,Denver (Big East),1,1-0,15,4,19,0.789,02/09/2019,2019.0
4,Maryland (Big Ten),2,2-0,33,11,44,0.750,02/09/2019,2019.0
4,Towson (CAA),1,1-0,21,7,28,0.750,02/09/2019,2019.0
6,Detroit Mercy (MAAC),1,1-0,15,6,21,0.714,02/09/2019,2019.0
7,Marquette (Big East),1,1-0,19,9,28,0.679,02/09/2019,2019.0
8,Delaware (CAA),1,1-0,14,8,22,0.636,02/09/2019,2019.0
9,Hobart (NEC),1,1-0,23,14,37,0.622,02/09/2019,2019.0
10,Holy Cross (Patriot),1,0-1,13,8,21,0.619,02/09/2019,2019.0
11,Duke (ACC),3,2-1,50,31,81,0.617,02/09/2019,2019.0
12,North Carolina (ACC),2,2-0,37,23,60,0.617,02/09/2019,2019.0
13,UMass Lowell (America East),1,1-0,16,10,26,0.615,02/09/2019,2019.0
14,Lehigh (Patriot),2,1-1,22,14,36,0.611,02/09/2019,2019.0
15,Rutgers (Big Ten),2,2-0,39,25,64,0.609,02/09/2019,2019.0
16,Penn St. (Big Ten),2,2-0,40,26,66,0.606,02/09/2019,2019.0
17,Vermont (America East),2,1-1,33,23,56,0.589,02/09/2019,2019.0
18,High Point (SoCon),2,2-0,25,18,43,0.581,02/09/2019,2019.0
19,St. John's (NY) (Big East),1,0-1,22,16,38,0.579,02/09/2019,2019.0
20,NJIT (DI Independent),2,0-2,30,22,52,0.577,02/09/2019,2019.0
21,Ohio St. (Big Ten),2,2-0,31,24,55,0.564,02/09/2019,2019.0
22,Cleveland St. (DI Independent),2,0-2,25,20,45,0.556,02/09/2019,2019.0
23,Loyola Maryland (Patriot),1,1-0,15,13,28,0.536,02/09/2019,2019.0
24,Manhattan (MAAC),1,1-0,13,12,25,0.520,02/09/2019,2019.0
24,Syracuse (ACC),1,0-1,13,12,25,0.520,02/09/2019,2019.0
26,Georgetown (Big East),1,1-0,14,13,27,0.519,02/09/2019,2019.0
27,Mercer (SoCon),2,0-2,30,29,59,0.508,02/09/2019,2019.0
28,Sacred Heart (NEC),1,0-1,13,14,27,0.481,02/09/2019,2019.0
29,Colgate (Patriot),1,1-0,12,13,25,0.480,02/09/2019,2019.0
30,Bellarmine (SoCon),2,0-2,21,24,45,0.467,02/09/2019,2019.0
31,Virginia (ACC),1,0-1,13,15,28,0.464,02/09/2019,2019.0
32,Boston U. (Patriot),2,1-1,22,27,49,0.449,02/09/2019,2019.0
33,Navy (Patriot),1,1-0,11,14,25,0.440,02/09/2019,2019.0
34,Utah (DI Independent),2,1-1,25,32,57,0.439,02/09/2019,2019.0
35,Robert Morris (NEC),1,0-1,16,23,39,0.410,02/09/2019,2019.0
36,Wagner (NEC),2,1-1,17,25,42,0.405,02/09/2019,2019.0
37,Providence (Big East),2,1-1,16,24,40,0.400,02/09/2019,2019.0
37,Michigan (Big Ten),1,1-0,8,12,20,0.400,02/09/2019,2019.0
37,Hofstra (CAA),1,1-0,4,6,10,0.400,02/09/2019,2019.0
40,Quinnipiac (MAAC),1,0-1,10,16,26,0.385,02/09/2019,2019.0
41,Bucknell (Patriot),1,0-1,8,13,21,0.381,02/09/2019,2019.0
42,Canisius (MAAC),1,0-1,14,23,37,0.378,02/09/2019,2019.0
43,Villanova (Big East),1,0-1,10,17,27,0.370,02/09/2019,2019.0
44,Mount St. Mary's (NEC),1,0-1,8,14,22,0.364,02/09/2019,2019.0
45,Furman (SoCon),2,0-2,16,40,56,0.286,02/09/2019,2019.0
46,Jacksonville (SoCon),2,0-2,13,33,46,0.283,02/09/2019,2019.0
47,Johns Hopkins (Big Ten),1,0-1,7,21,28,0.250,02/09/2019,2019.0
48,St. Bonaventure (MAAC),2,0-2,9,32,41,0.220,02/09/2019,2019.0
49,Air Force (SoCon),1,0-1,4,15,19,0.211,02/09/2019,2019.0
50,Lafayette (Patriot),2,1-1,9,43,52,0.173,02/09/2019,2019.0
51,Army West Point (Patriot),1,1-0,4,21,25,0.160,02/09/2019,2019.0
52,Richmond (SoCon),1,0-1,3,20,23,0.130,02/09/2019,2019.0
1,Rutgers (Big Ten),1,1-0,23,3,26,0.885,02/08/2019,2019.0
2,Detroit Mercy (MAAC),1,1-0,15,6,21,0.714,02/08/2019,2019.0
3,Bellarmine (SoCon),1,0-1,12,5,17,0.706,02/08/2019,2019.0
4,Penn St. (Big Ten),1,1-0,17,10,27,0.630,02/08/2019,2019.0
5,Maryland (Big Ten),1,1-0,13,8,21,0.619,02/08/2019,2019.0
6,Lehigh (Patriot),1,1-0,16,10,26,0.615,02/08/2019,2019.0
7,Vermont (America East),1,1-0,19,12,31,0.613,02/08/2019,2019.0
8,High Point (SoCon),2,2-0,25,18,43,0.581,02/08/2019,2019.0
9,Boston U. (Patriot),1,1-0,11,8,19,0.579,02/08/2019,2019.0
10,Duke (ACC),2,1-1,32,24,56,0.571,02/08/2019,2019.0
11,Syracuse (ACC),1,0-1,13,12,25,0.520,02/08/2019,2019.0
11,Cleveland St. (DI Independent),1,0-1,13,12,25,0.520,02/08/2019,2019.0
13,Mercer (SoCon),1,0-1,17,16,33,0.515,02/08/2019,2019.0
14,North Carolina (ACC),1,1-0,16,17,33,0.485,02/08/2019,2019.0
15,Colgate (Patriot),1,1-0,12,13,25,0.480,02/08/2019,2019.0
15,Ohio St. (Big Ten),1,1-0,12,13,25,0.480,02/08/2019,2019.0
17,Providence (Big East),1,0-1,8,11,19,0.421,02/08/2019,2019.0
18,Utah (DI Independent),1,0-1,12,19,31,0.387,02/08/2019,2019.0
19,NJIT (DI Independent),1,0-1,10,16,26,0.385,02/08/2019,2019.0
20,Bucknell (Patriot),1,0-1,8,13,21,0.381,02/08/2019,2019.0
21,Villanova (Big East),1,0-1,10,17,27,0.370,02/08/2019,2019.0
22,Furman (SoCon),1,0-1,10,19,29,0.345,02/08/2019,2019.0
23,St. Bonaventure (MAAC),1,0-1,5,11,16,0.313,02/08/2019,2019.0
24,Wagner (NEC),1,1-0,5,12,17,0.294,02/08/2019,2019.0
25,Jacksonville (SoCon),1,0-1,6,15,21,0.286,02/08/2019,2019.0
26,Lafayette (Patriot),1,0-1,3,23,26,0.115,02/08/2019,2019.0
1,Rutgers (Big Ten),1,1-0,23,3,26,0.885,02/06/2019,2019.0
2,Detroit Mercy (MAAC),1,1-0,15,6,21,0.714,02/06/2019,2019.0
3,Bellarmine (SoCon),1,0-1,12,5,17,0.706,02/06/2019,2019.0
4,Penn St. (Big Ten),1,1-0,17,10,27,0.630,02/06/2019,2019.0
5,Maryland (Big Ten),1,1-0,13,8,21,0.619,02/06/2019,2019.0
6,Lehigh (Patriot),1,1-0,16,10,26,0.615,02/06/2019,2019.0
7,Vermont (America East),1,1-0,19,12,31,0.613,02/06/2019,2019.0
8,High Point (SoCon),2,2-0,25,18,43,0.581,02/06/2019,2019.0
9,Boston U. (Patriot),1,1-0,11,8,19,0.579,02/06/2019,2019.0
10,Duke (ACC),2,1-1,32,24,56,0.571,02/06/2019,2019.0
11,Cleveland St. (DI Independent),1,0-1,13,12,25,0.520,02/06/2019,2019.0
12,Mercer (SoCon),1,0-1,17,16,33,0.515,02/06/2019,2019.0
13,North Carolina (ACC),1,1-0,16,17,33,0.485,02/06/2019,2019.0
14,Ohio St. (Big Ten),1,1-0,12,13,25,0.480,02/06/2019,2019.0
15,Providence (Big East),1,0-1,8,11,19,0.421,02/06/2019,2019.0
16,Utah (DI Independent),1,0-1,12,19,31,0.387,02/06/2019,2019.0
17,NJIT (DI Independent),1,0-1,10,16,26,0.385,02/06/2019,2019.0
18,Bucknell (Patriot),1,0-1,8,13,21,0.381,02/06/2019,2019.0
19,Villanova (Big East),1,0-1,10,17,27,0.370,02/06/2019,2019.0
20,Furman (SoCon),1,0-1,10,19,29,0.345,02/06/2019,2019.0
21,St. Bonaventure (MAAC),1,0-1,5,11,16,0.313,02/06/2019,2019.0
22,Wagner (NEC),1,1-0,5,12,17,0.294,02/06/2019,2019.0
23,Jacksonville (SoCon),1,0-1,6,15,21,0.286,02/06/2019,2019.0
24,Lafayette (Patriot),1,0-1,3,23,26,0.115,02/06/2019,2019.0
1,Rutgers (Big Ten),1,1-0,23,3,26,0.885,02/03/2019,2019.0
2,Detroit Mercy (MAAC),1,1-0,15,6,21,0.714,02/03/2019,2019.0
3,Bellarmine (SoCon),1,0-1,12,5,17,0.706,02/03/2019,2019.0
4,High Point (SoCon),1,1-0,11,5,16,0.688,02/03/2019,2019.0
5,Duke (ACC),1,1-0,19,10,29,0.655,02/03/2019,2019.0
6,Penn St. (Big Ten),1,1-0,17,10,27,0.630,02/03/2019,2019.0
7,Maryland (Big Ten),1,1-0,13,8,21,0.619,02/03/2019,2019.0
8,Lehigh (Patriot),1,1-0,16,10,26,0.615,02/03/2019,2019.0
9,Vermont (America East),1,1-0,19,12,31,0.613,02/03/2019,2019.0
10,Boston U. (Patriot),1,1-0,11,8,19,0.579,02/03/2019,2019.0
11,Cleveland St. (DI Independent),1,0-1,13,12,25,0.520,02/03/2019,2019.0
12,Mercer (SoCon),1,0-1,17,16,33,0.515,02/03/2019,2019.0
13,North Carolina (ACC),1,1-0,16,17,33,0.485,02/03/2019,2019.0
14,Ohio St. (Big Ten),1,1-0,12,13,25,0.480,02/03/2019,2019.0
15,Providence (Big East),1,0-1,8,11,19,0.421,02/03/2019,2019.0
16,Utah (DI Independent),1,0-1,12,19,31,0.387,02/03/2019,2019.0
17,NJIT (DI Independent),1,0-1,10,16,26,0.385,02/03/2019,2019.0
18,Bucknell (Patriot),1,0-1,8,13,21,0.381,02/03/2019,2019.0
19,Villanova (Big East),1,0-1,10,17,27,0.370,02/03/2019,2019.0
20,Furman (SoCon),1,0-1,10,19,29,0.345,02/03/2019,2019.0
21,St. Bonaventure (MAAC),1,0-1,5,11,16,0.313,02/03/2019,2019.0
22,Wagner (NEC),1,1-0,5,12,17,0.294,02/03/2019,2019.0
23,Jacksonville (SoCon),1,0-1,6,15,21,0.286,02/03/2019,2019.0
24,Lafayette (Patriot),1,0-1,3,23,26,0.115,02/03/2019,2019.0
1,Yale (Ivy League),4,3-1,87,29,116,0.750,03/12/2020-Final Statistics,2020.0
2,Mercer (SoCon),7,6-1,136,63,199,0.683,03/12/2020-Final Statistics,2020.0
3,Loyola Maryland (Patriot),6,4-2,96,45,141,0.681,03/12/2020-Final Statistics,2020.0
4,Georgetown (Big East),6,6-0,105,51,156,0.673,03/12/2020-Final Statistics,2020.0
5,Syracuse (ACC),5,5-0,100,49,149,0.671,03/12/2020-Final Statistics,2020.0
6,Penn (Ivy League),5,2-3,102,54,156,0.654,03/12/2020-Final Statistics,2020.0
7,Saint Joseph's (NEC),7,5-2,106,58,164,0.646,03/12/2020-Final Statistics,2020.0
8,Lehigh (Patriot),6,5-1,104,59,163,0.638,03/12/2020-Final Statistics,2020.0
9,Holy Cross (Patriot),7,4-3,100,58,158,0.633,03/12/2020-Final Statistics,2020.0
10,Denver (Big East),6,4-2,98,59,157,0.624,03/12/2020-Final Statistics,2020.0
11,Marist (MAAC),6,3-3,102,62,164,0.622,03/12/2020-Final Statistics,2020.0
12,Hofstra (CAA),7,4-3,117,73,190,0.616,03/12/2020-Final Statistics,2020.0
13,Boston U. (Patriot),6,3-3,87,56,143,0.608,03/12/2020-Final Statistics,2020.0
14,Quinnipiac (MAAC),6,0-6,99,64,163,0.607,03/12/2020-Final Statistics,2020.0
15,Brown (Ivy League),5,3-2,80,52,132,0.606,03/12/2020-Final Statistics,2020.0
16,Detroit Mercy (MAAC),5,2-3,97,67,164,0.591,03/12/2020-Final Statistics,2020.0
17,Johns Hopkins (Big Ten),6,2-4,97,68,165,0.588,03/12/2020-Final Statistics,2020.0
18,Duke (ACC),8,6-2,134,99,233,0.575,03/12/2020-Final Statistics,2020.0
19,Maryland (Big Ten),6,5-1,108,80,188,0.574,03/12/2020-Final Statistics,2020.0
20,Massachusetts (CAA),7,5-2,100,75,175,0.571,03/12/2020-Final Statistics,2020.0
21,Cleveland St. (DI Independent),7,2-5,99,75,174,0.569,03/12/2020-Final Statistics,2020.0
22,North Carolina (ACC),7,7-0,125,95,220,0.568,03/12/2020-Final Statistics,2020.0
23,Bucknell (Patriot),6,5-1,95,73,168,0.565,03/12/2020-Final Statistics,2020.0
24,Hartford (America East),6,3-3,85,67,152,0.559,03/12/2020-Final Statistics,2020.0
25,Hobart (NEC),5,4-1,98,78,176,0.557,03/12/2020-Final Statistics,2020.0
26,UMBC (America East),5,4-1,63,51,114,0.553,03/12/2020-Final Statistics,2020.0
27,Virginia (ACC),6,4-2,92,75,167,0.551,03/12/2020-Final Statistics,2020.0
28,Penn St. (Big Ten),7,5-2,122,100,222,0.550,03/12/2020-Final Statistics,2020.0
29,Ohio St. (Big Ten),7,5-2,104,86,190,0.547,03/12/2020-Final Statistics,2020.0
30,St. John's (NY) (Big East),7,3-4,117,98,215,0.544,03/12/2020-Final Statistics,2020.0
31,Cornell (Ivy League),5,5-0,92,82,174,0.529,03/12/2020-Final Statistics,2020.0
32,Dartmouth (Ivy League),4,3-1,47,43,90,0.522,03/12/2020-Final Statistics,2020.0
33,Stony Brook (America East),7,5-2,107,98,205,0.522,03/12/2020-Final Statistics,2020.0
34,Hampton (DI Independent),6,0-6,92,85,177,0.520,03/12/2020-Final Statistics,2020.0
35,Mount St. Mary's (NEC),8,3-5,97,91,188,0.516,03/12/2020-Final Statistics,2020.0
36,Colgate (Patriot),6,0-6,102,98,200,0.510,03/12/2020-Final Statistics,2020.0
37,Utah (DI Independent),6,3-3,82,79,161,0.509,03/12/2020-Final Statistics,2020.0
38,Navy (Patriot),5,3-2,64,62,126,0.508,03/12/2020-Final Statistics,2020.0
39,Michigan (Big Ten),7,4-3,99,98,197,0.503,03/12/2020-Final Statistics,2020.0
40,Princeton (Ivy League),5,5-0,80,81,161,0.497,03/12/2020-Final Statistics,2020.0
41,Fairfield (CAA),7,5-2,120,125,245,0.490,03/12/2020-Final Statistics,2020.0
42,Bryant (NEC),7,3-4,95,99,194,0.490,03/12/2020-Final Statistics,2020.0
43,Robert Morris (Independent),6,4-2,92,96,188,0.489,03/12/2020-Final Statistics,2020.0
44,High Point (SoCon),8,2-6,117,137,254,0.461,03/12/2020-Final Statistics,2020.0
45,Drexel (CAA),6,3-3,85,102,187,0.455,03/12/2020-Final Statistics,2020.0
46,Air Force (SoCon),7,4-3,77,93,170,0.453,03/12/2020-Final Statistics,2020.0
47,Army West Point (Patriot),8,6-2,87,106,193,0.451,03/12/2020-Final Statistics,2020.0
48,Monmouth (MAAC),6,2-4,56,69,125,0.448,03/12/2020-Final Statistics,2020.0
49,VMI (SoCon),4,0-4,43,53,96,0.448,03/12/2020-Final Statistics,2020.0
50,Marquette (Big East),7,3-4,78,99,177,0.441,03/12/2020-Final Statistics,2020.0
51,Jacksonville (SoCon),6,3-3,72,92,164,0.439,03/12/2020-Final Statistics,2020.0
51,NJIT (NEC),7,1-6,72,92,164,0.439,03/12/2020-Final Statistics,2020.0
53,Harvard (Ivy League),4,2-2,46,59,105,0.438,03/12/2020-Final Statistics,2020.0
54,Richmond (SoCon),7,4-3,81,105,186,0.435,03/12/2020-Final Statistics,2020.0
55,Vermont (America East),4,3-1,39,51,90,0.433,03/12/2020-Final Statistics,2020.0
56,UMass Lowell (America East),7,3-4,71,94,165,0.430,03/12/2020-Final Statistics,2020.0
57,Notre Dame (ACC),5,2-3,56,75,131,0.427,03/12/2020-Final Statistics,2020.0
58,Siena (MAAC),6,2-4,79,108,187,0.422,03/12/2020-Final Statistics,2020.0
59,Villanova (Big East),7,4-3,84,120,204,0.412,03/12/2020-Final Statistics,2020.0
60,Sacred Heart (NEC),6,1-5,66,96,162,0.407,03/12/2020-Final Statistics,2020.0
61,Delaware (CAA),6,4-2,59,86,145,0.407,03/12/2020-Final Statistics,2020.0
62,Lafayette (Patriot),6,0-6,64,94,158,0.405,03/12/2020-Final Statistics,2020.0
63,Providence (Big East),6,5-1,54,86,140,0.386,03/12/2020-Final Statistics,2020.0
64,Wagner (NEC),6,1-5,61,100,161,0.379,03/12/2020-Final Statistics,2020.0
65,Bellarmine (SoCon),8,2-6,77,134,211,0.365,03/12/2020-Final Statistics,2020.0
66,Manhattan (MAAC),6,3-3,45,83,128,0.352,03/12/2020-Final Statistics,2020.0
67,LIU (NEC),7,1-6,69,129,198,0.348,03/12/2020-Final Statistics,2020.0
68,UAlbany (America East),5,2-3,55,104,159,0.346,03/12/2020-Final Statistics,2020.0
69,Binghamton (America East),6,1-5,51,97,148,0.345,03/12/2020-Final Statistics,2020.0
70,Canisius (MAAC),5,0-5,49,94,143,0.343,03/12/2020-Final Statistics,2020.0
71,Rutgers (Big Ten),6,2-4,57,115,172,0.331,03/12/2020-Final Statistics,2020.0
72,Towson (CAA),6,0-6,49,99,148,0.331,03/12/2020-Final Statistics,2020.0
73,Furman (SoCon),7,1-6,61,141,202,0.302,03/12/2020-Final Statistics,2020.0
74,St. Bonaventure (MAAC),6,0-6,31,114,145,0.214,03/12/2020-Final Statistics,2020.0
-,Merrimack (NEC),6,1-5,76,74,150,0.507,03/12/2020-Final Statistics,2020.0
1,Yale (Ivy League),4,3-1,87,29,116,0.750,03/11/2020,2020.0
2,Mercer (SoCon),7,6-1,136,63,199,0.683,03/11/2020,2020.0
3,Loyola Maryland (Patriot),6,4-2,96,45,141,0.681,03/11/2020,2020.0
4,Georgetown (Big East),6,6-0,105,51,156,0.673,03/11/2020,2020.0
5,Syracuse (ACC),5,5-0,100,49,149,0.671,03/11/2020,2020.0
6,Penn (Ivy League),5,2-3,102,54,156,0.654,03/11/2020,2020.0
7,Saint Joseph's (NEC),7,5-2,106,58,164,0.646,03/11/2020,2020.0
8,Lehigh (Patriot),6,5-1,104,59,163,0.638,03/11/2020,2020.0
9,Holy Cross (Patriot),7,4-3,100,58,158,0.633,03/11/2020,2020.0
10,Denver (Big East),6,4-2,98,59,157,0.624,03/11/2020,2020.0
11,Marist (MAAC),6,3-3,102,62,164,0.622,03/11/2020,2020.0
12,Hofstra (CAA),7,4-3,117,73,190,0.616,03/11/2020,2020.0
13,Boston U. (Patriot),6,3-3,87,56,143,0.608,03/11/2020,2020.0
14,Quinnipiac (MAAC),6,0-6,99,64,163,0.607,03/11/2020,2020.0
15,Brown (Ivy League),5,3-2,80,52,132,0.606,03/11/2020,2020.0
16,Detroit Mercy (MAAC),5,2-3,97,67,164,0.591,03/11/2020,2020.0
17,Johns Hopkins (Big Ten),6,2-4,97,68,165,0.588,03/11/2020,2020.0
18,Duke (ACC),8,6-2,134,99,233,0.575,03/11/2020,2020.0
19,Maryland (Big Ten),6,5-1,108,80,188,0.574,03/11/2020,2020.0
20,Massachusetts (CAA),7,5-2,100,75,175,0.571,03/11/2020,2020.0
21,Cleveland St. (DI Independent),7,2-5,99,75,174,0.569,03/11/2020,2020.0
22,North Carolina (ACC),7,7-0,125,95,220,0.568,03/11/2020,2020.0
23,Bucknell (Patriot),6,5-1,95,73,168,0.565,03/11/2020,2020.0
24,Hartford (America East),6,3-3,85,67,152,0.559,03/11/2020,2020.0
25,Hobart (NEC),5,4-1,98,78,176,0.557,03/11/2020,2020.0
26,UMBC (America East),5,4-1,63,51,114,0.553,03/11/2020,2020.0
27,Virginia (ACC),6,4-2,92,75,167,0.551,03/11/2020,2020.0
28,Penn St. (Big Ten),7,5-2,122,100,222,0.550,03/11/2020,2020.0
29,Ohio St. (Big Ten),7,5-2,104,86,190,0.547,03/11/2020,2020.0
30,St. John's (NY) (Big East),7,3-4,117,98,215,0.544,03/11/2020,2020.0
31,Cornell (Ivy League),5,5-0,92,82,174,0.529,03/11/2020,2020.0
32,Dartmouth (Ivy League),4,3-1,47,43,90,0.522,03/11/2020,2020.0
33,Stony Brook (America East),7,5-2,107,98,205,0.522,03/11/2020,2020.0
34,Hampton (DI Independent),6,0-6,92,85,177,0.520,03/11/2020,2020.0
35,Mount St. Mary's (NEC),8,3-5,97,91,188,0.516,03/11/2020,2020.0
36,Colgate (Patriot),6,0-6,102,98,200,0.510,03/11/2020,2020.0
37,Utah (DI Independent),6,3-3,82,79,161,0.509,03/11/2020,2020.0
38,Navy (Patriot),5,3-2,64,62,126,0.508,03/11/2020,2020.0
39,Michigan (Big Ten),7,4-3,99,98,197,0.503,03/11/2020,2020.0
40,Princeton (Ivy League),5,5-0,80,81,161,0.497,03/11/2020,2020.0
41,Fairfield (CAA),7,5-2,120,125,245,0.490,03/11/2020,2020.0
42,Bryant (NEC),7,3-4,95,99,194,0.490,03/11/2020,2020.0
43,Robert Morris (Independent),6,4-2,92,96,188,0.489,03/11/2020,2020.0
44,High Point (SoCon),8,2-6,117,137,254,0.461,03/11/2020,2020.0
45,Drexel (CAA),6,3-3,85,102,187,0.455,03/11/2020,2020.0
46,Air Force (SoCon),7,4-3,77,93,170,0.453,03/11/2020,2020.0
47,Army West Point (Patriot),8,6-2,87,106,193,0.451,03/11/2020,2020.0
48,Monmouth (MAAC),6,2-4,56,69,125,0.448,03/11/2020,2020.0
49,VMI (SoCon),4,0-4,43,53,96,0.448,03/11/2020,2020.0
50,Marquette (Big East),7,3-4,78,99,177,0.441,03/11/2020,2020.0
51,Jacksonville (SoCon),6,3-3,72,92,164,0.439,03/11/2020,2020.0
51,NJIT (NEC),7,1-6,72,92,164,0.439,03/11/2020,2020.0
53,Harvard (Ivy League),4,2-2,46,59,105,0.438,03/11/2020,2020.0
54,Richmond (SoCon),7,4-3,81,105,186,0.435,03/11/2020,2020.0
55,Vermont (America East),4,3-1,39,51,90,0.433,03/11/2020,2020.0
56,UMass Lowell (America East),7,3-4,71,94,165,0.430,03/11/2020,2020.0
57,Notre Dame (ACC),5,2-3,56,75,131,0.427,03/11/2020,2020.0
58,Siena (MAAC),6,2-4,79,108,187,0.422,03/11/2020,2020.0
59,Villanova (Big East),7,4-3,84,120,204,0.412,03/11/2020,2020.0
60,Sacred Heart (NEC),6,1-5,66,96,162,0.407,03/11/2020,2020.0
61,Delaware (CAA),6,4-2,59,86,145,0.407,03/11/2020,2020.0
62,Lafayette (Patriot),6,0-6,64,94,158,0.405,03/11/2020,2020.0
63,Providence (Big East),6,5-1,54,86,140,0.386,03/11/2020,2020.0
64,Wagner (NEC),6,1-5,61,100,161,0.379,03/11/2020,2020.0
65,Bellarmine (SoCon),8,2-6,77,134,211,0.365,03/11/2020,2020.0
66,Manhattan (MAAC),6,3-3,45,83,128,0.352,03/11/2020,2020.0
67,LIU (NEC),7,1-6,69,129,198,0.348,03/11/2020,2020.0
68,UAlbany (America East),5,2-3,55,104,159,0.346,03/11/2020,2020.0
69,Binghamton (America East),6,1-5,51,97,148,0.345,03/11/2020,2020.0
70,Canisius (MAAC),5,0-5,49,94,143,0.343,03/11/2020,2020.0
71,Rutgers (Big Ten),6,2-4,57,115,172,0.331,03/11/2020,2020.0
72,Towson (CAA),6,0-6,49,99,148,0.331,03/11/2020,2020.0
73,Furman (SoCon),7,1-6,61,141,202,0.302,03/11/2020,2020.0
74,St. Bonaventure (MAAC),6,0-6,31,114,145,0.214,03/11/2020,2020.0
-,Merrimack (NEC),6,1-5,76,74,150,0.507,03/11/2020,2020.0
1,Yale (Ivy League),4,3-1,87,29,116,0.750,03/10/2020,2020.0
2,Mercer (SoCon),7,6-1,136,63,199,0.683,03/10/2020,2020.0
3,Loyola Maryland (Patriot),6,4-2,96,45,141,0.681,03/10/2020,2020.0
4,Georgetown (Big East),6,6-0,105,51,156,0.673,03/10/2020,2020.0
5,Syracuse (ACC),5,5-0,100,49,149,0.671,03/10/2020,2020.0
6,Penn (Ivy League),5,2-3,102,54,156,0.654,03/10/2020,2020.0
7,Saint Joseph's (NEC),7,5-2,106,58,164,0.646,03/10/2020,2020.0
8,Lehigh (Patriot),6,5-1,104,59,163,0.638,03/10/2020,2020.0
9,Holy Cross (Patriot),7,4-3,100,58,158,0.633,03/10/2020,2020.0
10,Denver (Big East),6,4-2,98,59,157,0.624,03/10/2020,2020.0
11,Marist (MAAC),6,3-3,102,62,164,0.622,03/10/2020,2020.0
12,Hofstra (CAA),7,4-3,117,73,190,0.616,03/10/2020,2020.0
13,Boston U. (Patriot),6,3-3,87,56,143,0.608,03/10/2020,2020.0
14,Quinnipiac (MAAC),6,0-6,99,64,163,0.607,03/10/2020,2020.0
15,Brown (Ivy League),5,3-2,80,52,132,0.606,03/10/2020,2020.0
16,Detroit Mercy (MAAC),5,2-3,97,67,164,0.591,03/10/2020,2020.0
17,Johns Hopkins (Big Ten),6,2-4,97,68,165,0.588,03/10/2020,2020.0
18,Duke (ACC),8,6-2,134,99,233,0.575,03/10/2020,2020.0
19,Maryland (Big Ten),6,5-1,108,80,188,0.574,03/10/2020,2020.0
20,Massachusetts (CAA),7,5-2,100,75,175,0.571,03/10/2020,2020.0
21,Cleveland St. (DI Independent),7,2-5,99,75,174,0.569,03/10/2020,2020.0
22,North Carolina (ACC),7,7-0,125,95,220,0.568,03/10/2020,2020.0
23,Bucknell (Patriot),6,5-1,95,73,168,0.565,03/10/2020,2020.0
24,Hartford (America East),6,3-3,85,67,152,0.559,03/10/2020,2020.0
25,Hobart (NEC),5,4-1,98,78,176,0.557,03/10/2020,2020.0
26,UMBC (America East),5,4-1,63,51,114,0.553,03/10/2020,2020.0
27,Virginia (ACC),6,4-2,92,75,167,0.551,03/10/2020,2020.0
28,Penn St. (Big Ten),7,5-2,122,100,222,0.550,03/10/2020,2020.0
29,Ohio St. (Big Ten),7,5-2,104,86,190,0.547,03/10/2020,2020.0
30,St. John's (NY) (Big East),7,3-4,117,98,215,0.544,03/10/2020,2020.0
31,Cornell (Ivy League),5,5-0,92,82,174,0.529,03/10/2020,2020.0
32,Dartmouth (Ivy League),4,3-1,47,43,90,0.522,03/10/2020,2020.0
33,Stony Brook (America East),7,5-2,107,98,205,0.522,03/10/2020,2020.0
34,Mount St. Mary's (NEC),8,3-5,97,91,188,0.516,03/10/2020,2020.0
35,Colgate (Patriot),6,0-6,102,98,200,0.510,03/10/2020,2020.0
36,Utah (DI Independent),6,3-3,82,79,161,0.509,03/10/2020,2020.0
37,Navy (Patriot),5,3-2,64,62,126,0.508,03/10/2020,2020.0
38,Princeton (Ivy League),5,5-0,80,81,161,0.497,03/10/2020,2020.0
39,Fairfield (CAA),7,5-2,120,125,245,0.490,03/10/2020,2020.0
40,Bryant (NEC),7,3-4,95,99,194,0.490,03/10/2020,2020.0
41,Robert Morris (Independent),6,4-2,92,96,188,0.489,03/10/2020,2020.0
42,Marquette (Big East),6,3-3,71,77,148,0.480,03/10/2020,2020.0
43,High Point (SoCon),8,2-6,117,137,254,0.461,03/10/2020,2020.0
44,Michigan (Big Ten),6,3-3,77,91,168,0.458,03/10/2020,2020.0
45,Army West Point (Patriot),8,6-2,88,105,193,0.456,03/10/2020,2020.0
46,Hampton (DI Independent),5,0-5,67,80,147,0.456,03/10/2020,2020.0
47,Drexel (CAA),6,3-3,85,102,187,0.455,03/10/2020,2020.0
48,Air Force (SoCon),7,4-3,77,93,170,0.453,03/10/2020,2020.0
49,Monmouth (MAAC),6,2-4,56,69,125,0.448,03/10/2020,2020.0
50,VMI (SoCon),4,0-4,43,53,96,0.448,03/10/2020,2020.0
51,Jacksonville (SoCon),6,3-3,72,92,164,0.439,03/10/2020,2020.0
51,NJIT (NEC),7,1-6,72,92,164,0.439,03/10/2020,2020.0
53,Harvard (Ivy League),4,2-2,46,59,105,0.438,03/10/2020,2020.0
54,Richmond (SoCon),7,4-3,81,105,186,0.435,03/10/2020,2020.0
55,Vermont (America East),4,3-1,39,51,90,0.433,03/10/2020,2020.0
56,UMass Lowell (America East),7,3-4,71,94,165,0.430,03/10/2020,2020.0
57,Notre Dame (ACC),5,2-3,56,75,131,0.427,03/10/2020,2020.0
58,Siena (MAAC),6,2-4,79,108,187,0.422,03/10/2020,2020.0
59,Villanova (Big East),7,4-3,84,120,204,0.412,03/10/2020,2020.0
60,Sacred Heart (NEC),6,1-5,66,96,162,0.407,03/10/2020,2020.0
61,Delaware (CAA),6,4-2,59,86,145,0.407,03/10/2020,2020.0
62,Lafayette (Patriot),6,0-6,63,95,158,0.399,03/10/2020,2020.0
63,Providence (Big East),6,5-1,54,86,140,0.386,03/10/2020,2020.0
64,Wagner (NEC),6,1-5,61,100,161,0.379,03/10/2020,2020.0
65,Bellarmine (SoCon),8,2-6,77,134,211,0.365,03/10/2020,2020.0
66,Manhattan (MAAC),6,3-3,45,83,128,0.352,03/10/2020,2020.0
67,LIU (NEC),7,1-6,69,129,198,0.348,03/10/2020,2020.0
68,UAlbany (America East),5,2-3,55,104,159,0.346,03/10/2020,2020.0
69,Binghamton (America East),6,1-5,51,97,148,0.345,03/10/2020,2020.0
70,Canisius (MAAC),5,0-5,49,94,143,0.343,03/10/2020,2020.0
71,Rutgers (Big Ten),6,2-4,57,115,172,0.331,03/10/2020,2020.0
72,Towson (CAA),6,0-6,49,99,148,0.331,03/10/2020,2020.0
73,Furman (SoCon),7,1-6,61,141,202,0.302,03/10/2020,2020.0
74,St. Bonaventure (MAAC),6,0-6,31,114,145,0.214,03/10/2020,2020.0
-,Merrimack (NEC),6,1-5,76,74,150,0.507,03/10/2020,2020.0
1,Yale (Ivy League),4,3-1,87,29,116,0.750,03/09/2020,2020.0
2,Mercer (SoCon),7,6-1,136,63,199,0.683,03/09/2020,2020.0
3,Loyola Maryland (Patriot),6,4-2,96,45,141,0.681,03/09/2020,2020.0
4,Georgetown (Big East),6,6-0,105,51,156,0.673,03/09/2020,2020.0
5,Syracuse (ACC),5,5-0,100,49,149,0.671,03/09/2020,2020.0
6,Penn (Ivy League),5,2-3,102,54,156,0.654,03/09/2020,2020.0
7,Saint Joseph's (NEC),7,5-2,106,58,164,0.646,03/09/2020,2020.0
8,Lehigh (Patriot),6,5-1,104,59,163,0.638,03/09/2020,2020.0
9,Holy Cross (Patriot),7,4-3,100,58,158,0.633,03/09/2020,2020.0
10,Denver (Big East),6,4-2,98,59,157,0.624,03/09/2020,2020.0
11,Marist (MAAC),6,3-3,102,62,164,0.622,03/09/2020,2020.0
12,Boston U. (Patriot),6,3-3,87,56,143,0.608,03/09/2020,2020.0
13,Quinnipiac (MAAC),6,0-6,99,64,163,0.607,03/09/2020,2020.0
14,Brown (Ivy League),5,3-2,80,52,132,0.606,03/09/2020,2020.0
15,Hofstra (CAA),6,3-3,95,63,158,0.601,03/09/2020,2020.0
16,Detroit Mercy (MAAC),5,2-3,97,67,164,0.591,03/09/2020,2020.0
17,St. John's (NY) (Big East),6,3-3,107,76,183,0.585,03/09/2020,2020.0
18,Maryland (Big Ten),6,5-1,108,80,188,0.574,03/09/2020,2020.0
19,Cleveland St. (DI Independent),7,2-5,99,75,174,0.569,03/09/2020,2020.0
20,Bucknell (Patriot),6,5-1,95,73,168,0.565,03/09/2020,2020.0
21,Massachusetts (CAA),6,4-2,83,64,147,0.565,03/09/2020,2020.0
22,Johns Hopkins (Big Ten),5,1-4,77,60,137,0.562,03/09/2020,2020.0
23,Hartford (America East),6,3-3,85,67,152,0.559,03/09/2020,2020.0
24,Hobart (NEC),5,4-1,98,78,176,0.557,03/09/2020,2020.0
25,Mount St. Mary's (NEC),7,3-4,89,71,160,0.556,03/09/2020,2020.0
26,Duke (ACC),7,5-2,113,91,204,0.554,03/09/2020,2020.0
27,UMBC (America East),5,4-1,63,51,114,0.553,03/09/2020,2020.0
28,Virginia (ACC),6,4-2,92,75,167,0.551,03/09/2020,2020.0
29,North Carolina (ACC),6,6-0,100,82,182,0.549,03/09/2020,2020.0
30,Ohio St. (Big Ten),6,4-2,89,74,163,0.546,03/09/2020,2020.0
31,Cornell (Ivy League),5,5-0,92,82,174,0.529,03/09/2020,2020.0
32,Penn St. (Big Ten),6,4-2,100,90,190,0.526,03/09/2020,2020.0
33,Bryant (NEC),6,3-3,82,74,156,0.526,03/09/2020,2020.0
34,Dartmouth (Ivy League),4,3-1,47,43,90,0.522,03/09/2020,2020.0
35,Stony Brook (America East),7,5-2,107,98,205,0.522,03/09/2020,2020.0
36,Colgate (Patriot),6,0-6,102,98,200,0.510,03/09/2020,2020.0
37,Utah (DI Independent),6,3-3,82,79,161,0.509,03/09/2020,2020.0
38,Navy (Patriot),5,3-2,64,62,126,0.508,03/09/2020,2020.0
39,Princeton (Ivy League),5,5-0,80,81,161,0.497,03/09/2020,2020.0
40,Robert Morris (Independent),6,4-2,92,96,188,0.489,03/09/2020,2020.0
41,Marquette (Big East),6,3-3,71,77,148,0.480,03/09/2020,2020.0
42,Jacksonville (SoCon),5,3-2,64,71,135,0.474,03/09/2020,2020.0
43,High Point (SoCon),8,2-6,117,137,254,0.461,03/09/2020,2020.0
44,Michigan (Big Ten),6,3-3,77,91,168,0.458,03/09/2020,2020.0
45,Hampton (DI Independent),5,0-5,67,80,147,0.456,03/09/2020,2020.0
46,Drexel (CAA),6,3-3,85,102,187,0.455,03/09/2020,2020.0
47,Siena (MAAC),5,2-3,68,82,150,0.453,03/09/2020,2020.0
48,Air Force (SoCon),7,4-3,77,93,170,0.453,03/09/2020,2020.0
49,Fairfield (CAA),6,4-2,94,114,208,0.452,03/09/2020,2020.0
50,Army West Point (Patriot),8,6-2,87,106,193,0.451,03/09/2020,2020.0
51,Monmouth (MAAC),6,2-4,56,69,125,0.448,03/09/2020,2020.0
52,VMI (SoCon),4,0-4,43,53,96,0.448,03/09/2020,2020.0
53,NJIT (NEC),7,1-6,72,92,164,0.439,03/09/2020,2020.0
54,Harvard (Ivy League),4,2-2,46,59,105,0.438,03/09/2020,2020.0
55,Richmond (SoCon),7,4-3,81,105,186,0.435,03/09/2020,2020.0
56,Vermont (America East),4,3-1,39,51,90,0.433,03/09/2020,2020.0
57,UMass Lowell (America East),7,3-4,71,94,165,0.430,03/09/2020,2020.0
58,Notre Dame (ACC),4,2-2,44,60,104,0.423,03/09/2020,2020.0
59,Villanova (Big East),7,4-3,84,120,204,0.412,03/09/2020,2020.0
60,Sacred Heart (NEC),6,1-5,66,96,162,0.407,03/09/2020,2020.0
61,Delaware (CAA),6,4-2,59,86,145,0.407,03/09/2020,2020.0
62,Lafayette (Patriot),6,0-6,64,94,158,0.405,03/09/2020,2020.0
63,Providence (Big East),6,5-1,54,86,140,0.386,03/09/2020,2020.0
64,Wagner (NEC),6,1-5,61,100,161,0.379,03/09/2020,2020.0
65,Bellarmine (SoCon),8,2-6,77,134,211,0.365,03/09/2020,2020.0
66,Manhattan (MAAC),6,3-3,45,83,128,0.352,03/09/2020,2020.0
67,UAlbany (America East),5,2-3,55,104,159,0.346,03/09/2020,2020.0
68,Binghamton (America East),6,1-5,51,97,148,0.345,03/09/2020,2020.0
69,Canisius (MAAC),5,0-5,49,94,143,0.343,03/09/2020,2020.0
70,LIU (NEC),6,1-5,58,112,170,0.341,03/09/2020,2020.0
71,Rutgers (Big Ten),6,2-4,57,115,172,0.331,03/09/2020,2020.0
72,Towson (CAA),6,0-6,49,99,148,0.331,03/09/2020,2020.0
73,Furman (SoCon),6,1-5,51,119,170,0.300,03/09/2020,2020.0
74,St. Bonaventure (MAAC),6,0-6,31,114,145,0.214,03/09/2020,2020.0
-,Merrimack (NEC),6,1-5,76,74,150,0.507,03/09/2020,2020.0
1,Yale (Ivy League),4,3-1,87,29,116,0.750,03/08/2020,2020.0
2,Mercer (SoCon),6,5-1,122,47,169,0.722,03/08/2020,2020.0
3,Loyola Maryland (Patriot),6,4-2,96,45,141,0.681,03/08/2020,2020.0
4,Georgetown (Big East),6,6-0,105,51,156,0.673,03/08/2020,2020.0
5,Syracuse (ACC),5,5-0,100,49,149,0.671,03/08/2020,2020.0
6,Penn (Ivy League),5,2-3,102,54,156,0.654,03/08/2020,2020.0
7,Saint Joseph's (NEC),7,5-2,106,58,164,0.646,03/08/2020,2020.0
8,Lehigh (Patriot),6,5-1,104,59,163,0.638,03/08/2020,2020.0
9,Holy Cross (Patriot),7,4-3,100,58,158,0.633,03/08/2020,2020.0
10,Denver (Big East),6,4-2,98,59,157,0.624,03/08/2020,2020.0
11,Marist (MAAC),6,3-3,102,62,164,0.622,03/08/2020,2020.0
12,Boston U. (Patriot),6,3-3,87,56,143,0.608,03/08/2020,2020.0
13,Quinnipiac (MAAC),6,0-6,99,64,163,0.607,03/08/2020,2020.0
14,Brown (Ivy League),5,3-2,80,52,132,0.606,03/08/2020,2020.0
15,Hofstra (CAA),6,3-3,95,63,158,0.601,03/08/2020,2020.0
16,Detroit Mercy (MAAC),5,2-3,97,67,164,0.591,03/08/2020,2020.0
17,St. John's (NY) (Big East),6,3-3,107,76,183,0.585,03/08/2020,2020.0
18,Cleveland St. (DI Independent),6,2-4,83,61,144,0.576,03/08/2020,2020.0
19,Maryland (Big Ten),6,5-1,108,80,188,0.574,03/08/2020,2020.0
20,Bucknell (Patriot),6,5-1,95,73,168,0.565,03/08/2020,2020.0
21,Massachusetts (CAA),6,4-2,83,64,147,0.565,03/08/2020,2020.0
22,Johns Hopkins (Big Ten),5,1-4,77,60,137,0.562,03/08/2020,2020.0
23,Hartford (America East),6,3-3,85,67,152,0.559,03/08/2020,2020.0
24,Hobart (NEC),5,4-1,98,78,176,0.557,03/08/2020,2020.0
25,Mount St. Mary's (NEC),7,3-4,89,71,160,0.556,03/08/2020,2020.0
26,Duke (ACC),7,5-2,113,91,204,0.554,03/08/2020,2020.0
27,UMBC (America East),5,4-1,63,51,114,0.553,03/08/2020,2020.0
28,Virginia (ACC),6,4-2,92,75,167,0.551,03/08/2020,2020.0
29,North Carolina (ACC),6,6-0,100,82,182,0.549,03/08/2020,2020.0
30,Ohio St. (Big Ten),6,4-2,89,74,163,0.546,03/08/2020,2020.0
31,Cornell (Ivy League),5,5-0,92,82,174,0.529,03/08/2020,2020.0
32,Penn St. (Big Ten),6,4-2,100,90,190,0.526,03/08/2020,2020.0
33,Bryant (NEC),6,3-3,82,74,156,0.526,03/08/2020,2020.0
34,Dartmouth (Ivy League),4,3-1,47,43,90,0.522,03/08/2020,2020.0
35,Stony Brook (America East),7,5-2,107,98,205,0.522,03/08/2020,2020.0
36,Colgate (Patriot),6,0-6,102,98,200,0.510,03/08/2020,2020.0
37,Utah (DI Independent),6,3-3,82,79,161,0.509,03/08/2020,2020.0
38,Navy (Patriot),5,3-2,64,62,126,0.508,03/08/2020,2020.0
39,Princeton (Ivy League),5,5-0,80,81,161,0.497,03/08/2020,2020.0
40,Robert Morris (Independent),6,4-2,92,96,188,0.489,03/08/2020,2020.0
41,Marquette (Big East),6,3-3,71,77,148,0.480,03/08/2020,2020.0
42,Jacksonville (SoCon),5,3-2,64,71,135,0.474,03/08/2020,2020.0
43,High Point (SoCon),8,2-6,117,137,254,0.461,03/08/2020,2020.0
44,Michigan (Big Ten),6,3-3,77,91,168,0.458,03/08/2020,2020.0
45,Hampton (DI Independent),5,0-5,67,80,147,0.456,03/08/2020,2020.0
46,Drexel (CAA),6,3-3,85,102,187,0.455,03/08/2020,2020.0
47,Siena (MAAC),5,2-3,68,82,150,0.453,03/08/2020,2020.0
48,Air Force (SoCon),7,4-3,77,93,170,0.453,03/08/2020,2020.0
49,Army West Point (Patriot),8,6-2,87,106,193,0.451,03/08/2020,2020.0
50,Fairfield (CAA),6,4-2,94,115,209,0.450,03/08/2020,2020.0
51,Monmouth (MAAC),6,2-4,56,69,125,0.448,03/08/2020,2020.0
52,VMI (SoCon),4,0-4,43,53,96,0.448,03/08/2020,2020.0
53,Harvard (Ivy League),4,2-2,47,59,106,0.443,03/08/2020,2020.0
54,NJIT (NEC),7,1-6,72,92,164,0.439,03/08/2020,2020.0
55,Richmond (SoCon),7,4-3,81,105,186,0.435,03/08/2020,2020.0
56,Vermont (America East),4,3-1,39,51,90,0.433,03/08/2020,2020.0
57,UMass Lowell (America East),7,3-4,71,94,165,0.430,03/08/2020,2020.0
58,Notre Dame (ACC),4,2-2,44,60,104,0.423,03/08/2020,2020.0
59,Villanova (Big East),7,4-3,84,120,204,0.412,03/08/2020,2020.0
60,Sacred Heart (NEC),6,1-5,66,96,162,0.407,03/08/2020,2020.0
61,Delaware (CAA),6,4-2,59,86,145,0.407,03/08/2020,2020.0
62,Lafayette (Patriot),6,0-6,64,94,158,0.405,03/08/2020,2020.0
63,Providence (Big East),6,5-1,54,86,140,0.386,03/08/2020,2020.0
64,Wagner (NEC),6,1-5,61,100,161,0.379,03/08/2020,2020.0
65,Bellarmine (SoCon),8,2-6,77,134,211,0.365,03/08/2020,2020.0
66,Manhattan (MAAC),6,3-3,45,83,128,0.352,03/08/2020,2020.0
67,UAlbany (America East),5,2-3,55,104,159,0.346,03/08/2020,2020.0
68,Binghamton (America East),6,1-5,51,97,148,0.345,03/08/2020,2020.0
69,Canisius (MAAC),5,0-5,49,94,143,0.343,03/08/2020,2020.0
70,LIU (NEC),6,1-5,58,112,170,0.341,03/08/2020,2020.0
71,Rutgers (Big Ten),6,2-4,57,115,172,0.331,03/08/2020,2020.0
72,Towson (CAA),6,0-6,49,99,148,0.331,03/08/2020,2020.0
73,Furman (SoCon),6,1-5,51,119,170,0.300,03/08/2020,2020.0
74,St. Bonaventure (MAAC),6,0-6,31,114,145,0.214,03/08/2020,2020.0
-,Merrimack (NEC),6,1-5,76,74,150,0.507,03/08/2020,2020.0
1,Saint Joseph's (NEC),5,4-1,84,30,114,0.737,03/06/2020,2020.0
2,Mercer (SoCon),5,4-1,109,39,148,0.736,03/06/2020,2020.0
3,Loyola Maryland (Patriot),5,4-1,80,34,114,0.702,03/06/2020,2020.0
4,Yale (Ivy League),3,2-1,60,26,86,0.698,03/06/2020,2020.0
5,Lehigh (Patriot),5,4-1,92,42,134,0.687,03/06/2020,2020.0
6,Georgetown (Big East),5,5-0,90,42,132,0.682,03/06/2020,2020.0
7,Syracuse (ACC),4,4-0,82,39,121,0.678,03/06/2020,2020.0
8,Holy Cross (Patriot),6,4-2,83,46,129,0.643,03/06/2020,2020.0
9,Brown (Ivy League),4,2-2,64,37,101,0.634,03/06/2020,2020.0
10,Penn (Ivy League),4,1-3,81,48,129,0.628,03/06/2020,2020.0
11,Hofstra (CAA),5,3-2,82,50,132,0.621,03/06/2020,2020.0
12,St. John's (NY) (Big East),5,2-3,95,59,154,0.617,03/06/2020,2020.0
13,Johns Hopkins (Big Ten),4,1-3,67,42,109,0.615,03/06/2020,2020.0
14,Boston U. (Patriot),6,3-3,87,56,143,0.608,03/06/2020,2020.0
15,Marist (MAAC),5,3-2,80,52,132,0.606,03/06/2020,2020.0
16,Quinnipiac (MAAC),5,0-5,83,56,139,0.597,03/06/2020,2020.0
17,Detroit Mercy (MAAC),5,2-3,97,67,164,0.591,03/06/2020,2020.0
18,Denver (Big East),5,3-2,76,53,129,0.589,03/06/2020,2020.0
19,Cleveland St. (DI Independent),6,2-4,83,61,144,0.576,03/06/2020,2020.0
20,Duke (ACC),6,4-2,102,75,177,0.576,03/06/2020,2020.0
21,Navy (Patriot),4,2-2,53,39,92,0.576,03/06/2020,2020.0
22,Utah (DI Independent),5,3-2,78,58,136,0.574,03/06/2020,2020.0
23,Virginia (ACC),5,4-1,77,59,136,0.566,03/06/2020,2020.0
24,Bucknell (Patriot),6,5-1,95,73,168,0.565,03/06/2020,2020.0
25,Massachusetts (CAA),6,4-2,83,64,147,0.565,03/06/2020,2020.0
26,Ohio St. (Big Ten),5,3-2,76,61,137,0.555,03/06/2020,2020.0
27,UMBC (America East),4,3-1,44,36,80,0.550,03/06/2020,2020.0
28,North Carolina (ACC),6,6-0,100,82,182,0.549,03/06/2020,2020.0
29,Dartmouth (Ivy League),3,3-0,39,32,71,0.549,03/06/2020,2020.0
30,Cornell (Ivy League),4,4-0,73,62,135,0.541,03/06/2020,2020.0
31,Maryland (Big Ten),5,4-1,85,73,158,0.538,03/06/2020,2020.0
32,Hartford (America East),5,2-3,65,56,121,0.537,03/06/2020,2020.0
33,Michigan (Big Ten),5,3-2,74,64,138,0.536,03/06/2020,2020.0
34,Bryant (NEC),5,2-3,68,59,127,0.535,03/06/2020,2020.0
35,Hobart (NEC),4,3-1,79,69,148,0.534,03/06/2020,2020.0
36,Penn St. (Big Ten),5,4-1,80,71,151,0.530,03/06/2020,2020.0
37,Stony Brook (America East),6,5-1,92,84,176,0.523,03/06/2020,2020.0
38,Marquette (Big East),5,3-2,62,61,123,0.504,03/06/2020,2020.0
39,Mount St. Mary's (NEC),6,2-4,68,67,135,0.504,03/06/2020,2020.0
40,Notre Dame (ACC),3,2-1,38,38,76,0.500,03/06/2020,2020.0
41,Drexel (CAA),4,2-2,64,70,134,0.478,03/06/2020,2020.0
42,Colgate (Patriot),5,0-5,79,87,166,0.476,03/06/2020,2020.0
43,Jacksonville (SoCon),5,3-2,64,71,135,0.474,03/06/2020,2020.0
44,Princeton (Ivy League),4,4-0,61,69,130,0.469,03/06/2020,2020.0
45,Army West Point (Patriot),7,5-2,77,88,165,0.467,03/06/2020,2020.0
46,Robert Morris (Independent),5,3-2,76,87,163,0.466,03/06/2020,2020.0
47,High Point (SoCon),7,2-5,102,118,220,0.464,03/06/2020,2020.0
48,Monmouth (MAAC),5,2-3,48,56,104,0.462,03/06/2020,2020.0
49,Hampton (DI Independent),5,0-5,67,80,147,0.456,03/06/2020,2020.0
50,Fairfield (CAA),5,4-1,79,98,177,0.446,03/06/2020,2020.0
51,UMass Lowell (America East),6,2-4,64,83,147,0.435,03/06/2020,2020.0
52,Delaware (CAA),5,3-2,49,64,113,0.434,03/06/2020,2020.0
53,VMI (SoCon),3,0-3,31,41,72,0.431,03/06/2020,2020.0
54,Richmond (SoCon),6,3-3,69,93,162,0.426,03/06/2020,2020.0
55,Siena (MAAC),4,2-2,51,70,121,0.421,03/06/2020,2020.0
56,NJIT (NEC),6,1-5,61,85,146,0.418,03/06/2020,2020.0
57,Sacred Heart (NEC),5,1-4,56,80,136,0.412,03/06/2020,2020.0
58,Harvard (Ivy League),3,1-2,30,44,74,0.405,03/06/2020,2020.0
59,Air Force (SoCon),6,3-3,56,84,140,0.400,03/06/2020,2020.0
60,Vermont (America East),3,2-1,28,43,71,0.394,03/06/2020,2020.0
61,Villanova (Big East),6,4-2,68,106,174,0.391,03/06/2020,2020.0
62,Wagner (NEC),5,1-4,50,80,130,0.385,03/06/2020,2020.0
63,UAlbany (America East),4,2-2,48,81,129,0.372,03/06/2020,2020.0
64,Bellarmine (SoCon),8,2-6,77,134,211,0.365,03/06/2020,2020.0
65,Canisius (MAAC),4,0-4,40,73,113,0.354,03/06/2020,2020.0
66,Lafayette (Patriot),5,0-5,46,84,130,0.354,03/06/2020,2020.0
67,Binghamton (America East),5,1-4,42,78,120,0.350,03/06/2020,2020.0
68,Manhattan (MAAC),5,2-3,38,72,110,0.345,03/06/2020,2020.0
69,LIU (NEC),5,0-5,50,96,146,0.342,03/06/2020,2020.0
70,Providence (Big East),5,4-1,38,76,114,0.333,03/06/2020,2020.0
71,Towson (CAA),5,0-5,40,84,124,0.323,03/06/2020,2020.0
72,Rutgers (Big Ten),5,2-3,45,96,141,0.319,03/06/2020,2020.0
73,Furman (SoCon),6,1-5,51,119,170,0.300,03/06/2020,2020.0
74,St. Bonaventure (MAAC),6,0-6,31,114,145,0.214,03/06/2020,2020.0
-,Merrimack (NEC),5,1-4,65,67,132,0.492,03/06/2020,2020.0
1,Saint Joseph's (NEC),5,4-1,84,30,114,0.737,03/04/2020,2020.0
2,Mercer (SoCon),5,4-1,109,39,148,0.736,03/04/2020,2020.0
3,Loyola Maryland (Patriot),5,4-1,80,34,114,0.702,03/04/2020,2020.0
4,Yale (Ivy League),3,2-1,60,26,86,0.698,03/04/2020,2020.0
5,Lehigh (Patriot),5,4-1,92,42,134,0.687,03/04/2020,2020.0
6,Georgetown (Big East),5,5-0,90,42,132,0.682,03/04/2020,2020.0
7,Syracuse (ACC),4,4-0,82,39,121,0.678,03/04/2020,2020.0
8,Holy Cross (Patriot),6,4-2,83,46,129,0.643,03/04/2020,2020.0
9,Brown (Ivy League),4,2-2,64,37,101,0.634,03/04/2020,2020.0
10,Hofstra (CAA),5,3-2,82,50,132,0.621,03/04/2020,2020.0
11,St. John's (NY) (Big East),5,2-3,95,59,154,0.617,03/04/2020,2020.0
12,Johns Hopkins (Big Ten),4,1-3,67,42,109,0.615,03/04/2020,2020.0
13,Boston U. (Patriot),6,3-3,87,56,143,0.608,03/04/2020,2020.0
14,Marist (MAAC),5,3-2,80,52,132,0.606,03/04/2020,2020.0
15,Quinnipiac (MAAC),5,0-5,83,56,139,0.597,03/04/2020,2020.0
16,Penn (Ivy League),3,1-2,61,42,103,0.592,03/04/2020,2020.0
17,Detroit Mercy (MAAC),5,2-3,97,67,164,0.591,03/04/2020,2020.0
18,Denver (Big East),5,3-2,76,53,129,0.589,03/04/2020,2020.0
19,Duke (ACC),6,4-2,102,75,177,0.576,03/04/2020,2020.0
20,Navy (Patriot),4,2-2,53,39,92,0.576,03/04/2020,2020.0
21,Utah (DI Independent),5,3-2,78,58,136,0.574,03/04/2020,2020.0
22,Virginia (ACC),5,4-1,77,59,136,0.566,03/04/2020,2020.0
23,Bucknell (Patriot),6,5-1,95,73,168,0.565,03/04/2020,2020.0
24,Massachusetts (CAA),6,4-2,83,64,147,0.565,03/04/2020,2020.0
25,Ohio St. (Big Ten),5,3-2,76,61,137,0.555,03/04/2020,2020.0
26,UMBC (America East),4,3-1,44,36,80,0.550,03/04/2020,2020.0
27,Dartmouth (Ivy League),3,3-0,39,32,71,0.549,03/04/2020,2020.0
28,Cornell (Ivy League),4,4-0,73,62,135,0.541,03/04/2020,2020.0
29,Maryland (Big Ten),5,4-1,85,73,158,0.538,03/04/2020,2020.0
30,Hartford (America East),5,2-3,65,56,121,0.537,03/04/2020,2020.0
31,Michigan (Big Ten),5,3-2,74,64,138,0.536,03/04/2020,2020.0
32,Bryant (NEC),5,2-3,68,59,127,0.535,03/04/2020,2020.0
33,Hobart (NEC),4,3-1,79,69,148,0.534,03/04/2020,2020.0
34,Penn St. (Big Ten),5,4-1,80,71,151,0.530,03/04/2020,2020.0
35,Cleveland St. (DI Independent),5,1-4,65,59,124,0.524,03/04/2020,2020.0
36,Stony Brook (America East),6,5-1,92,84,176,0.523,03/04/2020,2020.0
37,Marquette (Big East),5,3-2,62,61,123,0.504,03/04/2020,2020.0
38,Mount St. Mary's (NEC),6,2-4,68,67,135,0.504,03/04/2020,2020.0
39,North Carolina (ACC),5,5-0,75,75,150,0.500,03/04/2020,2020.0
39,Notre Dame (ACC),3,2-1,38,38,76,0.500,03/04/2020,2020.0
41,Drexel (CAA),4,2-2,64,70,134,0.478,03/04/2020,2020.0
42,Colgate (Patriot),5,0-5,79,87,166,0.476,03/04/2020,2020.0
43,Princeton (Ivy League),4,4-0,61,69,130,0.469,03/04/2020,2020.0
44,Army West Point (Patriot),7,5-2,77,88,165,0.467,03/04/2020,2020.0
45,Robert Morris (Independent),5,3-2,76,87,163,0.466,03/04/2020,2020.0
46,High Point (SoCon),7,2-5,102,118,220,0.464,03/04/2020,2020.0
47,Monmouth (MAAC),5,2-3,48,56,104,0.462,03/04/2020,2020.0
48,Jacksonville (SoCon),4,2-2,52,61,113,0.460,03/04/2020,2020.0
49,Hampton (DI Independent),4,0-4,57,68,125,0.456,03/04/2020,2020.0
50,Fairfield (CAA),5,4-1,79,98,177,0.446,03/04/2020,2020.0
51,UMass Lowell (America East),6,2-4,64,83,147,0.435,03/04/2020,2020.0
52,Delaware (CAA),5,3-2,49,64,113,0.434,03/04/2020,2020.0
53,VMI (SoCon),3,0-3,31,41,72,0.431,03/04/2020,2020.0
54,Richmond (SoCon),6,3-3,69,93,162,0.426,03/04/2020,2020.0
55,Siena (MAAC),4,2-2,51,70,121,0.421,03/04/2020,2020.0
56,Villanova (Big East),5,3-2,62,86,148,0.419,03/04/2020,2020.0
57,NJIT (NEC),6,1-5,61,85,146,0.418,03/04/2020,2020.0
58,Sacred Heart (NEC),5,1-4,56,80,136,0.412,03/04/2020,2020.0
59,Harvard (Ivy League),3,1-2,30,44,74,0.405,03/04/2020,2020.0
60,Air Force (SoCon),6,3-3,56,84,140,0.400,03/04/2020,2020.0
61,Vermont (America East),3,2-1,28,43,71,0.394,03/04/2020,2020.0
62,Bellarmine (SoCon),7,2-5,75,116,191,0.393,03/04/2020,2020.0
63,Wagner (NEC),5,1-4,50,80,130,0.385,03/04/2020,2020.0
64,UAlbany (America East),4,2-2,48,81,129,0.372,03/04/2020,2020.0
65,Canisius (MAAC),4,0-4,40,73,113,0.354,03/04/2020,2020.0
66,Lafayette (Patriot),5,0-5,46,84,130,0.354,03/04/2020,2020.0
67,Binghamton (America East),5,1-4,42,78,120,0.350,03/04/2020,2020.0
68,Manhattan (MAAC),5,2-3,38,72,110,0.345,03/04/2020,2020.0
69,LIU (NEC),5,0-5,50,96,146,0.342,03/04/2020,2020.0
70,Providence (Big East),5,4-1,38,76,114,0.333,03/04/2020,2020.0
71,Towson (CAA),5,0-5,40,84,124,0.323,03/04/2020,2020.0
72,Rutgers (Big Ten),5,2-3,45,96,141,0.319,03/04/2020,2020.0
73,Furman (SoCon),5,1-4,44,94,138,0.319,03/04/2020,2020.0
74,St. Bonaventure (MAAC),6,0-6,31,114,145,0.214,03/04/2020,2020.0
-,Merrimack (NEC),5,1-4,65,67,132,0.492,03/04/2020,2020.0
1,Saint Joseph's (NEC),5,4-1,84,30,114,0.737,03/03/2020,2020.0
2,Mercer (SoCon),4,3-1,85,33,118,0.720,03/03/2020,2020.0
3,Loyola Maryland (Patriot),5,4-1,80,34,114,0.702,03/03/2020,2020.0
4,Yale (Ivy League),3,2-1,60,26,86,0.698,03/03/2020,2020.0
5,Lehigh (Patriot),5,4-1,92,42,134,0.687,03/03/2020,2020.0
6,Georgetown (Big East),5,5-0,90,42,132,0.682,03/03/2020,2020.0
7,Syracuse (ACC),4,4-0,82,39,121,0.678,03/03/2020,2020.0
8,Holy Cross (Patriot),6,4-2,83,46,129,0.643,03/03/2020,2020.0
9,Brown (Ivy League),4,2-2,64,37,101,0.634,03/03/2020,2020.0
10,Hofstra (CAA),5,3-2,82,50,132,0.621,03/03/2020,2020.0
11,St. John's (NY) (Big East),5,2-3,95,59,154,0.617,03/03/2020,2020.0
12,Johns Hopkins (Big Ten),4,1-3,67,42,109,0.615,03/03/2020,2020.0
13,Boston U. (Patriot),6,3-3,87,56,143,0.608,03/03/2020,2020.0
14,Marist (MAAC),5,3-2,80,52,132,0.606,03/03/2020,2020.0
15,Quinnipiac (MAAC),5,0-5,83,56,139,0.597,03/03/2020,2020.0
16,Penn (Ivy League),3,1-2,61,42,103,0.592,03/03/2020,2020.0
17,Denver (Big East),5,3-2,76,53,129,0.589,03/03/2020,2020.0
18,Duke (ACC),6,4-2,102,75,177,0.576,03/03/2020,2020.0
19,Navy (Patriot),4,2-2,53,39,92,0.576,03/03/2020,2020.0
20,Detroit Mercy (MAAC),4,2-2,76,56,132,0.576,03/03/2020,2020.0
21,Utah (DI Independent),5,3-2,78,58,136,0.574,03/03/2020,2020.0
22,Virginia (ACC),5,4-1,77,59,136,0.566,03/03/2020,2020.0
23,Bucknell (Patriot),6,5-1,95,73,168,0.565,03/03/2020,2020.0
24,Massachusetts (CAA),6,4-2,83,64,147,0.565,03/03/2020,2020.0
25,Ohio St. (Big Ten),5,3-2,76,61,137,0.555,03/03/2020,2020.0
26,UMBC (America East),4,3-1,44,36,80,0.550,03/03/2020,2020.0
27,Dartmouth (Ivy League),3,3-0,39,32,71,0.549,03/03/2020,2020.0
28,Cornell (Ivy League),4,4-0,73,62,135,0.541,03/03/2020,2020.0
29,Maryland (Big Ten),5,4-1,85,73,158,0.538,03/03/2020,2020.0
30,Hartford (America East),5,2-3,65,56,121,0.537,03/03/2020,2020.0
31,Michigan (Big Ten),5,3-2,74,64,138,0.536,03/03/2020,2020.0
32,Bryant (NEC),5,2-3,68,59,127,0.535,03/03/2020,2020.0
33,Hobart (NEC),4,3-1,79,69,148,0.534,03/03/2020,2020.0
34,Penn St. (Big Ten),5,4-1,80,71,151,0.530,03/03/2020,2020.0
35,Cleveland St. (DI Independent),5,1-4,65,59,124,0.524,03/03/2020,2020.0
36,Stony Brook (America East),6,5-1,92,84,176,0.523,03/03/2020,2020.0
37,Marquette (Big East),5,3-2,62,61,123,0.504,03/03/2020,2020.0
38,Mount St. Mary's (NEC),6,2-4,68,67,135,0.504,03/03/2020,2020.0
39,North Carolina (ACC),5,5-0,75,75,150,0.500,03/03/2020,2020.0
39,Notre Dame (ACC),3,2-1,38,38,76,0.500,03/03/2020,2020.0
41,Robert Morris (Independent),4,2-2,65,66,131,0.496,03/03/2020,2020.0
42,Drexel (CAA),4,2-2,64,70,134,0.478,03/03/2020,2020.0
43,Colgate (Patriot),5,0-5,79,87,166,0.476,03/03/2020,2020.0
44,Princeton (Ivy League),4,4-0,61,69,130,0.469,03/03/2020,2020.0
45,Army West Point (Patriot),7,5-2,77,88,165,0.467,03/03/2020,2020.0
46,High Point (SoCon),7,2-5,102,118,220,0.464,03/03/2020,2020.0
47,Monmouth (MAAC),5,2-3,48,56,104,0.462,03/03/2020,2020.0
48,Jacksonville (SoCon),4,2-2,52,61,113,0.460,03/03/2020,2020.0
49,Hampton (DI Independent),4,0-4,57,68,125,0.456,03/03/2020,2020.0
50,Fairfield (CAA),5,4-1,79,98,177,0.446,03/03/2020,2020.0
51,UMass Lowell (America East),6,2-4,64,83,147,0.435,03/03/2020,2020.0
52,Delaware (CAA),5,3-2,49,64,113,0.434,03/03/2020,2020.0
53,VMI (SoCon),3,0-3,31,41,72,0.431,03/03/2020,2020.0
54,Richmond (SoCon),6,3-3,69,93,162,0.426,03/03/2020,2020.0
55,Siena (MAAC),4,2-2,51,70,121,0.421,03/03/2020,2020.0
56,Villanova (Big East),5,3-2,62,86,148,0.419,03/03/2020,2020.0
57,NJIT (NEC),6,1-5,61,85,146,0.418,03/03/2020,2020.0
58,Sacred Heart (NEC),5,1-4,56,80,136,0.412,03/03/2020,2020.0
59,Harvard (Ivy League),3,1-2,30,44,74,0.405,03/03/2020,2020.0
60,Air Force (SoCon),6,3-3,56,84,140,0.400,03/03/2020,2020.0
61,Vermont (America East),3,2-1,28,43,71,0.394,03/03/2020,2020.0
62,Bellarmine (SoCon),7,2-5,75,116,191,0.393,03/03/2020,2020.0
63,Wagner (NEC),5,1-4,50,80,130,0.385,03/03/2020,2020.0
64,UAlbany (America East),4,2-2,48,81,129,0.372,03/03/2020,2020.0
65,Canisius (MAAC),4,0-4,40,73,113,0.354,03/03/2020,2020.0
66,Lafayette (Patriot),5,0-5,46,84,130,0.354,03/03/2020,2020.0
67,Binghamton (America East),5,1-4,42,78,120,0.350,03/03/2020,2020.0
68,Manhattan (MAAC),5,2-3,38,72,110,0.345,03/03/2020,2020.0
69,LIU (NEC),5,0-5,50,96,146,0.342,03/03/2020,2020.0
70,Providence (Big East),5,4-1,38,76,114,0.333,03/03/2020,2020.0
71,Towson (CAA),5,0-5,40,84,124,0.323,03/03/2020,2020.0
72,Rutgers (Big Ten),5,2-3,45,96,141,0.319,03/03/2020,2020.0
73,Furman (SoCon),5,1-4,44,94,138,0.319,03/03/2020,2020.0
74,St. Bonaventure (MAAC),5,0-5,25,90,115,0.217,03/03/2020,2020.0
-,Merrimack (NEC),5,1-4,65,67,132,0.492,03/03/2020,2020.0
1,Saint Joseph's (NEC),5,4-1,84,30,114,0.737,03/02/2020,2020.0
2,Mercer (SoCon),4,3-1,85,33,118,0.720,03/02/2020,2020.0
3,Loyola Maryland (Patriot),5,4-1,80,34,114,0.702,03/02/2020,2020.0
4,Yale (Ivy League),3,2-1,60,26,86,0.698,03/02/2020,2020.0
5,Lehigh (Patriot),5,4-1,92,42,134,0.687,03/02/2020,2020.0
6,Georgetown (Big East),5,5-0,90,42,132,0.682,03/02/2020,2020.0
7,Syracuse (ACC),4,4-0,82,39,121,0.678,03/02/2020,2020.0
8,Holy Cross (Patriot),6,4-2,83,46,129,0.643,03/02/2020,2020.0
9,Brown (Ivy League),4,2-2,64,37,101,0.634,03/02/2020,2020.0
10,Hofstra (CAA),5,3-2,82,50,132,0.621,03/02/2020,2020.0
11,St. John's (NY) (Big East),5,2-3,95,59,154,0.617,03/02/2020,2020.0
12,Johns Hopkins (Big Ten),4,1-3,67,42,109,0.615,03/02/2020,2020.0
13,Boston U. (Patriot),6,3-3,87,56,143,0.608,03/02/2020,2020.0
14,Marist (MAAC),5,3-2,80,52,132,0.606,03/02/2020,2020.0
15,Quinnipiac (MAAC),5,0-5,83,56,139,0.597,03/02/2020,2020.0
16,Penn (Ivy League),3,1-2,61,42,103,0.592,03/02/2020,2020.0
17,Denver (Big East),5,3-2,76,53,129,0.589,03/02/2020,2020.0
18,Duke (ACC),6,4-2,102,75,177,0.576,03/02/2020,2020.0
19,Navy (Patriot),4,2-2,53,39,92,0.576,03/02/2020,2020.0
20,Detroit Mercy (MAAC),4,2-2,76,56,132,0.576,03/02/2020,2020.0
21,Utah (DI Independent),5,3-2,78,58,136,0.574,03/02/2020,2020.0
22,Virginia (ACC),5,4-1,77,59,136,0.566,03/02/2020,2020.0
23,Bucknell (Patriot),6,5-1,95,73,168,0.565,03/02/2020,2020.0
24,Ohio St. (Big Ten),5,3-2,76,61,137,0.555,03/02/2020,2020.0
25,Dartmouth (Ivy League),3,3-0,39,32,71,0.549,03/02/2020,2020.0
26,Cornell (Ivy League),4,4-0,73,62,135,0.541,03/02/2020,2020.0
27,Maryland (Big Ten),5,4-1,85,73,158,0.538,03/02/2020,2020.0
28,Michigan (Big Ten),5,3-2,74,64,138,0.536,03/02/2020,2020.0
29,Bryant (NEC),5,2-3,68,59,127,0.535,03/02/2020,2020.0
30,Hobart (NEC),4,3-1,79,69,148,0.534,03/02/2020,2020.0
31,Penn St. (Big Ten),5,4-1,80,71,151,0.530,03/02/2020,2020.0
32,Stony Brook (America East),5,4-1,78,70,148,0.527,03/02/2020,2020.0
33,Cleveland St. (DI Independent),5,1-4,65,59,124,0.524,03/02/2020,2020.0
34,Marquette (Big East),5,3-2,62,61,123,0.504,03/02/2020,2020.0
35,North Carolina (ACC),5,5-0,75,75,150,0.500,03/02/2020,2020.0
35,Massachusetts (CAA),5,3-2,57,57,114,0.500,03/02/2020,2020.0
35,Mount St. Mary's (NEC),5,2-3,56,56,112,0.500,03/02/2020,2020.0
35,Notre Dame (ACC),3,2-1,38,38,76,0.500,03/02/2020,2020.0
35,UMBC (America East),3,2-1,31,31,62,0.500,03/02/2020,2020.0
40,Robert Morris (Independent),4,2-2,65,66,131,0.496,03/02/2020,2020.0
41,Hartford (America East),4,1-3,48,50,98,0.490,03/02/2020,2020.0
42,Drexel (CAA),4,2-2,64,70,134,0.478,03/02/2020,2020.0
43,Colgate (Patriot),5,0-5,79,87,166,0.476,03/02/2020,2020.0
44,Princeton (Ivy League),4,4-0,61,69,130,0.469,03/02/2020,2020.0
45,High Point (SoCon),7,2-5,102,118,220,0.464,03/02/2020,2020.0
46,Army West Point (Patriot),6,4-2,63,73,136,0.463,03/02/2020,2020.0
47,Monmouth (MAAC),5,2-3,48,56,104,0.462,03/02/2020,2020.0
48,Jacksonville (SoCon),4,2-2,52,61,113,0.460,03/02/2020,2020.0
49,Hampton (DI Independent),4,0-4,57,68,125,0.456,03/02/2020,2020.0
50,UMass Lowell (America East),6,2-4,64,83,147,0.435,03/02/2020,2020.0
51,Delaware (CAA),5,3-2,49,64,113,0.434,03/02/2020,2020.0
52,VMI (SoCon),3,0-3,31,41,72,0.431,03/02/2020,2020.0
53,UAlbany (America East),3,2-1,41,55,96,0.427,03/02/2020,2020.0
54,Siena (MAAC),4,2-2,51,70,121,0.421,03/02/2020,2020.0
55,Villanova (Big East),5,3-2,62,86,148,0.419,03/02/2020,2020.0
56,NJIT (NEC),6,1-5,61,85,146,0.418,03/02/2020,2020.0
57,Richmond (SoCon),5,2-3,58,81,139,0.417,03/02/2020,2020.0
58,Harvard (Ivy League),3,1-2,30,44,74,0.405,03/02/2020,2020.0
59,Air Force (SoCon),6,3-3,56,84,140,0.400,03/02/2020,2020.0
60,Fairfield (CAA),4,3-1,56,85,141,0.397,03/02/2020,2020.0
61,Vermont (America East),3,2-1,28,43,71,0.394,03/02/2020,2020.0
62,Bellarmine (SoCon),7,2-5,75,116,191,0.393,03/02/2020,2020.0
63,Sacred Heart (NEC),4,1-3,42,66,108,0.389,03/02/2020,2020.0
64,Wagner (NEC),5,1-4,50,80,130,0.385,03/02/2020,2020.0
65,Manhattan (MAAC),4,2-2,32,55,87,0.368,03/02/2020,2020.0
66,Canisius (MAAC),4,0-4,40,73,113,0.354,03/02/2020,2020.0
67,Lafayette (Patriot),5,0-5,46,84,130,0.354,03/02/2020,2020.0
68,LIU (NEC),4,0-4,37,73,110,0.336,03/02/2020,2020.0
69,Providence (Big East),5,4-1,38,76,114,0.333,03/02/2020,2020.0
70,Towson (CAA),4,0-4,35,71,106,0.330,03/02/2020,2020.0
71,Rutgers (Big Ten),5,2-3,45,96,141,0.319,03/02/2020,2020.0
72,Furman (SoCon),5,1-4,44,94,138,0.319,03/02/2020,2020.0
73,Binghamton (America East),4,1-3,27,64,91,0.297,03/02/2020,2020.0
74,St. Bonaventure (MAAC),5,0-5,25,90,115,0.217,03/02/2020,2020.0
-,Merrimack (NEC),5,1-4,65,67,132,0.492,03/02/2020,2020.0
1,Saint Joseph's (NEC),5,4-1,84,30,114,0.737,03/01/2020,2020.0
2,Mercer (SoCon),4,3-1,85,33,118,0.720,03/01/2020,2020.0
3,Loyola Maryland (Patriot),5,4-1,80,34,114,0.702,03/01/2020,2020.0
4,Yale (Ivy League),3,2-1,60,26,86,0.698,03/01/2020,2020.0
5,Lehigh (Patriot),5,4-1,92,42,134,0.687,03/01/2020,2020.0
6,Georgetown (Big East),5,5-0,90,42,132,0.682,03/01/2020,2020.0
7,Syracuse (ACC),4,4-0,82,39,121,0.678,03/01/2020,2020.0
8,Holy Cross (Patriot),6,4-2,83,46,129,0.643,03/01/2020,2020.0
9,Brown (Ivy League),4,2-2,64,37,101,0.634,03/01/2020,2020.0
10,Hofstra (CAA),5,3-2,82,50,132,0.621,03/01/2020,2020.0
11,St. John's (NY) (Big East),5,2-3,95,59,154,0.617,03/01/2020,2020.0
12,Johns Hopkins (Big Ten),4,1-3,67,42,109,0.615,03/01/2020,2020.0
13,Boston U. (Patriot),6,3-3,87,56,143,0.608,03/01/2020,2020.0
14,Marist (MAAC),5,3-2,80,52,132,0.606,03/01/2020,2020.0
15,Quinnipiac (MAAC),5,0-5,83,56,139,0.597,03/01/2020,2020.0
16,Penn (Ivy League),3,1-2,61,42,103,0.592,03/01/2020,2020.0
17,Denver (Big East),5,3-2,76,53,129,0.589,03/01/2020,2020.0
18,Duke (ACC),6,4-2,102,75,177,0.576,03/01/2020,2020.0
19,Navy (Patriot),4,2-2,53,39,92,0.576,03/01/2020,2020.0
20,Detroit Mercy (MAAC),4,2-2,76,56,132,0.576,03/01/2020,2020.0
21,Utah (DI Independent),5,3-2,78,58,136,0.574,03/01/2020,2020.0
22,Virginia (ACC),5,4-1,77,59,136,0.566,03/01/2020,2020.0
23,Bucknell (Patriot),6,5-1,95,73,168,0.565,03/01/2020,2020.0
24,Ohio St. (Big Ten),5,3-2,76,61,137,0.555,03/01/2020,2020.0
25,Dartmouth (Ivy League),3,3-0,39,32,71,0.549,03/01/2020,2020.0
26,Cornell (Ivy League),4,4-0,73,62,135,0.541,03/01/2020,2020.0
27,Maryland (Big Ten),5,4-1,85,73,158,0.538,03/01/2020,2020.0
28,Michigan (Big Ten),5,3-2,74,64,138,0.536,03/01/2020,2020.0
29,Bryant (NEC),5,2-3,68,59,127,0.535,03/01/2020,2020.0
30,Hobart (NEC),4,3-1,79,69,148,0.534,03/01/2020,2020.0
31,Penn St. (Big Ten),5,4-1,80,71,151,0.530,03/01/2020,2020.0
32,Stony Brook (America East),5,4-1,78,70,148,0.527,03/01/2020,2020.0
33,Cleveland St. (DI Independent),5,1-4,65,59,124,0.524,03/01/2020,2020.0
34,Marquette (Big East),5,3-2,62,61,123,0.504,03/01/2020,2020.0
35,North Carolina (ACC),5,5-0,75,75,150,0.500,03/01/2020,2020.0
35,Massachusetts (CAA),5,3-2,57,57,114,0.500,03/01/2020,2020.0
35,Mount St. Mary's (NEC),5,2-3,56,56,112,0.500,03/01/2020,2020.0
35,Notre Dame (ACC),3,2-1,38,38,76,0.500,03/01/2020,2020.0
35,UMBC (America East),3,2-1,31,31,62,0.500,03/01/2020,2020.0
40,Robert Morris (Independent),4,2-2,65,66,131,0.496,03/01/2020,2020.0
41,Hartford (America East),4,1-3,48,50,98,0.490,03/01/2020,2020.0
42,Drexel (CAA),4,2-2,64,70,134,0.478,03/01/2020,2020.0
43,Colgate (Patriot),5,0-5,79,87,166,0.476,03/01/2020,2020.0
44,Princeton (Ivy League),4,4-0,61,69,130,0.469,03/01/2020,2020.0
45,Army West Point (Patriot),6,4-2,63,73,136,0.463,03/01/2020,2020.0
46,Monmouth (MAAC),5,2-3,48,56,104,0.462,03/01/2020,2020.0
47,Jacksonville (SoCon),4,2-2,52,61,113,0.460,03/01/2020,2020.0
48,Hampton (DI Independent),4,0-4,57,68,125,0.456,03/01/2020,2020.0
49,UMass Lowell (America East),6,2-4,64,83,147,0.435,03/01/2020,2020.0
50,High Point (SoCon),6,1-5,85,111,196,0.434,03/01/2020,2020.0
51,Delaware (CAA),5,3-2,49,64,113,0.434,03/01/2020,2020.0
52,VMI (SoCon),3,0-3,31,41,72,0.431,03/01/2020,2020.0
53,UAlbany (America East),3,2-1,41,55,96,0.427,03/01/2020,2020.0
54,Siena (MAAC),4,2-2,51,70,121,0.421,03/01/2020,2020.0
55,Villanova (Big East),5,3-2,62,86,148,0.419,03/01/2020,2020.0
56,NJIT (NEC),6,1-5,61,85,146,0.418,03/01/2020,2020.0
57,Richmond (SoCon),5,2-3,58,81,139,0.417,03/01/2020,2020.0
58,Harvard (Ivy League),3,1-2,30,44,74,0.405,03/01/2020,2020.0
59,Air Force (SoCon),6,3-3,56,84,140,0.400,03/01/2020,2020.0
60,Fairfield (CAA),4,3-1,56,85,141,0.397,03/01/2020,2020.0
61,Vermont (America East),3,2-1,28,43,71,0.394,03/01/2020,2020.0
62,Bellarmine (SoCon),7,2-5,75,116,191,0.393,03/01/2020,2020.0
63,Sacred Heart (NEC),4,1-3,42,66,108,0.389,03/01/2020,2020.0
64,Wagner (NEC),5,1-4,50,80,130,0.385,03/01/2020,2020.0
65,Manhattan (MAAC),4,2-2,32,55,87,0.368,03/01/2020,2020.0
66,Canisius (MAAC),4,0-4,40,73,113,0.354,03/01/2020,2020.0
67,Lafayette (Patriot),5,0-5,46,84,130,0.354,03/01/2020,2020.0
68,LIU (NEC),4,0-4,37,73,110,0.336,03/01/2020,2020.0
69,Providence (Big East),5,4-1,38,76,114,0.333,03/01/2020,2020.0
70,Towson (CAA),4,0-4,35,71,106,0.330,03/01/2020,2020.0
71,Rutgers (Big Ten),5,2-3,45,96,141,0.319,03/01/2020,2020.0
72,Furman (SoCon),5,1-4,44,94,138,0.319,03/01/2020,2020.0
73,Binghamton (America East),4,1-3,27,64,91,0.297,03/01/2020,2020.0
74,St. Bonaventure (MAAC),4,0-4,18,73,91,0.198,03/01/2020,2020.0
-,Merrimack (NEC),5,1-4,65,67,132,0.492,03/01/2020,2020.0
1,Saint Joseph's (NEC),4,3-1,70,28,98,0.714,02/28/2020,2020.0
2,Navy (Patriot),3,2-1,48,20,68,0.706,02/28/2020,2020.0
3,Loyola Maryland (Patriot),4,3-1,65,29,94,0.691,02/28/2020,2020.0
4,Mercer (SoCon),3,2-1,59,28,87,0.678,02/28/2020,2020.0
5,Syracuse (ACC),4,4-0,82,39,121,0.678,02/28/2020,2020.0
6,Georgetown (Big East),4,4-0,75,36,111,0.676,02/28/2020,2020.0
7,Cornell (Ivy League),3,3-0,66,32,98,0.673,02/28/2020,2020.0
8,Yale (Ivy League),2,2-0,40,20,60,0.667,02/28/2020,2020.0
9,Lehigh (Patriot),4,3-1,73,37,110,0.664,02/28/2020,2020.0
10,Holy Cross (Patriot),5,4-1,73,38,111,0.658,02/28/2020,2020.0
11,Boston U. (Patriot),5,2-3,75,41,116,0.647,02/28/2020,2020.0
12,St. John's (NY) (Big East),4,2-2,78,45,123,0.634,02/28/2020,2020.0
13,Marist (MAAC),4,3-1,62,36,98,0.633,02/28/2020,2020.0
14,Brown (Ivy League),3,2-1,44,28,72,0.611,02/28/2020,2020.0
15,Denver (Big East),4,3-1,59,38,97,0.608,02/28/2020,2020.0
16,Johns Hopkins (Big Ten),3,1-2,46,30,76,0.605,02/28/2020,2020.0
17,Notre Dame (ACC),2,2-0,30,20,50,0.600,02/28/2020,2020.0
18,Penn St. (Big Ten),4,3-1,67,45,112,0.598,02/28/2020,2020.0
19,Bucknell (Patriot),5,4-1,79,55,134,0.590,02/28/2020,2020.0
20,Massachusetts (CAA),4,2-2,51,37,88,0.580,02/28/2020,2020.0
21,Detroit Mercy (MAAC),4,2-2,76,56,132,0.576,02/28/2020,2020.0
22,Duke (ACC),5,3-2,84,64,148,0.568,02/28/2020,2020.0
23,Hofstra (CAA),4,2-2,61,47,108,0.565,02/28/2020,2020.0
24,Quinnipiac (MAAC),4,0-4,58,45,103,0.563,02/28/2020,2020.0
25,Michigan (Big Ten),4,2-2,60,47,107,0.561,02/28/2020,2020.0
26,Virginia (ACC),4,3-1,63,50,113,0.558,02/28/2020,2020.0
27,Utah (DI Independent),4,2-2,59,48,107,0.551,02/28/2020,2020.0
28,Penn (Ivy League),2,1-1,35,29,64,0.547,02/28/2020,2020.0
29,Hobart (NEC),4,3-1,79,69,148,0.534,02/28/2020,2020.0
30,Cleveland St. (DI Independent),5,1-4,65,59,124,0.524,02/28/2020,2020.0
31,Monmouth (MAAC),4,2-2,46,42,88,0.523,02/28/2020,2020.0
32,Dartmouth (Ivy League),2,2-0,26,24,50,0.520,02/28/2020,2020.0
33,Mount St. Mary's (NEC),4,1-3,46,43,89,0.517,02/28/2020,2020.0
34,North Carolina (ACC),4,4-0,60,58,118,0.508,02/28/2020,2020.0
35,Maryland (Big Ten),4,3-1,67,65,132,0.508,02/28/2020,2020.0
36,Princeton (Ivy League),3,3-0,49,48,97,0.505,02/28/2020,2020.0
37,Drexel (CAA),3,1-2,54,53,107,0.505,02/28/2020,2020.0
38,Jacksonville (SoCon),3,2-1,42,42,84,0.500,02/28/2020,2020.0
39,Stony Brook (America East),4,3-1,58,60,118,0.492,02/28/2020,2020.0
40,Robert Morris (Independent),3,1-2,50,52,102,0.490,02/28/2020,2020.0
41,Hartford (America East),4,1-3,48,50,98,0.490,02/28/2020,2020.0
42,Bryant (NEC),4,1-3,49,53,102,0.480,02/28/2020,2020.0
43,Marquette (Big East),4,3-1,45,51,96,0.469,02/28/2020,2020.0
44,Army West Point (Patriot),5,3-2,55,63,118,0.466,02/28/2020,2020.0
45,Colgate (Patriot),4,0-4,64,75,139,0.460,02/28/2020,2020.0
46,Ohio St. (Big Ten),4,3-1,46,54,100,0.460,02/28/2020,2020.0
47,Hampton (DI Independent),4,0-4,57,68,125,0.456,02/28/2020,2020.0
48,Wagner (NEC),4,1-3,45,54,99,0.455,02/28/2020,2020.0
49,Sacred Heart (NEC),3,1-2,38,47,85,0.447,02/28/2020,2020.0
50,UMass Lowell (America East),5,2-3,56,70,126,0.444,02/28/2020,2020.0
51,UAlbany (America East),2,1-1,28,36,64,0.438,02/28/2020,2020.0
52,Delaware (CAA),4,3-1,35,46,81,0.432,02/28/2020,2020.0
53,Fairfield (CAA),3,2-1,45,60,105,0.429,02/28/2020,2020.0
54,High Point (SoCon),5,1-4,71,96,167,0.425,02/28/2020,2020.0
55,Manhattan (MAAC),3,2-1,26,36,62,0.419,02/28/2020,2020.0
56,Richmond (SoCon),5,2-3,58,81,139,0.417,02/28/2020,2020.0
57,NJIT (NEC),5,1-4,52,74,126,0.413,02/28/2020,2020.0
58,Bellarmine (SoCon),6,2-4,69,101,170,0.406,02/28/2020,2020.0
59,Air Force (SoCon),5,3-2,47,70,117,0.402,02/28/2020,2020.0
60,Siena (MAAC),3,1-2,40,61,101,0.396,02/28/2020,2020.0
61,LIU (NEC),3,0-3,34,52,86,0.395,02/28/2020,2020.0
62,VMI (SoCon),2,0-2,19,30,49,0.388,02/28/2020,2020.0
63,Lafayette (Patriot),4,0-4,41,69,110,0.373,02/28/2020,2020.0
64,Villanova (Big East),4,2-2,43,73,116,0.371,02/28/2020,2020.0
65,Canisius (MAAC),4,0-4,40,73,113,0.354,02/28/2020,2020.0
66,Vermont (America East),2,1-1,18,33,51,0.353,02/28/2020,2020.0
67,Providence (Big East),4,3-1,29,56,85,0.341,02/28/2020,2020.0
68,Towson (CAA),4,0-4,35,71,106,0.330,02/28/2020,2020.0
69,Rutgers (Big Ten),4,2-2,35,76,111,0.315,02/28/2020,2020.0
70,UMBC (America East),2,1-1,12,27,39,0.308,02/28/2020,2020.0
71,Furman (SoCon),4,1-3,33,76,109,0.303,02/28/2020,2020.0
72,Binghamton (America East),4,1-3,27,64,91,0.297,02/28/2020,2020.0
73,Harvard (Ivy League),2,1-1,11,31,42,0.262,02/28/2020,2020.0
74,St. Bonaventure (MAAC),4,0-4,18,73,91,0.198,02/28/2020,2020.0
-,Merrimack (NEC),4,1-3,55,57,112,0.491,02/28/2020,2020.0
1,Syracuse (ACC),3,3-0,62,21,83,0.747,02/26/2020,2020.0
2,Saint Joseph's (NEC),4,3-1,70,28,98,0.714,02/26/2020,2020.0
3,Navy (Patriot),3,2-1,48,20,68,0.706,02/26/2020,2020.0
4,Loyola Maryland (Patriot),4,3-1,65,29,94,0.691,02/26/2020,2020.0
5,Mercer (SoCon),3,2-1,59,28,87,0.678,02/26/2020,2020.0
6,Georgetown (Big East),4,4-0,75,36,111,0.676,02/26/2020,2020.0
7,Cornell (Ivy League),3,3-0,66,32,98,0.673,02/26/2020,2020.0
8,Yale (Ivy League),2,2-0,40,20,60,0.667,02/26/2020,2020.0
9,Lehigh (Patriot),4,3-1,73,37,110,0.664,02/26/2020,2020.0
10,Holy Cross (Patriot),5,4-1,73,38,111,0.658,02/26/2020,2020.0
11,Boston U. (Patriot),5,2-3,75,41,116,0.647,02/26/2020,2020.0
12,St. John's (NY) (Big East),4,2-2,78,45,123,0.634,02/26/2020,2020.0
13,Marist (MAAC),4,3-1,62,36,98,0.633,02/26/2020,2020.0
14,Brown (Ivy League),3,2-1,44,28,72,0.611,02/26/2020,2020.0
15,Denver (Big East),4,3-1,59,38,97,0.608,02/26/2020,2020.0
16,Johns Hopkins (Big Ten),3,1-2,46,30,76,0.605,02/26/2020,2020.0
17,Notre Dame (ACC),2,2-0,30,20,50,0.600,02/26/2020,2020.0
18,Penn St. (Big Ten),4,3-1,67,45,112,0.598,02/26/2020,2020.0
19,Bucknell (Patriot),5,4-1,79,55,134,0.590,02/26/2020,2020.0
20,Massachusetts (CAA),4,2-2,51,37,88,0.580,02/26/2020,2020.0
21,Detroit Mercy (MAAC),4,2-2,76,56,132,0.576,02/26/2020,2020.0
22,Duke (ACC),4,2-2,66,49,115,0.574,02/26/2020,2020.0
23,Hofstra (CAA),4,2-2,61,47,108,0.565,02/26/2020,2020.0
24,Quinnipiac (MAAC),4,0-4,58,45,103,0.563,02/26/2020,2020.0
25,Michigan (Big Ten),4,2-2,60,47,107,0.561,02/26/2020,2020.0
26,Virginia (ACC),4,3-1,63,50,113,0.558,02/26/2020,2020.0
27,Hobart (NEC),3,3-0,61,49,110,0.555,02/26/2020,2020.0
28,Utah (DI Independent),4,2-2,59,48,107,0.551,02/26/2020,2020.0
29,Penn (Ivy League),2,1-1,35,29,64,0.547,02/26/2020,2020.0
30,Cleveland St. (DI Independent),5,1-4,65,59,124,0.524,02/26/2020,2020.0
31,Monmouth (MAAC),4,2-2,46,42,88,0.523,02/26/2020,2020.0
32,Dartmouth (Ivy League),2,2-0,26,24,50,0.520,02/26/2020,2020.0
33,Mount St. Mary's (NEC),4,1-3,46,43,89,0.517,02/26/2020,2020.0
34,North Carolina (ACC),4,4-0,60,58,118,0.508,02/26/2020,2020.0
35,Maryland (Big Ten),4,3-1,67,65,132,0.508,02/26/2020,2020.0
36,Princeton (Ivy League),3,3-0,49,48,97,0.505,02/26/2020,2020.0
37,Drexel (CAA),3,1-2,54,53,107,0.505,02/26/2020,2020.0
38,Jacksonville (SoCon),3,2-1,42,42,84,0.500,02/26/2020,2020.0
39,Stony Brook (America East),4,3-1,58,60,118,0.492,02/26/2020,2020.0
40,Robert Morris (Independent),3,1-2,50,52,102,0.490,02/26/2020,2020.0
41,Hartford (America East),4,1-3,48,50,98,0.490,02/26/2020,2020.0
42,Bryant (NEC),4,1-3,49,53,102,0.480,02/26/2020,2020.0
43,Marquette (Big East),4,3-1,45,51,96,0.469,02/26/2020,2020.0
44,Army West Point (Patriot),5,3-2,55,63,118,0.466,02/26/2020,2020.0
45,Colgate (Patriot),4,0-4,64,75,139,0.460,02/26/2020,2020.0
46,Ohio St. (Big Ten),4,3-1,46,54,100,0.460,02/26/2020,2020.0
47,Hampton (DI Independent),4,0-4,57,68,125,0.456,02/26/2020,2020.0
48,Wagner (NEC),4,1-3,45,54,99,0.455,02/26/2020,2020.0
49,Sacred Heart (NEC),3,1-2,38,47,85,0.447,02/26/2020,2020.0
50,UMass Lowell (America East),5,2-3,56,70,126,0.444,02/26/2020,2020.0
51,UAlbany (America East),2,1-1,28,36,64,0.438,02/26/2020,2020.0
52,Delaware (CAA),4,3-1,35,46,81,0.432,02/26/2020,2020.0
53,Fairfield (CAA),3,2-1,45,60,105,0.429,02/26/2020,2020.0
54,High Point (SoCon),5,1-4,71,96,167,0.425,02/26/2020,2020.0
55,Manhattan (MAAC),3,2-1,26,36,62,0.419,02/26/2020,2020.0
56,NJIT (NEC),5,1-4,52,74,126,0.413,02/26/2020,2020.0
57,Bellarmine (SoCon),6,2-4,69,101,170,0.406,02/26/2020,2020.0
58,Richmond (SoCon),4,2-2,43,63,106,0.406,02/26/2020,2020.0
59,Air Force (SoCon),5,3-2,47,70,117,0.402,02/26/2020,2020.0
60,Siena (MAAC),3,1-2,40,61,101,0.396,02/26/2020,2020.0
61,LIU (NEC),3,0-3,34,52,86,0.395,02/26/2020,2020.0
62,VMI (SoCon),2,0-2,19,30,49,0.388,02/26/2020,2020.0
63,Lafayette (Patriot),4,0-4,41,69,110,0.373,02/26/2020,2020.0
64,Villanova (Big East),4,2-2,43,73,116,0.371,02/26/2020,2020.0
65,Canisius (MAAC),4,0-4,40,73,113,0.354,02/26/2020,2020.0
66,Vermont (America East),2,1-1,18,33,51,0.353,02/26/2020,2020.0
67,Providence (Big East),4,3-1,29,56,85,0.341,02/26/2020,2020.0
68,Towson (CAA),4,0-4,35,71,106,0.330,02/26/2020,2020.0
69,Rutgers (Big Ten),4,2-2,35,76,111,0.315,02/26/2020,2020.0
70,UMBC (America East),2,1-1,12,27,39,0.308,02/26/2020,2020.0
71,Furman (SoCon),4,1-3,33,76,109,0.303,02/26/2020,2020.0
72,Binghamton (America East),4,1-3,27,64,91,0.297,02/26/2020,2020.0
73,Harvard (Ivy League),2,1-1,11,31,42,0.262,02/26/2020,2020.0
74,St. Bonaventure (MAAC),4,0-4,18,73,91,0.198,02/26/2020,2020.0
-,Merrimack (NEC),4,1-3,55,57,112,0.491,02/26/2020,2020.0
1,Syracuse (ACC),3,3-0,62,21,83,0.747,02/25/2020,2020.0
2,Saint Joseph's (NEC),4,3-1,70,28,98,0.714,02/25/2020,2020.0
3,Loyola Maryland (Patriot),3,2-1,49,20,69,0.710,02/25/2020,2020.0
4,Navy (Patriot),3,2-1,48,20,68,0.706,02/25/2020,2020.0
5,Mercer (SoCon),3,2-1,59,28,87,0.678,02/25/2020,2020.0
6,Georgetown (Big East),4,4-0,75,36,111,0.676,02/25/2020,2020.0
7,Cornell (Ivy League),3,3-0,66,32,98,0.673,02/25/2020,2020.0
8,Yale (Ivy League),2,2-0,40,20,60,0.667,02/25/2020,2020.0
9,Lehigh (Patriot),4,3-1,73,37,110,0.664,02/25/2020,2020.0
10,Holy Cross (Patriot),5,4-1,73,38,111,0.658,02/25/2020,2020.0
11,Boston U. (Patriot),5,2-3,75,41,116,0.647,02/25/2020,2020.0
12,St. John's (NY) (Big East),4,2-2,78,45,123,0.634,02/25/2020,2020.0
13,Marist (MAAC),4,3-1,62,36,98,0.633,02/25/2020,2020.0
14,Brown (Ivy League),3,2-1,44,28,72,0.611,02/25/2020,2020.0
15,Denver (Big East),4,3-1,59,38,97,0.608,02/25/2020,2020.0
16,Johns Hopkins (Big Ten),3,1-2,46,30,76,0.605,02/25/2020,2020.0
17,Notre Dame (ACC),2,2-0,30,20,50,0.600,02/25/2020,2020.0
18,Penn St. (Big Ten),4,3-1,67,45,112,0.598,02/25/2020,2020.0
19,Bucknell (Patriot),4,3-1,79,55,134,0.590,02/25/2020,2020.0
20,Massachusetts (CAA),4,2-2,51,37,88,0.580,02/25/2020,2020.0
21,Detroit Mercy (MAAC),4,2-2,76,56,132,0.576,02/25/2020,2020.0
22,Duke (ACC),4,2-2,66,49,115,0.574,02/25/2020,2020.0
23,Hofstra (CAA),4,2-2,61,47,108,0.565,02/25/2020,2020.0
24,Quinnipiac (MAAC),4,0-4,58,45,103,0.563,02/25/2020,2020.0
25,Michigan (Big Ten),4,2-2,60,47,107,0.561,02/25/2020,2020.0
26,Virginia (ACC),4,3-1,63,50,113,0.558,02/25/2020,2020.0
27,Hobart (NEC),3,3-0,61,49,110,0.555,02/25/2020,2020.0
28,Utah (DI Independent),4,2-2,59,48,107,0.551,02/25/2020,2020.0
29,Penn (Ivy League),2,1-1,35,29,64,0.547,02/25/2020,2020.0
30,Cleveland St. (DI Independent),5,1-4,65,59,124,0.524,02/25/2020,2020.0
31,Monmouth (MAAC),4,2-2,46,42,88,0.523,02/25/2020,2020.0
32,Dartmouth (Ivy League),2,2-0,26,24,50,0.520,02/25/2020,2020.0
33,Mount St. Mary's (NEC),4,1-3,46,43,89,0.517,02/25/2020,2020.0
34,North Carolina (ACC),4,4-0,60,58,118,0.508,02/25/2020,2020.0
35,Maryland (Big Ten),4,3-1,67,65,132,0.508,02/25/2020,2020.0
36,Princeton (Ivy League),3,3-0,49,48,97,0.505,02/25/2020,2020.0
37,Drexel (CAA),3,1-2,54,53,107,0.505,02/25/2020,2020.0
38,Jacksonville (SoCon),3,2-1,42,42,84,0.500,02/25/2020,2020.0
39,Stony Brook (America East),4,3-1,58,60,118,0.492,02/25/2020,2020.0
40,Merrimack (NEC),4,1-3,55,57,112,0.491,02/25/2020,2020.0
41,Robert Morris (Independent),3,1-2,50,52,102,0.490,02/25/2020,2020.0
42,Hartford (America East),4,1-3,48,50,98,0.490,02/25/2020,2020.0
43,Bryant (NEC),4,1-3,49,53,102,0.480,02/25/2020,2020.0
44,Marquette (Big East),4,3-1,45,51,96,0.469,02/25/2020,2020.0
45,Army West Point (Patriot),5,3-2,55,63,118,0.466,02/25/2020,2020.0
46,Colgate (Patriot),4,0-4,64,75,139,0.460,02/25/2020,2020.0
47,Ohio St. (Big Ten),4,3-1,46,54,100,0.460,02/25/2020,2020.0
48,Hampton (DI Independent),4,0-4,57,68,125,0.456,02/25/2020,2020.0
49,Wagner (NEC),4,1-3,45,54,99,0.455,02/25/2020,2020.0
50,Sacred Heart (NEC),3,1-2,38,47,85,0.447,02/25/2020,2020.0
51,UMass Lowell (America East),5,2-3,56,70,126,0.444,02/25/2020,2020.0
52,UAlbany (America East),2,1-1,28,36,64,0.438,02/25/2020,2020.0
53,Delaware (CAA),4,3-1,35,46,81,0.432,02/25/2020,2020.0
54,Fairfield (CAA),3,2-1,45,60,105,0.429,02/25/2020,2020.0
55,High Point (SoCon),5,1-4,71,96,167,0.425,02/25/2020,2020.0
56,Manhattan (MAAC),3,2-1,26,36,62,0.419,02/25/2020,2020.0
57,NJIT (NEC),5,1-4,52,74,126,0.413,02/25/2020,2020.0
58,Bellarmine (SoCon),6,2-4,69,101,170,0.406,02/25/2020,2020.0
59,Richmond (SoCon),4,2-2,43,63,106,0.406,02/25/2020,2020.0
60,Air Force (SoCon),5,3-2,47,70,117,0.402,02/25/2020,2020.0
61,Siena (MAAC),3,1-2,40,61,101,0.396,02/25/2020,2020.0
62,LIU (NEC),3,0-3,34,52,86,0.395,02/25/2020,2020.0
63,VMI (SoCon),2,0-2,19,30,49,0.388,02/25/2020,2020.0
64,Lafayette (Patriot),4,0-4,41,69,110,0.373,02/25/2020,2020.0
65,Villanova (Big East),4,2-2,43,73,116,0.371,02/25/2020,2020.0
66,Canisius (MAAC),4,0-4,40,73,113,0.354,02/25/2020,2020.0
67,Vermont (America East),2,1-1,18,33,51,0.353,02/25/2020,2020.0
68,Providence (Big East),4,3-1,29,56,85,0.341,02/25/2020,2020.0
69,Towson (CAA),3,0-3,26,55,81,0.321,02/25/2020,2020.0
70,Rutgers (Big Ten),4,2-2,35,76,111,0.315,02/25/2020,2020.0
71,UMBC (America East),2,1-1,12,27,39,0.308,02/25/2020,2020.0
72,Furman (SoCon),4,1-3,33,76,109,0.303,02/25/2020,2020.0
73,Binghamton (America East),3,1-2,27,64,91,0.297,02/25/2020,2020.0
74,Harvard (Ivy League),2,1-1,11,31,42,0.262,02/25/2020,2020.0
75,St. Bonaventure (MAAC),4,0-4,18,73,91,0.198,02/25/2020,2020.0
1,Syracuse (ACC),3,3-0,62,21,83,0.747,02/23/2020,2020.0
2,Saint Joseph's (NEC),4,3-1,70,28,98,0.714,02/23/2020,2020.0
3,Loyola Maryland (Patriot),3,2-1,49,20,69,0.710,02/23/2020,2020.0
4,Navy (Patriot),3,2-1,48,20,68,0.706,02/23/2020,2020.0
5,Mercer (SoCon),3,2-1,59,28,87,0.678,02/23/2020,2020.0
6,Cornell (Ivy League),3,3-0,66,32,98,0.673,02/23/2020,2020.0
7,Georgetown (Big East),3,3-0,58,29,87,0.667,02/23/2020,2020.0
7,Yale (Ivy League),2,2-0,40,20,60,0.667,02/23/2020,2020.0
9,Lehigh (Patriot),4,3-1,73,37,110,0.664,02/23/2020,2020.0
10,Boston U. (Patriot),5,2-3,75,41,116,0.647,02/23/2020,2020.0
11,Holy Cross (Patriot),4,3-1,58,33,91,0.637,02/23/2020,2020.0
12,Marist (MAAC),3,2-1,47,27,74,0.635,02/23/2020,2020.0
13,St. John's (NY) (Big East),4,2-2,78,45,123,0.634,02/23/2020,2020.0
14,Hofstra (CAA),3,2-1,49,31,80,0.613,02/23/2020,2020.0
15,Brown (Ivy League),3,2-1,44,28,72,0.611,02/23/2020,2020.0
16,Denver (Big East),4,3-1,59,38,97,0.608,02/23/2020,2020.0
17,Johns Hopkins (Big Ten),3,1-2,46,30,76,0.605,02/23/2020,2020.0
18,Notre Dame (ACC),2,2-0,30,20,50,0.600,02/23/2020,2020.0
19,Penn St. (Big Ten),4,3-1,67,45,112,0.598,02/23/2020,2020.0
20,Mount St. Mary's (NEC),3,1-2,37,25,62,0.597,02/23/2020,2020.0
21,Robert Morris (Independent),2,1-1,36,26,62,0.581,02/23/2020,2020.0
22,Massachusetts (CAA),3,1-2,37,27,64,0.578,02/23/2020,2020.0
23,Detroit Mercy (MAAC),4,2-2,76,56,132,0.576,02/23/2020,2020.0
24,Duke (ACC),4,2-2,66,49,115,0.574,02/23/2020,2020.0
25,Bucknell (Patriot),4,3-1,62,48,110,0.564,02/23/2020,2020.0
26,Quinnipiac (MAAC),4,0-4,58,45,103,0.563,02/23/2020,2020.0
27,Michigan (Big Ten),4,2-2,60,47,107,0.561,02/23/2020,2020.0
28,Hobart (NEC),3,3-0,61,49,110,0.555,02/23/2020,2020.0
29,Utah (DI Independent),4,2-2,59,48,107,0.551,02/23/2020,2020.0
30,Penn (Ivy League),2,1-1,35,29,64,0.547,02/23/2020,2020.0
31,Hartford (America East),3,1-2,39,35,74,0.527,02/23/2020,2020.0
32,Cleveland St. (DI Independent),5,1-4,65,59,124,0.524,02/23/2020,2020.0
33,Dartmouth (Ivy League),2,2-0,26,24,50,0.520,02/23/2020,2020.0
34,North Carolina (ACC),4,4-0,60,58,118,0.508,02/23/2020,2020.0
35,Maryland (Big Ten),4,3-1,67,65,132,0.508,02/23/2020,2020.0
36,Wagner (NEC),3,1-2,41,40,81,0.506,02/23/2020,2020.0
37,Princeton (Ivy League),3,3-0,49,48,97,0.505,02/23/2020,2020.0
38,Jacksonville (SoCon),3,2-1,42,42,84,0.500,02/23/2020,2020.0
39,Merrimack (NEC),4,1-3,55,57,112,0.491,02/23/2020,2020.0
40,Virginia (ACC),3,2-1,38,40,78,0.487,02/23/2020,2020.0
41,Bryant (NEC),4,1-3,49,53,102,0.480,02/23/2020,2020.0
42,Marquette (Big East),4,3-1,45,51,96,0.469,02/23/2020,2020.0
43,Stony Brook (America East),3,2-1,42,48,90,0.467,02/23/2020,2020.0
44,Army West Point (Patriot),5,3-2,55,63,118,0.466,02/23/2020,2020.0
45,High Point (SoCon),4,1-3,61,71,132,0.462,02/23/2020,2020.0
46,Colgate (Patriot),4,0-4,64,75,139,0.460,02/23/2020,2020.0
47,Ohio St. (Big Ten),4,3-1,46,54,100,0.460,02/23/2020,2020.0
48,Monmouth (MAAC),3,1-2,32,38,70,0.457,02/23/2020,2020.0
49,Hampton (DI Independent),4,0-4,57,68,125,0.456,02/23/2020,2020.0
50,UMass Lowell (America East),4,2-2,46,56,102,0.451,02/23/2020,2020.0
51,Sacred Heart (NEC),3,1-2,38,47,85,0.447,02/23/2020,2020.0
52,UAlbany (America East),2,1-1,28,36,64,0.438,02/23/2020,2020.0
53,Delaware (CAA),4,3-1,35,46,81,0.432,02/23/2020,2020.0
54,Fairfield (CAA),3,2-1,45,60,105,0.429,02/23/2020,2020.0
55,Manhattan (MAAC),3,2-1,26,36,62,0.419,02/23/2020,2020.0
56,Drexel (CAA),2,0-2,28,39,67,0.418,02/23/2020,2020.0
57,NJIT (NEC),5,1-4,52,74,126,0.413,02/23/2020,2020.0
58,Bellarmine (SoCon),6,2-4,69,101,170,0.406,02/23/2020,2020.0
59,Richmond (SoCon),4,2-2,43,63,106,0.406,02/23/2020,2020.0
60,Air Force (SoCon),5,3-2,47,70,117,0.402,02/23/2020,2020.0
61,Siena (MAAC),3,1-2,40,61,101,0.396,02/23/2020,2020.0
62,LIU (NEC),3,0-3,34,52,86,0.395,02/23/2020,2020.0
63,VMI (SoCon),2,0-2,19,30,49,0.388,02/23/2020,2020.0
64,Lafayette (Patriot),4,0-4,41,69,110,0.373,02/23/2020,2020.0
65,Villanova (Big East),4,2-2,43,73,116,0.371,02/23/2020,2020.0
66,Canisius (MAAC),4,0-4,40,73,113,0.354,02/23/2020,2020.0
67,Vermont (America East),2,1-1,18,33,51,0.353,02/23/2020,2020.0
68,Providence (Big East),4,3-1,29,56,85,0.341,02/23/2020,2020.0
69,Towson (CAA),3,0-3,26,55,81,0.321,02/23/2020,2020.0
70,Rutgers (Big Ten),4,2-2,35,76,111,0.315,02/23/2020,2020.0
71,UMBC (America East),2,1-1,11,25,36,0.306,02/23/2020,2020.0
72,Furman (SoCon),4,1-3,33,76,109,0.303,02/23/2020,2020.0
73,Binghamton (America East),3,1-2,20,47,67,0.299,02/23/2020,2020.0
74,Harvard (Ivy League),1,1-0,6,16,22,0.273,02/23/2020,2020.0
75,St. Bonaventure (MAAC),4,0-4,18,73,91,0.198,02/23/2020,2020.0
1,Syracuse (ACC),2,2-0,46,18,64,0.719,02/21/2020,2020.0
2,Navy (Patriot),3,2-1,48,20,68,0.706,02/21/2020,2020.0
2,Yale (Ivy League),1,1-0,24,10,34,0.706,02/21/2020,2020.0
4,Robert Morris (Independent),1,1-0,24,11,35,0.686,02/21/2020,2020.0
5,Georgetown (Big East),2,2-0,32,15,47,0.681,02/21/2020,2020.0
6,Saint Joseph's (NEC),3,2-1,51,25,76,0.671,02/21/2020,2020.0
7,Cornell (Ivy League),2,2-0,42,21,63,0.667,02/21/2020,2020.0
8,Penn St. (Big Ten),3,3-0,57,29,86,0.663,02/21/2020,2020.0
9,Mercer (SoCon),2,1-1,33,17,50,0.660,02/21/2020,2020.0
10,St. John's (NY) (Big East),3,1-2,57,31,88,0.648,02/21/2020,2020.0
11,Hofstra (CAA),2,2-0,38,21,59,0.644,02/21/2020,2020.0
12,Holy Cross (Patriot),4,3-1,58,33,91,0.637,02/21/2020,2020.0
13,Marist (MAAC),3,2-1,47,27,74,0.635,02/21/2020,2020.0
14,Michigan (Big Ten),3,2-1,49,29,78,0.628,02/21/2020,2020.0
15,Duke (ACC),3,2-1,54,32,86,0.628,02/21/2020,2020.0
16,Mount St. Mary's (NEC),2,1-1,31,19,50,0.620,02/21/2020,2020.0
17,Johns Hopkins (Big Ten),2,1-1,28,18,46,0.609,02/21/2020,2020.0
18,Lehigh (Patriot),3,2-1,49,32,81,0.605,02/21/2020,2020.0
19,Brown (Ivy League),2,2-0,29,19,48,0.604,02/21/2020,2020.0
20,Boston U. (Patriot),4,1-3,51,34,85,0.600,02/21/2020,2020.0
21,Bucknell (Patriot),3,3-0,48,33,81,0.593,02/21/2020,2020.0
22,Loyola Maryland (Patriot),2,1-1,26,18,44,0.591,02/21/2020,2020.0
23,Detroit Mercy (MAAC),3,2-1,62,44,106,0.585,02/21/2020,2020.0
24,Hobart (NEC),2,2-0,41,30,71,0.577,02/21/2020,2020.0
25,Denver (Big East),2,1-1,30,24,54,0.556,02/21/2020,2020.0
26,North Carolina (ACC),3,3-0,48,40,88,0.545,02/21/2020,2020.0
27,Princeton (Ivy League),2,2-0,35,31,66,0.530,02/21/2020,2020.0
28,Army West Point (Patriot),4,3-1,52,47,99,0.525,02/21/2020,2020.0
29,Hampton (DI Independent),3,0-3,46,42,88,0.523,02/21/2020,2020.0
30,Quinnipiac (MAAC),3,0-3,39,36,75,0.520,02/21/2020,2020.0
31,Cleveland St. (DI Independent),3,0-3,41,38,79,0.519,02/21/2020,2020.0
32,High Point (SoCon),3,1-2,50,47,97,0.515,02/21/2020,2020.0
33,Penn (Ivy League),1,0-1,18,17,35,0.514,02/21/2020,2020.0
34,Maryland (Big Ten),4,3-1,67,65,132,0.508,02/21/2020,2020.0
35,Stony Brook (America East),2,1-1,33,33,66,0.500,02/21/2020,2020.0
35,Massachusetts (CAA),2,1-1,21,21,42,0.500,02/21/2020,2020.0
37,Utah (DI Independent),3,1-2,39,40,79,0.494,02/21/2020,2020.0
37,Bryant (NEC),3,1-2,39,40,79,0.494,02/21/2020,2020.0
39,NJIT (NEC),4,1-3,47,50,97,0.485,02/21/2020,2020.0
40,Hartford (America East),2,0-2,27,29,56,0.482,02/21/2020,2020.0
41,Dartmouth (Ivy League),1,1-0,13,14,27,0.481,02/21/2020,2020.0
42,Fairfield (CAA),2,2-0,31,34,65,0.477,02/21/2020,2020.0
43,Richmond (SoCon),3,2-1,40,44,84,0.476,02/21/2020,2020.0
44,Jacksonville (SoCon),2,1-1,27,30,57,0.474,02/21/2020,2020.0
44,Manhattan (MAAC),2,1-1,18,20,38,0.474,02/21/2020,2020.0
46,Marquette (Big East),3,2-1,33,37,70,0.471,02/21/2020,2020.0
47,Colgate (Patriot),3,0-3,45,55,100,0.450,02/21/2020,2020.0
48,Sacred Heart (NEC),3,1-2,38,47,85,0.447,02/21/2020,2020.0
49,Virginia (ACC),2,2-0,21,26,47,0.447,02/21/2020,2020.0
50,Bellarmine (SoCon),5,2-3,62,77,139,0.446,02/21/2020,2020.0
51,Merrimack (NEC),3,0-3,37,46,83,0.446,02/21/2020,2020.0
52,Siena (MAAC),2,1-1,30,38,68,0.441,02/21/2020,2020.0
53,Wagner (NEC),2,1-1,25,32,57,0.439,02/21/2020,2020.0
54,Ohio St. (Big Ten),3,2-1,31,40,71,0.437,02/21/2020,2020.0
55,Monmouth (MAAC),2,1-1,24,31,55,0.436,02/21/2020,2020.0
56,Delaware (CAA),3,2-1,28,38,66,0.424,02/21/2020,2020.0
57,Providence (Big East),3,3-0,26,37,63,0.413,02/21/2020,2020.0
58,Notre Dame (ACC),1,1-0,11,17,28,0.393,02/21/2020,2020.0
59,LIU (NEC),2,0-2,20,31,51,0.392,02/21/2020,2020.0
60,Vermont (America East),1,0-1,9,14,23,0.391,02/21/2020,2020.0
61,VMI (SoCon),2,0-2,19,30,49,0.388,02/21/2020,2020.0
62,Rutgers (Big Ten),3,2-1,33,53,86,0.384,02/21/2020,2020.0
63,Drexel (CAA),1,0-1,13,22,35,0.371,02/21/2020,2020.0
64,Canisius (MAAC),3,0-3,34,61,95,0.358,02/21/2020,2020.0
65,Lafayette (Patriot),3,0-3,30,56,86,0.349,02/21/2020,2020.0
66,Villanova (Big East),3,1-2,33,62,95,0.347,02/21/2020,2020.0
67,UAlbany (America East),1,0-1,11,21,32,0.344,02/21/2020,2020.0
68,UMass Lowell (America East),3,1-2,23,46,69,0.333,02/21/2020,2020.0
69,Air Force (SoCon),3,2-1,24,49,73,0.329,02/21/2020,2020.0
70,Towson (CAA),3,0-3,26,55,81,0.321,02/21/2020,2020.0
71,Furman (SoCon),3,1-2,25,56,81,0.309,02/21/2020,2020.0
72,UMBC (America East),1,0-1,5,19,24,0.208,02/21/2020,2020.0
73,Binghamton (America East),2,0-2,7,36,43,0.163,02/21/2020,2020.0
74,St. Bonaventure (MAAC),2,0-2,7,42,49,0.143,02/21/2020,2020.0
1,Syracuse (ACC),2,2-0,46,18,64,0.719,02/20/2020,2020.0
2,Navy (Patriot),3,2-1,48,20,68,0.706,02/20/2020,2020.0
2,Yale (Ivy League),1,1-0,24,10,34,0.706,02/20/2020,2020.0
4,Robert Morris (Independent),1,1-0,24,11,35,0.686,02/20/2020,2020.0
5,Georgetown (Big East),2,2-0,32,15,47,0.681,02/20/2020,2020.0
6,Saint Joseph's (NEC),3,2-1,51,25,76,0.671,02/20/2020,2020.0
7,Penn St. (Big Ten),3,3-0,57,29,86,0.663,02/20/2020,2020.0
8,Mercer (SoCon),2,1-1,33,17,50,0.660,02/20/2020,2020.0
9,Cornell (Ivy League),1,1-0,21,11,32,0.656,02/20/2020,2020.0
10,St. John's (NY) (Big East),3,1-2,57,31,88,0.648,02/20/2020,2020.0
11,Hofstra (CAA),2,2-0,38,21,59,0.644,02/20/2020,2020.0
12,Holy Cross (Patriot),4,3-1,58,33,91,0.637,02/20/2020,2020.0
13,Marist (MAAC),3,2-1,47,27,74,0.635,02/20/2020,2020.0
14,Michigan (Big Ten),3,2-1,49,29,78,0.628,02/20/2020,2020.0
15,Duke (ACC),3,2-1,54,32,86,0.628,02/20/2020,2020.0
16,Mount St. Mary's (NEC),2,1-1,31,19,50,0.620,02/20/2020,2020.0
17,Johns Hopkins (Big Ten),2,1-1,28,18,46,0.609,02/20/2020,2020.0
18,Lehigh (Patriot),3,2-1,49,32,81,0.605,02/20/2020,2020.0
19,Brown (Ivy League),2,2-0,29,19,48,0.604,02/20/2020,2020.0
20,Boston U. (Patriot),4,1-3,51,34,85,0.600,02/20/2020,2020.0
21,Bucknell (Patriot),3,3-0,48,33,81,0.593,02/20/2020,2020.0
22,Loyola Maryland (Patriot),2,1-1,26,18,44,0.591,02/20/2020,2020.0
23,Detroit Mercy (MAAC),3,2-1,62,44,106,0.585,02/20/2020,2020.0
24,Hobart (NEC),2,2-0,41,30,71,0.577,02/20/2020,2020.0
25,Denver (Big East),2,1-1,30,24,54,0.556,02/20/2020,2020.0
26,North Carolina (ACC),3,3-0,48,40,88,0.545,02/20/2020,2020.0
27,Princeton (Ivy League),2,2-0,35,31,66,0.530,02/20/2020,2020.0
28,Army West Point (Patriot),4,3-1,52,47,99,0.525,02/20/2020,2020.0
29,Hampton (DI Independent),3,0-3,46,42,88,0.523,02/20/2020,2020.0
30,Quinnipiac (MAAC),3,0-3,39,36,75,0.520,02/20/2020,2020.0
31,Cleveland St. (DI Independent),3,0-3,41,38,79,0.519,02/20/2020,2020.0
32,High Point (SoCon),3,1-2,50,47,97,0.515,02/20/2020,2020.0
33,Penn (Ivy League),1,0-1,18,17,35,0.514,02/20/2020,2020.0
34,Maryland (Big Ten),4,3-1,67,65,132,0.508,02/20/2020,2020.0
35,Stony Brook (America East),2,1-1,33,33,66,0.500,02/20/2020,2020.0
35,Massachusetts (CAA),2,1-1,21,21,42,0.500,02/20/2020,2020.0
37,Utah (DI Independent),3,1-2,39,40,79,0.494,02/20/2020,2020.0
37,Bryant (NEC),3,1-2,39,40,79,0.494,02/20/2020,2020.0
39,NJIT (NEC),4,1-3,47,50,97,0.485,02/20/2020,2020.0
40,Hartford (America East),2,0-2,27,29,56,0.482,02/20/2020,2020.0
41,Dartmouth (Ivy League),1,1-0,13,14,27,0.481,02/20/2020,2020.0
42,Fairfield (CAA),2,2-0,31,34,65,0.477,02/20/2020,2020.0
43,Richmond (SoCon),3,2-1,40,44,84,0.476,02/20/2020,2020.0
44,Jacksonville (SoCon),2,1-1,27,30,57,0.474,02/20/2020,2020.0
44,Manhattan (MAAC),2,1-1,18,20,38,0.474,02/20/2020,2020.0
46,Marquette (Big East),3,2-1,33,37,70,0.471,02/20/2020,2020.0
47,Colgate (Patriot),3,0-3,45,55,100,0.450,02/20/2020,2020.0
48,Sacred Heart (NEC),3,1-2,38,47,85,0.447,02/20/2020,2020.0
49,Virginia (ACC),2,2-0,21,26,47,0.447,02/20/2020,2020.0
50,Bellarmine (SoCon),5,2-3,62,77,139,0.446,02/20/2020,2020.0
51,Merrimack (NEC),3,0-3,37,46,83,0.446,02/20/2020,2020.0
52,Siena (MAAC),2,1-1,30,38,68,0.441,02/20/2020,2020.0
53,Wagner (NEC),2,1-1,25,32,57,0.439,02/20/2020,2020.0
54,Ohio St. (Big Ten),3,2-1,31,40,71,0.437,02/20/2020,2020.0
55,Monmouth (MAAC),2,1-1,24,31,55,0.436,02/20/2020,2020.0
56,Delaware (CAA),3,2-1,28,38,66,0.424,02/20/2020,2020.0
57,Providence (Big East),3,3-0,26,37,63,0.413,02/20/2020,2020.0
58,Notre Dame (ACC),1,1-0,11,17,28,0.393,02/20/2020,2020.0
59,LIU (NEC),2,0-2,20,31,51,0.392,02/20/2020,2020.0
60,Vermont (America East),1,0-1,9,14,23,0.391,02/20/2020,2020.0
61,VMI (SoCon),2,0-2,19,30,49,0.388,02/20/2020,2020.0
62,Rutgers (Big Ten),3,2-1,33,53,86,0.384,02/20/2020,2020.0
63,Drexel (CAA),1,0-1,13,22,35,0.371,02/20/2020,2020.0
64,Canisius (MAAC),3,0-3,34,61,95,0.358,02/20/2020,2020.0
65,Lafayette (Patriot),3,0-3,30,56,86,0.349,02/20/2020,2020.0
66,Villanova (Big East),3,1-2,33,62,95,0.347,02/20/2020,2020.0
67,UAlbany (America East),1,0-1,11,21,32,0.344,02/20/2020,2020.0
68,UMass Lowell (America East),3,1-2,23,46,69,0.333,02/20/2020,2020.0
69,Air Force (SoCon),3,2-1,24,49,73,0.329,02/20/2020,2020.0
70,Towson (CAA),2,0-2,16,34,50,0.320,02/20/2020,2020.0
71,Furman (SoCon),3,1-2,25,56,81,0.309,02/20/2020,2020.0
72,UMBC (America East),1,0-1,5,19,24,0.208,02/20/2020,2020.0
73,Binghamton (America East),2,0-2,7,36,43,0.163,02/20/2020,2020.0
74,St. Bonaventure (MAAC),2,0-2,7,42,49,0.143,02/20/2020,2020.0
1,Syracuse (ACC),2,2-0,46,18,64,0.719,02/18/2020,2020.0
2,Navy (Patriot),3,2-1,48,20,68,0.706,02/18/2020,2020.0
2,Yale (Ivy League),1,1-0,24,10,34,0.706,02/18/2020,2020.0
4,Robert Morris (Independent),1,1-0,24,11,35,0.686,02/18/2020,2020.0
5,Georgetown (Big East),2,2-0,32,15,47,0.681,02/18/2020,2020.0
6,Saint Joseph's (NEC),3,2-1,51,25,76,0.671,02/18/2020,2020.0
7,Penn St. (Big Ten),3,3-0,57,29,86,0.663,02/18/2020,2020.0
8,Mercer (SoCon),2,1-1,33,17,50,0.660,02/18/2020,2020.0
9,Cornell (Ivy League),1,1-0,21,11,32,0.656,02/18/2020,2020.0
10,St. John's (NY) (Big East),3,1-2,57,31,88,0.648,02/18/2020,2020.0
11,Hofstra (CAA),2,2-0,38,21,59,0.644,02/18/2020,2020.0
12,Holy Cross (Patriot),3,2-1,41,23,64,0.641,02/18/2020,2020.0
13,Marist (MAAC),3,2-1,47,27,74,0.635,02/18/2020,2020.0
14,Michigan (Big Ten),3,2-1,49,29,78,0.628,02/18/2020,2020.0
15,Duke (ACC),3,2-1,54,32,86,0.628,02/18/2020,2020.0
16,Mount St. Mary's (NEC),2,1-1,31,19,50,0.620,02/18/2020,2020.0
17,Johns Hopkins (Big Ten),2,1-1,28,18,46,0.609,02/18/2020,2020.0
18,Brown (Ivy League),2,2-0,29,19,48,0.604,02/18/2020,2020.0
19,Boston U. (Patriot),4,1-3,51,34,85,0.600,02/18/2020,2020.0
20,Bucknell (Patriot),3,3-0,48,33,81,0.593,02/18/2020,2020.0
21,Loyola Maryland (Patriot),2,1-1,26,18,44,0.591,02/18/2020,2020.0
22,Detroit Mercy (MAAC),3,2-1,62,44,106,0.585,02/18/2020,2020.0
22,Lehigh (Patriot),2,1-1,31,22,53,0.585,02/18/2020,2020.0
24,Hobart (NEC),2,2-0,41,30,71,0.577,02/18/2020,2020.0
25,Denver (Big East),2,1-1,30,24,54,0.556,02/18/2020,2020.0
26,North Carolina (ACC),3,3-0,48,40,88,0.545,02/18/2020,2020.0
27,Princeton (Ivy League),2,2-0,35,31,66,0.530,02/18/2020,2020.0
28,Army West Point (Patriot),4,3-1,52,47,99,0.525,02/18/2020,2020.0
29,Hampton (DI Independent),3,0-3,46,42,88,0.523,02/18/2020,2020.0
30,Quinnipiac (MAAC),3,0-3,39,36,75,0.520,02/18/2020,2020.0
31,Cleveland St. (DI Independent),3,0-3,41,38,79,0.519,02/18/2020,2020.0
32,High Point (SoCon),3,1-2,50,47,97,0.515,02/18/2020,2020.0
33,Penn (Ivy League),1,0-1,18,17,35,0.514,02/18/2020,2020.0
34,Maryland (Big Ten),4,3-1,67,65,132,0.508,02/18/2020,2020.0
35,Stony Brook (America East),2,1-1,33,33,66,0.500,02/18/2020,2020.0
35,Massachusetts (CAA),2,1-1,21,21,42,0.500,02/18/2020,2020.0
37,Utah (DI Independent),3,1-2,39,40,79,0.494,02/18/2020,2020.0
37,Bryant (NEC),3,1-2,39,40,79,0.494,02/18/2020,2020.0
39,NJIT (NEC),4,1-3,47,50,97,0.485,02/18/2020,2020.0
40,Hartford (America East),2,0-2,27,29,56,0.482,02/18/2020,2020.0
41,Dartmouth (Ivy League),1,1-0,13,14,27,0.481,02/18/2020,2020.0
42,Fairfield (CAA),2,2-0,31,34,65,0.477,02/18/2020,2020.0
43,Richmond (SoCon),3,2-1,40,44,84,0.476,02/18/2020,2020.0
44,Jacksonville (SoCon),2,1-1,27,30,57,0.474,02/18/2020,2020.0
44,Manhattan (MAAC),2,1-1,18,20,38,0.474,02/18/2020,2020.0
46,Marquette (Big East),3,2-1,33,37,70,0.471,02/18/2020,2020.0
47,Colgate (Patriot),3,0-3,45,55,100,0.450,02/18/2020,2020.0
48,Sacred Heart (NEC),3,1-2,38,47,85,0.447,02/18/2020,2020.0
49,Virginia (ACC),2,2-0,21,26,47,0.447,02/18/2020,2020.0
50,Bellarmine (SoCon),5,2-3,62,77,139,0.446,02/18/2020,2020.0
51,Merrimack (NEC),3,0-3,37,46,83,0.446,02/18/2020,2020.0
52,Siena (MAAC),2,1-1,30,38,68,0.441,02/18/2020,2020.0
53,Wagner (NEC),2,1-1,25,32,57,0.439,02/18/2020,2020.0
54,Ohio St. (Big Ten),3,2-1,31,40,71,0.437,02/18/2020,2020.0
55,Monmouth (MAAC),2,1-1,24,31,55,0.436,02/18/2020,2020.0
56,VMI (SoCon),1,0-1,9,12,21,0.429,02/18/2020,2020.0
57,Delaware (CAA),3,2-1,28,38,66,0.424,02/18/2020,2020.0
58,Providence (Big East),3,3-0,26,37,63,0.413,02/18/2020,2020.0
59,Notre Dame (ACC),1,1-0,11,17,28,0.393,02/18/2020,2020.0
60,LIU (NEC),2,0-2,20,31,51,0.392,02/18/2020,2020.0
61,Vermont (America East),1,0-1,9,14,23,0.391,02/18/2020,2020.0
62,Rutgers (Big Ten),3,2-1,33,53,86,0.384,02/18/2020,2020.0
63,Drexel (CAA),1,0-1,13,22,35,0.371,02/18/2020,2020.0
64,Canisius (MAAC),3,0-3,34,61,95,0.358,02/18/2020,2020.0
65,Lafayette (Patriot),3,0-3,30,56,86,0.349,02/18/2020,2020.0
66,Villanova (Big East),3,1-2,33,62,95,0.347,02/18/2020,2020.0
67,UAlbany (America East),1,0-1,11,21,32,0.344,02/18/2020,2020.0
68,Air Force (SoCon),3,2-1,24,49,73,0.329,02/18/2020,2020.0
69,Towson (CAA),2,0-2,16,34,50,0.320,02/18/2020,2020.0
70,UMass Lowell (America East),2,1-1,13,29,42,0.310,02/18/2020,2020.0
71,Furman (SoCon),3,1-2,25,56,81,0.309,02/18/2020,2020.0
72,UMBC (America East),1,0-1,5,19,24,0.208,02/18/2020,2020.0
73,Binghamton (America East),2,0-2,7,36,43,0.163,02/18/2020,2020.0
74,St. Bonaventure (MAAC),2,0-2,7,42,49,0.143,02/18/2020,2020.0
1,Navy (Patriot),2,2-0,33,10,43,0.767,02/15/2020,2020.0
2,Syracuse (ACC),2,2-0,46,18,64,0.719,02/15/2020,2020.0
3,Yale (Ivy League),1,1-0,24,10,34,0.706,02/15/2020,2020.0
4,Robert Morris (Independent),1,1-0,24,11,35,0.686,02/15/2020,2020.0
5,Saint Joseph's (NEC),2,1-1,37,17,54,0.685,02/15/2020,2020.0
6,Georgetown (Big East),2,2-0,32,15,47,0.681,02/15/2020,2020.0
7,Boston U. (Patriot),3,1-2,40,19,59,0.678,02/15/2020,2020.0
8,Penn St. (Big Ten),3,3-0,57,29,86,0.663,02/15/2020,2020.0
9,Mercer (SoCon),2,1-1,33,17,50,0.660,02/15/2020,2020.0
10,Cornell (Ivy League),1,1-0,21,11,32,0.656,02/15/2020,2020.0
11,Marist (MAAC),2,1-1,30,16,46,0.652,02/15/2020,2020.0
12,Brown (Ivy League),1,1-0,13,7,20,0.650,02/15/2020,2020.0
13,St. John's (NY) (Big East),3,1-2,57,31,88,0.648,02/15/2020,2020.0
14,Hofstra (CAA),2,2-0,38,21,59,0.644,02/15/2020,2020.0
15,Holy Cross (Patriot),3,2-1,41,23,64,0.641,02/15/2020,2020.0
16,Princeton (Ivy League),1,1-0,21,12,33,0.636,02/15/2020,2020.0
17,Duke (ACC),3,2-1,54,32,86,0.628,02/15/2020,2020.0
18,Mount St. Mary's (NEC),2,1-1,31,19,50,0.620,02/15/2020,2020.0
19,Johns Hopkins (Big Ten),2,1-1,28,18,46,0.609,02/15/2020,2020.0
20,Bucknell (Patriot),3,3-0,48,33,81,0.593,02/15/2020,2020.0
21,Loyola Maryland (Patriot),2,1-1,26,18,44,0.591,02/15/2020,2020.0
22,Michigan (Big Ten),2,1-1,30,21,51,0.588,02/15/2020,2020.0
23,Lehigh (Patriot),2,1-1,31,22,53,0.585,02/15/2020,2020.0
24,Hobart (NEC),2,2-0,41,30,71,0.577,02/15/2020,2020.0
24,Army West Point (Patriot),3,3-0,41,30,71,0.577,02/15/2020,2020.0
26,Denver (Big East),2,1-1,30,24,54,0.556,02/15/2020,2020.0
27,North Carolina (ACC),3,3-0,48,40,88,0.545,02/15/2020,2020.0
28,Hampton (DI Independent),3,0-3,46,42,88,0.523,02/15/2020,2020.0
29,Quinnipiac (MAAC),3,0-3,39,36,75,0.520,02/15/2020,2020.0
30,Cleveland St. (DI Independent),3,0-3,41,38,79,0.519,02/15/2020,2020.0
31,High Point (SoCon),3,1-2,50,47,97,0.515,02/15/2020,2020.0
32,Penn (Ivy League),1,0-1,18,17,35,0.514,02/15/2020,2020.0
33,Bellarmine (SoCon),4,2-2,52,50,102,0.510,02/15/2020,2020.0
34,Richmond (SoCon),2,1-1,30,29,59,0.508,02/15/2020,2020.0
35,Detroit Mercy (MAAC),2,1-1,35,34,69,0.507,02/15/2020,2020.0
36,Stony Brook (America East),2,1-1,33,33,66,0.500,02/15/2020,2020.0
36,Massachusetts (CAA),2,1-1,21,21,42,0.500,02/15/2020,2020.0
38,Utah (DI Independent),3,1-2,39,40,79,0.494,02/15/2020,2020.0
39,Maryland (Big Ten),3,3-0,50,53,103,0.485,02/15/2020,2020.0
40,NJIT (NEC),4,1-3,47,50,97,0.485,02/15/2020,2020.0
41,Hartford (America East),2,0-2,27,29,56,0.482,02/15/2020,2020.0
42,Dartmouth (Ivy League),1,1-0,13,14,27,0.481,02/15/2020,2020.0
43,Jacksonville (SoCon),2,1-1,27,30,57,0.474,02/15/2020,2020.0
43,Manhattan (MAAC),2,1-1,18,20,38,0.474,02/15/2020,2020.0
45,Marquette (Big East),3,2-1,33,37,70,0.471,02/15/2020,2020.0
46,Sacred Heart (NEC),2,1-1,26,31,57,0.456,02/15/2020,2020.0
47,Delaware (CAA),2,2-0,20,24,44,0.455,02/15/2020,2020.0
48,Bryant (NEC),2,0-2,24,29,53,0.453,02/15/2020,2020.0
49,Virginia (ACC),2,2-0,21,26,47,0.447,02/15/2020,2020.0
50,Siena (MAAC),2,1-1,30,38,68,0.441,02/15/2020,2020.0
51,Wagner (NEC),2,1-1,25,32,57,0.439,02/15/2020,2020.0
52,Ohio St. (Big Ten),3,2-1,31,40,71,0.437,02/15/2020,2020.0
53,Merrimack (NEC),2,0-2,24,31,55,0.436,02/15/2020,2020.0
53,Monmouth (MAAC),2,1-1,24,31,55,0.436,02/15/2020,2020.0
55,Fairfield (CAA),1,1-0,16,21,37,0.432,02/15/2020,2020.0
56,VMI (SoCon),1,0-1,9,12,21,0.429,02/15/2020,2020.0
57,Providence (Big East),3,3-0,26,37,63,0.413,02/15/2020,2020.0
58,Notre Dame (ACC),1,1-0,11,17,28,0.393,02/15/2020,2020.0
59,LIU (NEC),2,0-2,20,31,51,0.392,02/15/2020,2020.0
60,Vermont (America East),1,0-1,9,14,23,0.391,02/15/2020,2020.0
61,Colgate (Patriot),2,0-2,26,41,67,0.388,02/15/2020,2020.0
62,Rutgers (Big Ten),3,2-1,33,53,86,0.384,02/15/2020,2020.0
63,Canisius (MAAC),2,0-2,26,42,68,0.382,02/15/2020,2020.0
64,Drexel (CAA),1,0-1,13,22,35,0.371,02/15/2020,2020.0
65,Lafayette (Patriot),3,0-3,30,56,86,0.349,02/15/2020,2020.0
66,UAlbany (America East),1,0-1,11,21,32,0.344,02/15/2020,2020.0
67,Air Force (SoCon),3,2-1,24,49,73,0.329,02/15/2020,2020.0
68,Towson (CAA),2,0-2,16,34,50,0.320,02/15/2020,2020.0
69,Villanova (Big East),2,0-2,21,45,66,0.318,02/15/2020,2020.0
70,UMass Lowell (America East),2,1-1,13,29,42,0.310,02/15/2020,2020.0
71,Furman (SoCon),3,1-2,25,56,81,0.309,02/15/2020,2020.0
72,UMBC (America East),1,0-1,5,19,24,0.208,02/15/2020,2020.0
73,Binghamton (America East),2,0-2,7,36,43,0.163,02/15/2020,2020.0
74,St. Bonaventure (MAAC),2,0-2,7,42,49,0.143,02/15/2020,2020.0
1,Saint Joseph's (NEC),1,1-0,24,3,27,0.889,02/14/2020,2020.0
2,Boston U. (Patriot),2,0-2,30,9,39,0.769,02/14/2020,2020.0
2,Johns Hopkins (Big Ten),1,1-0,20,6,26,0.769,02/14/2020,2020.0
4,Hofstra (CAA),1,1-0,27,9,36,0.750,02/14/2020,2020.0
5,Denver (Big East),1,1-0,17,6,23,0.739,02/14/2020,2020.0
6,Penn St. (Big Ten),2,2-0,43,16,59,0.729,02/14/2020,2020.0
7,St. John's (NY) (Big East),2,0-2,42,18,60,0.700,02/14/2020,2020.0
8,Mercer (SoCon),2,1-1,33,17,50,0.660,02/14/2020,2020.0
9,Holy Cross (Patriot),2,1-1,27,14,41,0.659,02/14/2020,2020.0
10,Duke (ACC),2,1-1,36,19,55,0.655,02/14/2020,2020.0
11,Mount St. Mary's (NEC),1,0-1,17,9,26,0.654,02/14/2020,2020.0
12,Marist (MAAC),2,1-1,30,16,46,0.652,02/14/2020,2020.0
13,Navy (Patriot),1,1-0,11,6,17,0.647,02/14/2020,2020.0
14,Michigan (Big Ten),1,1-0,18,10,28,0.643,02/14/2020,2020.0
15,Syracuse (ACC),1,1-0,25,14,39,0.641,02/14/2020,2020.0
16,Lehigh (Patriot),1,1-0,19,11,30,0.633,02/14/2020,2020.0
17,Bucknell (Patriot),2,2-0,31,21,52,0.596,02/14/2020,2020.0
18,Loyola Maryland (Patriot),1,0-1,14,10,24,0.583,02/14/2020,2020.0
19,Quinnipiac (MAAC),2,0-2,32,23,55,0.582,02/14/2020,2020.0
20,Georgetown (Big East),1,1-0,13,10,23,0.565,02/14/2020,2020.0
21,Hobart (NEC),1,1-0,18,15,33,0.545,02/14/2020,2020.0
21,Monmouth (MAAC),1,1-0,12,10,22,0.545,02/14/2020,2020.0
23,Army West Point (Patriot),2,2-0,26,23,49,0.531,02/14/2020,2020.0
24,Hampton (DI Independent),3,0-3,46,42,88,0.523,02/14/2020,2020.0
25,Massachusetts (CAA),1,0-1,13,12,25,0.520,02/14/2020,2020.0
26,North Carolina (ACC),2,2-0,27,25,52,0.519,02/14/2020,2020.0
27,Richmond (SoCon),2,1-1,30,29,59,0.508,02/14/2020,2020.0
28,Detroit Mercy (MAAC),2,1-1,35,34,69,0.507,02/14/2020,2020.0
29,NJIT (NEC),3,1-2,40,39,79,0.506,02/14/2020,2020.0
30,Siena (MAAC),1,1-0,15,15,30,0.500,02/14/2020,2020.0
30,LIU (NEC),1,0-1,15,15,30,0.500,02/14/2020,2020.0
30,Hartford (America East),1,0-1,14,14,28,0.500,02/14/2020,2020.0
30,Sacred Heart (NEC),1,1-0,14,14,28,0.500,02/14/2020,2020.0
34,Maryland (Big Ten),2,2-0,33,35,68,0.485,02/14/2020,2020.0
35,Utah (DI Independent),2,1-1,28,31,59,0.475,02/14/2020,2020.0
36,Cleveland St. (DI Independent),2,0-2,24,27,51,0.471,02/14/2020,2020.0
37,Bryant (NEC),1,0-1,11,13,24,0.458,02/14/2020,2020.0
38,Marquette (Big East),2,2-0,21,25,46,0.457,02/14/2020,2020.0
39,Canisius (MAAC),1,0-1,15,18,33,0.455,02/14/2020,2020.0
39,Jacksonville (SoCon),1,0-1,15,18,33,0.455,02/14/2020,2020.0
41,High Point (SoCon),2,0-2,28,34,62,0.452,02/14/2020,2020.0
42,Bellarmine (SoCon),3,1-2,34,46,80,0.425,02/14/2020,2020.0
43,Virginia (ACC),1,1-0,10,14,24,0.417,02/14/2020,2020.0
44,Stony Brook (America East),1,1-0,12,17,29,0.414,02/14/2020,2020.0
45,Ohio St. (Big Ten),2,2-0,22,32,54,0.407,02/14/2020,2020.0
46,Rutgers (Big Ten),2,2-0,26,38,64,0.406,02/14/2020,2020.0
47,Colgate (Patriot),2,0-2,26,41,67,0.388,02/14/2020,2020.0
48,Furman (SoCon),2,1-1,21,34,55,0.382,02/14/2020,2020.0
49,Merrimack (NEC),1,0-1,10,18,28,0.357,02/14/2020,2020.0
50,Manhattan (MAAC),1,0-1,6,11,17,0.353,02/14/2020,2020.0
51,Delaware (CAA),1,1-0,9,17,26,0.346,02/14/2020,2020.0
52,Villanova (Big East),1,0-1,11,21,32,0.344,02/14/2020,2020.0
53,Lafayette (Patriot),2,0-2,15,35,50,0.300,02/14/2020,2020.0
54,Providence (Big East),2,2-0,10,24,34,0.294,02/14/2020,2020.0
55,Air Force (SoCon),2,1-1,15,38,53,0.283,02/14/2020,2020.0
56,Wagner (NEC),1,0-1,9,27,36,0.250,02/14/2020,2020.0
57,Towson (CAA),1,0-1,6,20,26,0.231,02/14/2020,2020.0
58,Binghamton (America East),1,0-1,3,15,18,0.167,02/14/2020,2020.0
59,UMass Lowell (America East),1,1-0,3,19,22,0.136,02/14/2020,2020.0
60,St. Bonaventure (MAAC),1,0-1,3,24,27,0.111,02/14/2020,2020.0
1,Saint Joseph's (NEC),1,1-0,24,3,27,0.889,02/11/2020,2020.0
2,Marist (MAAC),1,1-0,15,3,18,0.833,02/11/2020,2020.0
3,Boston U. (Patriot),2,0-2,30,9,39,0.769,02/11/2020,2020.0
3,Johns Hopkins (Big Ten),1,1-0,20,6,26,0.769,02/11/2020,2020.0
5,Hofstra (CAA),1,1-0,27,9,36,0.750,02/11/2020,2020.0
6,Denver (Big East),1,1-0,17,6,23,0.739,02/11/2020,2020.0
7,Penn St. (Big Ten),2,2-0,43,16,59,0.729,02/11/2020,2020.0
8,St. John's (NY) (Big East),2,0-2,42,18,60,0.700,02/11/2020,2020.0
9,Mercer (SoCon),2,1-1,33,17,50,0.660,02/11/2020,2020.0
10,Holy Cross (Patriot),2,1-1,27,14,41,0.659,02/11/2020,2020.0
11,Duke (ACC),2,1-1,36,19,55,0.655,02/11/2020,2020.0
12,Mount St. Mary's (NEC),1,0-1,17,9,26,0.654,02/11/2020,2020.0
13,Navy (Patriot),1,1-0,11,6,17,0.647,02/11/2020,2020.0
14,Michigan (Big Ten),1,1-0,18,10,28,0.643,02/11/2020,2020.0
15,Syracuse (ACC),1,1-0,25,14,39,0.641,02/11/2020,2020.0
16,Lehigh (Patriot),1,1-0,19,11,30,0.633,02/11/2020,2020.0
17,Bucknell (Patriot),2,2-0,31,21,52,0.596,02/11/2020,2020.0
18,Loyola Maryland (Patriot),1,0-1,14,10,24,0.583,02/11/2020,2020.0
19,Quinnipiac (MAAC),2,0-2,32,23,55,0.582,02/11/2020,2020.0
20,Georgetown (Big East),1,1-0,13,10,23,0.565,02/11/2020,2020.0
21,Richmond (SoCon),1,0-1,17,14,31,0.548,02/11/2020,2020.0
22,Hobart (NEC),1,1-0,18,15,33,0.545,02/11/2020,2020.0
22,Monmouth (MAAC),1,1-0,12,10,22,0.545,02/11/2020,2020.0
24,Army West Point (Patriot),2,2-0,26,23,49,0.531,02/11/2020,2020.0
25,Hampton (DI Independent),3,0-3,46,42,88,0.523,02/11/2020,2020.0
26,Massachusetts (CAA),1,0-1,13,12,25,0.520,02/11/2020,2020.0
27,North Carolina (ACC),2,2-0,27,25,52,0.519,02/11/2020,2020.0
28,Detroit Mercy (MAAC),2,1-1,35,34,69,0.507,02/11/2020,2020.0
29,NJIT (NEC),3,1-2,40,39,79,0.506,02/11/2020,2020.0
30,Siena (MAAC),1,1-0,15,15,30,0.500,02/11/2020,2020.0
30,LIU (NEC),1,0-1,15,15,30,0.500,02/11/2020,2020.0
30,Hartford (America East),1,0-1,14,14,28,0.500,02/11/2020,2020.0
30,Sacred Heart (NEC),1,1-0,14,14,28,0.500,02/11/2020,2020.0
34,Maryland (Big Ten),2,2-0,33,35,68,0.485,02/11/2020,2020.0
35,Utah (DI Independent),2,1-1,28,31,59,0.475,02/11/2020,2020.0
36,Cleveland St. (DI Independent),2,0-2,24,27,51,0.471,02/11/2020,2020.0
37,Bryant (NEC),1,0-1,11,13,24,0.458,02/11/2020,2020.0
38,Marquette (Big East),2,2-0,21,25,46,0.457,02/11/2020,2020.0
39,Canisius (MAAC),1,0-1,15,18,33,0.455,02/11/2020,2020.0
39,Jacksonville (SoCon),1,0-1,15,18,33,0.455,02/11/2020,2020.0
41,High Point (SoCon),2,0-2,28,34,62,0.452,02/11/2020,2020.0
42,Bellarmine (SoCon),3,1-2,34,46,80,0.425,02/11/2020,2020.0
43,Virginia (ACC),1,1-0,10,14,24,0.417,02/11/2020,2020.0
44,Stony Brook (America East),1,1-0,12,17,29,0.414,02/11/2020,2020.0
45,Ohio St. (Big Ten),2,2-0,22,32,54,0.407,02/11/2020,2020.0
46,Rutgers (Big Ten),2,2-0,26,38,64,0.406,02/11/2020,2020.0
47,Colgate (Patriot),2,0-2,26,41,67,0.388,02/11/2020,2020.0
48,Furman (SoCon),2,1-1,21,34,55,0.382,02/11/2020,2020.0
49,Merrimack (NEC),1,0-1,10,18,28,0.357,02/11/2020,2020.0
50,Manhattan (MAAC),1,0-1,6,11,17,0.353,02/11/2020,2020.0
51,Delaware (CAA),1,1-0,9,17,26,0.346,02/11/2020,2020.0
52,Villanova (Big East),1,0-1,11,21,32,0.344,02/11/2020,2020.0
53,Lafayette (Patriot),2,0-2,15,35,50,0.300,02/11/2020,2020.0
54,Providence (Big East),2,2-0,10,24,34,0.294,02/11/2020,2020.0
55,Air Force (SoCon),2,1-1,15,38,53,0.283,02/11/2020,2020.0
56,Wagner (NEC),1,0-1,9,27,36,0.250,02/11/2020,2020.0
57,Towson (CAA),1,0-1,6,20,26,0.231,02/11/2020,2020.0
58,Binghamton (America East),1,0-1,3,15,18,0.167,02/11/2020,2020.0
59,UMass Lowell (America East),1,1-0,3,19,22,0.136,02/11/2020,2020.0
60,St. Bonaventure (MAAC),1,0-1,3,24,27,0.111,02/11/2020,2020.0
1,Saint Joseph's (NEC),1,1-0,24,3,27,0.889,02/10/2020,2020.0
2,Marist (MAAC),1,1-0,15,3,18,0.833,02/10/2020,2020.0
3,St. John's (NY) (Big East),1,0-1,25,6,31,0.806,02/10/2020,2020.0
4,Boston U. (Patriot),2,0-2,30,9,39,0.769,02/10/2020,2020.0
4,Johns Hopkins (Big Ten),1,1-0,20,6,26,0.769,02/10/2020,2020.0
6,Hofstra (CAA),1,1-0,27,9,36,0.750,02/10/2020,2020.0
7,Denver (Big East),1,1-0,17,6,23,0.739,02/10/2020,2020.0
8,Penn St. (Big Ten),2,2-0,43,16,59,0.729,02/10/2020,2020.0
9,Mercer (SoCon),2,1-1,33,17,50,0.660,02/10/2020,2020.0
10,Holy Cross (Patriot),2,1-1,27,14,41,0.659,02/10/2020,2020.0
11,Duke (ACC),2,1-1,36,19,55,0.655,02/10/2020,2020.0
12,Mount St. Mary's (NEC),1,0-1,17,9,26,0.654,02/10/2020,2020.0
13,Navy (Patriot),1,1-0,11,6,17,0.647,02/10/2020,2020.0
14,Michigan (Big Ten),1,1-0,18,10,28,0.643,02/10/2020,2020.0
15,Syracuse (ACC),1,1-0,25,14,39,0.641,02/10/2020,2020.0
16,Lehigh (Patriot),1,1-0,19,11,30,0.633,02/10/2020,2020.0
17,Bucknell (Patriot),2,2-0,31,21,52,0.596,02/10/2020,2020.0
18,Loyola Maryland (Patriot),1,0-1,14,10,24,0.583,02/10/2020,2020.0
19,Quinnipiac (MAAC),2,0-2,32,23,55,0.582,02/10/2020,2020.0
20,Georgetown (Big East),1,1-0,13,10,23,0.565,02/10/2020,2020.0
21,Richmond (SoCon),1,0-1,17,14,31,0.548,02/10/2020,2020.0
22,Canisius (MAAC),1,0-1,18,15,33,0.545,02/10/2020,2020.0
22,Monmouth (MAAC),1,1-0,12,10,22,0.545,02/10/2020,2020.0
24,Army West Point (Patriot),2,2-0,26,24,50,0.520,02/10/2020,2020.0
24,Massachusetts (CAA),1,0-1,13,12,25,0.520,02/10/2020,2020.0
26,North Carolina (ACC),2,2-0,27,25,52,0.519,02/10/2020,2020.0
27,NJIT (NEC),3,1-2,41,39,80,0.513,02/10/2020,2020.0
28,Detroit Mercy (MAAC),2,1-1,35,34,69,0.507,02/10/2020,2020.0
29,LIU (NEC),1,0-1,15,15,30,0.500,02/10/2020,2020.0
29,Siena (MAAC),1,1-0,15,15,30,0.500,02/10/2020,2020.0
29,Sacred Heart (NEC),1,1-0,14,14,28,0.500,02/10/2020,2020.0
29,Hartford (America East),1,0-1,14,14,28,0.500,02/10/2020,2020.0
33,Maryland (Big Ten),2,2-0,33,35,68,0.485,02/10/2020,2020.0
34,Hampton (DI Independent),2,0-2,29,31,60,0.483,02/10/2020,2020.0
35,Utah (DI Independent),2,1-1,28,31,59,0.475,02/10/2020,2020.0
36,Cleveland St. (DI Independent),2,0-2,24,27,51,0.471,02/10/2020,2020.0
37,Bryant (NEC),1,0-1,11,13,24,0.458,02/10/2020,2020.0
38,Marquette (Big East),2,2-0,21,25,46,0.457,02/10/2020,2020.0
39,Jacksonville (SoCon),1,0-1,15,18,33,0.455,02/10/2020,2020.0
39,Hobart (NEC),1,1-0,15,18,33,0.455,02/10/2020,2020.0
41,High Point (SoCon),2,0-2,28,34,62,0.452,02/10/2020,2020.0
42,Bellarmine (SoCon),2,0-2,23,29,52,0.442,02/10/2020,2020.0
43,Virginia (ACC),1,1-0,10,14,24,0.417,02/10/2020,2020.0
44,Ohio St. (Big Ten),2,2-0,22,32,54,0.407,02/10/2020,2020.0
45,Rutgers (Big Ten),2,2-0,26,38,64,0.406,02/10/2020,2020.0
46,Colgate (Patriot),2,0-2,26,41,67,0.388,02/10/2020,2020.0
47,Furman (SoCon),2,1-1,21,34,55,0.382,02/10/2020,2020.0
48,Merrimack (NEC),1,0-1,10,18,28,0.357,02/10/2020,2020.0
49,Manhattan (MAAC),1,0-1,6,11,17,0.353,02/10/2020,2020.0
50,Delaware (CAA),1,1-0,9,17,26,0.346,02/10/2020,2020.0
51,Villanova (Big East),1,0-1,11,21,32,0.344,02/10/2020,2020.0
52,Lafayette (Patriot),2,0-2,15,35,50,0.300,02/10/2020,2020.0
53,Providence (Big East),2,2-0,10,24,34,0.294,02/10/2020,2020.0
54,Air Force (SoCon),2,1-1,15,38,53,0.283,02/10/2020,2020.0
55,Wagner (NEC),1,0-1,9,27,36,0.250,02/10/2020,2020.0
56,Towson (CAA),1,0-1,6,20,26,0.231,02/10/2020,2020.0
57,Binghamton (America East),1,0-1,3,15,18,0.167,02/10/2020,2020.0
58,UMass Lowell (America East),1,1-0,3,19,22,0.136,02/10/2020,2020.0
59,St. Bonaventure (MAAC),1,0-1,3,24,27,0.111,02/10/2020,2020.0
1,Saint Joseph's (NEC),1,1-0,24,3,27,0.889,02/09/2020,2020.0
2,Marist (MAAC),1,1-0,15,3,18,0.833,02/09/2020,2020.0
3,St. John's (NY) (Big East),1,0-1,25,6,31,0.806,02/09/2020,2020.0
4,Boston U. (Patriot),2,0-2,30,9,39,0.769,02/09/2020,2020.0
4,Johns Hopkins (Big Ten),1,1-0,20,6,26,0.769,02/09/2020,2020.0
6,Hofstra (CAA),1,1-0,27,9,36,0.750,02/09/2020,2020.0
7,Denver (Big East),1,1-0,17,6,23,0.739,02/09/2020,2020.0
8,Penn St. (Big Ten),2,2-0,43,16,59,0.729,02/09/2020,2020.0
9,Mercer (SoCon),2,1-1,33,17,50,0.660,02/09/2020,2020.0
10,Holy Cross (Patriot),2,1-1,27,14,41,0.659,02/09/2020,2020.0
11,Duke (ACC),2,1-1,36,19,55,0.655,02/09/2020,2020.0
12,Mount St. Mary's (NEC),1,0-1,17,9,26,0.654,02/09/2020,2020.0
13,Navy (Patriot),1,1-0,11,6,17,0.647,02/09/2020,2020.0
14,Michigan (Big Ten),1,1-0,18,10,28,0.643,02/09/2020,2020.0
15,Syracuse (ACC),1,1-0,25,14,39,0.641,02/09/2020,2020.0
16,Bucknell (Patriot),2,2-0,31,21,52,0.596,02/09/2020,2020.0
17,Loyola Maryland (Patriot),1,0-1,14,10,24,0.583,02/09/2020,2020.0
18,Quinnipiac (MAAC),2,0-2,32,23,55,0.582,02/09/2020,2020.0
19,Lehigh (Patriot),1,1-0,17,13,30,0.567,02/09/2020,2020.0
20,Georgetown (Big East),1,1-0,13,10,23,0.565,02/09/2020,2020.0
21,Richmond (SoCon),1,0-1,17,14,31,0.548,02/09/2020,2020.0
22,NJIT (NEC),2,1-1,30,25,55,0.545,02/09/2020,2020.0
22,Canisius (MAAC),1,0-1,18,15,33,0.545,02/09/2020,2020.0
22,Monmouth (MAAC),1,1-0,12,10,22,0.545,02/09/2020,2020.0
25,Massachusetts (CAA),1,0-1,13,12,25,0.520,02/09/2020,2020.0
26,North Carolina (ACC),2,2-0,27,25,52,0.519,02/09/2020,2020.0
27,Utah (DI Independent),2,1-1,30,29,59,0.508,02/09/2020,2020.0
28,Detroit Mercy (MAAC),2,1-1,35,34,69,0.507,02/09/2020,2020.0
29,LIU (NEC),1,0-1,15,15,30,0.500,02/09/2020,2020.0
29,Siena (MAAC),1,1-0,15,15,30,0.500,02/09/2020,2020.0
29,Sacred Heart (NEC),1,1-0,14,14,28,0.500,02/09/2020,2020.0
29,Hartford (America East),1,0-1,14,14,28,0.500,02/09/2020,2020.0
33,Maryland (Big Ten),2,2-0,33,35,68,0.485,02/09/2020,2020.0
34,Hampton (DI Independent),2,0-2,29,31,60,0.483,02/09/2020,2020.0
35,Army West Point (Patriot),1,1-0,12,13,25,0.480,02/09/2020,2020.0
36,Cleveland St. (DI Independent),2,0-2,24,27,51,0.471,02/09/2020,2020.0
37,Bryant (NEC),1,0-1,11,13,24,0.458,02/09/2020,2020.0
38,Marquette (Big East),2,2-0,21,25,46,0.457,02/09/2020,2020.0
39,Hobart (NEC),1,1-0,15,18,33,0.455,02/09/2020,2020.0
39,Jacksonville (SoCon),1,0-1,15,18,33,0.455,02/09/2020,2020.0
41,High Point (SoCon),2,0-2,28,34,62,0.452,02/09/2020,2020.0
42,Bellarmine (SoCon),2,0-2,23,29,52,0.442,02/09/2020,2020.0
43,Virginia (ACC),1,1-0,10,14,24,0.417,02/09/2020,2020.0
44,Ohio St. (Big Ten),2,2-0,22,32,54,0.407,02/09/2020,2020.0
45,Rutgers (Big Ten),2,2-0,26,38,64,0.406,02/09/2020,2020.0
46,Colgate (Patriot),2,0-2,26,41,67,0.388,02/09/2020,2020.0
47,Furman (SoCon),2,1-1,21,34,55,0.382,02/09/2020,2020.0
48,Merrimack (NEC),1,0-1,10,18,28,0.357,02/09/2020,2020.0
49,Manhattan (MAAC),1,0-1,6,11,17,0.353,02/09/2020,2020.0
50,Delaware (CAA),1,1-0,9,17,26,0.346,02/09/2020,2020.0
51,Villanova (Big East),1,0-1,11,21,32,0.344,02/09/2020,2020.0
52,Lafayette (Patriot),2,0-2,15,35,50,0.300,02/09/2020,2020.0
53,Providence (Big East),2,2-0,10,24,34,0.294,02/09/2020,2020.0
54,Air Force (SoCon),2,1-1,15,38,53,0.283,02/09/2020,2020.0
55,Wagner (NEC),1,0-1,9,27,36,0.250,02/09/2020,2020.0
56,Towson (CAA),1,0-1,6,20,26,0.231,02/09/2020,2020.0
57,Binghamton (America East),1,0-1,3,15,18,0.167,02/09/2020,2020.0
58,UMass Lowell (America East),1,1-0,3,19,22,0.136,02/09/2020,2020.0
59,St. Bonaventure (MAAC),1,0-1,3,24,27,0.111,02/09/2020,2020.0
1,Penn St. (Big Ten),1,1-0,22,5,27,0.815,02/07/2020,2020.0
2,Mercer (SoCon),1,1-0,20,6,26,0.769,02/07/2020,2020.0
3,Boston U. (Patriot),1,0-1,15,6,21,0.714,02/07/2020,2020.0
4,Duke (ACC),1,0-1,21,9,30,0.700,02/07/2020,2020.0
5,Navy (Patriot),1,1-0,11,6,17,0.647,02/07/2020,2020.0
6,Holy Cross (Patriot),1,1-0,18,10,28,0.643,02/07/2020,2020.0
6,Bucknell (Patriot),1,1-0,18,10,28,0.643,02/07/2020,2020.0
8,Syracuse (ACC),1,1-0,25,14,39,0.641,02/07/2020,2020.0
9,Cleveland St. (DI Independent),1,0-1,14,9,23,0.609,02/07/2020,2020.0
10,Rutgers (Big Ten),1,1-0,20,13,33,0.606,02/07/2020,2020.0
10,NJIT (NEC),1,1-0,20,13,33,0.606,02/07/2020,2020.0
12,Utah (DI Independent),1,1-0,17,12,29,0.586,02/07/2020,2020.0
13,North Carolina (ACC),1,1-0,16,12,28,0.571,02/07/2020,2020.0
14,Ohio St. (Big Ten),1,1-0,19,17,36,0.528,02/07/2020,2020.0
15,Maryland (Big Ten),1,1-0,19,18,37,0.514,02/07/2020,2020.0
16,Detroit Mercy (MAAC),2,1-1,35,34,69,0.507,02/07/2020,2020.0
17,High Point (SoCon),1,0-1,18,19,37,0.486,02/07/2020,2020.0
18,Jacksonville (SoCon),1,0-1,15,18,33,0.455,02/07/2020,2020.0
19,Bellarmine (SoCon),1,0-1,12,17,29,0.414,02/07/2020,2020.0
20,Quinnipiac (MAAC),1,0-1,13,20,33,0.394,02/07/2020,2020.0
20,Hampton (DI Independent),1,0-1,13,20,33,0.394,02/07/2020,2020.0
22,Marquette (Big East),1,1-0,9,14,23,0.391,02/07/2020,2020.0
23,Colgate (Patriot),2,0-2,26,41,67,0.388,02/07/2020,2020.0
24,Furman (SoCon),1,0-1,10,18,28,0.357,02/07/2020,2020.0
24,Merrimack (NEC),1,0-1,10,18,28,0.357,02/07/2020,2020.0
26,Manhattan (MAAC),1,0-1,6,11,17,0.353,02/07/2020,2020.0
27,Air Force (SoCon),1,1-0,9,21,30,0.300,02/07/2020,2020.0
28,Providence (Big East),1,1-0,6,15,21,0.286,02/07/2020,2020.0
29,Lafayette (Patriot),1,0-1,5,22,27,0.185,02/07/2020,2020.0
1,Penn St. (Big Ten),1,1-0,22,5,27,0.815,02/04/2020,2020.0
2,Mercer (SoCon),1,1-0,20,6,26,0.769,02/04/2020,2020.0
3,Boston U. (Patriot),1,0-1,15,6,21,0.714,02/04/2020,2020.0
4,Duke (ACC),1,0-1,21,9,30,0.700,02/04/2020,2020.0
5,Bucknell (Patriot),1,1-0,18,10,28,0.643,02/04/2020,2020.0
5,Holy Cross (Patriot),1,1-0,18,10,28,0.643,02/04/2020,2020.0
7,Cleveland St. (DI Independent),1,0-1,14,9,23,0.609,02/04/2020,2020.0
8,NJIT (NEC),1,1-0,20,13,33,0.606,02/04/2020,2020.0
8,Rutgers (Big Ten),1,1-0,20,13,33,0.606,02/04/2020,2020.0
10,Utah (DI Independent),1,1-0,17,12,29,0.586,02/04/2020,2020.0
11,North Carolina (ACC),1,1-0,16,12,28,0.571,02/04/2020,2020.0
12,Ohio St. (Big Ten),1,1-0,19,17,36,0.528,02/04/2020,2020.0
13,Maryland (Big Ten),1,1-0,19,18,37,0.514,02/04/2020,2020.0
14,Detroit Mercy (MAAC),2,1-1,35,34,69,0.507,02/04/2020,2020.0
15,High Point (SoCon),1,0-1,18,19,37,0.486,02/04/2020,2020.0
16,Jacksonville (SoCon),1,0-1,15,18,33,0.455,02/04/2020,2020.0
17,Colgate (Patriot),1,0-1,12,16,28,0.429,02/04/2020,2020.0
18,Bellarmine (SoCon),1,0-1,12,17,29,0.414,02/04/2020,2020.0
19,Hampton (DI Independent),1,0-1,13,20,33,0.394,02/04/2020,2020.0
19,Quinnipiac (MAAC),1,0-1,13,20,33,0.394,02/04/2020,2020.0
21,Marquette (Big East),1,1-0,9,14,23,0.391,02/04/2020,2020.0
22,Furman (SoCon),1,0-1,10,18,28,0.357,02/04/2020,2020.0
22,Merrimack (NEC),1,0-1,10,18,28,0.357,02/04/2020,2020.0
24,Air Force (SoCon),1,1-0,9,21,30,0.300,02/04/2020,2020.0
25,Providence (Big East),1,1-0,6,15,21,0.286,02/04/2020,2020.0
26,Lafayette (Patriot),1,0-1,5,22,27,0.185,02/04/2020,2020.0
1,Penn St. (Big Ten),1,1-0,22,5,27,0.815,02/01/2020,2020.0
2,Mercer (SoCon),1,1-0,20,6,26,0.769,02/01/2020,2020.0
3,Boston U. (Patriot),1,0-1,15,6,21,0.714,02/01/2020,2020.0
4,Duke (ACC),1,0-1,21,9,30,0.700,02/01/2020,2020.0
5,Holy Cross (Patriot),1,1-0,18,10,28,0.643,02/01/2020,2020.0
5,Bucknell (Patriot),1,1-0,18,10,28,0.643,02/01/2020,2020.0
7,Cleveland St. (DI Independent),1,0-1,14,9,23,0.609,02/01/2020,2020.0
8,NJIT (NEC),1,1-0,20,13,33,0.606,02/01/2020,2020.0
8,Rutgers (Big Ten),1,1-0,20,13,33,0.606,02/01/2020,2020.0
10,Utah (DI Independent),1,1-0,17,12,29,0.586,02/01/2020,2020.0
11,North Carolina (ACC),1,1-0,16,12,28,0.571,02/01/2020,2020.0
12,Detroit Mercy (MAAC),1,1-0,18,15,33,0.545,02/01/2020,2020.0
13,Maryland (Big Ten),1,1-0,19,18,37,0.514,02/01/2020,2020.0
14,High Point (SoCon),1,0-1,18,19,37,0.486,02/01/2020,2020.0
15,Jacksonville (SoCon),1,0-1,15,18,33,0.455,02/01/2020,2020.0
16,Colgate (Patriot),1,0-1,12,16,28,0.429,02/01/2020,2020.0
17,Bellarmine (SoCon),1,0-1,12,17,29,0.414,02/01/2020,2020.0
18,Hampton (DI Independent),1,0-1,13,20,33,0.394,02/01/2020,2020.0
18,Quinnipiac (MAAC),1,0-1,13,20,33,0.394,02/01/2020,2020.0
20,Marquette (Big East),1,1-0,9,14,23,0.391,02/01/2020,2020.0
21,Furman (SoCon),1,0-1,10,18,28,0.357,02/01/2020,2020.0
21,Merrimack (NEC),1,0-1,10,18,28,0.357,02/01/2020,2020.0
23,Air Force (SoCon),1,1-0,9,21,30,0.300,02/01/2020,2020.0
24,Providence (Big East),1,1-0,6,15,21,0.286,02/01/2020,2020.0
25,Lafayette (Patriot),1,0-1,5,22,27,0.185,02/01/2020,2020.0
1,Lehigh (Patriot),12,10-2,248,84,332,0.747,05/31/2021-Final Statistics,2021.0
2,Quinnipiac (MAAC),7,4-3,115,44,159,0.723,05/31/2021-Final Statistics,2021.0
3,Monmouth (MAAC),11,8-3,160,77,237,0.675,05/31/2021-Final Statistics,2021.0
4,Vermont (America East),14,9-5,257,124,381,0.675,05/31/2021-Final Statistics,2021.0
5,Saint Joseph's (NEC),13,9-4,225,116,341,0.660,05/31/2021-Final Statistics,2021.0
6,Hobart (NEC),9,6-3,153,85,238,0.643,05/31/2021-Final Statistics,2021.0
7,Denver (Big East),17,12-5,299,168,467,0.640,05/31/2021-Final Statistics,2021.0
8,Hofstra (CAA),14,8-6,246,140,386,0.637,05/31/2021-Final Statistics,2021.0
9,Notre Dame (ACC),12,8-4,195,119,314,0.621,05/31/2021-Final Statistics,2021.0
10,Virginia (ACC),18,14-4,321,209,530,0.606,05/31/2021-Final Statistics,2021.0
11,Detroit Mercy (MAAC),7,3-4,92,61,153,0.601,05/31/2021-Final Statistics,2021.0
12,Mercer (SoCon),13,5-8,202,143,345,0.586,05/31/2021-Final Statistics,2021.0
13,Duke (ACC),17,14-3,273,195,468,0.583,05/31/2021-Final Statistics,2021.0
14,Bryant (NEC),13,9-4,214,153,367,0.583,05/31/2021-Final Statistics,2021.0
15,Georgetown (Big East),16,13-3,222,173,395,0.562,05/31/2021-Final Statistics,2021.0
16,Penn St. (Big Ten),11,4-7,165,129,294,0.561,05/31/2021-Final Statistics,2021.0
17,Jacksonville (SoCon),14,7-7,197,159,356,0.553,05/31/2021-Final Statistics,2021.0
18,North Carolina (ACC),16,13-3,261,223,484,0.539,05/31/2021-Final Statistics,2021.0
19,Canisius (MAAC),10,5-5,125,108,233,0.536,05/31/2021-Final Statistics,2021.0
20,Ohio St. (Big Ten),11,4-7,163,142,305,0.534,05/31/2021-Final Statistics,2021.0
21,Richmond (SoCon),13,7-6,175,154,329,0.532,05/31/2021-Final Statistics,2021.0
22,Massachusetts (CAA),10,4-6,136,120,256,0.531,05/31/2021-Final Statistics,2021.0
23,Michigan (Big Ten),12,3-9,183,163,346,0.529,05/31/2021-Final Statistics,2021.0
24,Binghamton (America East),9,5-4,104,95,199,0.523,05/31/2021-Final Statistics,2021.0
25,Johns Hopkins (Big Ten),13,4-9,180,166,346,0.520,05/31/2021-Final Statistics,2021.0
26,Syracuse (ACC),13,7-6,206,193,399,0.516,05/31/2021-Final Statistics,2021.0
27,Colgate (Patriot),10,3-7,140,133,273,0.513,05/31/2021-Final Statistics,2021.0
28,Stony Brook (America East),14,8-6,201,195,396,0.508,05/31/2021-Final Statistics,2021.0
29,Loyola Maryland (Patriot),16,10-6,204,203,407,0.501,05/31/2021-Final Statistics,2021.0
30,Delaware (CAA),13,10-3,173,173,346,0.500,05/31/2021-Final Statistics,2021.0
31,Fairfield (CAA),11,2-9,161,164,325,0.495,05/31/2021-Final Statistics,2021.0
32,Utah (DI Independent),11,4-7,136,139,275,0.495,05/31/2021-Final Statistics,2021.0
33,Providence (Big East),13,4-9,169,174,343,0.493,05/31/2021-Final Statistics,2021.0
34,Villanova (Big East),12,7-5,155,160,315,0.492,05/31/2021-Final Statistics,2021.0
35,Drexel (CAA),13,10-3,170,184,354,0.480,05/31/2021-Final Statistics,2021.0
36,Air Force (SoCon),13,4-9,150,163,313,0.479,05/31/2021-Final Statistics,2021.0
37,Cleveland St. (DI Independent),10,3-7,107,117,224,0.478,05/31/2021-Final Statistics,2021.0
38,UAlbany (America East),13,8-5,174,191,365,0.477,05/31/2021-Final Statistics,2021.0
39,Maryland (Big Ten),16,15-1,224,246,470,0.477,05/31/2021-Final Statistics,2021.0
40,UMBC (America East),11,8-3,122,138,260,0.469,05/31/2021-Final Statistics,2021.0
41,LIU (NEC),11,6-5,158,180,338,0.467,05/31/2021-Final Statistics,2021.0
42,High Point (SoCon),14,8-6,195,224,419,0.465,05/31/2021-Final Statistics,2021.0
43,Army West Point (Patriot),11,7-4,125,144,269,0.465,05/31/2021-Final Statistics,2021.0
44,Mount St. Mary's (NEC),13,4-9,154,182,336,0.458,05/31/2021-Final Statistics,2021.0
45,Navy (Patriot),9,6-3,96,121,217,0.442,05/31/2021-Final Statistics,2021.0
46,Holy Cross (Patriot),6,2-4,62,80,142,0.437,05/31/2021-Final Statistics,2021.0
47,Hartford (America East),7,2-5,76,99,175,0.434,05/31/2021-Final Statistics,2021.0
48,Bucknell (Patriot),8,2-6,92,122,214,0.430,05/31/2021-Final Statistics,2021.0
49,Boston U. (Patriot),11,6-5,113,162,275,0.411,05/31/2021-Final Statistics,2021.0
50,Lafayette (Patriot),11,0-11,121,175,296,0.409,05/31/2021-Final Statistics,2021.0
51,Robert Morris (DI Independent),13,7-6,162,238,400,0.405,05/31/2021-Final Statistics,2021.0
52,NJIT (America East),11,1-10,108,167,275,0.393,05/31/2021-Final Statistics,2021.0
53,Rutgers (Big Ten),13,9-4,148,230,378,0.392,05/31/2021-Final Statistics,2021.0
54,Sacred Heart (NEC),12,1-11,126,202,328,0.384,05/31/2021-Final Statistics,2021.0
55,Wagner (NEC),9,0-9,91,146,237,0.384,05/31/2021-Final Statistics,2021.0
56,Marquette (Big East),12,4-8,115,185,300,0.383,05/31/2021-Final Statistics,2021.0
57,UMass Lowell (America East),9,1-8,89,144,233,0.382,05/31/2021-Final Statistics,2021.0
58,St. Bonaventure (MAAC),10,5-5,80,138,218,0.367,05/31/2021-Final Statistics,2021.0
59,Towson (CAA),14,6-8,120,210,330,0.364,05/31/2021-Final Statistics,2021.0
60,Siena (MAAC),8,0-8,62,112,174,0.356,05/31/2021-Final Statistics,2021.0
61,VMI (SoCon),11,1-10,109,204,313,0.348,05/31/2021-Final Statistics,2021.0
62,Manhattan (MAAC),10,5-5,74,153,227,0.326,05/31/2021-Final Statistics,2021.0
63,St. John's (NY) (Big East),11,1-10,99,232,331,0.299,05/31/2021-Final Statistics,2021.0
64,Bellarmine (SoCon),15,5-10,98,234,332,0.295,05/31/2021-Final Statistics,2021.0
-,Merrimack (NEC),10,5-5,118,142,260,0.454,05/31/2021-Final Statistics,2021.0
1,Denver (Big East),1,0-1,23,7,30,0.767,05/15/2021 - 05/31/2021-2021 NCAA MLA Championship,2021.0
2,Lehigh (Patriot),1,0-1,16,5,21,0.762,05/15/2021 - 05/31/2021-2021 NCAA MLA Championship,2021.0
3,Notre Dame (ACC),2,1-1,35,17,52,0.673,05/15/2021 - 05/31/2021-2021 NCAA MLA Championship,2021.0
4,Duke (ACC),3,2-1,44,27,71,0.620,05/15/2021 - 05/31/2021-2021 NCAA MLA Championship,2021.0
5,Bryant (NEC),1,0-1,16,11,27,0.593,05/15/2021 - 05/31/2021-2021 NCAA MLA Championship,2021.0
6,Virginia (ACC),4,4-0,63,49,112,0.563,05/15/2021 - 05/31/2021-2021 NCAA MLA Championship,2021.0
7,North Carolina (ACC),3,2-1,39,39,78,0.500,05/15/2021 - 05/31/2021-2021 NCAA MLA Championship,2021.0
7,Syracuse (ACC),1,0-1,14,14,28,0.500,05/15/2021 - 05/31/2021-2021 NCAA MLA Championship,2021.0
9,Maryland (Big Ten),4,3-1,58,63,121,0.479,05/15/2021 - 05/31/2021-2021 NCAA MLA Championship,2021.0
10,Rutgers (Big Ten),2,1-1,20,28,48,0.417,05/15/2021 - 05/31/2021-2021 NCAA MLA Championship,2021.0
11,Georgetown (Big East),2,1-1,19,30,49,0.388,05/15/2021 - 05/31/2021-2021 NCAA MLA Championship,2021.0
12,Vermont (America East),1,0-1,12,20,32,0.375,05/15/2021 - 05/31/2021-2021 NCAA MLA Championship,2021.0
12,Monmouth (MAAC),1,0-1,9,15,24,0.375,05/15/2021 - 05/31/2021-2021 NCAA MLA Championship,2021.0
14,Drexel (CAA),1,0-1,7,15,22,0.318,05/15/2021 - 05/31/2021-2021 NCAA MLA Championship,2021.0
15,Loyola Maryland (Patriot),2,1-1,15,37,52,0.288,05/15/2021 - 05/31/2021-2021 NCAA MLA Championship,2021.0
16,High Point (SoCon),1,0-1,7,20,27,0.259,05/15/2021 - 05/31/2021-2021 NCAA MLA Championship,2021.0
1,Lehigh (Patriot),12,10-2,248,84,332,0.747,05/29/2021,2021.0
2,Quinnipiac (MAAC),7,4-3,115,44,159,0.723,05/29/2021,2021.0
3,Monmouth (MAAC),11,8-3,160,77,237,0.675,05/29/2021,2021.0
4,Vermont (America East),14,9-5,257,124,381,0.675,05/29/2021,2021.0
5,Saint Joseph's (NEC),13,9-4,225,116,341,0.660,05/29/2021,2021.0
6,Hobart (NEC),9,6-3,153,85,238,0.643,05/29/2021,2021.0
7,Denver (Big East),17,12-5,299,168,467,0.640,05/29/2021,2021.0
8,Hofstra (CAA),14,8-6,246,140,386,0.637,05/29/2021,2021.0
9,Notre Dame (ACC),12,8-4,195,119,314,0.621,05/29/2021,2021.0
10,Virginia (ACC),17,13-4,300,193,493,0.609,05/29/2021,2021.0
11,Detroit Mercy (MAAC),7,3-4,92,61,153,0.601,05/29/2021,2021.0
12,Mercer (SoCon),13,5-8,202,143,345,0.586,05/29/2021,2021.0
13,Duke (ACC),17,14-3,273,195,468,0.583,05/29/2021,2021.0
14,Bryant (NEC),13,9-4,214,153,367,0.583,05/29/2021,2021.0
15,Georgetown (Big East),16,13-3,222,173,395,0.562,05/29/2021,2021.0
16,Penn St. (Big Ten),11,4-7,165,129,294,0.561,05/29/2021,2021.0
17,Jacksonville (SoCon),14,7-7,197,159,356,0.553,05/29/2021,2021.0
18,North Carolina (ACC),16,13-3,261,223,484,0.539,05/29/2021,2021.0
19,Canisius (MAAC),10,5-5,125,108,233,0.536,05/29/2021,2021.0
20,Ohio St. (Big Ten),11,4-7,163,142,305,0.534,05/29/2021,2021.0
21,Richmond (SoCon),13,7-6,175,154,329,0.532,05/29/2021,2021.0
22,Massachusetts (CAA),10,4-6,136,120,256,0.531,05/29/2021,2021.0
23,Michigan (Big Ten),12,3-9,183,163,346,0.529,05/29/2021,2021.0
24,Binghamton (America East),9,5-4,104,95,199,0.523,05/29/2021,2021.0
25,Johns Hopkins (Big Ten),13,4-9,180,166,346,0.520,05/29/2021,2021.0
26,Syracuse (ACC),13,7-6,206,193,399,0.516,05/29/2021,2021.0
27,Colgate (Patriot),10,3-7,140,133,273,0.513,05/29/2021,2021.0
28,Stony Brook (America East),14,8-6,201,195,396,0.508,05/29/2021,2021.0
29,Loyola Maryland (Patriot),16,10-6,204,203,407,0.501,05/29/2021,2021.0
30,Delaware (CAA),13,10-3,173,173,346,0.500,05/29/2021,2021.0
31,Fairfield (CAA),11,2-9,161,164,325,0.495,05/29/2021,2021.0
32,Utah (DI Independent),11,4-7,136,139,275,0.495,05/29/2021,2021.0
33,Providence (Big East),13,4-9,169,174,343,0.493,05/29/2021,2021.0
34,Villanova (Big East),12,7-5,155,160,315,0.492,05/29/2021,2021.0
35,Maryland (Big Ten),15,15-0,208,225,433,0.480,05/29/2021,2021.0
36,Drexel (CAA),13,10-3,170,184,354,0.480,05/29/2021,2021.0
37,Air Force (SoCon),13,4-9,150,163,313,0.479,05/29/2021,2021.0
38,Cleveland St. (DI Independent),10,3-7,107,117,224,0.478,05/29/2021,2021.0
39,UAlbany (America East),13,8-5,174,191,365,0.477,05/29/2021,2021.0
40,UMBC (America East),11,8-3,122,138,260,0.469,05/29/2021,2021.0
41,LIU (NEC),11,6-5,158,180,338,0.467,05/29/2021,2021.0
42,High Point (SoCon),14,8-6,195,224,419,0.465,05/29/2021,2021.0
43,Army West Point (Patriot),11,7-4,125,144,269,0.465,05/29/2021,2021.0
44,Mount St. Mary's (NEC),13,4-9,154,182,336,0.458,05/29/2021,2021.0
45,Navy (Patriot),9,6-3,96,121,217,0.442,05/29/2021,2021.0
46,Holy Cross (Patriot),6,2-4,62,80,142,0.437,05/29/2021,2021.0
47,Hartford (America East),7,2-5,76,99,175,0.434,05/29/2021,2021.0
48,Bucknell (Patriot),8,2-6,92,122,214,0.430,05/29/2021,2021.0
49,Boston U. (Patriot),11,6-5,113,162,275,0.411,05/29/2021,2021.0
50,Lafayette (Patriot),11,0-11,121,175,296,0.409,05/29/2021,2021.0
51,Robert Morris (DI Independent),13,7-6,162,238,400,0.405,05/29/2021,2021.0
52,Marist (MAAC),4,3-1,44,65,109,0.404,05/29/2021,2021.0
53,NJIT (America East),11,1-10,108,167,275,0.393,05/29/2021,2021.0
54,Rutgers (Big Ten),13,9-4,148,230,378,0.392,05/29/2021,2021.0
55,Sacred Heart (NEC),12,1-11,126,202,328,0.384,05/29/2021,2021.0
56,Wagner (NEC),9,0-9,91,146,237,0.384,05/29/2021,2021.0
57,Marquette (Big East),12,4-8,115,185,300,0.383,05/29/2021,2021.0
58,UMass Lowell (America East),9,1-8,89,144,233,0.382,05/29/2021,2021.0
59,St. Bonaventure (MAAC),10,5-5,80,138,218,0.367,05/29/2021,2021.0
60,Towson (CAA),14,6-8,120,210,330,0.364,05/29/2021,2021.0
61,Siena (MAAC),8,0-8,62,112,174,0.356,05/29/2021,2021.0
62,VMI (SoCon),11,1-10,109,204,313,0.348,05/29/2021,2021.0
63,Manhattan (MAAC),10,5-5,74,153,227,0.326,05/29/2021,2021.0
64,St. John's (NY) (Big East),11,1-10,99,232,331,0.299,05/29/2021,2021.0
65,Bellarmine (SoCon),15,5-10,98,234,332,0.295,05/29/2021,2021.0
-,Merrimack (NEC),10,5-5,118,142,260,0.454,05/29/2021,2021.0
1,Lehigh (Patriot),12,10-2,248,84,332,0.747,05/23/2021,2021.0
2,Quinnipiac (MAAC),7,4-3,115,44,159,0.723,05/23/2021,2021.0
3,Monmouth (MAAC),11,8-3,160,77,237,0.675,05/23/2021,2021.0
4,Vermont (America East),14,9-5,257,124,381,0.675,05/23/2021,2021.0
5,Saint Joseph's (NEC),13,9-4,225,116,341,0.660,05/23/2021,2021.0
6,Hobart (NEC),9,6-3,153,85,238,0.643,05/23/2021,2021.0
7,Denver (Big East),17,12-5,299,168,467,0.640,05/23/2021,2021.0
8,Hofstra (CAA),14,8-6,246,140,386,0.637,05/23/2021,2021.0
9,Notre Dame (ACC),12,8-4,195,119,314,0.621,05/23/2021,2021.0
10,Virginia (ACC),16,12-4,285,181,466,0.612,05/23/2021,2021.0
11,Detroit Mercy (MAAC),7,3-4,92,61,153,0.601,05/23/2021,2021.0
12,Duke (ACC),16,14-2,263,183,446,0.590,05/23/2021,2021.0
13,Mercer (SoCon),13,5-8,202,143,345,0.586,05/23/2021,2021.0
14,Bryant (NEC),13,9-4,214,153,367,0.583,05/23/2021,2021.0
15,Georgetown (Big East),16,13-3,222,173,395,0.562,05/23/2021,2021.0
16,Penn St. (Big Ten),11,4-7,165,129,294,0.561,05/23/2021,2021.0
17,Jacksonville (SoCon),14,7-7,197,159,356,0.553,05/23/2021,2021.0
18,North Carolina (ACC),15,13-2,249,208,457,0.545,05/23/2021,2021.0
19,Canisius (MAAC),10,5-5,125,108,233,0.536,05/23/2021,2021.0
20,Ohio St. (Big Ten),11,4-7,163,142,305,0.534,05/23/2021,2021.0
21,Richmond (SoCon),13,7-6,175,154,329,0.532,05/23/2021,2021.0
22,Massachusetts (CAA),10,4-6,136,120,256,0.531,05/23/2021,2021.0
23,Michigan (Big Ten),12,3-9,183,163,346,0.529,05/23/2021,2021.0
24,Binghamton (America East),9,5-4,104,95,199,0.523,05/23/2021,2021.0
25,Johns Hopkins (Big Ten),13,4-9,180,166,346,0.520,05/23/2021,2021.0
26,Syracuse (ACC),13,7-6,206,193,399,0.516,05/23/2021,2021.0
27,Colgate (Patriot),10,3-7,140,133,273,0.513,05/23/2021,2021.0
28,Stony Brook (America East),14,8-6,201,195,396,0.508,05/23/2021,2021.0
29,Loyola Maryland (Patriot),16,10-6,204,203,407,0.501,05/23/2021,2021.0
30,Delaware (CAA),13,10-3,173,173,346,0.500,05/23/2021,2021.0
31,Fairfield (CAA),11,2-9,161,164,325,0.495,05/23/2021,2021.0
32,Utah (DI Independent),11,4-7,136,139,275,0.495,05/23/2021,2021.0
33,Providence (Big East),13,4-9,169,174,343,0.493,05/23/2021,2021.0
34,Villanova (Big East),12,7-5,155,160,315,0.492,05/23/2021,2021.0
35,Drexel (CAA),13,10-3,170,184,354,0.480,05/23/2021,2021.0
36,Air Force (SoCon),13,4-9,150,163,313,0.479,05/23/2021,2021.0
37,Cleveland St. (DI Independent),10,3-7,107,117,224,0.478,05/23/2021,2021.0
38,Maryland (Big Ten),14,14-0,196,215,411,0.477,05/23/2021,2021.0
39,UAlbany (America East),13,8-5,174,191,365,0.477,05/23/2021,2021.0
40,UMBC (America East),11,8-3,122,138,260,0.469,05/23/2021,2021.0
41,LIU (NEC),11,6-5,158,180,338,0.467,05/23/2021,2021.0
42,High Point (SoCon),14,8-6,195,224,419,0.465,05/23/2021,2021.0
43,Army West Point (Patriot),11,7-4,125,144,269,0.465,05/23/2021,2021.0
44,Mount St. Mary's (NEC),13,4-9,154,182,336,0.458,05/23/2021,2021.0
45,Navy (Patriot),9,6-3,96,121,217,0.442,05/23/2021,2021.0
46,Holy Cross (Patriot),6,2-4,62,80,142,0.437,05/23/2021,2021.0
47,Hartford (America East),7,2-5,76,99,175,0.434,05/23/2021,2021.0
48,Bucknell (Patriot),8,2-6,92,122,214,0.430,05/23/2021,2021.0
49,Boston U. (Patriot),11,6-5,113,162,275,0.411,05/23/2021,2021.0
50,Lafayette (Patriot),11,0-11,121,175,296,0.409,05/23/2021,2021.0
51,Robert Morris (DI Independent),13,7-6,162,238,400,0.405,05/23/2021,2021.0
52,Marist (MAAC),4,3-1,44,65,109,0.404,05/23/2021,2021.0
53,NJIT (America East),11,1-10,108,167,275,0.393,05/23/2021,2021.0
54,Rutgers (Big Ten),13,9-4,148,230,378,0.392,05/23/2021,2021.0
55,Sacred Heart (NEC),12,1-11,126,202,328,0.384,05/23/2021,2021.0
56,Wagner (NEC),9,0-9,91,146,237,0.384,05/23/2021,2021.0
57,Marquette (Big East),12,4-8,115,185,300,0.383,05/23/2021,2021.0
58,UMass Lowell (America East),9,1-8,89,144,233,0.382,05/23/2021,2021.0
59,St. Bonaventure (MAAC),10,5-5,80,138,218,0.367,05/23/2021,2021.0
60,Towson (CAA),14,6-8,120,210,330,0.364,05/23/2021,2021.0
61,Siena (MAAC),8,0-8,62,112,174,0.356,05/23/2021,2021.0
62,VMI (SoCon),11,1-10,109,204,313,0.348,05/23/2021,2021.0
63,Manhattan (MAAC),10,5-5,74,153,227,0.326,05/23/2021,2021.0
64,St. John's (NY) (Big East),11,1-10,99,232,331,0.299,05/23/2021,2021.0
65,Bellarmine (SoCon),15,5-10,98,234,332,0.295,05/23/2021,2021.0
-,Merrimack (NEC),10,5-5,118,142,260,0.454,05/23/2021,2021.0
1,Lehigh (Patriot),12,10-2,248,84,332,0.747,05/22/2021,2021.0
2,Quinnipiac (MAAC),7,4-3,115,44,159,0.723,05/22/2021,2021.0
3,Monmouth (MAAC),11,8-3,160,77,237,0.675,05/22/2021,2021.0
4,Vermont (America East),14,9-5,257,124,381,0.675,05/22/2021,2021.0
5,Saint Joseph's (NEC),13,9-4,225,116,341,0.660,05/22/2021,2021.0
6,Hobart (NEC),9,6-3,153,85,238,0.643,05/22/2021,2021.0
7,Denver (Big East),17,12-5,299,168,467,0.640,05/22/2021,2021.0
8,Hofstra (CAA),14,8-6,246,140,386,0.637,05/22/2021,2021.0
9,Notre Dame (ACC),11,8-3,175,109,284,0.616,05/22/2021,2021.0
10,Virginia (ACC),16,12-4,285,181,466,0.612,05/22/2021,2021.0
11,Detroit Mercy (MAAC),7,3-4,92,61,153,0.601,05/22/2021,2021.0
12,Duke (ACC),15,13-2,249,175,424,0.587,05/22/2021,2021.0
13,Mercer (SoCon),13,5-8,202,143,345,0.586,05/22/2021,2021.0
14,Bryant (NEC),13,9-4,214,153,367,0.583,05/22/2021,2021.0
15,Georgetown (Big East),16,13-3,222,173,395,0.562,05/22/2021,2021.0
16,Penn St. (Big Ten),11,4-7,165,129,294,0.561,05/22/2021,2021.0
17,Jacksonville (SoCon),14,7-7,197,159,356,0.553,05/22/2021,2021.0
18,North Carolina (ACC),15,13-2,249,208,457,0.545,05/22/2021,2021.0
19,Canisius (MAAC),10,5-5,125,108,233,0.536,05/22/2021,2021.0
20,Ohio St. (Big Ten),11,4-7,163,142,305,0.534,05/22/2021,2021.0
21,Richmond (SoCon),13,7-6,175,154,329,0.532,05/22/2021,2021.0
22,Massachusetts (CAA),10,4-6,136,120,256,0.531,05/22/2021,2021.0
23,Michigan (Big Ten),12,3-9,183,163,346,0.529,05/22/2021,2021.0
24,Binghamton (America East),9,5-4,104,95,199,0.523,05/22/2021,2021.0
25,Johns Hopkins (Big Ten),13,4-9,180,166,346,0.520,05/22/2021,2021.0
26,Syracuse (ACC),13,7-6,206,193,399,0.516,05/22/2021,2021.0
27,Colgate (Patriot),10,3-7,140,133,273,0.513,05/22/2021,2021.0
28,Loyola Maryland (Patriot),15,10-5,196,189,385,0.509,05/22/2021,2021.0
29,Stony Brook (America East),14,8-6,201,195,396,0.508,05/22/2021,2021.0
30,Delaware (CAA),13,10-3,173,173,346,0.500,05/22/2021,2021.0
31,Fairfield (CAA),11,2-9,161,164,325,0.495,05/22/2021,2021.0
32,Utah (DI Independent),11,4-7,136,139,275,0.495,05/22/2021,2021.0
33,Providence (Big East),13,4-9,169,174,343,0.493,05/22/2021,2021.0
34,Villanova (Big East),12,7-5,155,160,315,0.492,05/22/2021,2021.0
35,Maryland (Big Ten),13,13-0,186,195,381,0.488,05/22/2021,2021.0
36,Drexel (CAA),13,10-3,170,184,354,0.480,05/22/2021,2021.0
37,Air Force (SoCon),13,4-9,150,163,313,0.479,05/22/2021,2021.0
38,Cleveland St. (DI Independent),10,3-7,107,117,224,0.478,05/22/2021,2021.0
39,UAlbany (America East),13,8-5,174,191,365,0.477,05/22/2021,2021.0
40,UMBC (America East),11,8-3,122,138,260,0.469,05/22/2021,2021.0
41,LIU (NEC),11,6-5,158,180,338,0.467,05/22/2021,2021.0
42,High Point (SoCon),14,8-6,195,224,419,0.465,05/22/2021,2021.0
43,Army West Point (Patriot),11,7-4,125,144,269,0.465,05/22/2021,2021.0
44,Mount St. Mary's (NEC),13,4-9,154,182,336,0.458,05/22/2021,2021.0
45,Navy (Patriot),9,6-3,96,121,217,0.442,05/22/2021,2021.0
46,Holy Cross (Patriot),6,2-4,62,80,142,0.437,05/22/2021,2021.0
47,Hartford (America East),7,2-5,76,99,175,0.434,05/22/2021,2021.0
48,Bucknell (Patriot),8,2-6,92,122,214,0.430,05/22/2021,2021.0
49,Boston U. (Patriot),11,6-5,113,162,275,0.411,05/22/2021,2021.0
50,Lafayette (Patriot),11,0-11,121,175,296,0.409,05/22/2021,2021.0
51,Robert Morris (DI Independent),13,7-6,162,238,400,0.405,05/22/2021,2021.0
52,Marist (MAAC),4,3-1,44,65,109,0.404,05/22/2021,2021.0
53,NJIT (America East),11,1-10,108,167,275,0.393,05/22/2021,2021.0
54,Rutgers (Big Ten),13,9-4,148,230,378,0.392,05/22/2021,2021.0
55,Sacred Heart (NEC),12,1-11,126,202,328,0.384,05/22/2021,2021.0
56,Wagner (NEC),9,0-9,91,146,237,0.384,05/22/2021,2021.0
57,Marquette (Big East),12,4-8,115,185,300,0.383,05/22/2021,2021.0
58,UMass Lowell (America East),9,1-8,89,144,233,0.382,05/22/2021,2021.0
59,St. Bonaventure (MAAC),10,5-5,80,138,218,0.367,05/22/2021,2021.0
60,Towson (CAA),14,6-8,120,210,330,0.364,05/22/2021,2021.0
61,Siena (MAAC),8,0-8,62,112,174,0.356,05/22/2021,2021.0
62,VMI (SoCon),11,1-10,109,204,313,0.348,05/22/2021,2021.0
63,Manhattan (MAAC),10,5-5,74,153,227,0.326,05/22/2021,2021.0
64,St. John's (NY) (Big East),11,1-10,99,232,331,0.299,05/22/2021,2021.0
65,Bellarmine (SoCon),15,5-10,98,234,332,0.295,05/22/2021,2021.0
-,Merrimack (NEC),10,5-5,118,142,260,0.454,05/22/2021,2021.0
1,Lehigh (Patriot),12,10-2,248,84,332,0.747,05/16/2021,2021.0
2,Quinnipiac (MAAC),7,4-3,115,44,159,0.723,05/16/2021,2021.0
3,Monmouth (MAAC),11,8-3,160,77,237,0.675,05/16/2021,2021.0
4,Vermont (America East),14,9-5,257,124,381,0.675,05/16/2021,2021.0
5,Saint Joseph's (NEC),13,9-4,225,116,341,0.660,05/16/2021,2021.0
6,Hobart (NEC),9,6-3,153,85,238,0.643,05/16/2021,2021.0
7,Denver (Big East),17,12-5,299,168,467,0.640,05/16/2021,2021.0
8,Hofstra (CAA),14,8-6,246,140,386,0.637,05/16/2021,2021.0
9,Notre Dame (ACC),11,8-3,175,109,284,0.616,05/16/2021,2021.0
10,Virginia (ACC),15,11-4,269,176,445,0.604,05/16/2021,2021.0
11,Detroit Mercy (MAAC),7,3-4,92,61,153,0.601,05/16/2021,2021.0
12,Duke (ACC),15,13-2,249,175,424,0.587,05/16/2021,2021.0
13,Mercer (SoCon),13,5-8,202,143,345,0.586,05/16/2021,2021.0
14,Bryant (NEC),13,9-4,214,153,367,0.583,05/16/2021,2021.0
15,Georgetown (Big East),15,13-2,217,157,374,0.580,05/16/2021,2021.0
16,Penn St. (Big Ten),11,4-7,165,129,294,0.561,05/16/2021,2021.0
17,Jacksonville (SoCon),14,7-7,197,159,356,0.553,05/16/2021,2021.0
18,North Carolina (ACC),14,12-2,237,193,430,0.551,05/16/2021,2021.0
19,Canisius (MAAC),10,5-5,125,108,233,0.536,05/16/2021,2021.0
20,Ohio St. (Big Ten),11,4-7,163,142,305,0.534,05/16/2021,2021.0
21,Richmond (SoCon),13,7-6,175,154,329,0.532,05/16/2021,2021.0
22,Massachusetts (CAA),10,4-6,136,120,256,0.531,05/16/2021,2021.0
23,Michigan (Big Ten),12,3-9,183,163,346,0.529,05/16/2021,2021.0
24,Binghamton (America East),9,5-4,104,95,199,0.523,05/16/2021,2021.0
25,Johns Hopkins (Big Ten),13,4-9,180,166,346,0.520,05/16/2021,2021.0
26,Syracuse (ACC),13,7-6,206,193,399,0.516,05/16/2021,2021.0
27,Colgate (Patriot),10,3-7,140,133,273,0.513,05/16/2021,2021.0
28,Loyola Maryland (Patriot),15,10-5,196,189,385,0.509,05/16/2021,2021.0
29,Stony Brook (America East),14,8-6,201,195,396,0.508,05/16/2021,2021.0
30,Delaware (CAA),13,10-3,173,173,346,0.500,05/16/2021,2021.0
31,Fairfield (CAA),11,2-9,161,164,325,0.495,05/16/2021,2021.0
32,Utah (DI Independent),11,4-7,136,139,275,0.495,05/16/2021,2021.0
33,Providence (Big East),13,4-9,169,174,343,0.493,05/16/2021,2021.0
34,Villanova (Big East),12,7-5,155,160,315,0.492,05/16/2021,2021.0
35,Maryland (Big Ten),13,13-0,186,195,381,0.488,05/16/2021,2021.0
36,Drexel (CAA),13,10-3,170,184,354,0.480,05/16/2021,2021.0
37,Air Force (SoCon),13,4-9,150,163,313,0.479,05/16/2021,2021.0
38,Cleveland St. (DI Independent),10,3-7,107,117,224,0.478,05/16/2021,2021.0
39,UAlbany (America East),13,8-5,174,191,365,0.477,05/16/2021,2021.0
40,UMBC (America East),11,8-3,122,138,260,0.469,05/16/2021,2021.0
41,LIU (NEC),11,6-5,158,180,338,0.467,05/16/2021,2021.0
42,High Point (SoCon),14,8-6,195,224,419,0.465,05/16/2021,2021.0
43,Army West Point (Patriot),11,7-4,125,144,269,0.465,05/16/2021,2021.0
44,Mount St. Mary's (NEC),13,4-9,154,182,336,0.458,05/16/2021,2021.0
45,Navy (Patriot),9,6-3,96,121,217,0.442,05/16/2021,2021.0
46,Holy Cross (Patriot),6,2-4,62,80,142,0.437,05/16/2021,2021.0
47,Hartford (America East),7,2-5,76,99,175,0.434,05/16/2021,2021.0
48,Bucknell (Patriot),8,2-6,92,122,214,0.430,05/16/2021,2021.0
49,Boston U. (Patriot),11,6-5,113,162,275,0.411,05/16/2021,2021.0
50,Lafayette (Patriot),11,0-11,121,175,296,0.409,05/16/2021,2021.0
51,Robert Morris (DI Independent),13,7-6,162,238,400,0.405,05/16/2021,2021.0
52,Marist (MAAC),4,3-1,44,65,109,0.404,05/16/2021,2021.0
53,NJIT (America East),11,1-10,108,167,275,0.393,05/16/2021,2021.0
54,Sacred Heart (NEC),12,1-11,126,202,328,0.384,05/16/2021,2021.0
55,Wagner (NEC),9,0-9,91,146,237,0.384,05/16/2021,2021.0
56,Marquette (Big East),12,4-8,115,185,300,0.383,05/16/2021,2021.0
57,UMass Lowell (America East),9,1-8,89,144,233,0.382,05/16/2021,2021.0
58,Rutgers (Big Ten),12,9-3,133,218,351,0.379,05/16/2021,2021.0
59,St. Bonaventure (MAAC),10,5-5,80,138,218,0.367,05/16/2021,2021.0
60,Towson (CAA),14,6-8,120,210,330,0.364,05/16/2021,2021.0
61,Siena (MAAC),8,0-8,62,112,174,0.356,05/16/2021,2021.0
62,VMI (SoCon),11,1-10,109,204,313,0.348,05/16/2021,2021.0
63,Manhattan (MAAC),10,5-5,74,153,227,0.326,05/16/2021,2021.0
64,St. John's (NY) (Big East),11,1-10,99,232,331,0.299,05/16/2021,2021.0
65,Bellarmine (SoCon),15,5-10,98,234,332,0.295,05/16/2021,2021.0
-,Merrimack (NEC),10,5-5,118,142,260,0.454,05/16/2021,2021.0
1,Lehigh (Patriot),12,10-2,248,84,332,0.747,05/15/2021,2021.0
2,Quinnipiac (MAAC),7,4-3,115,44,159,0.723,05/15/2021,2021.0
3,Vermont (America East),13,9-4,245,104,349,0.702,05/15/2021,2021.0
4,Monmouth (MAAC),11,8-3,160,77,237,0.675,05/15/2021,2021.0
5,Saint Joseph's (NEC),13,9-4,225,116,341,0.660,05/15/2021,2021.0
6,Hobart (NEC),9,6-3,153,85,238,0.643,05/15/2021,2021.0
7,Hofstra (CAA),14,8-6,246,140,386,0.637,05/15/2021,2021.0
8,Denver (Big East),16,12-4,276,161,437,0.632,05/15/2021,2021.0
9,Virginia (ACC),14,10-4,258,160,418,0.617,05/15/2021,2021.0
10,Notre Dame (ACC),11,8-3,175,109,284,0.616,05/15/2021,2021.0
11,Detroit Mercy (MAAC),7,3-4,92,61,153,0.601,05/15/2021,2021.0
12,Mercer (SoCon),13,5-8,202,143,345,0.586,05/15/2021,2021.0
13,Bryant (NEC),12,9-3,198,142,340,0.582,05/15/2021,2021.0
14,Georgetown (Big East),15,13-2,217,157,374,0.580,05/15/2021,2021.0
15,Duke (ACC),14,12-2,229,168,397,0.577,05/15/2021,2021.0
16,Penn St. (Big Ten),11,4-7,165,129,294,0.561,05/15/2021,2021.0
17,Jacksonville (SoCon),14,7-7,197,159,356,0.553,05/15/2021,2021.0
18,North Carolina (ACC),14,12-2,237,193,430,0.551,05/15/2021,2021.0
19,Canisius (MAAC),10,5-5,125,108,233,0.536,05/15/2021,2021.0
20,Ohio St. (Big Ten),11,4-7,163,142,305,0.534,05/15/2021,2021.0
21,Loyola Maryland (Patriot),14,9-5,189,166,355,0.532,05/15/2021,2021.0
22,Richmond (SoCon),13,7-6,175,154,329,0.532,05/15/2021,2021.0
23,Massachusetts (CAA),10,4-6,136,120,256,0.531,05/15/2021,2021.0
24,Michigan (Big Ten),12,3-9,183,163,346,0.529,05/15/2021,2021.0
25,Binghamton (America East),9,5-4,104,95,199,0.523,05/15/2021,2021.0
26,Johns Hopkins (Big Ten),13,4-9,180,166,346,0.520,05/15/2021,2021.0
27,Syracuse (ACC),13,7-6,206,193,399,0.516,05/15/2021,2021.0
28,Colgate (Patriot),10,3-7,140,133,273,0.513,05/15/2021,2021.0
29,Stony Brook (America East),14,8-6,201,195,396,0.508,05/15/2021,2021.0
30,Delaware (CAA),13,10-3,173,173,346,0.500,05/15/2021,2021.0
31,Fairfield (CAA),11,2-9,161,164,325,0.495,05/15/2021,2021.0
32,Utah (DI Independent),11,4-7,136,139,275,0.495,05/15/2021,2021.0
33,Providence (Big East),13,4-9,169,174,343,0.493,05/15/2021,2021.0
34,Villanova (Big East),12,7-5,155,160,315,0.492,05/15/2021,2021.0
35,Drexel (CAA),13,10-3,170,184,354,0.480,05/15/2021,2021.0
36,High Point (SoCon),13,8-5,188,204,392,0.480,05/15/2021,2021.0
37,Air Force (SoCon),13,4-9,150,163,313,0.479,05/15/2021,2021.0
38,Cleveland St. (DI Independent),10,3-7,107,117,224,0.478,05/15/2021,2021.0
39,UAlbany (America East),13,8-5,174,191,365,0.477,05/15/2021,2021.0
40,Maryland (Big Ten),12,12-0,166,183,349,0.476,05/15/2021,2021.0
41,UMBC (America East),11,8-3,122,138,260,0.469,05/15/2021,2021.0
42,LIU (NEC),11,6-5,158,180,338,0.467,05/15/2021,2021.0
43,Army West Point (Patriot),11,7-4,125,144,269,0.465,05/15/2021,2021.0
44,Mount St. Mary's (NEC),13,4-9,154,182,336,0.458,05/15/2021,2021.0
45,Navy (Patriot),9,6-3,96,121,217,0.442,05/15/2021,2021.0
46,Holy Cross (Patriot),6,2-4,62,80,142,0.437,05/15/2021,2021.0
47,Hartford (America East),7,2-5,76,99,175,0.434,05/15/2021,2021.0
48,Bucknell (Patriot),8,2-6,92,122,214,0.430,05/15/2021,2021.0
49,Boston U. (Patriot),11,6-5,113,162,275,0.411,05/15/2021,2021.0
50,Lafayette (Patriot),11,0-11,121,175,296,0.409,05/15/2021,2021.0
51,Robert Morris (DI Independent),13,7-6,162,238,400,0.405,05/15/2021,2021.0
52,Marist (MAAC),4,3-1,44,65,109,0.404,05/15/2021,2021.0
53,NJIT (America East),11,1-10,108,167,275,0.393,05/15/2021,2021.0
54,Sacred Heart (NEC),12,1-11,126,202,328,0.384,05/15/2021,2021.0
55,Wagner (NEC),9,0-9,91,146,237,0.384,05/15/2021,2021.0
56,Marquette (Big East),12,4-8,115,185,300,0.383,05/15/2021,2021.0
57,UMass Lowell (America East),9,1-8,89,144,233,0.382,05/15/2021,2021.0
58,St. Bonaventure (MAAC),10,5-5,80,138,218,0.367,05/15/2021,2021.0
59,Towson (CAA),14,6-8,120,210,330,0.364,05/15/2021,2021.0
60,Siena (MAAC),8,0-8,62,112,174,0.356,05/15/2021,2021.0
61,VMI (SoCon),11,1-10,109,204,313,0.348,05/15/2021,2021.0
62,Manhattan (MAAC),10,5-5,74,153,227,0.326,05/15/2021,2021.0
63,St. John's (NY) (Big East),11,1-10,99,232,331,0.299,05/15/2021,2021.0
64,Bellarmine (SoCon),15,5-10,98,234,332,0.295,05/15/2021,2021.0
-,Merrimack (NEC),10,5-5,118,142,260,0.454,05/15/2021,2021.0
1,Lehigh (Patriot),11,10-1,232,79,311,0.746,05/08/2021,2021.0
2,Quinnipiac (MAAC),7,4-3,115,44,159,0.723,05/08/2021,2021.0
3,Monmouth (MAAC),10,8-2,151,62,213,0.709,05/08/2021,2021.0
4,Vermont (America East),13,9-4,245,104,349,0.702,05/08/2021,2021.0
5,Saint Joseph's (NEC),13,9-4,225,116,341,0.660,05/08/2021,2021.0
6,Hobart (NEC),9,6-3,153,85,238,0.643,05/08/2021,2021.0
7,Hofstra (CAA),14,8-6,246,140,386,0.637,05/08/2021,2021.0
8,Denver (Big East),16,12-4,276,161,437,0.632,05/08/2021,2021.0
9,Virginia (ACC),14,10-4,258,160,418,0.617,05/08/2021,2021.0
10,Notre Dame (ACC),10,7-3,160,102,262,0.611,05/08/2021,2021.0
11,Detroit Mercy (MAAC),7,3-4,92,61,153,0.601,05/08/2021,2021.0
12,Georgetown (Big East),14,12-2,203,143,346,0.587,05/08/2021,2021.0
13,Mercer (SoCon),13,5-8,202,143,345,0.586,05/08/2021,2021.0
14,Bryant (NEC),12,9-3,198,142,340,0.582,05/08/2021,2021.0
15,Duke (ACC),14,12-2,229,168,397,0.577,05/08/2021,2021.0
16,Penn St. (Big Ten),11,4-7,165,129,294,0.561,05/08/2021,2021.0
17,Jacksonville (SoCon),14,7-7,197,159,356,0.553,05/08/2021,2021.0
18,North Carolina (ACC),13,11-2,222,184,406,0.547,05/08/2021,2021.0
19,Canisius (MAAC),10,5-5,125,108,233,0.536,05/08/2021,2021.0
20,Ohio St. (Big Ten),11,4-7,163,142,305,0.534,05/08/2021,2021.0
21,Loyola Maryland (Patriot),14,9-5,189,166,355,0.532,05/08/2021,2021.0
22,Richmond (SoCon),13,7-6,175,154,329,0.532,05/08/2021,2021.0
23,Massachusetts (CAA),10,4-6,136,120,256,0.531,05/08/2021,2021.0
24,Michigan (Big Ten),12,3-9,183,163,346,0.529,05/08/2021,2021.0
25,Binghamton (America East),9,5-4,104,95,199,0.523,05/08/2021,2021.0
26,Johns Hopkins (Big Ten),13,4-9,180,166,346,0.520,05/08/2021,2021.0
27,Syracuse (ACC),12,7-5,192,179,371,0.518,05/08/2021,2021.0
28,Colgate (Patriot),10,3-7,140,133,273,0.513,05/08/2021,2021.0
29,Stony Brook (America East),14,8-6,201,195,396,0.508,05/08/2021,2021.0
30,Delaware (CAA),13,10-3,173,173,346,0.500,05/08/2021,2021.0
31,Fairfield (CAA),11,2-9,161,164,325,0.495,05/08/2021,2021.0
32,Utah (DI Independent),11,4-7,136,139,275,0.495,05/08/2021,2021.0
33,Providence (Big East),13,4-9,169,174,343,0.493,05/08/2021,2021.0
34,Villanova (Big East),12,7-5,155,160,315,0.492,05/08/2021,2021.0
35,Drexel (CAA),12,10-2,163,169,332,0.491,05/08/2021,2021.0
36,High Point (SoCon),13,8-5,188,204,392,0.480,05/08/2021,2021.0
37,Air Force (SoCon),13,4-9,150,163,313,0.479,05/08/2021,2021.0
38,Cleveland St. (DI Independent),10,3-7,107,117,224,0.478,05/08/2021,2021.0
39,UAlbany (America East),13,8-5,174,191,365,0.477,05/08/2021,2021.0
40,Maryland (Big Ten),12,12-0,166,183,349,0.476,05/08/2021,2021.0
41,UMBC (America East),11,8-3,122,138,260,0.469,05/08/2021,2021.0
42,LIU (NEC),11,6-5,158,180,338,0.467,05/08/2021,2021.0
43,Army West Point (Patriot),11,7-4,125,144,269,0.465,05/08/2021,2021.0
44,Mount St. Mary's (NEC),13,4-9,154,182,336,0.458,05/08/2021,2021.0
45,Navy (Patriot),9,6-3,96,121,217,0.442,05/08/2021,2021.0
46,Holy Cross (Patriot),6,2-4,62,80,142,0.437,05/08/2021,2021.0
47,Hartford (America East),7,2-5,76,99,175,0.434,05/08/2021,2021.0
48,Bucknell (Patriot),8,2-6,92,122,214,0.430,05/08/2021,2021.0
49,Boston U. (Patriot),11,6-5,113,162,275,0.411,05/08/2021,2021.0
50,Lafayette (Patriot),11,0-11,121,175,296,0.409,05/08/2021,2021.0
51,Robert Morris (DI Independent),13,7-6,162,238,400,0.405,05/08/2021,2021.0
52,Marist (MAAC),4,3-1,44,65,109,0.404,05/08/2021,2021.0
53,NJIT (America East),11,1-10,108,167,275,0.393,05/08/2021,2021.0
54,Rutgers (Big Ten),11,8-3,128,202,330,0.388,05/08/2021,2021.0
55,Sacred Heart (NEC),12,1-11,126,202,328,0.384,05/08/2021,2021.0
56,Wagner (NEC),9,0-9,91,146,237,0.384,05/08/2021,2021.0
57,Marquette (Big East),12,4-8,115,185,300,0.383,05/08/2021,2021.0
58,UMass Lowell (America East),9,1-8,89,144,233,0.382,05/08/2021,2021.0
59,St. Bonaventure (MAAC),10,5-5,80,138,218,0.367,05/08/2021,2021.0
60,Towson (CAA),14,6-8,120,210,330,0.364,05/08/2021,2021.0
61,Siena (MAAC),8,0-8,62,112,174,0.356,05/08/2021,2021.0
62,VMI (SoCon),11,1-10,109,204,313,0.348,05/08/2021,2021.0
63,Manhattan (MAAC),10,5-5,74,153,227,0.326,05/08/2021,2021.0
64,St. John's (NY) (Big East),11,1-10,99,232,331,0.299,05/08/2021,2021.0
65,Bellarmine (SoCon),15,5-10,98,234,332,0.295,05/08/2021,2021.0
-,Merrimack (NEC),10,5-5,118,142,260,0.454,05/08/2021,2021.0
1,Lehigh (Patriot),11,10-1,232,79,311,0.746,05/07/2021,2021.0
2,Quinnipiac (MAAC),7,4-3,115,44,159,0.723,05/07/2021,2021.0
3,Monmouth (MAAC),9,7-2,131,55,186,0.704,05/07/2021,2021.0
4,Vermont (America East),12,8-4,222,98,320,0.694,05/07/2021,2021.0
5,Saint Joseph's (NEC),12,9-3,212,99,311,0.682,05/07/2021,2021.0
6,Hofstra (CAA),13,8-5,231,128,359,0.643,05/07/2021,2021.0
7,Hobart (NEC),9,6-3,153,85,238,0.643,05/07/2021,2021.0
8,Denver (Big East),15,12-3,261,153,414,0.630,05/07/2021,2021.0
9,Virginia (ACC),14,10-4,258,160,418,0.617,05/07/2021,2021.0
10,Notre Dame (ACC),10,7-3,160,102,262,0.611,05/07/2021,2021.0
11,Georgetown (Big East),13,11-2,195,128,323,0.604,05/07/2021,2021.0
12,Detroit Mercy (MAAC),7,3-4,92,61,153,0.601,05/07/2021,2021.0
13,Mercer (SoCon),13,5-8,202,143,345,0.586,05/07/2021,2021.0
14,Bryant (NEC),11,8-3,181,129,310,0.584,05/07/2021,2021.0
15,Duke (ACC),14,12-2,229,168,397,0.577,05/07/2021,2021.0
16,Penn St. (Big Ten),11,4-7,165,129,294,0.561,05/07/2021,2021.0
17,Jacksonville (SoCon),14,7-7,197,159,356,0.553,05/07/2021,2021.0
18,North Carolina (ACC),13,11-2,222,184,406,0.547,05/07/2021,2021.0
19,Canisius (MAAC),10,5-5,125,108,233,0.536,05/07/2021,2021.0
20,Ohio St. (Big Ten),11,4-7,163,142,305,0.534,05/07/2021,2021.0
21,Loyola Maryland (Patriot),14,9-5,189,166,355,0.532,05/07/2021,2021.0
22,Richmond (SoCon),13,7-6,175,154,329,0.532,05/07/2021,2021.0
23,Massachusetts (CAA),10,4-6,136,120,256,0.531,05/07/2021,2021.0
24,Michigan (Big Ten),12,3-9,183,163,346,0.529,05/07/2021,2021.0
25,Binghamton (America East),9,5-4,104,95,199,0.523,05/07/2021,2021.0
26,Johns Hopkins (Big Ten),12,4-8,167,153,320,0.522,05/07/2021,2021.0
27,Syracuse (ACC),12,7-5,192,179,371,0.518,05/07/2021,2021.0
28,Colgate (Patriot),10,3-7,140,133,273,0.513,05/07/2021,2021.0
29,Stony Brook (America East),14,8-6,201,195,396,0.508,05/07/2021,2021.0
30,Delaware (CAA),13,10-3,173,173,346,0.500,05/07/2021,2021.0
30,UAlbany (America East),12,8-4,168,168,336,0.500,05/07/2021,2021.0
32,Fairfield (CAA),11,2-9,161,164,325,0.495,05/07/2021,2021.0
33,Drexel (CAA),11,9-2,151,154,305,0.495,05/07/2021,2021.0
34,Utah (DI Independent),11,4-7,136,139,275,0.495,05/07/2021,2021.0
35,Providence (Big East),13,4-9,169,174,343,0.493,05/07/2021,2021.0
36,Villanova (Big East),12,7-5,155,160,315,0.492,05/07/2021,2021.0
37,High Point (SoCon),13,8-5,188,204,392,0.480,05/07/2021,2021.0
38,Air Force (SoCon),13,4-9,150,163,313,0.479,05/07/2021,2021.0
39,Cleveland St. (DI Independent),10,3-7,107,117,224,0.478,05/07/2021,2021.0
40,Maryland (Big Ten),11,11-0,153,170,323,0.474,05/07/2021,2021.0
41,UMBC (America East),11,8-3,122,138,260,0.469,05/07/2021,2021.0
42,LIU (NEC),11,6-5,158,180,338,0.467,05/07/2021,2021.0
43,Army West Point (Patriot),11,7-4,125,144,269,0.465,05/07/2021,2021.0
44,Mount St. Mary's (NEC),13,4-9,154,182,336,0.458,05/07/2021,2021.0
45,Navy (Patriot),9,6-3,96,121,217,0.442,05/07/2021,2021.0
46,Holy Cross (Patriot),6,2-4,62,80,142,0.437,05/07/2021,2021.0
47,Hartford (America East),7,2-5,76,99,175,0.434,05/07/2021,2021.0
48,Bucknell (Patriot),8,2-6,92,122,214,0.430,05/07/2021,2021.0
49,Boston U. (Patriot),11,6-5,113,162,275,0.411,05/07/2021,2021.0
50,Lafayette (Patriot),11,0-11,121,175,296,0.409,05/07/2021,2021.0
51,Robert Morris (DI Independent),13,7-6,162,238,400,0.405,05/07/2021,2021.0
52,Marist (MAAC),4,3-1,44,65,109,0.404,05/07/2021,2021.0
53,NJIT (America East),11,1-10,108,167,275,0.393,05/07/2021,2021.0
54,Rutgers (Big Ten),11,8-3,128,202,330,0.388,05/07/2021,2021.0
55,Sacred Heart (NEC),12,1-11,126,202,328,0.384,05/07/2021,2021.0
56,Wagner (NEC),9,0-9,91,146,237,0.384,05/07/2021,2021.0
57,Marquette (Big East),12,4-8,115,185,300,0.383,05/07/2021,2021.0
58,UMass Lowell (America East),9,1-8,89,144,233,0.382,05/07/2021,2021.0
59,St. Bonaventure (MAAC),10,5-5,80,138,218,0.367,05/07/2021,2021.0
60,Towson (CAA),14,6-8,120,210,330,0.364,05/07/2021,2021.0
61,Siena (MAAC),8,0-8,62,112,174,0.356,05/07/2021,2021.0
62,VMI (SoCon),11,1-10,109,204,313,0.348,05/07/2021,2021.0
63,Manhattan (MAAC),9,5-4,67,133,200,0.335,05/07/2021,2021.0
64,St. John's (NY) (Big East),11,1-10,99,232,331,0.299,05/07/2021,2021.0
65,Bellarmine (SoCon),15,5-10,98,234,332,0.295,05/07/2021,2021.0
-,Merrimack (NEC),10,5-5,118,142,260,0.454,05/07/2021,2021.0
1,Lehigh (Patriot),10,9-1,214,71,285,0.751,05/06/2021,2021.0
2,Quinnipiac (MAAC),7,4-3,115,44,159,0.723,05/06/2021,2021.0
3,Monmouth (MAAC),9,7-2,131,55,186,0.704,05/06/2021,2021.0
4,Vermont (America East),12,8-4,222,98,320,0.694,05/06/2021,2021.0
5,Saint Joseph's (NEC),12,9-3,212,99,311,0.682,05/06/2021,2021.0
6,Hofstra (CAA),13,8-5,231,128,359,0.643,05/06/2021,2021.0
7,Hobart (NEC),9,6-3,153,85,238,0.643,05/06/2021,2021.0
8,Denver (Big East),15,12-3,261,153,414,0.630,05/06/2021,2021.0
9,Virginia (ACC),14,10-4,258,160,418,0.617,05/06/2021,2021.0
10,Notre Dame (ACC),10,7-3,160,102,262,0.611,05/06/2021,2021.0
11,Georgetown (Big East),13,11-2,195,128,323,0.604,05/06/2021,2021.0
12,Detroit Mercy (MAAC),7,3-4,92,61,153,0.601,05/06/2021,2021.0
13,Mercer (SoCon),13,5-8,202,143,345,0.586,05/06/2021,2021.0
14,Bryant (NEC),11,8-3,181,129,310,0.584,05/06/2021,2021.0
15,Duke (ACC),14,12-2,229,168,397,0.577,05/06/2021,2021.0
16,Penn St. (Big Ten),11,4-7,165,129,294,0.561,05/06/2021,2021.0
17,Richmond (SoCon),12,7-5,170,137,307,0.554,05/06/2021,2021.0
18,Jacksonville (SoCon),14,7-7,197,159,356,0.553,05/06/2021,2021.0
19,North Carolina (ACC),13,11-2,222,184,406,0.547,05/06/2021,2021.0
20,Loyola Maryland (Patriot),13,8-5,180,151,331,0.544,05/06/2021,2021.0
21,Canisius (MAAC),10,5-5,125,108,233,0.536,05/06/2021,2021.0
22,Ohio St. (Big Ten),11,4-7,163,142,305,0.534,05/06/2021,2021.0
23,Colgate (Patriot),9,3-6,132,115,247,0.534,05/06/2021,2021.0
24,Massachusetts (CAA),10,4-6,136,120,256,0.531,05/06/2021,2021.0
25,Michigan (Big Ten),12,3-9,183,163,346,0.529,05/06/2021,2021.0
26,Binghamton (America East),9,5-4,104,95,199,0.523,05/06/2021,2021.0
27,Johns Hopkins (Big Ten),12,4-8,167,153,320,0.522,05/06/2021,2021.0
28,Stony Brook (America East),14,8-6,201,195,396,0.508,05/06/2021,2021.0
29,Delaware (CAA),13,10-3,173,173,346,0.500,05/06/2021,2021.0
29,UAlbany (America East),12,8-4,168,168,336,0.500,05/06/2021,2021.0
31,Syracuse (ACC),11,6-5,166,168,334,0.497,05/06/2021,2021.0
32,Fairfield (CAA),11,2-9,161,164,325,0.495,05/06/2021,2021.0
33,Drexel (CAA),11,9-2,151,154,305,0.495,05/06/2021,2021.0
34,Utah (DI Independent),11,4-7,136,139,275,0.495,05/06/2021,2021.0
35,Providence (Big East),13,4-9,169,174,343,0.493,05/06/2021,2021.0
36,Villanova (Big East),12,7-5,155,160,315,0.492,05/06/2021,2021.0
37,Air Force (SoCon),13,4-9,150,163,313,0.479,05/06/2021,2021.0
38,Cleveland St. (DI Independent),10,3-7,107,117,224,0.478,05/06/2021,2021.0
39,Maryland (Big Ten),11,11-0,153,170,323,0.474,05/06/2021,2021.0
40,UMBC (America East),11,8-3,122,138,260,0.469,05/06/2021,2021.0
41,LIU (NEC),11,6-5,158,180,338,0.467,05/06/2021,2021.0
42,High Point (SoCon),12,7-5,171,199,370,0.462,05/06/2021,2021.0
43,Army West Point (Patriot),10,7-3,110,135,245,0.449,05/06/2021,2021.0
44,Mount St. Mary's (NEC),12,3-9,136,170,306,0.444,05/06/2021,2021.0
45,Navy (Patriot),9,6-3,96,121,217,0.442,05/06/2021,2021.0
46,Holy Cross (Patriot),6,2-4,62,80,142,0.437,05/06/2021,2021.0
47,Hartford (America East),7,2-5,76,99,175,0.434,05/06/2021,2021.0
48,Bucknell (Patriot),8,2-6,92,122,214,0.430,05/06/2021,2021.0
49,Robert Morris (DI Independent),12,7-5,151,212,363,0.416,05/06/2021,2021.0
50,Boston U. (Patriot),11,6-5,113,162,275,0.411,05/06/2021,2021.0
51,Lafayette (Patriot),11,0-11,121,175,296,0.409,05/06/2021,2021.0
52,Marist (MAAC),4,3-1,44,65,109,0.404,05/06/2021,2021.0
53,NJIT (America East),11,1-10,108,167,275,0.393,05/06/2021,2021.0
54,Rutgers (Big Ten),11,8-3,128,202,330,0.388,05/06/2021,2021.0
55,Sacred Heart (NEC),12,1-11,126,202,328,0.384,05/06/2021,2021.0
56,Marquette (Big East),12,4-8,115,185,300,0.383,05/06/2021,2021.0
57,UMass Lowell (America East),9,1-8,89,144,233,0.382,05/06/2021,2021.0
58,Wagner (NEC),8,0-8,79,128,207,0.382,05/06/2021,2021.0
59,St. Bonaventure (MAAC),10,5-5,80,138,218,0.367,05/06/2021,2021.0
60,Towson (CAA),14,6-8,120,210,330,0.364,05/06/2021,2021.0
61,Siena (MAAC),8,0-8,62,112,174,0.356,05/06/2021,2021.0
62,VMI (SoCon),11,1-10,109,204,313,0.348,05/06/2021,2021.0
63,Manhattan (MAAC),9,5-4,67,133,200,0.335,05/06/2021,2021.0
64,St. John's (NY) (Big East),11,1-10,99,232,331,0.299,05/06/2021,2021.0
65,Bellarmine (SoCon),15,5-10,98,234,332,0.295,05/06/2021,2021.0
-,Merrimack (NEC),10,5-5,118,142,260,0.454,05/06/2021,2021.0
1,Lehigh (Patriot),10,9-1,214,71,285,0.751,05/05/2021,2021.0
2,Quinnipiac (MAAC),7,4-3,115,44,159,0.723,05/05/2021,2021.0
3,Monmouth (MAAC),9,7-2,131,55,186,0.704,05/05/2021,2021.0
4,Vermont (America East),11,7-4,208,92,300,0.693,05/05/2021,2021.0
5,Saint Joseph's (NEC),12,9-3,212,99,311,0.682,05/05/2021,2021.0
6,Hofstra (CAA),12,7-5,221,115,336,0.658,05/05/2021,2021.0
7,Hobart (NEC),9,6-3,153,85,238,0.643,05/05/2021,2021.0
8,Denver (Big East),14,11-3,249,143,392,0.635,05/05/2021,2021.0
9,Virginia (ACC),14,10-4,258,160,418,0.617,05/05/2021,2021.0
10,Notre Dame (ACC),10,7-3,160,102,262,0.611,05/05/2021,2021.0
11,Georgetown (Big East),12,10-2,178,116,294,0.605,05/05/2021,2021.0
12,Detroit Mercy (MAAC),7,3-4,92,61,153,0.601,05/05/2021,2021.0
13,Mercer (SoCon),13,5-8,202,143,345,0.586,05/05/2021,2021.0
14,Bryant (NEC),11,8-3,181,129,310,0.584,05/05/2021,2021.0
15,Duke (ACC),14,12-2,229,168,397,0.577,05/05/2021,2021.0
16,Penn St. (Big Ten),11,4-7,165,129,294,0.561,05/05/2021,2021.0
17,Richmond (SoCon),12,7-5,170,137,307,0.554,05/05/2021,2021.0
18,Jacksonville (SoCon),14,7-7,197,159,356,0.553,05/05/2021,2021.0
19,North Carolina (ACC),13,11-2,222,184,406,0.547,05/05/2021,2021.0
20,Loyola Maryland (Patriot),13,8-5,180,151,331,0.544,05/05/2021,2021.0
21,Massachusetts (CAA),9,4-5,125,106,231,0.541,05/05/2021,2021.0
22,Canisius (MAAC),10,5-5,125,108,233,0.536,05/05/2021,2021.0
23,Michigan (Big Ten),11,3-8,171,148,319,0.536,05/05/2021,2021.0
24,Ohio St. (Big Ten),11,4-7,163,142,305,0.534,05/05/2021,2021.0
25,Colgate (Patriot),9,3-6,132,115,247,0.534,05/05/2021,2021.0
26,Binghamton (America East),9,5-4,104,95,199,0.523,05/05/2021,2021.0
27,Stony Brook (America East),13,8-5,195,181,376,0.519,05/05/2021,2021.0
28,Johns Hopkins (Big Ten),11,3-8,148,146,294,0.503,05/05/2021,2021.0
29,Villanova (Big East),11,7-4,143,143,286,0.500,05/05/2021,2021.0
30,Syracuse (ACC),11,6-5,166,168,334,0.497,05/05/2021,2021.0
31,Fairfield (CAA),11,2-9,161,164,325,0.495,05/05/2021,2021.0
32,Delaware (CAA),12,10-2,160,163,323,0.495,05/05/2021,2021.0
33,Providence (Big East),12,4-8,159,162,321,0.495,05/05/2021,2021.0
34,Utah (DI Independent),11,4-7,136,139,275,0.495,05/05/2021,2021.0
35,Drexel (CAA),10,8-2,137,143,280,0.489,05/05/2021,2021.0
36,UAlbany (America East),11,7-4,150,157,307,0.489,05/05/2021,2021.0
37,UMBC (America East),10,8-2,111,120,231,0.481,05/05/2021,2021.0
38,Air Force (SoCon),13,4-9,150,163,313,0.479,05/05/2021,2021.0
39,Cleveland St. (DI Independent),10,3-7,107,117,224,0.478,05/05/2021,2021.0
40,LIU (NEC),11,6-5,158,180,338,0.467,05/05/2021,2021.0
41,Maryland (Big Ten),10,10-0,138,158,296,0.466,05/05/2021,2021.0
42,High Point (SoCon),12,7-5,171,199,370,0.462,05/05/2021,2021.0
43,Army West Point (Patriot),10,7-3,110,135,245,0.449,05/05/2021,2021.0
44,Mount St. Mary's (NEC),12,3-9,136,170,306,0.444,05/05/2021,2021.0
45,Navy (Patriot),9,6-3,96,121,217,0.442,05/05/2021,2021.0
46,Holy Cross (Patriot),6,2-4,62,80,142,0.437,05/05/2021,2021.0
47,Hartford (America East),7,2-5,76,99,175,0.434,05/05/2021,2021.0
48,Bucknell (Patriot),8,2-6,92,122,214,0.430,05/05/2021,2021.0
49,Robert Morris (DI Independent),12,7-5,151,212,363,0.416,05/05/2021,2021.0
50,Boston U. (Patriot),11,6-5,113,162,275,0.411,05/05/2021,2021.0
51,Lafayette (Patriot),11,0-11,121,175,296,0.409,05/05/2021,2021.0
52,Marist (MAAC),4,3-1,44,65,109,0.404,05/05/2021,2021.0
53,Rutgers (Big Ten),10,8-2,121,183,304,0.398,05/05/2021,2021.0
54,NJIT (America East),11,1-10,108,167,275,0.393,05/05/2021,2021.0
55,Sacred Heart (NEC),12,1-11,126,202,328,0.384,05/05/2021,2021.0
56,Marquette (Big East),12,4-8,115,185,300,0.383,05/05/2021,2021.0
57,UMass Lowell (America East),9,1-8,89,144,233,0.382,05/05/2021,2021.0
58,Wagner (NEC),8,0-8,79,128,207,0.382,05/05/2021,2021.0
59,St. Bonaventure (MAAC),10,5-5,80,138,218,0.367,05/05/2021,2021.0
60,Towson (CAA),14,6-8,120,210,330,0.364,05/05/2021,2021.0
61,Siena (MAAC),8,0-8,62,112,174,0.356,05/05/2021,2021.0
62,VMI (SoCon),11,1-10,109,204,313,0.348,05/05/2021,2021.0
63,Manhattan (MAAC),9,5-4,67,133,200,0.335,05/05/2021,2021.0
64,St. John's (NY) (Big East),11,1-10,99,232,331,0.299,05/05/2021,2021.0
65,Bellarmine (SoCon),15,5-10,98,234,332,0.295,05/05/2021,2021.0
-,Merrimack (NEC),10,5-5,118,142,260,0.454,05/05/2021,2021.0
1,Lehigh (Patriot),10,9-1,214,71,285,0.751,05/04/2021,2021.0
2,Quinnipiac (MAAC),7,4-3,115,44,159,0.723,05/04/2021,2021.0
3,Vermont (America East),11,7-4,208,92,300,0.693,05/04/2021,2021.0
4,Monmouth (MAAC),8,6-2,114,51,165,0.691,05/04/2021,2021.0
5,Saint Joseph's (NEC),11,8-3,188,89,277,0.679,05/04/2021,2021.0
6,Hofstra (CAA),12,7-5,221,115,336,0.658,05/04/2021,2021.0
7,Hobart (NEC),8,6-2,137,72,209,0.656,05/04/2021,2021.0
8,Denver (Big East),14,11-3,249,143,392,0.635,05/04/2021,2021.0
9,Virginia (ACC),14,10-4,258,160,418,0.617,05/04/2021,2021.0
10,Notre Dame (ACC),10,7-3,160,102,262,0.611,05/04/2021,2021.0
11,Georgetown (Big East),12,10-2,178,116,294,0.605,05/04/2021,2021.0
12,Detroit Mercy (MAAC),7,3-4,92,61,153,0.601,05/04/2021,2021.0
13,Bryant (NEC),10,7-3,168,113,281,0.598,05/04/2021,2021.0
14,Mercer (SoCon),13,5-8,202,143,345,0.586,05/04/2021,2021.0
15,Duke (ACC),14,12-2,229,168,397,0.577,05/04/2021,2021.0
16,Penn St. (Big Ten),11,4-7,165,129,294,0.561,05/04/2021,2021.0
17,Richmond (SoCon),11,6-5,159,128,287,0.554,05/04/2021,2021.0
18,Canisius (MAAC),9,5-4,118,97,215,0.549,05/04/2021,2021.0
19,North Carolina (ACC),13,11-2,222,184,406,0.547,05/04/2021,2021.0
20,Jacksonville (SoCon),13,7-6,182,151,333,0.547,05/04/2021,2021.0
21,Loyola Maryland (Patriot),13,8-5,180,151,331,0.544,05/04/2021,2021.0
22,Massachusetts (CAA),9,4-5,125,106,231,0.541,05/04/2021,2021.0
23,Michigan (Big Ten),11,3-8,171,148,319,0.536,05/04/2021,2021.0
24,Ohio St. (Big Ten),11,4-7,163,142,305,0.534,05/04/2021,2021.0
25,Colgate (Patriot),9,3-6,132,115,247,0.534,05/04/2021,2021.0
26,Binghamton (America East),9,5-4,104,95,199,0.523,05/04/2021,2021.0
27,Stony Brook (America East),13,8-5,195,181,376,0.519,05/04/2021,2021.0
28,Johns Hopkins (Big Ten),11,3-8,148,146,294,0.503,05/04/2021,2021.0
29,Villanova (Big East),11,7-4,143,143,286,0.500,05/04/2021,2021.0
30,Syracuse (ACC),11,6-5,166,168,334,0.497,05/04/2021,2021.0
31,Fairfield (CAA),11,2-9,161,164,325,0.495,05/04/2021,2021.0
32,Delaware (CAA),12,10-2,160,163,323,0.495,05/04/2021,2021.0
33,Providence (Big East),12,4-8,159,162,321,0.495,05/04/2021,2021.0
34,Utah (DI Independent),11,4-7,136,139,275,0.495,05/04/2021,2021.0
35,Drexel (CAA),10,8-2,137,143,280,0.489,05/04/2021,2021.0
36,UAlbany (America East),11,7-4,150,157,307,0.489,05/04/2021,2021.0
37,LIU (NEC),10,6-4,148,156,304,0.487,05/04/2021,2021.0
38,Air Force (SoCon),12,4-8,141,152,293,0.481,05/04/2021,2021.0
39,UMBC (America East),10,8-2,111,120,231,0.481,05/04/2021,2021.0
40,Cleveland St. (DI Independent),10,3-7,107,117,224,0.478,05/04/2021,2021.0
41,High Point (SoCon),11,6-5,163,184,347,0.470,05/04/2021,2021.0
42,Maryland (Big Ten),10,10-0,138,158,296,0.466,05/04/2021,2021.0
43,Army West Point (Patriot),10,7-3,110,135,245,0.449,05/04/2021,2021.0
44,Mount St. Mary's (NEC),12,3-9,136,170,306,0.444,05/04/2021,2021.0
45,Navy (Patriot),9,6-3,96,121,217,0.442,05/04/2021,2021.0
46,Holy Cross (Patriot),6,2-4,62,80,142,0.437,05/04/2021,2021.0
47,Hartford (America East),7,2-5,76,99,175,0.434,05/04/2021,2021.0
48,Bucknell (Patriot),8,2-6,92,122,214,0.430,05/04/2021,2021.0
49,Robert Morris (DI Independent),12,7-5,151,212,363,0.416,05/04/2021,2021.0
50,Boston U. (Patriot),11,6-5,113,162,275,0.411,05/04/2021,2021.0
51,Lafayette (Patriot),11,0-11,121,175,296,0.409,05/04/2021,2021.0
52,Marist (MAAC),4,3-1,44,65,109,0.404,05/04/2021,2021.0
53,Rutgers (Big Ten),10,8-2,121,183,304,0.398,05/04/2021,2021.0
54,NJIT (America East),11,1-10,108,167,275,0.393,05/04/2021,2021.0
55,St. Bonaventure (MAAC),9,5-4,76,121,197,0.386,05/04/2021,2021.0
56,Sacred Heart (NEC),12,1-11,126,202,328,0.384,05/04/2021,2021.0
57,Marquette (Big East),12,4-8,115,185,300,0.383,05/04/2021,2021.0
58,UMass Lowell (America East),9,1-8,89,144,233,0.382,05/04/2021,2021.0
59,Wagner (NEC),8,0-8,79,128,207,0.382,05/04/2021,2021.0
60,Towson (CAA),14,6-8,120,210,330,0.364,05/04/2021,2021.0
61,Siena (MAAC),8,0-8,62,112,174,0.356,05/04/2021,2021.0
62,VMI (SoCon),11,1-10,109,204,313,0.348,05/04/2021,2021.0
63,Manhattan (MAAC),8,4-4,56,126,182,0.308,05/04/2021,2021.0
64,St. John's (NY) (Big East),11,1-10,99,232,331,0.299,05/04/2021,2021.0
65,Bellarmine (SoCon),15,5-10,98,234,332,0.295,05/04/2021,2021.0
-,Merrimack (NEC),10,5-5,118,142,260,0.454,05/04/2021,2021.0
1,Lehigh (Patriot),10,9-1,214,71,285,0.751,05/02/2021,2021.0
2,Quinnipiac (MAAC),7,4-3,115,44,159,0.723,05/02/2021,2021.0
3,Vermont (America East),11,7-4,208,92,300,0.693,05/02/2021,2021.0
4,Monmouth (MAAC),8,6-2,114,51,165,0.691,05/02/2021,2021.0
5,Saint Joseph's (NEC),11,8-3,188,89,277,0.679,05/02/2021,2021.0
6,Hofstra (CAA),12,7-5,221,115,336,0.658,05/02/2021,2021.0
7,Hobart (NEC),8,6-2,137,72,209,0.656,05/02/2021,2021.0
8,Denver (Big East),14,11-3,249,143,392,0.635,05/02/2021,2021.0
9,Virginia (ACC),14,10-4,258,160,418,0.617,05/02/2021,2021.0
10,Notre Dame (ACC),10,7-3,160,102,262,0.611,05/02/2021,2021.0
11,Georgetown (Big East),12,10-2,178,116,294,0.605,05/02/2021,2021.0
12,Detroit Mercy (MAAC),7,3-4,92,61,153,0.601,05/02/2021,2021.0
13,Bryant (NEC),10,7-3,168,113,281,0.598,05/02/2021,2021.0
14,Mercer (SoCon),13,5-8,202,143,345,0.586,05/02/2021,2021.0
15,Duke (ACC),14,12-2,229,168,397,0.577,05/02/2021,2021.0
16,Penn St. (Big Ten),11,4-7,165,129,294,0.561,05/02/2021,2021.0
17,Richmond (SoCon),11,6-5,159,128,287,0.554,05/02/2021,2021.0
18,Canisius (MAAC),9,5-4,118,97,215,0.549,05/02/2021,2021.0
19,North Carolina (ACC),13,11-2,222,184,406,0.547,05/02/2021,2021.0
20,Jacksonville (SoCon),13,7-6,182,151,333,0.547,05/02/2021,2021.0
21,Massachusetts (CAA),9,4-5,126,105,231,0.545,05/02/2021,2021.0
22,Michigan (Big Ten),11,3-8,171,148,319,0.536,05/02/2021,2021.0
23,Ohio St. (Big Ten),11,4-7,163,142,305,0.534,05/02/2021,2021.0
24,Loyola Maryland (Patriot),12,7-5,159,143,302,0.526,05/02/2021,2021.0
25,Binghamton (America East),9,5-4,104,95,199,0.523,05/02/2021,2021.0
26,Stony Brook (America East),13,8-5,195,181,376,0.519,05/02/2021,2021.0
27,Colgate (Patriot),8,2-6,116,109,225,0.516,05/02/2021,2021.0
28,Johns Hopkins (Big Ten),11,3-8,148,146,294,0.503,05/02/2021,2021.0
29,Villanova (Big East),11,7-4,143,143,286,0.500,05/02/2021,2021.0
30,Syracuse (ACC),11,6-5,166,168,334,0.497,05/02/2021,2021.0
31,Fairfield (CAA),11,2-9,161,164,325,0.495,05/02/2021,2021.0
32,Providence (Big East),12,4-8,159,162,321,0.495,05/02/2021,2021.0
33,Utah (DI Independent),11,4-7,136,139,275,0.495,05/02/2021,2021.0
34,Delaware (CAA),12,10-2,159,164,323,0.492,05/02/2021,2021.0
35,Drexel (CAA),10,8-2,137,143,280,0.489,05/02/2021,2021.0
36,UAlbany (America East),11,7-4,150,157,307,0.489,05/02/2021,2021.0
37,LIU (NEC),10,6-4,148,156,304,0.487,05/02/2021,2021.0
38,Air Force (SoCon),12,4-8,141,152,293,0.481,05/02/2021,2021.0
39,UMBC (America East),10,8-2,111,120,231,0.481,05/02/2021,2021.0
40,Cleveland St. (DI Independent),10,3-7,107,117,224,0.478,05/02/2021,2021.0
41,High Point (SoCon),11,6-5,163,184,347,0.470,05/02/2021,2021.0
42,Navy (Patriot),8,6-2,88,100,188,0.468,05/02/2021,2021.0
43,Maryland (Big Ten),10,10-0,138,158,296,0.466,05/02/2021,2021.0
44,Army West Point (Patriot),10,7-3,110,135,245,0.449,05/02/2021,2021.0
45,Mount St. Mary's (NEC),12,3-9,136,170,306,0.444,05/02/2021,2021.0
46,Holy Cross (Patriot),6,2-4,62,80,142,0.437,05/02/2021,2021.0
47,Hartford (America East),7,2-5,76,99,175,0.434,05/02/2021,2021.0
48,Bucknell (Patriot),8,2-6,92,122,214,0.430,05/02/2021,2021.0
49,Boston U. (Patriot),10,6-4,107,146,253,0.423,05/02/2021,2021.0
50,Robert Morris (DI Independent),12,7-5,151,212,363,0.416,05/02/2021,2021.0
51,Lafayette (Patriot),11,0-11,121,175,296,0.409,05/02/2021,2021.0
52,Marist (MAAC),4,3-1,44,65,109,0.404,05/02/2021,2021.0
53,Rutgers (Big Ten),10,8-2,121,183,304,0.398,05/02/2021,2021.0
54,NJIT (America East),11,1-10,108,167,275,0.393,05/02/2021,2021.0
55,St. Bonaventure (MAAC),9,5-4,76,121,197,0.386,05/02/2021,2021.0
56,Sacred Heart (NEC),12,1-11,126,202,328,0.384,05/02/2021,2021.0
57,Marquette (Big East),12,4-8,115,185,300,0.383,05/02/2021,2021.0
58,UMass Lowell (America East),9,1-8,89,144,233,0.382,05/02/2021,2021.0
59,Wagner (NEC),8,0-8,79,128,207,0.382,05/02/2021,2021.0
60,Towson (CAA),14,6-8,120,210,330,0.364,05/02/2021,2021.0
61,Siena (MAAC),8,0-8,62,112,174,0.356,05/02/2021,2021.0
62,VMI (SoCon),11,1-10,109,204,313,0.348,05/02/2021,2021.0
63,Manhattan (MAAC),8,4-4,56,126,182,0.308,05/02/2021,2021.0
64,St. John's (NY) (Big East),11,1-10,99,232,331,0.299,05/02/2021,2021.0
65,Bellarmine (SoCon),15,5-10,98,234,332,0.295,05/02/2021,2021.0
-,Merrimack (NEC),10,5-5,118,142,260,0.454,05/02/2021,2021.0
1,Brown (Ivy League),1,1-0,16,5,21,0.762,05/01/2021,2021.0
2,Lehigh (Patriot),10,9-1,214,71,285,0.751,05/01/2021,2021.0
3,Quinnipiac (MAAC),7,4-3,115,44,159,0.723,05/01/2021,2021.0
4,Penn (Ivy League),1,1-0,25,10,35,0.714,05/01/2021,2021.0
5,Vermont (America East),11,7-4,208,92,300,0.693,05/01/2021,2021.0
6,Monmouth (MAAC),8,6-2,114,51,165,0.691,05/01/2021,2021.0
7,Saint Joseph's (NEC),11,8-3,188,89,277,0.679,05/01/2021,2021.0
8,Hofstra (CAA),12,7-5,221,115,336,0.658,05/01/2021,2021.0
9,Hobart (NEC),8,6-2,137,72,209,0.656,05/01/2021,2021.0
10,Dartmouth (Ivy League),1,0-1,18,10,28,0.643,05/01/2021,2021.0
11,Denver (Big East),14,11-3,249,143,392,0.635,05/01/2021,2021.0
12,Virginia (ACC),14,10-4,258,160,418,0.617,05/01/2021,2021.0
13,Notre Dame (ACC),10,7-3,160,102,262,0.611,05/01/2021,2021.0
14,Georgetown (Big East),12,10-2,178,116,294,0.605,05/01/2021,2021.0
15,Detroit Mercy (MAAC),7,3-4,92,61,153,0.601,05/01/2021,2021.0
16,Bryant (NEC),10,7-3,168,113,281,0.598,05/01/2021,2021.0
17,Mercer (SoCon),13,5-8,202,143,345,0.586,05/01/2021,2021.0
18,Duke (ACC),13,12-1,214,152,366,0.585,05/01/2021,2021.0
19,Penn St. (Big Ten),11,4-7,165,129,294,0.561,05/01/2021,2021.0
20,Richmond (SoCon),11,6-5,159,128,287,0.554,05/01/2021,2021.0
21,North Carolina (ACC),12,10-2,206,169,375,0.549,05/01/2021,2021.0
22,Canisius (MAAC),9,5-4,118,97,215,0.549,05/01/2021,2021.0
23,Jacksonville (SoCon),13,7-6,182,151,333,0.547,05/01/2021,2021.0
24,Massachusetts (CAA),9,4-5,126,105,231,0.545,05/01/2021,2021.0
25,Michigan (Big Ten),11,3-8,171,148,319,0.536,05/01/2021,2021.0
26,Ohio St. (Big Ten),11,4-7,163,142,305,0.534,05/01/2021,2021.0
27,Loyola Maryland (Patriot),12,7-5,159,143,302,0.526,05/01/2021,2021.0
28,Stony Brook (America East),13,8-5,195,181,376,0.519,05/01/2021,2021.0
29,Binghamton (America East),8,4-4,92,86,178,0.517,05/01/2021,2021.0
30,Colgate (Patriot),8,2-6,116,109,225,0.516,05/01/2021,2021.0
31,Johns Hopkins (Big Ten),11,3-8,148,146,294,0.503,05/01/2021,2021.0
32,Villanova (Big East),11,7-4,143,143,286,0.500,05/01/2021,2021.0
33,Syracuse (ACC),11,6-5,166,168,334,0.497,05/01/2021,2021.0
34,Fairfield (CAA),11,2-9,161,164,325,0.495,05/01/2021,2021.0
35,Providence (Big East),12,4-8,159,162,321,0.495,05/01/2021,2021.0
36,Utah (DI Independent),11,4-7,136,139,275,0.495,05/01/2021,2021.0
37,Delaware (CAA),12,10-2,159,164,323,0.492,05/01/2021,2021.0
38,Drexel (CAA),10,8-2,137,143,280,0.489,05/01/2021,2021.0
39,UAlbany (America East),11,7-4,150,157,307,0.489,05/01/2021,2021.0
40,LIU (NEC),10,6-4,148,156,304,0.487,05/01/2021,2021.0
41,Air Force (SoCon),12,4-8,141,152,293,0.481,05/01/2021,2021.0
42,UMBC (America East),10,8-2,111,120,231,0.481,05/01/2021,2021.0
43,Cleveland St. (DI Independent),10,3-7,107,117,224,0.478,05/01/2021,2021.0
44,High Point (SoCon),11,6-5,163,184,347,0.470,05/01/2021,2021.0
45,Navy (Patriot),8,6-2,88,100,188,0.468,05/01/2021,2021.0
46,Maryland (Big Ten),10,10-0,138,158,296,0.466,05/01/2021,2021.0
47,Army West Point (Patriot),10,7-3,110,135,245,0.449,05/01/2021,2021.0
48,Mount St. Mary's (NEC),12,3-9,136,170,306,0.444,05/01/2021,2021.0
49,Holy Cross (Patriot),6,2-4,62,80,142,0.437,05/01/2021,2021.0
50,Hartford (America East),7,2-5,76,99,175,0.434,05/01/2021,2021.0
51,Bucknell (Patriot),8,2-6,92,122,214,0.430,05/01/2021,2021.0
52,Boston U. (Patriot),10,6-4,107,146,253,0.423,05/01/2021,2021.0
53,Robert Morris (DI Independent),12,7-5,151,212,363,0.416,05/01/2021,2021.0
54,Lafayette (Patriot),11,0-11,121,175,296,0.409,05/01/2021,2021.0
55,Marist (MAAC),4,3-1,44,65,109,0.404,05/01/2021,2021.0
56,Rutgers (Big Ten),10,8-2,121,183,304,0.398,05/01/2021,2021.0
57,NJIT (America East),11,1-10,108,167,275,0.393,05/01/2021,2021.0
58,St. Bonaventure (MAAC),9,5-4,76,121,197,0.386,05/01/2021,2021.0
59,Sacred Heart (NEC),12,1-11,126,202,328,0.384,05/01/2021,2021.0
60,Marquette (Big East),12,4-8,115,185,300,0.383,05/01/2021,2021.0
61,Wagner (NEC),8,0-8,79,128,207,0.382,05/01/2021,2021.0
62,UMass Lowell (America East),8,1-7,80,132,212,0.377,05/01/2021,2021.0
63,Towson (CAA),14,6-8,120,210,330,0.364,05/01/2021,2021.0
64,Siena (MAAC),8,0-8,62,112,174,0.356,05/01/2021,2021.0
65,VMI (SoCon),11,1-10,109,204,313,0.348,05/01/2021,2021.0
66,Manhattan (MAAC),8,4-4,56,126,182,0.308,05/01/2021,2021.0
67,St. John's (NY) (Big East),11,1-10,99,232,331,0.299,05/01/2021,2021.0
68,Bellarmine (SoCon),15,5-10,98,234,332,0.295,05/01/2021,2021.0
-,Merrimack (NEC),10,5-5,118,142,260,0.454,05/01/2021,2021.0
1,Brown (Ivy League),1,1-0,16,5,21,0.762,04/30/2021,2021.0
2,Lehigh (Patriot),9,9-0,193,66,259,0.745,04/30/2021,2021.0
3,Quinnipiac (MAAC),7,4-3,115,44,159,0.723,04/30/2021,2021.0
4,Penn (Ivy League),1,1-0,25,10,35,0.714,04/30/2021,2021.0
5,Monmouth (MAAC),8,6-2,114,51,165,0.691,04/30/2021,2021.0
6,Vermont (America East),10,6-4,186,85,271,0.686,04/30/2021,2021.0
7,Saint Joseph's (NEC),11,8-3,188,89,277,0.679,04/30/2021,2021.0
8,Hofstra (CAA),12,7-5,221,115,336,0.658,04/30/2021,2021.0
9,Dartmouth (Ivy League),1,0-1,18,10,28,0.643,04/30/2021,2021.0
10,Hobart (NEC),7,5-2,114,65,179,0.637,04/30/2021,2021.0
11,Denver (Big East),14,11-3,249,143,392,0.635,04/30/2021,2021.0
12,Virginia (ACC),14,10-4,258,160,418,0.617,04/30/2021,2021.0
13,Notre Dame (ACC),9,6-3,140,90,230,0.609,04/30/2021,2021.0
14,Georgetown (Big East),12,10-2,178,116,294,0.605,04/30/2021,2021.0
15,Detroit Mercy (MAAC),7,3-4,92,61,153,0.601,04/30/2021,2021.0
16,Bryant (NEC),10,7-3,168,113,281,0.598,04/30/2021,2021.0
17,Duke (ACC),13,12-1,214,152,366,0.585,04/30/2021,2021.0
18,Richmond (SoCon),10,6-4,150,116,266,0.564,04/30/2021,2021.0
19,Mercer (SoCon),12,5-7,182,141,323,0.563,04/30/2021,2021.0
20,Penn St. (Big Ten),10,4-6,148,120,268,0.552,04/30/2021,2021.0
21,North Carolina (ACC),12,10-2,206,169,375,0.549,04/30/2021,2021.0
22,Canisius (MAAC),9,5-4,118,97,215,0.549,04/30/2021,2021.0
23,Jacksonville (SoCon),12,7-5,166,137,303,0.548,04/30/2021,2021.0
24,Massachusetts (CAA),9,4-5,126,105,231,0.545,04/30/2021,2021.0
25,Michigan (Big Ten),10,2-8,158,132,290,0.545,04/30/2021,2021.0
26,Stony Brook (America East),12,8-4,188,159,347,0.542,04/30/2021,2021.0
27,Ohio St. (Big Ten),10,4-6,147,129,276,0.533,04/30/2021,2021.0
28,Villanova (Big East),10,6-4,138,122,260,0.531,04/30/2021,2021.0
29,Loyola Maryland (Patriot),12,7-5,159,143,302,0.526,04/30/2021,2021.0
30,Johns Hopkins (Big Ten),10,2-8,139,129,268,0.519,04/30/2021,2021.0
31,Binghamton (America East),8,4-4,92,86,178,0.517,04/30/2021,2021.0
32,Colgate (Patriot),8,2-6,116,109,225,0.516,04/30/2021,2021.0
33,Syracuse (ACC),10,6-4,154,148,302,0.510,04/30/2021,2021.0
34,Utah (DI Independent),10,4-6,124,120,244,0.508,04/30/2021,2021.0
35,Fairfield (CAA),11,2-9,161,164,325,0.495,04/30/2021,2021.0
36,Providence (Big East),12,4-8,159,162,321,0.495,04/30/2021,2021.0
37,Delaware (CAA),12,10-2,159,164,323,0.492,04/30/2021,2021.0
38,UAlbany (America East),11,7-4,150,157,307,0.489,04/30/2021,2021.0
39,LIU (NEC),10,6-4,148,156,304,0.487,04/30/2021,2021.0
40,Drexel (CAA),9,7-2,123,130,253,0.486,04/30/2021,2021.0
41,Air Force (SoCon),11,3-8,129,143,272,0.474,04/30/2021,2021.0
42,UMBC (America East),9,7-2,98,109,207,0.473,04/30/2021,2021.0
43,High Point (SoCon),10,5-5,149,168,317,0.470,04/30/2021,2021.0
44,Maryland (Big Ten),10,10-0,138,158,296,0.466,04/30/2021,2021.0
45,Navy (Patriot),7,5-2,73,89,162,0.451,04/30/2021,2021.0
46,Army West Point (Patriot),10,7-3,110,135,245,0.449,04/30/2021,2021.0
47,Cleveland St. (DI Independent),9,2-7,87,108,195,0.446,04/30/2021,2021.0
48,Mount St. Mary's (NEC),12,3-9,136,170,306,0.444,04/30/2021,2021.0
49,Holy Cross (Patriot),6,2-4,62,80,142,0.437,04/30/2021,2021.0
50,Hartford (America East),7,2-5,76,99,175,0.434,04/30/2021,2021.0
51,Bucknell (Patriot),8,2-6,92,122,214,0.430,04/30/2021,2021.0
52,Boston U. (Patriot),10,6-4,107,146,253,0.423,04/30/2021,2021.0
53,Lafayette (Patriot),10,0-10,110,160,270,0.407,04/30/2021,2021.0
54,Marist (MAAC),4,3-1,44,65,109,0.404,04/30/2021,2021.0
55,Sacred Heart (NEC),11,1-10,119,179,298,0.399,04/30/2021,2021.0
56,Rutgers (Big Ten),10,8-2,121,183,304,0.398,04/30/2021,2021.0
57,Robert Morris (DI Independent),11,6-5,132,200,332,0.398,04/30/2021,2021.0
58,NJIT (America East),10,1-9,97,154,251,0.386,04/30/2021,2021.0
59,St. Bonaventure (MAAC),9,5-4,76,121,197,0.386,04/30/2021,2021.0
60,Marquette (Big East),12,4-8,115,185,300,0.383,04/30/2021,2021.0
61,Wagner (NEC),8,0-8,79,128,207,0.382,04/30/2021,2021.0
62,UMass Lowell (America East),8,1-7,80,132,212,0.377,04/30/2021,2021.0
63,Siena (MAAC),8,0-8,62,112,174,0.356,04/30/2021,2021.0
64,Towson (CAA),13,6-7,107,196,303,0.353,04/30/2021,2021.0
65,VMI (SoCon),10,1-9,100,184,284,0.352,04/30/2021,2021.0
66,Bellarmine (SoCon),14,4-10,96,214,310,0.310,04/30/2021,2021.0
67,Manhattan (MAAC),8,4-4,56,126,182,0.308,04/30/2021,2021.0
68,St. John's (NY) (Big East),11,1-10,99,232,331,0.299,04/30/2021,2021.0
-,Merrimack (NEC),10,5-5,118,142,260,0.454,04/30/2021,2021.0
1,Brown (Ivy League),1,1-0,16,5,21,0.762,04/29/2021,2021.0
2,Lehigh (Patriot),9,9-0,193,66,259,0.745,04/29/2021,2021.0
3,Quinnipiac (MAAC),7,4-3,115,44,159,0.723,04/29/2021,2021.0
4,Penn (Ivy League),1,1-0,25,10,35,0.714,04/29/2021,2021.0
5,Saint Joseph's (NEC),10,7-3,175,77,252,0.694,04/29/2021,2021.0
6,Vermont (America East),10,6-4,186,85,271,0.686,04/29/2021,2021.0
7,Monmouth (MAAC),7,5-2,96,44,140,0.686,04/29/2021,2021.0
8,Hofstra (CAA),11,6-5,199,102,301,0.661,04/29/2021,2021.0
9,Dartmouth (Ivy League),1,0-1,18,10,28,0.643,04/29/2021,2021.0
10,Hobart (NEC),7,5-2,114,65,179,0.637,04/29/2021,2021.0
11,Denver (Big East),14,11-3,249,143,392,0.635,04/29/2021,2021.0
12,Detroit Mercy (MAAC),6,3-3,82,49,131,0.626,04/29/2021,2021.0
13,Virginia (ACC),14,10-4,258,160,418,0.617,04/29/2021,2021.0
14,Notre Dame (ACC),9,6-3,140,90,230,0.609,04/29/2021,2021.0
15,Georgetown (Big East),12,10-2,178,116,294,0.605,04/29/2021,2021.0
16,Bryant (NEC),10,7-3,168,113,281,0.598,04/29/2021,2021.0
17,Duke (ACC),13,12-1,214,152,366,0.585,04/29/2021,2021.0
18,Richmond (SoCon),10,6-4,150,116,266,0.564,04/29/2021,2021.0
19,Mercer (SoCon),12,5-7,182,141,323,0.563,04/29/2021,2021.0
20,Penn St. (Big Ten),10,4-6,148,120,268,0.552,04/29/2021,2021.0
21,North Carolina (ACC),12,10-2,206,169,375,0.549,04/29/2021,2021.0
22,Jacksonville (SoCon),12,7-5,166,137,303,0.548,04/29/2021,2021.0
23,Michigan (Big Ten),10,2-8,158,132,290,0.545,04/29/2021,2021.0
24,Stony Brook (America East),12,8-4,188,159,347,0.542,04/29/2021,2021.0
25,Massachusetts (CAA),8,4-4,115,99,214,0.537,04/29/2021,2021.0
26,Ohio St. (Big Ten),10,4-6,147,129,276,0.533,04/29/2021,2021.0
27,Villanova (Big East),10,6-4,138,122,260,0.531,04/29/2021,2021.0
28,Canisius (MAAC),8,4-4,98,87,185,0.530,04/29/2021,2021.0
29,Loyola Maryland (Patriot),12,7-5,159,143,302,0.526,04/29/2021,2021.0
30,Colgate (Patriot),7,2-5,103,94,197,0.523,04/29/2021,2021.0
31,Johns Hopkins (Big Ten),10,2-8,139,129,268,0.519,04/29/2021,2021.0
32,Binghamton (America East),8,4-4,92,86,178,0.517,04/29/2021,2021.0
33,Fairfield (CAA),10,2-8,148,142,290,0.510,04/29/2021,2021.0
34,Syracuse (ACC),10,6-4,154,148,302,0.510,04/29/2021,2021.0
35,Utah (DI Independent),10,4-6,124,120,244,0.508,04/29/2021,2021.0
36,Delaware (CAA),11,9-2,153,153,306,0.500,04/29/2021,2021.0
37,Providence (Big East),12,4-8,159,162,321,0.495,04/29/2021,2021.0
38,UAlbany (America East),11,7-4,150,157,307,0.489,04/29/2021,2021.0
39,LIU (NEC),10,6-4,148,156,304,0.487,04/29/2021,2021.0
40,Drexel (CAA),9,7-2,123,130,253,0.486,04/29/2021,2021.0
41,Air Force (SoCon),11,3-8,129,143,272,0.474,04/29/2021,2021.0
42,UMBC (America East),9,7-2,98,109,207,0.473,04/29/2021,2021.0
43,High Point (SoCon),10,5-5,149,168,317,0.470,04/29/2021,2021.0
44,Maryland (Big Ten),10,10-0,138,158,296,0.466,04/29/2021,2021.0
45,Navy (Patriot),7,5-2,73,89,162,0.451,04/29/2021,2021.0
46,Cleveland St. (DI Independent),9,2-7,87,108,195,0.446,04/29/2021,2021.0
47,Mount St. Mary's (NEC),12,3-9,136,170,306,0.444,04/29/2021,2021.0
48,Army West Point (Patriot),9,6-3,95,122,217,0.438,04/29/2021,2021.0
49,Holy Cross (Patriot),6,2-4,62,80,142,0.437,04/29/2021,2021.0
50,Hartford (America East),7,2-5,76,99,175,0.434,04/29/2021,2021.0
51,Marist (MAAC),3,3-0,34,45,79,0.430,04/29/2021,2021.0
52,Bucknell (Patriot),8,2-6,92,122,214,0.430,04/29/2021,2021.0
53,Boston U. (Patriot),10,6-4,107,146,253,0.423,04/29/2021,2021.0
54,Lafayette (Patriot),10,0-10,110,160,270,0.407,04/29/2021,2021.0
55,Sacred Heart (NEC),11,1-10,119,179,298,0.399,04/29/2021,2021.0
56,Rutgers (Big Ten),10,8-2,121,183,304,0.398,04/29/2021,2021.0
57,Robert Morris (DI Independent),11,6-5,132,200,332,0.398,04/29/2021,2021.0
58,NJIT (America East),10,1-9,97,154,251,0.386,04/29/2021,2021.0
59,UMass Lowell (America East),8,1-7,80,132,212,0.377,04/29/2021,2021.0
60,Marquette (Big East),11,3-8,99,168,267,0.371,04/29/2021,2021.0
61,Siena (MAAC),7,0-7,55,94,149,0.369,04/29/2021,2021.0
62,Wagner (NEC),7,0-7,67,115,182,0.368,04/29/2021,2021.0
63,St. Bonaventure (MAAC),8,4-4,64,111,175,0.366,04/29/2021,2021.0
64,Towson (CAA),13,6-7,107,196,303,0.353,04/29/2021,2021.0
65,VMI (SoCon),10,1-9,100,184,284,0.352,04/29/2021,2021.0
66,Bellarmine (SoCon),14,4-10,96,214,310,0.310,04/29/2021,2021.0
67,Manhattan (MAAC),8,4-4,56,126,182,0.308,04/29/2021,2021.0
68,St. John's (NY) (Big East),10,1-9,82,216,298,0.275,04/29/2021,2021.0
-,Merrimack (NEC),10,5-5,118,142,260,0.454,04/29/2021,2021.0
1,Brown (Ivy League),1,1-0,16,5,21,0.762,04/28/2021,2021.0
2,Lehigh (Patriot),9,9-0,193,66,259,0.745,04/28/2021,2021.0
3,Quinnipiac (MAAC),7,4-3,115,44,159,0.723,04/28/2021,2021.0
4,Penn (Ivy League),1,1-0,25,10,35,0.714,04/28/2021,2021.0
5,Saint Joseph's (NEC),10,7-3,175,77,252,0.694,04/28/2021,2021.0
6,Vermont (America East),10,6-4,186,85,271,0.686,04/28/2021,2021.0
7,Monmouth (MAAC),7,5-2,96,44,140,0.686,04/28/2021,2021.0
8,Hofstra (CAA),11,6-5,199,102,301,0.661,04/28/2021,2021.0
9,Dartmouth (Ivy League),1,0-1,18,10,28,0.643,04/28/2021,2021.0
10,Hobart (NEC),7,5-2,114,65,179,0.637,04/28/2021,2021.0
11,Denver (Big East),14,11-3,249,143,392,0.635,04/28/2021,2021.0
12,Detroit Mercy (MAAC),6,3-3,82,49,131,0.626,04/28/2021,2021.0
13,Virginia (ACC),14,10-4,258,160,418,0.617,04/28/2021,2021.0
14,Georgetown (Big East),11,10-1,166,104,270,0.615,04/28/2021,2021.0
15,Notre Dame (ACC),9,6-3,140,90,230,0.609,04/28/2021,2021.0
16,Bryant (NEC),10,7-3,168,113,281,0.598,04/28/2021,2021.0
17,Duke (ACC),13,12-1,214,152,366,0.585,04/28/2021,2021.0
18,Richmond (SoCon),10,6-4,150,116,266,0.564,04/28/2021,2021.0
19,Mercer (SoCon),12,5-7,182,141,323,0.563,04/28/2021,2021.0
20,Penn St. (Big Ten),10,4-6,148,120,268,0.552,04/28/2021,2021.0
21,North Carolina (ACC),12,10-2,206,169,375,0.549,04/28/2021,2021.0
22,Jacksonville (SoCon),12,7-5,166,137,303,0.548,04/28/2021,2021.0
23,Michigan (Big Ten),10,2-8,158,132,290,0.545,04/28/2021,2021.0
24,Stony Brook (America East),12,8-4,188,159,347,0.542,04/28/2021,2021.0
25,Massachusetts (CAA),8,4-4,115,99,214,0.537,04/28/2021,2021.0
26,Ohio St. (Big Ten),10,4-6,147,129,276,0.533,04/28/2021,2021.0
27,Villanova (Big East),10,6-4,138,122,260,0.531,04/28/2021,2021.0
28,Canisius (MAAC),8,4-4,98,87,185,0.530,04/28/2021,2021.0
29,Loyola Maryland (Patriot),11,6-5,147,131,278,0.529,04/28/2021,2021.0
30,Colgate (Patriot),7,2-5,103,94,197,0.523,04/28/2021,2021.0
31,Johns Hopkins (Big Ten),10,2-8,139,129,268,0.519,04/28/2021,2021.0
32,Binghamton (America East),8,4-4,92,86,178,0.517,04/28/2021,2021.0
33,Fairfield (CAA),10,2-8,148,142,290,0.510,04/28/2021,2021.0
34,Syracuse (ACC),10,6-4,154,148,302,0.510,04/28/2021,2021.0
35,Utah (DI Independent),10,4-6,124,120,244,0.508,04/28/2021,2021.0
36,Delaware (CAA),11,9-2,153,153,306,0.500,04/28/2021,2021.0
37,Providence (Big East),12,4-8,159,162,321,0.495,04/28/2021,2021.0
38,UAlbany (America East),11,7-4,150,157,307,0.489,04/28/2021,2021.0
39,LIU (NEC),10,6-4,148,156,304,0.487,04/28/2021,2021.0
40,Drexel (CAA),9,7-2,123,130,253,0.486,04/28/2021,2021.0
41,Air Force (SoCon),11,3-8,129,143,272,0.474,04/28/2021,2021.0
42,UMBC (America East),9,7-2,98,109,207,0.473,04/28/2021,2021.0
43,High Point (SoCon),10,5-5,149,168,317,0.470,04/28/2021,2021.0
44,Maryland (Big Ten),10,10-0,138,158,296,0.466,04/28/2021,2021.0
45,Navy (Patriot),7,5-2,73,89,162,0.451,04/28/2021,2021.0
46,Cleveland St. (DI Independent),9,2-7,87,108,195,0.446,04/28/2021,2021.0
47,Mount St. Mary's (NEC),12,3-9,136,170,306,0.444,04/28/2021,2021.0
48,Army West Point (Patriot),9,6-3,95,122,217,0.438,04/28/2021,2021.0
49,Holy Cross (Patriot),6,2-4,62,80,142,0.437,04/28/2021,2021.0
50,Hartford (America East),7,2-5,76,99,175,0.434,04/28/2021,2021.0
51,Marist (MAAC),3,3-0,34,45,79,0.430,04/28/2021,2021.0
52,Bucknell (Patriot),8,2-6,92,122,214,0.430,04/28/2021,2021.0
53,Boston U. (Patriot),10,6-4,107,146,253,0.423,04/28/2021,2021.0
54,Lafayette (Patriot),10,0-10,110,160,270,0.407,04/28/2021,2021.0
55,Sacred Heart (NEC),11,1-10,119,179,298,0.399,04/28/2021,2021.0
56,Rutgers (Big Ten),10,8-2,121,183,304,0.398,04/28/2021,2021.0
57,Robert Morris (DI Independent),11,6-5,132,200,332,0.398,04/28/2021,2021.0
58,NJIT (America East),10,1-9,97,154,251,0.386,04/28/2021,2021.0
59,UMass Lowell (America East),8,1-7,80,132,212,0.377,04/28/2021,2021.0
60,Marquette (Big East),11,3-8,99,168,267,0.371,04/28/2021,2021.0
61,Siena (MAAC),7,0-7,55,94,149,0.369,04/28/2021,2021.0
62,Wagner (NEC),7,0-7,67,115,182,0.368,04/28/2021,2021.0
63,St. Bonaventure (MAAC),8,4-4,64,111,175,0.366,04/28/2021,2021.0
64,Towson (CAA),13,6-7,107,196,303,0.353,04/28/2021,2021.0
65,VMI (SoCon),10,1-9,100,184,284,0.352,04/28/2021,2021.0
66,Bellarmine (SoCon),14,4-10,96,214,310,0.310,04/28/2021,2021.0
67,Manhattan (MAAC),8,4-4,56,126,182,0.308,04/28/2021,2021.0
68,St. John's (NY) (Big East),10,1-9,82,216,298,0.275,04/28/2021,2021.0
-,Merrimack (NEC),10,5-5,118,142,260,0.454,04/28/2021,2021.0
1,Lehigh (Patriot),9,9-0,193,66,259,0.745,04/27/2021,2021.0
2,Quinnipiac (MAAC),7,4-3,115,44,159,0.723,04/27/2021,2021.0
3,Penn (Ivy League),1,1-0,25,10,35,0.714,04/27/2021,2021.0
3,Brown (Ivy League),1,1-0,15,6,21,0.714,04/27/2021,2021.0
5,Saint Joseph's (NEC),10,7-3,175,77,252,0.694,04/27/2021,2021.0
6,Vermont (America East),9,5-4,163,74,237,0.688,04/27/2021,2021.0
7,Monmouth (MAAC),7,5-2,96,44,140,0.686,04/27/2021,2021.0
8,Hofstra (CAA),11,6-5,199,102,301,0.661,04/27/2021,2021.0
9,Dartmouth (Ivy League),1,0-1,18,10,28,0.643,04/27/2021,2021.0
10,Denver (Big East),13,10-3,233,132,365,0.638,04/27/2021,2021.0
11,Hobart (NEC),7,5-2,114,65,179,0.637,04/27/2021,2021.0
12,Detroit Mercy (MAAC),6,3-3,82,49,131,0.626,04/27/2021,2021.0
13,Virginia (ACC),14,10-4,258,160,418,0.617,04/27/2021,2021.0
14,Georgetown (Big East),11,10-1,166,104,270,0.615,04/27/2021,2021.0
15,Notre Dame (ACC),9,6-3,140,90,230,0.609,04/27/2021,2021.0
16,Bryant (NEC),10,7-3,168,113,281,0.598,04/27/2021,2021.0
17,Duke (ACC),13,12-1,214,152,366,0.585,04/27/2021,2021.0
18,Richmond (SoCon),10,6-4,150,116,266,0.564,04/27/2021,2021.0
19,Mercer (SoCon),12,5-7,182,141,323,0.563,04/27/2021,2021.0
20,Penn St. (Big Ten),10,4-6,148,120,268,0.552,04/27/2021,2021.0
21,North Carolina (ACC),12,10-2,206,169,375,0.549,04/27/2021,2021.0
22,Jacksonville (SoCon),12,7-5,166,137,303,0.548,04/27/2021,2021.0
23,Villanova (Big East),9,6-3,127,106,233,0.545,04/27/2021,2021.0
24,Michigan (Big Ten),10,2-8,158,132,290,0.545,04/27/2021,2021.0
25,Stony Brook (America East),12,8-4,188,159,347,0.542,04/27/2021,2021.0
26,Massachusetts (CAA),8,4-4,115,99,214,0.537,04/27/2021,2021.0
27,Ohio St. (Big Ten),10,4-6,147,129,276,0.533,04/27/2021,2021.0
28,Canisius (MAAC),8,4-4,98,87,185,0.530,04/27/2021,2021.0
29,Loyola Maryland (Patriot),11,6-5,147,131,278,0.529,04/27/2021,2021.0
30,Colgate (Patriot),7,2-5,103,94,197,0.523,04/27/2021,2021.0
31,Johns Hopkins (Big Ten),10,2-8,139,129,268,0.519,04/27/2021,2021.0
32,Binghamton (America East),8,4-4,92,86,178,0.517,04/27/2021,2021.0
33,Fairfield (CAA),10,2-8,148,142,290,0.510,04/27/2021,2021.0
34,Syracuse (ACC),10,6-4,154,148,302,0.510,04/27/2021,2021.0
35,UAlbany (America East),10,7-3,139,134,273,0.509,04/27/2021,2021.0
36,Utah (DI Independent),10,4-6,124,120,244,0.508,04/27/2021,2021.0
37,Delaware (CAA),11,9-2,153,153,306,0.500,04/27/2021,2021.0
38,Providence (Big East),12,4-8,159,162,321,0.495,04/27/2021,2021.0
39,LIU (NEC),10,6-4,148,156,304,0.487,04/27/2021,2021.0
40,Drexel (CAA),9,7-2,123,130,253,0.486,04/27/2021,2021.0
41,Air Force (SoCon),11,3-8,129,143,272,0.474,04/27/2021,2021.0
42,UMBC (America East),9,7-2,98,109,207,0.473,04/27/2021,2021.0
43,High Point (SoCon),10,5-5,149,168,317,0.470,04/27/2021,2021.0
44,Maryland (Big Ten),10,10-0,138,158,296,0.466,04/27/2021,2021.0
45,Navy (Patriot),7,5-2,73,89,162,0.451,04/27/2021,2021.0
46,Cleveland St. (DI Independent),9,2-7,87,108,195,0.446,04/27/2021,2021.0
47,Mount St. Mary's (NEC),12,3-9,136,170,306,0.444,04/27/2021,2021.0
48,Army West Point (Patriot),9,6-3,95,122,217,0.438,04/27/2021,2021.0
49,Holy Cross (Patriot),6,2-4,62,80,142,0.437,04/27/2021,2021.0
50,Hartford (America East),7,2-5,76,99,175,0.434,04/27/2021,2021.0
51,Marist (MAAC),3,3-0,34,45,79,0.430,04/27/2021,2021.0
52,Bucknell (Patriot),8,2-6,92,122,214,0.430,04/27/2021,2021.0
53,Boston U. (Patriot),10,6-4,108,145,253,0.427,04/27/2021,2021.0
54,Lafayette (Patriot),10,0-10,110,160,270,0.407,04/27/2021,2021.0
55,Sacred Heart (NEC),11,1-10,119,179,298,0.399,04/27/2021,2021.0
56,Rutgers (Big Ten),10,8-2,121,183,304,0.398,04/27/2021,2021.0
57,Robert Morris (DI Independent),11,6-5,132,200,332,0.398,04/27/2021,2021.0
58,NJIT (America East),10,1-9,97,154,251,0.386,04/27/2021,2021.0
59,UMass Lowell (America East),8,1-7,80,132,212,0.377,04/27/2021,2021.0
60,Marquette (Big East),11,3-8,99,168,267,0.371,04/27/2021,2021.0
61,Siena (MAAC),7,0-7,55,94,149,0.369,04/27/2021,2021.0
62,Wagner (NEC),7,0-7,67,115,182,0.368,04/27/2021,2021.0
63,St. Bonaventure (MAAC),8,4-4,64,111,175,0.366,04/27/2021,2021.0
64,Towson (CAA),13,6-7,107,196,303,0.353,04/27/2021,2021.0
65,VMI (SoCon),10,1-9,100,184,284,0.352,04/27/2021,2021.0
66,Bellarmine (SoCon),14,4-10,96,214,310,0.310,04/27/2021,2021.0
67,Manhattan (MAAC),8,4-4,56,126,182,0.308,04/27/2021,2021.0
68,St. John's (NY) (Big East),10,1-9,82,216,298,0.275,04/27/2021,2021.0
-,Merrimack (NEC),10,5-5,118,142,260,0.454,04/27/2021,2021.0
1,Lehigh (Patriot),9,9-0,193,66,259,0.745,04/25/2021,2021.0
2,Quinnipiac (MAAC),7,4-3,115,44,159,0.723,04/25/2021,2021.0
3,Penn (Ivy League),1,1-0,25,10,35,0.714,04/25/2021,2021.0
3,Brown (Ivy League),1,1-0,15,6,21,0.714,04/25/2021,2021.0
5,Saint Joseph's (NEC),10,7-3,175,77,252,0.694,04/25/2021,2021.0
6,Vermont (America East),9,5-4,163,74,237,0.688,04/25/2021,2021.0
7,Monmouth (MAAC),7,5-2,96,44,140,0.686,04/25/2021,2021.0
8,Hofstra (CAA),11,6-5,199,102,301,0.661,04/25/2021,2021.0
9,Dartmouth (Ivy League),1,0-1,18,10,28,0.643,04/25/2021,2021.0
10,Denver (Big East),13,10-3,233,132,365,0.638,04/25/2021,2021.0
11,Hobart (NEC),6,4-2,100,59,159,0.629,04/25/2021,2021.0
12,Detroit Mercy (MAAC),6,3-3,82,49,131,0.626,04/25/2021,2021.0
13,Virginia (ACC),14,10-4,258,160,418,0.617,04/25/2021,2021.0
14,Georgetown (Big East),11,10-1,166,104,270,0.615,04/25/2021,2021.0
15,Notre Dame (ACC),9,6-3,140,90,230,0.609,04/25/2021,2021.0
16,Duke (ACC),13,12-1,214,152,366,0.585,04/25/2021,2021.0
17,Bryant (NEC),9,6-3,138,102,240,0.575,04/25/2021,2021.0
18,Richmond (SoCon),10,6-4,150,116,266,0.564,04/25/2021,2021.0
19,Mercer (SoCon),12,5-7,182,141,323,0.563,04/25/2021,2021.0
20,Penn St. (Big Ten),10,4-6,148,120,268,0.552,04/25/2021,2021.0
21,North Carolina (ACC),12,10-2,206,169,375,0.549,04/25/2021,2021.0
22,Villanova (Big East),9,6-3,127,106,233,0.545,04/25/2021,2021.0
23,Michigan (Big Ten),10,2-8,158,132,290,0.545,04/25/2021,2021.0
24,Stony Brook (America East),12,8-4,188,159,347,0.542,04/25/2021,2021.0
25,Massachusetts (CAA),8,4-4,115,99,214,0.537,04/25/2021,2021.0
26,Ohio St. (Big Ten),10,4-6,147,129,276,0.533,04/25/2021,2021.0
27,Canisius (MAAC),8,4-4,98,87,185,0.530,04/25/2021,2021.0
28,Loyola Maryland (Patriot),11,6-5,147,131,278,0.529,04/25/2021,2021.0
29,Jacksonville (SoCon),12,7-5,150,134,284,0.528,04/25/2021,2021.0
30,Colgate (Patriot),7,2-5,103,94,197,0.523,04/25/2021,2021.0
31,LIU (NEC),9,6-3,137,126,263,0.521,04/25/2021,2021.0
32,Johns Hopkins (Big Ten),10,2-8,139,129,268,0.519,04/25/2021,2021.0
33,Binghamton (America East),8,4-4,92,86,178,0.517,04/25/2021,2021.0
34,Fairfield (CAA),10,2-8,148,142,290,0.510,04/25/2021,2021.0
35,Syracuse (ACC),10,6-4,154,148,302,0.510,04/25/2021,2021.0
36,UAlbany (America East),10,7-3,139,134,273,0.509,04/25/2021,2021.0
37,Utah (DI Independent),10,4-6,124,120,244,0.508,04/25/2021,2021.0
38,Delaware (CAA),11,9-2,153,153,306,0.500,04/25/2021,2021.0
39,Providence (Big East),12,4-8,159,162,321,0.495,04/25/2021,2021.0
40,Drexel (CAA),9,7-2,123,130,253,0.486,04/25/2021,2021.0
41,Air Force (SoCon),11,3-8,129,143,272,0.474,04/25/2021,2021.0
42,UMBC (America East),9,7-2,98,109,207,0.473,04/25/2021,2021.0
43,High Point (SoCon),10,5-5,149,168,317,0.470,04/25/2021,2021.0
44,Maryland (Big Ten),10,10-0,138,158,296,0.466,04/25/2021,2021.0
45,Navy (Patriot),7,5-2,73,89,162,0.451,04/25/2021,2021.0
46,Mount St. Mary's (NEC),12,3-9,136,170,306,0.444,04/25/2021,2021.0
47,Cleveland St. (DI Independent),9,2-7,86,108,194,0.443,04/25/2021,2021.0
48,Army West Point (Patriot),9,6-3,95,122,217,0.438,04/25/2021,2021.0
49,Holy Cross (Patriot),6,2-4,62,80,142,0.437,04/25/2021,2021.0
50,Hartford (America East),7,2-5,76,99,175,0.434,04/25/2021,2021.0
51,Bucknell (Patriot),8,2-6,92,122,214,0.430,04/25/2021,2021.0
52,Boston U. (Patriot),10,6-4,108,145,253,0.427,04/25/2021,2021.0
53,Lafayette (Patriot),10,0-10,110,160,270,0.407,04/25/2021,2021.0
54,Sacred Heart (NEC),11,1-10,119,179,298,0.399,04/25/2021,2021.0
55,Rutgers (Big Ten),10,8-2,121,183,304,0.398,04/25/2021,2021.0
56,Robert Morris (DI Independent),11,6-5,132,200,332,0.398,04/25/2021,2021.0
57,NJIT (America East),10,1-9,97,154,251,0.386,04/25/2021,2021.0
58,Marist (MAAC),3,3-0,21,34,55,0.382,04/25/2021,2021.0
59,UMass Lowell (America East),8,1-7,80,132,212,0.377,04/25/2021,2021.0
60,Wagner (NEC),6,0-6,61,101,162,0.377,04/25/2021,2021.0
61,Marquette (Big East),11,3-8,99,168,267,0.371,04/25/2021,2021.0
62,Siena (MAAC),7,0-7,55,94,149,0.369,04/25/2021,2021.0
63,St. Bonaventure (MAAC),8,4-4,64,111,175,0.366,04/25/2021,2021.0
64,VMI (SoCon),10,1-9,100,183,283,0.353,04/25/2021,2021.0
65,Towson (CAA),13,6-7,107,196,303,0.353,04/25/2021,2021.0
66,Bellarmine (SoCon),14,4-10,93,198,291,0.320,04/25/2021,2021.0
67,Manhattan (MAAC),8,4-4,45,113,158,0.285,04/25/2021,2021.0
68,St. John's (NY) (Big East),10,1-9,82,216,298,0.275,04/25/2021,2021.0
-,Merrimack (NEC),10,5-5,118,142,260,0.454,04/25/2021,2021.0
1,Lehigh (Patriot),8,8-0,169,57,226,0.748,04/23/2021,2021.0
2,Quinnipiac (MAAC),7,4-3,115,44,159,0.723,04/23/2021,2021.0
3,Penn (Ivy League),1,1-0,25,10,35,0.714,04/23/2021,2021.0
3,Brown (Ivy League),1,1-0,15,6,21,0.714,04/23/2021,2021.0
5,Saint Joseph's (NEC),9,6-3,153,70,223,0.686,04/23/2021,2021.0
6,Monmouth (MAAC),7,5-2,96,44,140,0.686,04/23/2021,2021.0
7,Vermont (America East),8,5-3,147,70,217,0.677,04/23/2021,2021.0
8,Hofstra (CAA),10,6-4,186,93,279,0.667,04/23/2021,2021.0
9,Virginia (ACC),13,10-3,255,136,391,0.652,04/23/2021,2021.0
10,Notre Dame (ACC),8,6-2,129,75,204,0.632,04/23/2021,2021.0
11,Georgetown (Big East),10,9-1,157,92,249,0.631,04/23/2021,2021.0
12,Detroit Mercy (MAAC),6,3-3,82,49,131,0.626,04/23/2021,2021.0
13,Denver (Big East),12,9-3,205,127,332,0.617,04/23/2021,2021.0
14,Hobart (NEC),5,3-2,81,51,132,0.614,04/23/2021,2021.0
15,Duke (ACC),13,12-1,214,152,366,0.585,04/23/2021,2021.0
16,Mercer (SoCon),10,4-6,152,110,262,0.580,04/23/2021,2021.0
17,Bryant (NEC),8,5-3,115,89,204,0.564,04/23/2021,2021.0
18,Binghamton (America East),7,3-4,88,70,158,0.557,04/23/2021,2021.0
19,LIU (NEC),8,6-2,130,104,234,0.556,04/23/2021,2021.0
20,Penn St. (Big Ten),9,3-6,135,111,246,0.549,04/23/2021,2021.0
21,North Carolina (ACC),11,9-2,191,158,349,0.547,04/23/2021,2021.0
22,Richmond (SoCon),9,5-4,128,107,235,0.545,04/23/2021,2021.0
23,Ohio St. (Big Ten),9,4-5,138,116,254,0.543,04/23/2021,2021.0
24,Loyola Maryland (Patriot),10,5-5,139,117,256,0.543,04/23/2021,2021.0
25,Villanova (Big East),8,5-3,110,94,204,0.539,04/23/2021,2021.0
26,Michigan (Big Ten),9,2-7,140,121,261,0.536,04/23/2021,2021.0
27,Massachusetts (CAA),7,3-4,94,82,176,0.534,04/23/2021,2021.0
28,Stony Brook (America East),11,8-3,169,149,318,0.531,04/23/2021,2021.0
29,Canisius (MAAC),8,4-4,98,87,185,0.530,04/23/2021,2021.0
30,Jacksonville (SoCon),11,6-5,150,134,284,0.528,04/23/2021,2021.0
31,Colgate (Patriot),7,2-5,103,94,197,0.523,04/23/2021,2021.0
32,Fairfield (CAA),9,2-7,131,121,252,0.520,04/23/2021,2021.0
33,Johns Hopkins (Big Ten),9,2-7,123,116,239,0.515,04/23/2021,2021.0
34,Utah (DI Independent),9,3-6,110,112,222,0.495,04/23/2021,2021.0
35,UMBC (America East),8,6-2,88,90,178,0.494,04/23/2021,2021.0
36,UAlbany (America East),9,6-3,120,123,243,0.494,04/23/2021,2021.0
37,Drexel (CAA),8,6-2,114,117,231,0.494,04/23/2021,2021.0
38,Providence (Big East),11,4-7,147,153,300,0.490,04/23/2021,2021.0
39,Delaware (CAA),10,8-2,137,145,282,0.486,04/23/2021,2021.0
40,Syracuse (ACC),9,5-4,130,145,275,0.473,04/23/2021,2021.0
41,High Point (SoCon),9,4-5,139,156,295,0.471,04/23/2021,2021.0
42,Maryland (Big Ten),9,9-0,125,142,267,0.468,04/23/2021,2021.0
43,Air Force (SoCon),10,3-7,117,133,250,0.468,04/23/2021,2021.0
44,Bucknell (Patriot),7,2-5,83,98,181,0.459,04/23/2021,2021.0
45,Cleveland St. (DI Independent),8,2-6,78,94,172,0.453,04/23/2021,2021.0
46,Mount St. Mary's (NEC),12,3-9,136,170,306,0.444,04/23/2021,2021.0
47,Army West Point (Patriot),8,6-2,88,112,200,0.440,04/23/2021,2021.0
48,Holy Cross (Patriot),6,2-4,62,80,142,0.437,04/23/2021,2021.0
49,Navy (Patriot),6,4-2,63,82,145,0.434,04/23/2021,2021.0
50,Hartford (America East),7,2-5,76,99,175,0.434,04/23/2021,2021.0
51,Boston U. (Patriot),10,6-4,108,145,253,0.427,04/23/2021,2021.0
52,Sacred Heart (NEC),10,1-9,106,156,262,0.405,04/23/2021,2021.0
53,Rutgers (Big Ten),9,7-2,110,165,275,0.400,04/23/2021,2021.0
54,Robert Morris (DI Independent),11,6-5,132,200,332,0.398,04/23/2021,2021.0
55,NJIT (America East),9,1-8,86,135,221,0.389,04/23/2021,2021.0
56,Lafayette (Patriot),9,0-9,96,152,248,0.387,04/23/2021,2021.0
57,Marist (MAAC),2,2-0,21,34,55,0.382,04/23/2021,2021.0
58,UMass Lowell (America East),8,1-7,80,132,212,0.377,04/23/2021,2021.0
59,Wagner (NEC),6,0-6,61,101,162,0.377,04/23/2021,2021.0
60,Marquette (Big East),10,3-7,87,151,238,0.366,04/23/2021,2021.0
61,St. Bonaventure (MAAC),7,3-4,56,98,154,0.364,04/23/2021,2021.0
62,VMI (SoCon),9,1-8,91,162,253,0.360,04/23/2021,2021.0
63,Towson (CAA),12,6-6,99,180,279,0.355,04/23/2021,2021.0
64,Siena (MAAC),6,0-6,42,86,128,0.328,04/23/2021,2021.0
65,Bellarmine (SoCon),13,4-9,93,198,291,0.320,04/23/2021,2021.0
66,St. John's (NY) (Big East),9,1-8,77,188,265,0.291,04/23/2021,2021.0
67,Manhattan (MAAC),7,4-3,45,113,158,0.285,04/23/2021,2021.0
-,Merrimack (NEC),9,5-4,110,123,233,0.472,04/23/2021,2021.0
1,Lehigh (Patriot),8,8-0,169,57,226,0.748,04/22/2021,2021.0
2,Quinnipiac (MAAC),7,4-3,115,44,159,0.723,04/22/2021,2021.0
3,Monmouth (MAAC),6,5-1,84,38,122,0.689,04/22/2021,2021.0
4,Saint Joseph's (NEC),9,6-3,153,70,223,0.686,04/22/2021,2021.0
5,Vermont (America East),8,5-3,147,70,217,0.677,04/22/2021,2021.0
6,Hofstra (CAA),10,6-4,186,93,279,0.667,04/22/2021,2021.0
7,Virginia (ACC),13,10-3,255,136,391,0.652,04/22/2021,2021.0
8,Notre Dame (ACC),8,6-2,129,75,204,0.632,04/22/2021,2021.0
9,Georgetown (Big East),10,9-1,157,92,249,0.631,04/22/2021,2021.0
10,Detroit Mercy (MAAC),6,3-3,82,49,131,0.626,04/22/2021,2021.0
11,Denver (Big East),12,9-3,205,127,332,0.617,04/22/2021,2021.0
12,Hobart (NEC),5,3-2,81,51,132,0.614,04/22/2021,2021.0
13,Duke (ACC),13,12-1,214,152,366,0.585,04/22/2021,2021.0
14,Mercer (SoCon),10,4-6,152,110,262,0.580,04/22/2021,2021.0
15,Bryant (NEC),8,5-3,115,89,204,0.564,04/22/2021,2021.0
16,Binghamton (America East),7,3-4,88,70,158,0.557,04/22/2021,2021.0
17,LIU (NEC),8,6-2,130,104,234,0.556,04/22/2021,2021.0
18,Canisius (MAAC),7,3-4,92,75,167,0.551,04/22/2021,2021.0
19,Penn St. (Big Ten),9,3-6,135,111,246,0.549,04/22/2021,2021.0
20,North Carolina (ACC),11,9-2,191,158,349,0.547,04/22/2021,2021.0
21,Richmond (SoCon),9,5-4,128,107,235,0.545,04/22/2021,2021.0
22,Ohio St. (Big Ten),9,4-5,138,116,254,0.543,04/22/2021,2021.0
23,Loyola Maryland (Patriot),10,5-5,139,117,256,0.543,04/22/2021,2021.0
24,Villanova (Big East),8,5-3,110,94,204,0.539,04/22/2021,2021.0
25,Michigan (Big Ten),9,2-7,140,121,261,0.536,04/22/2021,2021.0
26,Massachusetts (CAA),7,3-4,94,82,176,0.534,04/22/2021,2021.0
27,Stony Brook (America East),11,8-3,169,149,318,0.531,04/22/2021,2021.0
28,Jacksonville (SoCon),11,6-5,150,134,284,0.528,04/22/2021,2021.0
29,Colgate (Patriot),7,2-5,103,94,197,0.523,04/22/2021,2021.0
30,Fairfield (CAA),9,2-7,131,121,252,0.520,04/22/2021,2021.0
31,Johns Hopkins (Big Ten),9,2-7,123,116,239,0.515,04/22/2021,2021.0
32,Utah (DI Independent),9,3-6,110,112,222,0.495,04/22/2021,2021.0
33,UMBC (America East),8,6-2,88,90,178,0.494,04/22/2021,2021.0
34,UAlbany (America East),9,6-3,120,123,243,0.494,04/22/2021,2021.0
35,Drexel (CAA),8,6-2,114,117,231,0.494,04/22/2021,2021.0
36,Providence (Big East),11,4-7,147,153,300,0.490,04/22/2021,2021.0
37,Delaware (CAA),10,8-2,137,145,282,0.486,04/22/2021,2021.0
38,Syracuse (ACC),9,5-4,130,145,275,0.473,04/22/2021,2021.0
39,High Point (SoCon),9,4-5,139,156,295,0.471,04/22/2021,2021.0
40,Maryland (Big Ten),9,9-0,125,142,267,0.468,04/22/2021,2021.0
41,Air Force (SoCon),10,3-7,117,133,250,0.468,04/22/2021,2021.0
42,Bucknell (Patriot),7,2-5,83,98,181,0.459,04/22/2021,2021.0
43,Cleveland St. (DI Independent),8,2-6,78,94,172,0.453,04/22/2021,2021.0
44,Mount St. Mary's (NEC),12,3-9,136,170,306,0.444,04/22/2021,2021.0
45,Army West Point (Patriot),8,6-2,88,112,200,0.440,04/22/2021,2021.0
46,Boston U. (Patriot),9,6-3,102,130,232,0.440,04/22/2021,2021.0
47,Holy Cross (Patriot),6,2-4,62,80,142,0.437,04/22/2021,2021.0
48,Navy (Patriot),6,4-2,63,82,145,0.434,04/22/2021,2021.0
49,Hartford (America East),7,2-5,76,99,175,0.434,04/22/2021,2021.0
50,Sacred Heart (NEC),10,1-9,106,156,262,0.405,04/22/2021,2021.0
51,Rutgers (Big Ten),9,7-2,110,165,275,0.400,04/22/2021,2021.0
52,Robert Morris (DI Independent),11,6-5,132,200,332,0.398,04/22/2021,2021.0
53,NJIT (America East),9,1-8,86,135,221,0.389,04/22/2021,2021.0
54,Lafayette (Patriot),9,0-9,96,152,248,0.387,04/22/2021,2021.0
55,Marist (MAAC),2,2-0,21,34,55,0.382,04/22/2021,2021.0
56,UMass Lowell (America East),8,1-7,80,132,212,0.377,04/22/2021,2021.0
57,Wagner (NEC),6,0-6,61,101,162,0.377,04/22/2021,2021.0
58,Marquette (Big East),10,3-7,87,151,238,0.366,04/22/2021,2021.0
59,St. Bonaventure (MAAC),7,3-4,56,98,154,0.364,04/22/2021,2021.0
60,VMI (SoCon),9,1-8,91,162,253,0.360,04/22/2021,2021.0
61,Towson (CAA),12,6-6,99,180,279,0.355,04/22/2021,2021.0
62,Siena (MAAC),6,0-6,42,86,128,0.328,04/22/2021,2021.0
63,Bellarmine (SoCon),13,4-9,93,198,291,0.320,04/22/2021,2021.0
64,St. John's (NY) (Big East),9,1-8,77,188,265,0.291,04/22/2021,2021.0
65,Manhattan (MAAC),7,4-3,45,113,158,0.285,04/22/2021,2021.0
-,Merrimack (NEC),9,5-4,110,123,233,0.472,04/22/2021,2021.0
1,Lehigh (Patriot),8,8-0,169,57,226,0.748,04/20/2021,2021.0
2,Quinnipiac (MAAC),7,4-3,115,44,159,0.723,04/20/2021,2021.0
3,Monmouth (MAAC),6,5-1,84,38,122,0.689,04/20/2021,2021.0
4,Saint Joseph's (NEC),9,6-3,153,70,223,0.686,04/20/2021,2021.0
5,Vermont (America East),8,5-3,147,70,217,0.677,04/20/2021,2021.0
6,Hofstra (CAA),10,6-4,186,93,279,0.667,04/20/2021,2021.0
7,Notre Dame (ACC),7,6-1,115,60,175,0.657,04/20/2021,2021.0
8,Virginia (ACC),13,10-3,255,136,391,0.652,04/20/2021,2021.0
9,Georgetown (Big East),10,9-1,157,92,249,0.631,04/20/2021,2021.0
10,Detroit Mercy (MAAC),6,3-3,82,49,131,0.626,04/20/2021,2021.0
11,Denver (Big East),12,9-3,205,127,332,0.617,04/20/2021,2021.0
12,Hobart (NEC),5,3-2,81,51,132,0.614,04/20/2021,2021.0
13,Duke (ACC),12,11-1,199,138,337,0.591,04/20/2021,2021.0
14,Mercer (SoCon),10,4-6,152,110,262,0.580,04/20/2021,2021.0
15,Bryant (NEC),8,5-3,115,89,204,0.564,04/20/2021,2021.0
16,Binghamton (America East),7,3-4,88,70,158,0.557,04/20/2021,2021.0
17,LIU (NEC),8,6-2,130,104,234,0.556,04/20/2021,2021.0
18,Canisius (MAAC),7,3-4,92,75,167,0.551,04/20/2021,2021.0
19,Penn St. (Big Ten),9,3-6,135,111,246,0.549,04/20/2021,2021.0
20,North Carolina (ACC),11,9-2,191,158,349,0.547,04/20/2021,2021.0
21,Richmond (SoCon),9,5-4,128,107,235,0.545,04/20/2021,2021.0
22,Ohio St. (Big Ten),9,4-5,138,116,254,0.543,04/20/2021,2021.0
23,Loyola Maryland (Patriot),10,5-5,139,117,256,0.543,04/20/2021,2021.0
24,Villanova (Big East),8,5-3,110,94,204,0.539,04/20/2021,2021.0
25,Michigan (Big Ten),9,2-7,140,121,261,0.536,04/20/2021,2021.0
26,Massachusetts (CAA),7,3-4,94,82,176,0.534,04/20/2021,2021.0
27,Stony Brook (America East),11,8-3,169,149,318,0.531,04/20/2021,2021.0
28,Jacksonville (SoCon),11,6-5,150,134,284,0.528,04/20/2021,2021.0
29,Colgate (Patriot),7,2-5,103,94,197,0.523,04/20/2021,2021.0
30,Fairfield (CAA),9,2-7,131,121,252,0.520,04/20/2021,2021.0
31,Johns Hopkins (Big Ten),9,2-7,123,116,239,0.515,04/20/2021,2021.0
32,Utah (DI Independent),9,3-6,110,112,222,0.495,04/20/2021,2021.0
33,UMBC (America East),8,6-2,88,90,178,0.494,04/20/2021,2021.0
34,UAlbany (America East),9,6-3,120,123,243,0.494,04/20/2021,2021.0
35,Drexel (CAA),8,6-2,114,117,231,0.494,04/20/2021,2021.0
36,Providence (Big East),11,4-7,147,153,300,0.490,04/20/2021,2021.0
37,Delaware (CAA),10,8-2,137,145,282,0.486,04/20/2021,2021.0
38,Syracuse (ACC),9,5-4,130,145,275,0.473,04/20/2021,2021.0
39,High Point (SoCon),9,4-5,139,156,295,0.471,04/20/2021,2021.0
40,Maryland (Big Ten),9,9-0,125,142,267,0.468,04/20/2021,2021.0
41,Air Force (SoCon),10,3-7,117,133,250,0.468,04/20/2021,2021.0
42,Bucknell (Patriot),7,2-5,83,98,181,0.459,04/20/2021,2021.0
43,Cleveland St. (DI Independent),8,2-6,78,94,172,0.453,04/20/2021,2021.0
44,Mount St. Mary's (NEC),12,3-9,136,170,306,0.444,04/20/2021,2021.0
45,Army West Point (Patriot),8,6-2,88,112,200,0.440,04/20/2021,2021.0
46,Boston U. (Patriot),9,6-3,102,130,232,0.440,04/20/2021,2021.0
47,Holy Cross (Patriot),6,2-4,62,80,142,0.437,04/20/2021,2021.0
48,Navy (Patriot),6,4-2,63,82,145,0.434,04/20/2021,2021.0
49,Hartford (America East),7,2-5,76,99,175,0.434,04/20/2021,2021.0
50,Sacred Heart (NEC),10,1-9,106,156,262,0.405,04/20/2021,2021.0
51,Rutgers (Big Ten),9,7-2,110,165,275,0.400,04/20/2021,2021.0
52,Robert Morris (DI Independent),11,6-5,132,200,332,0.398,04/20/2021,2021.0
53,NJIT (America East),9,1-8,86,135,221,0.389,04/20/2021,2021.0
54,Lafayette (Patriot),9,0-9,96,152,248,0.387,04/20/2021,2021.0
55,Marist (MAAC),2,2-0,21,34,55,0.382,04/20/2021,2021.0
56,UMass Lowell (America East),8,1-7,80,132,212,0.377,04/20/2021,2021.0
57,Wagner (NEC),6,0-6,61,101,162,0.377,04/20/2021,2021.0
58,Marquette (Big East),10,3-7,87,151,238,0.366,04/20/2021,2021.0
59,St. Bonaventure (MAAC),7,3-4,56,98,154,0.364,04/20/2021,2021.0
60,VMI (SoCon),9,1-8,91,162,253,0.360,04/20/2021,2021.0
61,Towson (CAA),12,6-6,99,180,279,0.355,04/20/2021,2021.0
62,Siena (MAAC),6,0-6,42,86,128,0.328,04/20/2021,2021.0
63,Bellarmine (SoCon),13,4-9,93,198,291,0.320,04/20/2021,2021.0
64,St. John's (NY) (Big East),9,1-8,77,188,265,0.291,04/20/2021,2021.0
65,Manhattan (MAAC),7,4-3,45,113,158,0.285,04/20/2021,2021.0
-,Merrimack (NEC),9,5-4,110,123,233,0.472,04/20/2021,2021.0
1,Lehigh (Patriot),8,8-0,169,57,226,0.748,04/18/2021,2021.0
2,Quinnipiac (MAAC),6,4-2,96,36,132,0.727,04/18/2021,2021.0
3,Monmouth (MAAC),6,5-1,84,38,122,0.689,04/18/2021,2021.0
4,Saint Joseph's (NEC),9,6-3,153,70,223,0.686,04/18/2021,2021.0
5,Vermont (America East),8,5-3,147,70,217,0.677,04/18/2021,2021.0
6,Hofstra (CAA),10,6-4,186,93,279,0.667,04/18/2021,2021.0
7,Notre Dame (ACC),7,6-1,115,60,175,0.657,04/18/2021,2021.0
8,Virginia (ACC),13,10-3,255,136,391,0.652,04/18/2021,2021.0
9,Georgetown (Big East),10,9-1,157,92,249,0.631,04/18/2021,2021.0
10,Detroit Mercy (MAAC),6,3-3,82,49,131,0.626,04/18/2021,2021.0
11,Denver (Big East),12,9-3,205,127,332,0.617,04/18/2021,2021.0
12,Hobart (NEC),5,3-2,81,51,132,0.614,04/18/2021,2021.0
13,Duke (ACC),12,11-1,199,138,337,0.591,04/18/2021,2021.0
14,Mercer (SoCon),10,4-6,152,110,262,0.580,04/18/2021,2021.0
15,Bryant (NEC),8,5-3,115,89,204,0.564,04/18/2021,2021.0
16,Binghamton (America East),7,3-4,88,70,158,0.557,04/18/2021,2021.0
17,LIU (NEC),8,6-2,130,104,234,0.556,04/18/2021,2021.0
18,Canisius (MAAC),7,3-4,92,75,167,0.551,04/18/2021,2021.0
19,Penn St. (Big Ten),9,3-6,135,111,246,0.549,04/18/2021,2021.0
20,North Carolina (ACC),11,9-2,191,158,349,0.547,04/18/2021,2021.0
21,Richmond (SoCon),9,5-4,128,107,235,0.545,04/18/2021,2021.0
22,Villanova (Big East),8,5-3,111,93,204,0.544,04/18/2021,2021.0
23,Ohio St. (Big Ten),9,4-5,138,116,254,0.543,04/18/2021,2021.0
24,Loyola Maryland (Patriot),10,5-5,139,117,256,0.543,04/18/2021,2021.0
25,Michigan (Big Ten),9,2-7,140,121,261,0.536,04/18/2021,2021.0
26,Massachusetts (CAA),7,3-4,94,82,176,0.534,04/18/2021,2021.0
27,Stony Brook (America East),11,8-3,169,149,318,0.531,04/18/2021,2021.0
28,Jacksonville (SoCon),11,6-5,150,134,284,0.528,04/18/2021,2021.0
29,Colgate (Patriot),7,2-5,103,94,197,0.523,04/18/2021,2021.0
30,Fairfield (CAA),9,2-7,131,121,252,0.520,04/18/2021,2021.0
31,Johns Hopkins (Big Ten),9,2-7,123,116,239,0.515,04/18/2021,2021.0
32,Utah (DI Independent),9,3-6,110,112,222,0.495,04/18/2021,2021.0
33,UMBC (America East),8,6-2,88,90,178,0.494,04/18/2021,2021.0
34,UAlbany (America East),9,6-3,120,123,243,0.494,04/18/2021,2021.0
35,Drexel (CAA),8,6-2,114,117,231,0.494,04/18/2021,2021.0
36,Providence (Big East),11,4-7,147,153,300,0.490,04/18/2021,2021.0
37,Delaware (CAA),10,8-2,137,145,282,0.486,04/18/2021,2021.0
38,Syracuse (ACC),9,5-4,130,145,275,0.473,04/18/2021,2021.0
39,High Point (SoCon),9,4-5,139,156,295,0.471,04/18/2021,2021.0
40,Maryland (Big Ten),9,9-0,125,142,267,0.468,04/18/2021,2021.0
41,Air Force (SoCon),10,3-7,117,133,250,0.468,04/18/2021,2021.0
42,Marist (MAAC),1,1-0,13,15,28,0.464,04/18/2021,2021.0
43,Bucknell (Patriot),7,2-5,83,98,181,0.459,04/18/2021,2021.0
44,Cleveland St. (DI Independent),8,2-6,78,94,172,0.453,04/18/2021,2021.0
45,Mount St. Mary's (NEC),12,3-9,136,170,306,0.444,04/18/2021,2021.0
46,Army West Point (Patriot),8,6-2,88,112,200,0.440,04/18/2021,2021.0
47,Boston U. (Patriot),9,6-3,102,130,232,0.440,04/18/2021,2021.0
48,Holy Cross (Patriot),6,2-4,62,80,142,0.437,04/18/2021,2021.0
49,Navy (Patriot),6,4-2,63,82,145,0.434,04/18/2021,2021.0
50,Hartford (America East),7,2-5,76,99,175,0.434,04/18/2021,2021.0
51,Sacred Heart (NEC),10,1-9,106,156,262,0.405,04/18/2021,2021.0
52,Rutgers (Big Ten),9,7-2,110,165,275,0.400,04/18/2021,2021.0
53,Robert Morris (DI Independent),11,6-5,132,200,332,0.398,04/18/2021,2021.0
54,NJIT (America East),9,1-8,86,135,221,0.389,04/18/2021,2021.0
55,Lafayette (Patriot),9,0-9,96,152,248,0.387,04/18/2021,2021.0
56,UMass Lowell (America East),8,1-7,80,132,212,0.377,04/18/2021,2021.0
57,Wagner (NEC),6,0-6,61,101,162,0.377,04/18/2021,2021.0
58,Marquette (Big East),10,3-7,87,151,238,0.366,04/18/2021,2021.0
59,St. Bonaventure (MAAC),7,3-4,56,98,154,0.364,04/18/2021,2021.0
60,VMI (SoCon),9,1-8,91,162,253,0.360,04/18/2021,2021.0
61,Towson (CAA),12,6-6,99,180,279,0.355,04/18/2021,2021.0
62,Siena (MAAC),6,0-6,42,86,128,0.328,04/18/2021,2021.0
63,Bellarmine (SoCon),13,4-9,93,198,291,0.320,04/18/2021,2021.0
64,St. John's (NY) (Big East),9,1-8,76,189,265,0.287,04/18/2021,2021.0
65,Manhattan (MAAC),7,4-3,45,113,158,0.285,04/18/2021,2021.0
-,Merrimack (NEC),9,5-4,110,123,233,0.472,04/18/2021,2021.0
1,Lehigh (Patriot),7,7-0,144,53,197,0.731,04/17/2021,2021.0
2,Quinnipiac (MAAC),6,4-2,96,36,132,0.727,04/17/2021,2021.0
3,Monmouth (MAAC),6,5-1,84,38,122,0.689,04/17/2021,2021.0
4,Saint Joseph's (NEC),9,6-3,153,70,223,0.686,04/17/2021,2021.0
5,Vermont (America East),8,5-3,147,70,217,0.677,04/17/2021,2021.0
6,Hofstra (CAA),10,6-4,186,93,279,0.667,04/17/2021,2021.0
7,Notre Dame (ACC),7,6-1,115,60,175,0.657,04/17/2021,2021.0
8,Virginia (ACC),13,10-3,255,136,391,0.652,04/17/2021,2021.0
9,Georgetown (Big East),10,9-1,157,92,249,0.631,04/17/2021,2021.0
10,Detroit Mercy (MAAC),6,3-3,82,49,131,0.626,04/17/2021,2021.0
11,Denver (Big East),12,9-3,205,127,332,0.617,04/17/2021,2021.0
12,Hobart (NEC),5,3-2,81,51,132,0.614,04/17/2021,2021.0
13,Duke (ACC),12,11-1,199,138,337,0.591,04/17/2021,2021.0
14,Mercer (SoCon),10,4-6,152,110,262,0.580,04/17/2021,2021.0
15,Bryant (NEC),8,5-3,115,89,204,0.564,04/17/2021,2021.0
16,Binghamton (America East),7,3-4,88,70,158,0.557,04/17/2021,2021.0
17,LIU (NEC),8,6-2,130,104,234,0.556,04/17/2021,2021.0
18,Canisius (MAAC),7,3-4,92,75,167,0.551,04/17/2021,2021.0
19,Penn St. (Big Ten),9,3-6,135,111,246,0.549,04/17/2021,2021.0
20,North Carolina (ACC),11,9-2,191,158,349,0.547,04/17/2021,2021.0
21,Richmond (SoCon),9,5-4,128,107,235,0.545,04/17/2021,2021.0
22,Ohio St. (Big Ten),8,4-4,122,102,224,0.545,04/17/2021,2021.0
23,Villanova (Big East),8,5-3,111,93,204,0.544,04/17/2021,2021.0
24,Loyola Maryland (Patriot),10,5-5,139,117,256,0.543,04/17/2021,2021.0
25,Michigan (Big Ten),9,2-7,140,121,261,0.536,04/17/2021,2021.0
26,Massachusetts (CAA),7,3-4,94,82,176,0.534,04/17/2021,2021.0
27,Stony Brook (America East),11,8-3,169,149,318,0.531,04/17/2021,2021.0
28,Jacksonville (SoCon),11,6-5,150,134,284,0.528,04/17/2021,2021.0
29,Colgate (Patriot),7,2-5,103,94,197,0.523,04/17/2021,2021.0
30,Fairfield (CAA),9,2-7,131,121,252,0.520,04/17/2021,2021.0
31,Johns Hopkins (Big Ten),9,2-7,123,116,239,0.515,04/17/2021,2021.0
32,Utah (DI Independent),9,3-6,110,112,222,0.495,04/17/2021,2021.0
33,UMBC (America East),8,6-2,88,90,178,0.494,04/17/2021,2021.0
34,UAlbany (America East),9,6-3,120,123,243,0.494,04/17/2021,2021.0
35,Drexel (CAA),8,6-2,114,117,231,0.494,04/17/2021,2021.0
36,Providence (Big East),11,4-7,147,153,300,0.490,04/17/2021,2021.0
37,Delaware (CAA),10,8-2,137,145,282,0.486,04/17/2021,2021.0
38,Syracuse (ACC),9,5-4,130,145,275,0.473,04/17/2021,2021.0
39,High Point (SoCon),9,4-5,139,156,295,0.471,04/17/2021,2021.0
40,Maryland (Big Ten),8,8-0,111,126,237,0.468,04/17/2021,2021.0
41,Air Force (SoCon),10,3-7,117,133,250,0.468,04/17/2021,2021.0
42,Marist (MAAC),1,1-0,13,15,28,0.464,04/17/2021,2021.0
43,Bucknell (Patriot),7,2-5,83,98,181,0.459,04/17/2021,2021.0
44,Cleveland St. (DI Independent),8,2-6,78,94,172,0.453,04/17/2021,2021.0
45,Mount St. Mary's (NEC),12,3-9,136,170,306,0.444,04/17/2021,2021.0
46,Army West Point (Patriot),8,6-2,88,112,200,0.440,04/17/2021,2021.0
47,Boston U. (Patriot),9,6-3,102,130,232,0.440,04/17/2021,2021.0
48,Holy Cross (Patriot),6,2-4,62,80,142,0.437,04/17/2021,2021.0
49,Navy (Patriot),6,4-2,63,82,145,0.434,04/17/2021,2021.0
50,Hartford (America East),7,2-5,76,99,175,0.434,04/17/2021,2021.0
51,Lafayette (Patriot),8,0-8,92,127,219,0.420,04/17/2021,2021.0
52,Sacred Heart (NEC),10,1-9,106,156,262,0.405,04/17/2021,2021.0
53,Rutgers (Big Ten),9,7-2,110,165,275,0.400,04/17/2021,2021.0
54,Robert Morris (DI Independent),11,6-5,132,200,332,0.398,04/17/2021,2021.0
55,NJIT (America East),9,1-8,86,135,221,0.389,04/17/2021,2021.0
56,UMass Lowell (America East),8,1-7,80,132,212,0.377,04/17/2021,2021.0
57,Wagner (NEC),6,0-6,61,101,162,0.377,04/17/2021,2021.0
58,Marquette (Big East),10,3-7,87,151,238,0.366,04/17/2021,2021.0
59,St. Bonaventure (MAAC),7,3-4,56,98,154,0.364,04/17/2021,2021.0
60,VMI (SoCon),9,1-8,91,162,253,0.360,04/17/2021,2021.0
61,Towson (CAA),12,6-6,99,180,279,0.355,04/17/2021,2021.0
62,Siena (MAAC),6,0-6,42,86,128,0.328,04/17/2021,2021.0
63,Bellarmine (SoCon),13,4-9,93,198,291,0.320,04/17/2021,2021.0
64,St. John's (NY) (Big East),9,1-8,76,189,265,0.287,04/17/2021,2021.0
65,Manhattan (MAAC),7,4-3,45,113,158,0.285,04/17/2021,2021.0
-,Merrimack (NEC),9,5-4,110,123,233,0.472,04/17/2021,2021.0
1,Quinnipiac (MAAC),5,3-2,74,26,100,0.740,04/16/2021,2021.0
2,Lehigh (Patriot),7,7-0,118,46,164,0.720,04/16/2021,2021.0
3,Monmouth (MAAC),6,5-1,84,38,122,0.689,04/16/2021,2021.0
4,Vermont (America East),8,5-3,147,70,217,0.677,04/16/2021,2021.0
5,Hofstra (CAA),9,6-3,169,81,250,0.676,04/16/2021,2021.0
6,Saint Joseph's (NEC),8,5-3,133,68,201,0.662,04/16/2021,2021.0
7,Notre Dame (ACC),7,6-1,115,60,175,0.657,04/16/2021,2021.0
8,Virginia (ACC),12,9-3,229,129,358,0.640,04/16/2021,2021.0
9,Denver (Big East),11,9-2,197,111,308,0.640,04/16/2021,2021.0
10,Georgetown (Big East),9,8-1,141,84,225,0.627,04/16/2021,2021.0
11,Detroit Mercy (MAAC),6,3-3,82,49,131,0.626,04/16/2021,2021.0
12,Bryant (NEC),7,5-2,113,69,182,0.621,04/16/2021,2021.0
13,Hobart (NEC),5,3-2,81,51,132,0.614,04/16/2021,2021.0
14,Canisius (MAAC),6,3-3,82,53,135,0.607,04/16/2021,2021.0
15,Mercer (SoCon),9,4-5,137,95,232,0.591,04/16/2021,2021.0
16,Duke (ACC),12,11-1,199,138,337,0.591,04/16/2021,2021.0
17,LIU (NEC),7,5-2,111,87,198,0.561,04/16/2021,2021.0
18,Binghamton (America East),7,3-4,88,70,158,0.557,04/16/2021,2021.0
19,Loyola Maryland (Patriot),9,5-4,126,101,227,0.555,04/16/2021,2021.0
20,Jacksonville (SoCon),10,6-4,143,117,260,0.550,04/16/2021,2021.0
21,Penn St. (Big Ten),9,3-6,135,111,246,0.549,04/16/2021,2021.0
22,North Carolina (ACC),10,8-2,172,143,315,0.546,04/16/2021,2021.0
23,Utah (DI Independent),8,3-5,103,86,189,0.545,04/16/2021,2021.0
24,Ohio St. (Big Ten),8,4-4,122,102,224,0.545,04/16/2021,2021.0
25,Michigan (Big Ten),9,2-7,140,121,261,0.536,04/16/2021,2021.0
26,Fairfield (CAA),8,2-6,120,104,224,0.536,04/16/2021,2021.0
27,Stony Brook (America East),11,8-3,169,149,318,0.531,04/16/2021,2021.0
28,Richmond (SoCon),8,4-4,111,100,211,0.526,04/16/2021,2021.0
29,Colgate (Patriot),7,2-5,103,94,197,0.523,04/16/2021,2021.0
30,Villanova (Big East),7,4-3,90,83,173,0.520,04/16/2021,2021.0
31,Johns Hopkins (Big Ten),8,2-6,103,105,208,0.495,04/16/2021,2021.0
32,Delaware (CAA),9,7-2,125,128,253,0.494,04/16/2021,2021.0
33,UAlbany (America East),9,6-3,120,123,243,0.494,04/16/2021,2021.0
34,UMBC (America East),7,5-2,78,80,158,0.494,04/16/2021,2021.0
35,Massachusetts (CAA),6,3-3,77,80,157,0.490,04/16/2021,2021.0
36,Providence (Big East),10,4-6,137,143,280,0.489,04/16/2021,2021.0
37,Drexel (CAA),7,5-2,97,106,203,0.478,04/16/2021,2021.0
38,Syracuse (ACC),8,5-3,115,126,241,0.477,04/16/2021,2021.0
39,Maryland (Big Ten),8,8-0,111,126,237,0.468,04/16/2021,2021.0
40,High Point (SoCon),8,3-5,124,141,265,0.468,04/16/2021,2021.0
41,Marist (MAAC),1,1-0,13,15,28,0.464,04/16/2021,2021.0
42,Bucknell (Patriot),7,2-5,83,98,181,0.459,04/16/2021,2021.0
43,Cleveland St. (DI Independent),7,2-5,70,83,153,0.458,04/16/2021,2021.0
44,Boston U. (Patriot),8,6-2,93,113,206,0.451,04/16/2021,2021.0
45,Air Force (SoCon),9,2-7,101,123,224,0.451,04/16/2021,2021.0
46,Hartford (America East),6,1-5,67,82,149,0.450,04/16/2021,2021.0
47,Mount St. Mary's (NEC),11,3-8,119,151,270,0.441,04/16/2021,2021.0
48,Holy Cross (Patriot),6,2-4,62,80,142,0.437,04/16/2021,2021.0
49,Lafayette (Patriot),8,0-8,92,127,219,0.420,04/16/2021,2021.0
50,Army West Point (Patriot),7,5-2,71,103,174,0.408,04/16/2021,2021.0
51,Rutgers (Big Ten),8,6-2,99,145,244,0.406,04/16/2021,2021.0
52,Navy (Patriot),5,3-2,47,69,116,0.405,04/16/2021,2021.0
53,Sacred Heart (NEC),9,1-8,94,141,235,0.400,04/16/2021,2021.0
54,Robert Morris (DI Independent),11,6-5,132,200,332,0.398,04/16/2021,2021.0
55,Wagner (NEC),6,0-6,61,101,162,0.377,04/16/2021,2021.0
56,Towson (CAA),11,5-6,97,163,260,0.373,04/16/2021,2021.0
57,UMass Lowell (America East),7,1-6,70,122,192,0.365,04/16/2021,2021.0
58,St. Bonaventure (MAAC),7,3-4,56,98,154,0.364,04/16/2021,2021.0
59,VMI (SoCon),8,1-7,81,146,227,0.357,04/16/2021,2021.0
60,NJIT (America East),8,1-7,69,126,195,0.354,04/16/2021,2021.0
61,Marquette (Big East),9,2-7,77,141,218,0.353,04/16/2021,2021.0
62,Bellarmine (SoCon),12,3-9,82,190,272,0.301,04/16/2021,2021.0
63,Siena (MAAC),5,0-5,28,71,99,0.283,04/16/2021,2021.0
64,St. John's (NY) (Big East),8,1-7,66,168,234,0.282,04/16/2021,2021.0
65,Manhattan (MAAC),6,3-3,30,99,129,0.233,04/16/2021,2021.0
-,Merrimack (NEC),8,4-4,95,111,206,0.461,04/16/2021,2021.0
1,Quinnipiac (MAAC),5,3-2,74,26,100,0.740,04/15/2021,2021.0
2,Lehigh (Patriot),6,6-0,118,46,164,0.720,04/15/2021,2021.0
3,Monmouth (MAAC),6,5-1,84,38,122,0.689,04/15/2021,2021.0
4,Vermont (America East),8,5-3,147,70,217,0.677,04/15/2021,2021.0
5,Hofstra (CAA),9,6-3,169,81,250,0.676,04/15/2021,2021.0
6,Saint Joseph's (NEC),8,5-3,133,68,201,0.662,04/15/2021,2021.0
7,Notre Dame (ACC),7,6-1,115,60,175,0.657,04/15/2021,2021.0
8,Virginia (ACC),12,9-3,229,129,358,0.640,04/15/2021,2021.0
9,Denver (Big East),11,9-2,197,111,308,0.640,04/15/2021,2021.0
10,Georgetown (Big East),9,8-1,141,84,225,0.627,04/15/2021,2021.0
11,Detroit Mercy (MAAC),6,3-3,82,49,131,0.626,04/15/2021,2021.0
12,Bryant (NEC),7,5-2,113,69,182,0.621,04/15/2021,2021.0
13,Hobart (NEC),5,3-2,81,51,132,0.614,04/15/2021,2021.0
14,Canisius (MAAC),6,3-3,82,53,135,0.607,04/15/2021,2021.0
15,Mercer (SoCon),9,4-5,137,95,232,0.591,04/15/2021,2021.0
16,Duke (ACC),12,11-1,199,138,337,0.591,04/15/2021,2021.0
17,Binghamton (America East),6,3-3,73,51,124,0.589,04/15/2021,2021.0
18,LIU (NEC),7,5-2,111,87,198,0.561,04/15/2021,2021.0
19,Penn St. (Big Ten),8,2-6,120,96,216,0.556,04/15/2021,2021.0
20,Loyola Maryland (Patriot),9,5-4,126,101,227,0.555,04/15/2021,2021.0
21,Jacksonville (SoCon),10,6-4,143,117,260,0.550,04/15/2021,2021.0
22,North Carolina (ACC),10,8-2,172,143,315,0.546,04/15/2021,2021.0
23,Utah (DI Independent),8,3-5,103,86,189,0.545,04/15/2021,2021.0
24,Ohio St. (Big Ten),8,4-4,122,102,224,0.545,04/15/2021,2021.0
25,Michigan (Big Ten),8,2-6,125,106,231,0.541,04/15/2021,2021.0
26,Fairfield (CAA),8,2-6,120,104,224,0.536,04/15/2021,2021.0
27,Stony Brook (America East),10,7-3,150,134,284,0.528,04/15/2021,2021.0
28,Richmond (SoCon),8,4-4,111,100,211,0.526,04/15/2021,2021.0
29,Colgate (Patriot),7,2-5,103,94,197,0.523,04/15/2021,2021.0
30,Villanova (Big East),7,4-3,90,83,173,0.520,04/15/2021,2021.0
31,Johns Hopkins (Big Ten),8,2-6,103,105,208,0.495,04/15/2021,2021.0
32,Delaware (CAA),9,7-2,125,128,253,0.494,04/15/2021,2021.0
33,UAlbany (America East),9,6-3,120,123,243,0.494,04/15/2021,2021.0
34,UMBC (America East),7,5-2,78,80,158,0.494,04/15/2021,2021.0
35,Massachusetts (CAA),6,3-3,77,80,157,0.490,04/15/2021,2021.0
36,Providence (Big East),10,4-6,137,143,280,0.489,04/15/2021,2021.0
37,Drexel (CAA),7,5-2,97,106,203,0.478,04/15/2021,2021.0
38,Syracuse (ACC),8,5-3,115,126,241,0.477,04/15/2021,2021.0
39,Maryland (Big Ten),8,8-0,111,126,237,0.468,04/15/2021,2021.0
40,High Point (SoCon),8,3-5,124,141,265,0.468,04/15/2021,2021.0
41,Marist (MAAC),1,1-0,13,15,28,0.464,04/15/2021,2021.0
42,Cleveland St. (DI Independent),7,2-5,70,83,153,0.458,04/15/2021,2021.0
43,Lafayette (Patriot),7,0-7,85,101,186,0.457,04/15/2021,2021.0
44,Bucknell (Patriot),6,2-4,74,88,162,0.457,04/15/2021,2021.0
45,Boston U. (Patriot),8,6-2,93,113,206,0.451,04/15/2021,2021.0
46,Air Force (SoCon),9,2-7,101,123,224,0.451,04/15/2021,2021.0
47,Hartford (America East),6,1-5,67,82,149,0.450,04/15/2021,2021.0
48,Mount St. Mary's (NEC),11,3-8,119,151,270,0.441,04/15/2021,2021.0
49,Holy Cross (Patriot),6,2-4,62,80,142,0.437,04/15/2021,2021.0
50,Army West Point (Patriot),7,5-2,71,103,174,0.408,04/15/2021,2021.0
51,Rutgers (Big Ten),8,6-2,99,145,244,0.406,04/15/2021,2021.0
52,Navy (Patriot),5,3-2,47,69,116,0.405,04/15/2021,2021.0
53,Sacred Heart (NEC),9,1-8,94,141,235,0.400,04/15/2021,2021.0
54,Robert Morris (DI Independent),10,5-5,122,191,313,0.390,04/15/2021,2021.0
55,Wagner (NEC),6,0-6,61,101,162,0.377,04/15/2021,2021.0
56,Towson (CAA),11,5-6,97,163,260,0.373,04/15/2021,2021.0
57,UMass Lowell (America East),7,1-6,70,122,192,0.365,04/15/2021,2021.0
58,St. Bonaventure (MAAC),7,3-4,56,98,154,0.364,04/15/2021,2021.0
59,VMI (SoCon),8,1-7,81,146,227,0.357,04/15/2021,2021.0
60,NJIT (America East),8,1-7,69,126,195,0.354,04/15/2021,2021.0
61,Marquette (Big East),9,2-7,77,141,218,0.353,04/15/2021,2021.0
62,Bellarmine (SoCon),12,3-9,82,190,272,0.301,04/15/2021,2021.0
63,Siena (MAAC),5,0-5,28,71,99,0.283,04/15/2021,2021.0
64,St. John's (NY) (Big East),8,1-7,66,168,234,0.282,04/15/2021,2021.0
65,Manhattan (MAAC),6,3-3,30,99,129,0.233,04/15/2021,2021.0
-,Merrimack (NEC),8,4-4,95,111,206,0.461,04/15/2021,2021.0
1,Quinnipiac (MAAC),5,3-2,74,26,100,0.740,04/14/2021,2021.0
2,Lehigh (Patriot),6,6-0,118,46,164,0.720,04/14/2021,2021.0
3,Monmouth (MAAC),6,5-1,84,38,122,0.689,04/14/2021,2021.0
4,Vermont (America East),8,5-3,147,70,217,0.677,04/14/2021,2021.0
5,Hofstra (CAA),9,6-3,169,81,250,0.676,04/14/2021,2021.0
6,Saint Joseph's (NEC),8,5-3,133,68,201,0.662,04/14/2021,2021.0
7,Notre Dame (ACC),7,6-1,115,60,175,0.657,04/14/2021,2021.0
8,Denver (Big East),11,9-2,197,111,308,0.640,04/14/2021,2021.0
9,Virginia (ACC),11,9-2,211,120,331,0.637,04/14/2021,2021.0
10,Georgetown (Big East),9,8-1,141,84,225,0.627,04/14/2021,2021.0
11,Detroit Mercy (MAAC),6,3-3,82,49,131,0.626,04/14/2021,2021.0
12,Bryant (NEC),7,5-2,113,69,182,0.621,04/14/2021,2021.0
13,Hobart (NEC),5,3-2,81,51,132,0.614,04/14/2021,2021.0
14,Duke (ACC),11,10-1,190,120,310,0.613,04/14/2021,2021.0
15,Canisius (MAAC),6,3-3,82,53,135,0.607,04/14/2021,2021.0
16,Mercer (SoCon),9,4-5,137,95,232,0.591,04/14/2021,2021.0
17,Binghamton (America East),6,3-3,73,51,124,0.589,04/14/2021,2021.0
18,LIU (NEC),7,5-2,111,87,198,0.561,04/14/2021,2021.0
19,Penn St. (Big Ten),8,2-6,120,96,216,0.556,04/14/2021,2021.0
20,Loyola Maryland (Patriot),9,5-4,126,101,227,0.555,04/14/2021,2021.0
21,Jacksonville (SoCon),10,6-4,143,117,260,0.550,04/14/2021,2021.0
22,North Carolina (ACC),10,8-2,172,143,315,0.546,04/14/2021,2021.0
23,Utah (DI Independent),8,3-5,103,86,189,0.545,04/14/2021,2021.0
24,Ohio St. (Big Ten),8,4-4,122,102,224,0.545,04/14/2021,2021.0
25,Michigan (Big Ten),8,2-6,125,106,231,0.541,04/14/2021,2021.0
26,Fairfield (CAA),8,2-6,120,104,224,0.536,04/14/2021,2021.0
27,Stony Brook (America East),10,7-3,150,134,284,0.528,04/14/2021,2021.0
28,Richmond (SoCon),8,4-4,111,100,211,0.526,04/14/2021,2021.0
29,Colgate (Patriot),7,2-5,103,94,197,0.523,04/14/2021,2021.0
30,Villanova (Big East),7,4-3,90,83,173,0.520,04/14/2021,2021.0
31,Johns Hopkins (Big Ten),8,2-6,103,105,208,0.495,04/14/2021,2021.0
32,Delaware (CAA),9,7-2,125,128,253,0.494,04/14/2021,2021.0
33,UAlbany (America East),9,6-3,120,123,243,0.494,04/14/2021,2021.0
34,UMBC (America East),7,5-2,78,80,158,0.494,04/14/2021,2021.0
35,Massachusetts (CAA),6,3-3,77,80,157,0.490,04/14/2021,2021.0
36,Providence (Big East),10,4-6,137,143,280,0.489,04/14/2021,2021.0
37,Drexel (CAA),7,5-2,97,106,203,0.478,04/14/2021,2021.0
38,Syracuse (ACC),8,5-3,115,126,241,0.477,04/14/2021,2021.0
39,Maryland (Big Ten),8,8-0,111,126,237,0.468,04/14/2021,2021.0
40,High Point (SoCon),8,3-5,124,141,265,0.468,04/14/2021,2021.0
41,Marist (MAAC),1,1-0,13,15,28,0.464,04/14/2021,2021.0
42,Cleveland St. (DI Independent),7,2-5,70,83,153,0.458,04/14/2021,2021.0
43,Lafayette (Patriot),7,0-7,85,101,186,0.457,04/14/2021,2021.0
44,Bucknell (Patriot),6,2-4,74,88,162,0.457,04/14/2021,2021.0
45,Boston U. (Patriot),8,6-2,93,113,206,0.451,04/14/2021,2021.0
46,Air Force (SoCon),9,2-7,101,123,224,0.451,04/14/2021,2021.0
47,Hartford (America East),6,1-5,67,82,149,0.450,04/14/2021,2021.0
48,Mount St. Mary's (NEC),11,3-8,119,151,270,0.441,04/14/2021,2021.0
49,Holy Cross (Patriot),6,2-4,62,80,142,0.437,04/14/2021,2021.0
50,Army West Point (Patriot),7,5-2,71,103,174,0.408,04/14/2021,2021.0
51,Rutgers (Big Ten),8,6-2,99,145,244,0.406,04/14/2021,2021.0
52,Navy (Patriot),5,3-2,47,69,116,0.405,04/14/2021,2021.0
53,Sacred Heart (NEC),9,1-8,94,141,235,0.400,04/14/2021,2021.0
54,Robert Morris (DI Independent),10,5-5,122,191,313,0.390,04/14/2021,2021.0
55,Wagner (NEC),6,0-6,61,101,162,0.377,04/14/2021,2021.0
56,Towson (CAA),11,5-6,97,163,260,0.373,04/14/2021,2021.0
57,UMass Lowell (America East),7,1-6,70,122,192,0.365,04/14/2021,2021.0
58,St. Bonaventure (MAAC),7,3-4,56,98,154,0.364,04/14/2021,2021.0
59,VMI (SoCon),8,1-7,81,146,227,0.357,04/14/2021,2021.0
60,NJIT (America East),8,1-7,69,126,195,0.354,04/14/2021,2021.0
61,Marquette (Big East),9,2-7,77,141,218,0.353,04/14/2021,2021.0
62,Bellarmine (SoCon),12,3-9,82,190,272,0.301,04/14/2021,2021.0
63,Siena (MAAC),5,0-5,28,71,99,0.283,04/14/2021,2021.0
64,St. John's (NY) (Big East),8,1-7,66,168,234,0.282,04/14/2021,2021.0
65,Manhattan (MAAC),6,3-3,30,99,129,0.233,04/14/2021,2021.0
-,Merrimack (NEC),8,4-4,95,111,206,0.461,04/14/2021,2021.0
1,Quinnipiac (MAAC),5,3-2,74,26,100,0.740,04/13/2021,2021.0
2,Lehigh (Patriot),6,6-0,118,46,164,0.720,04/13/2021,2021.0
3,Monmouth (MAAC),6,5-1,84,38,122,0.689,04/13/2021,2021.0
4,Vermont (America East),8,5-3,147,70,217,0.677,04/13/2021,2021.0
5,Hofstra (CAA),9,6-3,169,81,250,0.676,04/13/2021,2021.0
6,Saint Joseph's (NEC),8,5-3,133,68,201,0.662,04/13/2021,2021.0
7,Notre Dame (ACC),7,6-1,115,60,175,0.657,04/13/2021,2021.0
8,Denver (Big East),11,9-2,197,111,308,0.640,04/13/2021,2021.0
9,Virginia (ACC),11,9-2,211,120,331,0.637,04/13/2021,2021.0
10,Georgetown (Big East),9,8-1,141,84,225,0.627,04/13/2021,2021.0
11,Detroit Mercy (MAAC),6,3-3,82,49,131,0.626,04/13/2021,2021.0
12,Bryant (NEC),7,5-2,113,69,182,0.621,04/13/2021,2021.0
13,Hobart (NEC),5,3-2,81,51,132,0.614,04/13/2021,2021.0
14,Duke (ACC),11,10-1,190,120,310,0.613,04/13/2021,2021.0
15,Canisius (MAAC),6,3-3,82,53,135,0.607,04/13/2021,2021.0
16,Mercer (SoCon),9,4-5,137,95,232,0.591,04/13/2021,2021.0
17,Binghamton (America East),6,3-3,73,51,124,0.589,04/13/2021,2021.0
18,LIU (NEC),7,5-2,111,87,198,0.561,04/13/2021,2021.0
19,Penn St. (Big Ten),8,2-6,120,96,216,0.556,04/13/2021,2021.0
20,Loyola Maryland (Patriot),9,5-4,126,101,227,0.555,04/13/2021,2021.0
21,Jacksonville (SoCon),10,6-4,143,117,260,0.550,04/13/2021,2021.0
22,North Carolina (ACC),10,8-2,172,143,315,0.546,04/13/2021,2021.0
23,Utah (DI Independent),8,3-5,103,86,189,0.545,04/13/2021,2021.0
24,Ohio St. (Big Ten),8,4-4,122,102,224,0.545,04/13/2021,2021.0
25,Michigan (Big Ten),8,2-6,125,106,231,0.541,04/13/2021,2021.0
26,Fairfield (CAA),8,2-6,120,104,224,0.536,04/13/2021,2021.0
27,Stony Brook (America East),10,7-3,150,134,284,0.528,04/13/2021,2021.0
28,Richmond (SoCon),8,4-4,111,100,211,0.526,04/13/2021,2021.0
29,Colgate (Patriot),7,2-5,103,94,197,0.523,04/13/2021,2021.0
30,Villanova (Big East),7,4-3,90,83,173,0.520,04/13/2021,2021.0
31,Johns Hopkins (Big Ten),8,2-6,103,105,208,0.495,04/13/2021,2021.0
32,Delaware (CAA),9,7-2,125,128,253,0.494,04/13/2021,2021.0
33,UAlbany (America East),9,6-3,120,123,243,0.494,04/13/2021,2021.0
34,UMBC (America East),7,5-2,78,80,158,0.494,04/13/2021,2021.0
35,Massachusetts (CAA),6,3-3,77,80,157,0.490,04/13/2021,2021.0
36,Providence (Big East),10,4-6,137,143,280,0.489,04/13/2021,2021.0
37,Drexel (CAA),7,5-2,97,106,203,0.478,04/13/2021,2021.0
38,Syracuse (ACC),8,5-3,115,126,241,0.477,04/13/2021,2021.0
39,Maryland (Big Ten),8,8-0,111,126,237,0.468,04/13/2021,2021.0
40,High Point (SoCon),8,3-5,124,141,265,0.468,04/13/2021,2021.0
41,Marist (MAAC),1,1-0,13,15,28,0.464,04/13/2021,2021.0
42,Cleveland St. (DI Independent),7,2-5,70,83,153,0.458,04/13/2021,2021.0
43,Lafayette (Patriot),7,0-7,85,101,186,0.457,04/13/2021,2021.0
44,Bucknell (Patriot),6,2-4,74,88,162,0.457,04/13/2021,2021.0
45,Mount St. Mary's (NEC),10,2-8,109,131,240,0.454,04/13/2021,2021.0
46,Boston U. (Patriot),8,6-2,93,113,206,0.451,04/13/2021,2021.0
47,Air Force (SoCon),9,2-7,101,123,224,0.451,04/13/2021,2021.0
48,Hartford (America East),6,1-5,67,82,149,0.450,04/13/2021,2021.0
49,Holy Cross (Patriot),6,2-4,62,80,142,0.437,04/13/2021,2021.0
50,Army West Point (Patriot),7,5-2,71,103,174,0.408,04/13/2021,2021.0
51,Rutgers (Big Ten),8,6-2,99,145,244,0.406,04/13/2021,2021.0
52,Navy (Patriot),5,3-2,47,69,116,0.405,04/13/2021,2021.0
53,Robert Morris (DI Independent),10,5-5,122,191,313,0.390,04/13/2021,2021.0
54,Wagner (NEC),6,0-6,61,101,162,0.377,04/13/2021,2021.0
55,Towson (CAA),11,5-6,97,163,260,0.373,04/13/2021,2021.0
56,UMass Lowell (America East),7,1-6,70,122,192,0.365,04/13/2021,2021.0
57,St. Bonaventure (MAAC),7,3-4,56,98,154,0.364,04/13/2021,2021.0
58,Sacred Heart (NEC),8,1-7,74,131,205,0.361,04/13/2021,2021.0
59,VMI (SoCon),8,1-7,81,146,227,0.357,04/13/2021,2021.0
60,NJIT (America East),8,1-7,69,126,195,0.354,04/13/2021,2021.0
61,Marquette (Big East),8,1-7,62,135,197,0.315,04/13/2021,2021.0
62,Bellarmine (SoCon),12,3-9,82,190,272,0.301,04/13/2021,2021.0
63,Siena (MAAC),5,0-5,28,71,99,0.283,04/13/2021,2021.0
64,St. John's (NY) (Big East),7,1-6,60,153,213,0.282,04/13/2021,2021.0
65,Manhattan (MAAC),6,3-3,30,99,129,0.233,04/13/2021,2021.0
-,Merrimack (NEC),8,4-4,95,111,206,0.461,04/13/2021,2021.0
1,Quinnipiac (MAAC),5,3-2,74,26,100,0.740,04/11/2021,2021.0
2,Lehigh (Patriot),6,6-0,118,46,164,0.720,04/11/2021,2021.0
3,Monmouth (MAAC),6,5-1,84,38,122,0.689,04/11/2021,2021.0
4,Vermont (America East),8,5-3,147,70,217,0.677,04/11/2021,2021.0
5,Hofstra (CAA),8,6-2,154,76,230,0.670,04/11/2021,2021.0
6,Saint Joseph's (NEC),8,5-3,133,68,201,0.662,04/11/2021,2021.0
7,Notre Dame (ACC),7,6-1,115,60,175,0.657,04/11/2021,2021.0
8,Denver (Big East),11,9-2,197,111,308,0.640,04/11/2021,2021.0
9,Virginia (ACC),11,9-2,211,120,331,0.637,04/11/2021,2021.0
10,Georgetown (Big East),9,8-1,141,84,225,0.627,04/11/2021,2021.0
11,Detroit Mercy (MAAC),6,3-3,82,49,131,0.626,04/11/2021,2021.0
12,Bryant (NEC),7,5-2,113,69,182,0.621,04/11/2021,2021.0
13,Hobart (NEC),5,3-2,81,51,132,0.614,04/11/2021,2021.0
14,Duke (ACC),11,10-1,190,120,310,0.613,04/11/2021,2021.0
15,Canisius (MAAC),6,3-3,82,53,135,0.607,04/11/2021,2021.0
16,Mercer (SoCon),9,4-5,137,95,232,0.591,04/11/2021,2021.0
17,Binghamton (America East),6,3-3,73,51,124,0.589,04/11/2021,2021.0
18,LIU (NEC),7,5-2,111,87,198,0.561,04/11/2021,2021.0
19,Penn St. (Big Ten),8,2-6,120,96,216,0.556,04/11/2021,2021.0
20,Loyola Maryland (Patriot),9,5-4,126,101,227,0.555,04/11/2021,2021.0
21,Jacksonville (SoCon),10,6-4,143,117,260,0.550,04/11/2021,2021.0
22,North Carolina (ACC),10,8-2,172,143,315,0.546,04/11/2021,2021.0
23,Utah (DI Independent),8,3-5,103,86,189,0.545,04/11/2021,2021.0
24,Ohio St. (Big Ten),8,4-4,122,102,224,0.545,04/11/2021,2021.0
25,Michigan (Big Ten),8,2-6,125,106,231,0.541,04/11/2021,2021.0
26,Fairfield (CAA),8,2-6,120,104,224,0.536,04/11/2021,2021.0
27,Stony Brook (America East),10,7-3,150,134,284,0.528,04/11/2021,2021.0
28,Richmond (SoCon),8,4-4,111,100,211,0.526,04/11/2021,2021.0
29,Colgate (Patriot),7,2-5,103,94,197,0.523,04/11/2021,2021.0
30,Villanova (Big East),7,4-3,90,83,173,0.520,04/11/2021,2021.0
31,Johns Hopkins (Big Ten),8,2-6,103,105,208,0.495,04/11/2021,2021.0
32,Delaware (CAA),9,7-2,125,128,253,0.494,04/11/2021,2021.0
33,UAlbany (America East),9,6-3,120,123,243,0.494,04/11/2021,2021.0
34,UMBC (America East),7,5-2,78,80,158,0.494,04/11/2021,2021.0
35,Massachusetts (CAA),6,3-3,77,80,157,0.490,04/11/2021,2021.0
36,Providence (Big East),10,4-6,137,143,280,0.489,04/11/2021,2021.0
37,Drexel (CAA),7,5-2,97,106,203,0.478,04/11/2021,2021.0
38,Syracuse (ACC),8,5-3,115,126,241,0.477,04/11/2021,2021.0
39,Maryland (Big Ten),8,8-0,111,126,237,0.468,04/11/2021,2021.0
40,High Point (SoCon),8,3-5,124,141,265,0.468,04/11/2021,2021.0
41,Marist (MAAC),1,1-0,13,15,28,0.464,04/11/2021,2021.0
42,Cleveland St. (DI Independent),7,2-5,70,83,153,0.458,04/11/2021,2021.0
43,Lafayette (Patriot),7,0-7,85,101,186,0.457,04/11/2021,2021.0
44,Bucknell (Patriot),6,2-4,74,88,162,0.457,04/11/2021,2021.0
45,Mount St. Mary's (NEC),10,2-8,109,131,240,0.454,04/11/2021,2021.0
46,Boston U. (Patriot),8,6-2,93,113,206,0.451,04/11/2021,2021.0
47,Air Force (SoCon),9,2-7,101,123,224,0.451,04/11/2021,2021.0
48,Hartford (America East),6,1-5,67,82,149,0.450,04/11/2021,2021.0
49,Holy Cross (Patriot),6,2-4,62,80,142,0.437,04/11/2021,2021.0
50,Army West Point (Patriot),7,5-2,71,103,174,0.408,04/11/2021,2021.0
51,Rutgers (Big Ten),8,6-2,99,145,244,0.406,04/11/2021,2021.0
52,Navy (Patriot),5,3-2,47,69,116,0.405,04/11/2021,2021.0
53,Robert Morris (DI Independent),10,5-5,122,191,313,0.390,04/11/2021,2021.0
54,Towson (CAA),10,4-6,92,148,240,0.383,04/11/2021,2021.0
55,Wagner (NEC),6,0-6,61,101,162,0.377,04/11/2021,2021.0
56,UMass Lowell (America East),7,1-6,70,122,192,0.365,04/11/2021,2021.0
57,St. Bonaventure (MAAC),7,3-4,56,98,154,0.364,04/11/2021,2021.0
58,Sacred Heart (NEC),8,1-7,74,131,205,0.361,04/11/2021,2021.0
59,VMI (SoCon),8,1-7,81,146,227,0.357,04/11/2021,2021.0
60,NJIT (America East),8,1-7,69,126,195,0.354,04/11/2021,2021.0
61,Marquette (Big East),8,1-7,62,135,197,0.315,04/11/2021,2021.0
62,Bellarmine (SoCon),12,3-9,82,190,272,0.301,04/11/2021,2021.0
63,Siena (MAAC),5,0-5,28,71,99,0.283,04/11/2021,2021.0
64,St. John's (NY) (Big East),7,1-6,60,153,213,0.282,04/11/2021,2021.0
65,Manhattan (MAAC),6,3-3,30,99,129,0.233,04/11/2021,2021.0
-,Merrimack (NEC),8,4-4,95,111,206,0.461,04/11/2021,2021.0
1,Quinnipiac (MAAC),5,3-2,74,26,100,0.740,04/10/2021,2021.0
2,Lehigh (Patriot),6,6-0,118,46,164,0.720,04/10/2021,2021.0
3,Monmouth (MAAC),6,5-1,84,38,122,0.689,04/10/2021,2021.0
4,Vermont (America East),8,5-3,147,70,217,0.677,04/10/2021,2021.0
5,Hofstra (CAA),8,6-2,154,76,230,0.670,04/10/2021,2021.0
6,Saint Joseph's (NEC),8,5-3,133,68,201,0.662,04/10/2021,2021.0
7,Notre Dame (ACC),7,6-1,115,60,175,0.657,04/10/2021,2021.0
8,Denver (Big East),11,9-2,197,111,308,0.640,04/10/2021,2021.0
9,Virginia (ACC),11,9-2,211,120,331,0.637,04/10/2021,2021.0
10,Georgetown (Big East),9,8-1,141,84,225,0.627,04/10/2021,2021.0
11,Detroit Mercy (MAAC),6,3-3,82,49,131,0.626,04/10/2021,2021.0
12,Bryant (NEC),7,5-2,113,69,182,0.621,04/10/2021,2021.0
13,Hobart (NEC),5,3-2,81,51,132,0.614,04/10/2021,2021.0
14,Duke (ACC),11,10-1,190,120,310,0.613,04/10/2021,2021.0
15,Canisius (MAAC),5,3-2,67,43,110,0.609,04/10/2021,2021.0
16,Mercer (SoCon),9,4-5,137,95,232,0.591,04/10/2021,2021.0
17,Binghamton (America East),6,3-3,73,51,124,0.589,04/10/2021,2021.0
18,LIU (NEC),7,5-2,111,87,198,0.561,04/10/2021,2021.0
19,Penn St. (Big Ten),8,2-6,120,96,216,0.556,04/10/2021,2021.0
20,Loyola Maryland (Patriot),9,5-4,126,101,227,0.555,04/10/2021,2021.0
21,Jacksonville (SoCon),10,6-4,143,117,260,0.550,04/10/2021,2021.0
22,North Carolina (ACC),10,8-2,172,143,315,0.546,04/10/2021,2021.0
23,Utah (DI Independent),8,3-5,103,86,189,0.545,04/10/2021,2021.0
24,Ohio St. (Big Ten),8,4-4,122,102,224,0.545,04/10/2021,2021.0
25,Michigan (Big Ten),8,2-6,125,106,231,0.541,04/10/2021,2021.0
26,Fairfield (CAA),8,2-6,120,104,224,0.536,04/10/2021,2021.0
27,Stony Brook (America East),10,7-3,150,134,284,0.528,04/10/2021,2021.0
28,Richmond (SoCon),8,4-4,111,100,211,0.526,04/10/2021,2021.0
29,Colgate (Patriot),7,2-5,103,94,197,0.523,04/10/2021,2021.0
30,Villanova (Big East),7,4-3,90,83,173,0.520,04/10/2021,2021.0
31,Johns Hopkins (Big Ten),8,2-6,103,105,208,0.495,04/10/2021,2021.0
32,Delaware (CAA),9,7-2,125,128,253,0.494,04/10/2021,2021.0
33,UAlbany (America East),8,5-3,107,110,217,0.493,04/10/2021,2021.0
34,UMBC (America East),6,5-1,65,67,132,0.492,04/10/2021,2021.0
35,Massachusetts (CAA),6,3-3,77,80,157,0.490,04/10/2021,2021.0
36,Providence (Big East),10,4-6,137,143,280,0.489,04/10/2021,2021.0
37,Drexel (CAA),7,5-2,97,106,203,0.478,04/10/2021,2021.0
38,Syracuse (ACC),8,5-3,115,126,241,0.477,04/10/2021,2021.0
39,Maryland (Big Ten),8,8-0,111,126,237,0.468,04/10/2021,2021.0
40,High Point (SoCon),8,3-5,124,141,265,0.468,04/10/2021,2021.0
41,Marist (MAAC),1,1-0,13,15,28,0.464,04/10/2021,2021.0
42,Cleveland St. (DI Independent),7,2-5,70,83,153,0.458,04/10/2021,2021.0
43,Lafayette (Patriot),7,0-7,85,101,186,0.457,04/10/2021,2021.0
44,Bucknell (Patriot),6,2-4,74,88,162,0.457,04/10/2021,2021.0
45,Mount St. Mary's (NEC),10,2-8,109,131,240,0.454,04/10/2021,2021.0
46,Boston U. (Patriot),8,6-2,93,113,206,0.451,04/10/2021,2021.0
47,Air Force (SoCon),9,2-7,101,123,224,0.451,04/10/2021,2021.0
48,Hartford (America East),6,1-5,67,82,149,0.450,04/10/2021,2021.0
49,Holy Cross (Patriot),6,2-4,62,80,142,0.437,04/10/2021,2021.0
50,Army West Point (Patriot),7,5-2,71,103,174,0.408,04/10/2021,2021.0
51,Rutgers (Big Ten),8,6-2,99,145,244,0.406,04/10/2021,2021.0
52,Navy (Patriot),5,3-2,47,69,116,0.405,04/10/2021,2021.0
53,Robert Morris (DI Independent),10,5-5,122,191,313,0.390,04/10/2021,2021.0
54,Towson (CAA),10,4-6,92,148,240,0.383,04/10/2021,2021.0
55,Wagner (NEC),6,0-6,61,101,162,0.377,04/10/2021,2021.0
56,UMass Lowell (America East),7,1-6,70,122,192,0.365,04/10/2021,2021.0
57,Sacred Heart (NEC),8,1-7,74,131,205,0.361,04/10/2021,2021.0
58,VMI (SoCon),8,1-7,81,146,227,0.357,04/10/2021,2021.0
59,St. Bonaventure (MAAC),6,2-4,46,83,129,0.357,04/10/2021,2021.0
60,NJIT (America East),8,1-7,69,126,195,0.354,04/10/2021,2021.0
61,Marquette (Big East),8,1-7,62,135,197,0.315,04/10/2021,2021.0
62,Bellarmine (SoCon),12,3-9,82,190,272,0.301,04/10/2021,2021.0
63,Siena (MAAC),5,0-5,28,71,99,0.283,04/10/2021,2021.0
64,St. John's (NY) (Big East),7,1-6,60,153,213,0.282,04/10/2021,2021.0
65,Manhattan (MAAC),6,3-3,30,99,129,0.233,04/10/2021,2021.0
-,Merrimack (NEC),8,4-4,95,111,206,0.461,04/10/2021,2021.0
1,Notre Dame (ACC),6,5-1,108,44,152,0.711,04/09/2021,2021.0
2,Lehigh (Patriot),5,5-0,100,41,141,0.709,04/09/2021,2021.0
3,Monmouth (MAAC),6,5-1,84,38,122,0.689,04/09/2021,2021.0
4,Saint Joseph's (NEC),7,4-3,119,54,173,0.688,04/09/2021,2021.0
5,Vermont (America East),7,4-3,129,63,192,0.672,04/09/2021,2021.0
6,Quinnipiac (MAAC),4,2-2,47,23,70,0.671,04/09/2021,2021.0
7,Hofstra (CAA),8,6-2,154,76,230,0.670,04/09/2021,2021.0
8,Hobart (NEC),4,3-1,67,37,104,0.644,04/09/2021,2021.0
9,Denver (Big East),10,8-2,179,99,278,0.644,04/09/2021,2021.0
10,Virginia (ACC),10,8-2,185,108,293,0.631,04/09/2021,2021.0
11,Binghamton (America East),5,3-2,66,39,105,0.629,04/09/2021,2021.0
12,Detroit Mercy (MAAC),6,3-3,82,49,131,0.626,04/09/2021,2021.0
13,Georgetown (Big East),8,7-1,127,76,203,0.626,04/09/2021,2021.0
14,Bryant (NEC),7,5-2,113,69,182,0.621,04/09/2021,2021.0
15,Canisius (MAAC),5,3-2,67,43,110,0.609,04/09/2021,2021.0
16,Duke (ACC),10,10-0,174,113,287,0.606,04/09/2021,2021.0
17,Mercer (SoCon),9,4-5,137,95,232,0.591,04/09/2021,2021.0
18,North Carolina (ACC),9,8-1,160,117,277,0.578,04/09/2021,2021.0
19,LIU (NEC),7,5-2,111,87,198,0.561,04/09/2021,2021.0
20,Ohio St. (Big Ten),7,3-4,108,86,194,0.557,04/09/2021,2021.0
21,Jacksonville (SoCon),9,5-4,133,107,240,0.554,04/09/2021,2021.0
22,Michigan (Big Ten),7,2-5,110,89,199,0.553,04/09/2021,2021.0
23,Villanova (Big East),6,4-2,78,65,143,0.545,04/09/2021,2021.0
24,Utah (DI Independent),8,3-5,103,86,189,0.545,04/09/2021,2021.0
25,Penn St. (Big Ten),7,2-5,98,83,181,0.541,04/09/2021,2021.0
26,Loyola Maryland (Patriot),8,5-3,110,94,204,0.539,04/09/2021,2021.0
27,Stony Brook (America East),9,6-3,139,122,261,0.533,04/09/2021,2021.0
28,Richmond (SoCon),8,4-4,111,100,211,0.526,04/09/2021,2021.0
29,Fairfield (CAA),7,2-5,103,95,198,0.520,04/09/2021,2021.0
30,Colgate (Patriot),6,2-4,88,82,170,0.518,04/09/2021,2021.0
31,UAlbany (America East),8,5-3,107,110,217,0.493,04/09/2021,2021.0
32,UMBC (America East),6,5-1,65,67,132,0.492,04/09/2021,2021.0
33,Massachusetts (CAA),6,3-3,77,80,157,0.490,04/09/2021,2021.0
34,Johns Hopkins (Big Ten),7,2-5,87,91,178,0.489,04/09/2021,2021.0
35,Delaware (CAA),8,7-1,111,117,228,0.487,04/09/2021,2021.0
36,Drexel (CAA),6,4-2,86,92,178,0.483,04/09/2021,2021.0
37,Syracuse (ACC),8,5-3,115,126,241,0.477,04/09/2021,2021.0
38,Mount St. Mary's (NEC),9,2-7,101,112,213,0.474,04/09/2021,2021.0
39,High Point (SoCon),8,3-5,124,141,265,0.468,04/09/2021,2021.0
40,Cleveland St. (DI Independent),6,2-4,60,69,129,0.465,04/09/2021,2021.0
41,Marist (MAAC),1,1-0,13,15,28,0.464,04/09/2021,2021.0
42,Maryland (Big Ten),7,7-0,94,111,205,0.459,04/09/2021,2021.0
43,Lafayette (Patriot),6,0-6,74,88,162,0.457,04/09/2021,2021.0
44,Providence (Big East),9,3-6,113,135,248,0.456,04/09/2021,2021.0
45,Boston U. (Patriot),7,5-2,81,98,179,0.453,04/09/2021,2021.0
46,Navy (Patriot),4,3-1,42,51,93,0.452,04/09/2021,2021.0
47,Air Force (SoCon),8,2-6,91,113,204,0.446,04/09/2021,2021.0
48,Bucknell (Patriot),5,1-4,61,77,138,0.442,04/09/2021,2021.0
49,Holy Cross (Patriot),6,2-4,62,80,142,0.437,04/09/2021,2021.0
50,Army West Point (Patriot),6,4-2,64,87,151,0.424,04/09/2021,2021.0
51,Hartford (America East),5,0-5,55,75,130,0.423,04/09/2021,2021.0
52,Rutgers (Big Ten),7,5-2,86,123,209,0.411,04/09/2021,2021.0
53,Towson (CAA),9,3-6,83,131,214,0.388,04/09/2021,2021.0
54,UMass Lowell (America East),6,1-5,63,104,167,0.377,04/09/2021,2021.0
55,Wagner (NEC),6,0-6,61,101,162,0.377,04/09/2021,2021.0
56,Robert Morris (DI Independent),9,4-5,108,181,289,0.374,04/09/2021,2021.0
57,Sacred Heart (NEC),8,1-7,74,131,205,0.361,04/09/2021,2021.0
58,St. Bonaventure (MAAC),6,2-4,46,83,129,0.357,04/09/2021,2021.0
59,NJIT (America East),7,1-6,57,115,172,0.331,04/09/2021,2021.0
60,VMI (SoCon),7,1-6,67,137,204,0.328,04/09/2021,2021.0
61,Marquette (Big East),7,1-6,54,121,175,0.309,04/09/2021,2021.0
62,Bellarmine (SoCon),11,2-9,73,176,249,0.293,04/09/2021,2021.0
63,St. John's (NY) (Big East),6,1-5,52,129,181,0.287,04/09/2021,2021.0
64,Siena (MAAC),5,0-5,28,71,99,0.283,04/09/2021,2021.0
65,Manhattan (MAAC),5,3-2,27,72,99,0.273,04/09/2021,2021.0
-,Merrimack (NEC),7,3-4,76,103,179,0.425,04/09/2021,2021.0
1,Notre Dame (ACC),6,5-1,108,44,152,0.711,04/08/2021,2021.0
2,Lehigh (Patriot),5,5-0,100,41,141,0.709,04/08/2021,2021.0
3,Monmouth (MAAC),5,4-1,73,30,103,0.709,04/08/2021,2021.0
4,Saint Joseph's (NEC),7,4-3,119,54,173,0.688,04/08/2021,2021.0
5,Vermont (America East),7,4-3,129,63,192,0.672,04/08/2021,2021.0
6,Quinnipiac (MAAC),4,2-2,47,23,70,0.671,04/08/2021,2021.0
7,Hofstra (CAA),7,5-2,136,68,204,0.667,04/08/2021,2021.0
8,Detroit Mercy (MAAC),5,3-2,74,38,112,0.661,04/08/2021,2021.0
9,Hobart (NEC),4,3-1,67,37,104,0.644,04/08/2021,2021.0
10,Denver (Big East),10,8-2,179,99,278,0.644,04/08/2021,2021.0
11,Virginia (ACC),10,8-2,185,108,293,0.631,04/08/2021,2021.0
12,Binghamton (America East),5,3-2,66,39,105,0.629,04/08/2021,2021.0
13,Georgetown (Big East),8,7-1,127,76,203,0.626,04/08/2021,2021.0
14,Bryant (NEC),7,5-2,113,69,182,0.621,04/08/2021,2021.0
15,Canisius (MAAC),5,3-2,67,43,110,0.609,04/08/2021,2021.0
16,Duke (ACC),10,10-0,174,113,287,0.606,04/08/2021,2021.0
17,Mercer (SoCon),9,4-5,137,95,232,0.591,04/08/2021,2021.0
18,North Carolina (ACC),9,8-1,160,117,277,0.578,04/08/2021,2021.0
19,Jacksonville (SoCon),9,5-4,135,104,239,0.565,04/08/2021,2021.0
20,LIU (NEC),7,5-2,111,87,198,0.561,04/08/2021,2021.0
21,Ohio St. (Big Ten),7,3-4,108,86,194,0.557,04/08/2021,2021.0
22,Michigan (Big Ten),7,2-5,110,89,199,0.553,04/08/2021,2021.0
23,Villanova (Big East),6,4-2,78,65,143,0.545,04/08/2021,2021.0
24,Utah (DI Independent),8,3-5,103,86,189,0.545,04/08/2021,2021.0
25,Penn St. (Big Ten),7,2-5,98,83,181,0.541,04/08/2021,2021.0
26,Loyola Maryland (Patriot),8,5-3,110,94,204,0.539,04/08/2021,2021.0
27,Stony Brook (America East),9,6-3,139,122,261,0.533,04/08/2021,2021.0
28,Massachusetts (CAA),5,3-2,69,62,131,0.527,04/08/2021,2021.0
29,Richmond (SoCon),8,4-4,111,100,211,0.526,04/08/2021,2021.0
30,Fairfield (CAA),7,2-5,103,95,198,0.520,04/08/2021,2021.0
31,Colgate (Patriot),6,2-4,88,82,170,0.518,04/08/2021,2021.0
32,UAlbany (America East),8,5-3,107,110,217,0.493,04/08/2021,2021.0
33,UMBC (America East),6,5-1,65,67,132,0.492,04/08/2021,2021.0
34,Johns Hopkins (Big Ten),7,2-5,87,91,178,0.489,04/08/2021,2021.0
35,Delaware (CAA),8,7-1,111,117,228,0.487,04/08/2021,2021.0
36,Drexel (CAA),6,4-2,86,92,178,0.483,04/08/2021,2021.0
37,Syracuse (ACC),8,5-3,115,126,241,0.477,04/08/2021,2021.0
38,Mount St. Mary's (NEC),9,2-7,101,112,213,0.474,04/08/2021,2021.0
39,High Point (SoCon),8,3-5,124,141,265,0.468,04/08/2021,2021.0
40,Cleveland St. (DI Independent),6,2-4,60,69,129,0.465,04/08/2021,2021.0
41,Marist (MAAC),1,1-0,13,15,28,0.464,04/08/2021,2021.0
42,Maryland (Big Ten),7,7-0,94,111,205,0.459,04/08/2021,2021.0
43,Lafayette (Patriot),6,0-6,74,88,162,0.457,04/08/2021,2021.0
44,Providence (Big East),9,3-6,113,135,248,0.456,04/08/2021,2021.0
45,Boston U. (Patriot),7,5-2,81,98,179,0.453,04/08/2021,2021.0
46,Navy (Patriot),4,3-1,42,51,93,0.452,04/08/2021,2021.0
47,Air Force (SoCon),8,2-6,91,113,204,0.446,04/08/2021,2021.0
48,Bucknell (Patriot),5,1-4,61,77,138,0.442,04/08/2021,2021.0
49,Holy Cross (Patriot),6,2-4,62,80,142,0.437,04/08/2021,2021.0
50,Army West Point (Patriot),6,4-2,64,87,151,0.424,04/08/2021,2021.0
51,Hartford (America East),5,0-5,55,75,130,0.423,04/08/2021,2021.0
52,Rutgers (Big Ten),7,5-2,86,123,209,0.411,04/08/2021,2021.0
53,Towson (CAA),9,3-6,83,131,214,0.388,04/08/2021,2021.0
54,UMass Lowell (America East),6,1-5,63,104,167,0.377,04/08/2021,2021.0
55,Wagner (NEC),6,0-6,61,101,162,0.377,04/08/2021,2021.0
56,Robert Morris (DI Independent),9,4-5,108,181,289,0.374,04/08/2021,2021.0
57,Sacred Heart (NEC),8,1-7,74,131,205,0.361,04/08/2021,2021.0
58,St. Bonaventure (MAAC),6,2-4,46,83,129,0.357,04/08/2021,2021.0
59,NJIT (America East),7,1-6,57,115,172,0.331,04/08/2021,2021.0
60,VMI (SoCon),7,1-6,67,137,204,0.328,04/08/2021,2021.0
61,Marquette (Big East),7,1-6,54,121,175,0.309,04/08/2021,2021.0
62,Bellarmine (SoCon),11,2-9,73,176,249,0.293,04/08/2021,2021.0
63,St. John's (NY) (Big East),6,1-5,52,129,181,0.287,04/08/2021,2021.0
64,Siena (MAAC),5,0-5,28,71,99,0.283,04/08/2021,2021.0
65,Manhattan (MAAC),5,3-2,27,72,99,0.273,04/08/2021,2021.0
-,Merrimack (NEC),7,3-4,76,103,179,0.425,04/08/2021,2021.0
1,Notre Dame (ACC),6,5-1,108,44,152,0.711,04/07/2021,2021.0
2,Lehigh (Patriot),5,5-0,100,41,141,0.709,04/07/2021,2021.0
3,Monmouth (MAAC),5,4-1,73,30,103,0.709,04/07/2021,2021.0
4,Saint Joseph's (NEC),7,4-3,119,54,173,0.688,04/07/2021,2021.0
5,Vermont (America East),7,4-3,129,63,192,0.672,04/07/2021,2021.0
6,Quinnipiac (MAAC),4,2-2,47,23,70,0.671,04/07/2021,2021.0
7,Hofstra (CAA),7,5-2,136,68,204,0.667,04/07/2021,2021.0
8,Detroit Mercy (MAAC),5,3-2,74,38,112,0.661,04/07/2021,2021.0
9,Hobart (NEC),4,3-1,67,37,104,0.644,04/07/2021,2021.0
10,Denver (Big East),10,8-2,179,99,278,0.644,04/07/2021,2021.0
11,Virginia (ACC),10,8-2,185,108,293,0.631,04/07/2021,2021.0
12,Binghamton (America East),5,3-2,66,39,105,0.629,04/07/2021,2021.0
13,Georgetown (Big East),8,7-1,127,76,203,0.626,04/07/2021,2021.0
14,Bryant (NEC),7,5-2,113,69,182,0.621,04/07/2021,2021.0
15,Canisius (MAAC),5,3-2,67,43,110,0.609,04/07/2021,2021.0
16,Duke (ACC),10,10-0,174,113,287,0.606,04/07/2021,2021.0
17,Mercer (SoCon),9,4-5,137,95,232,0.591,04/07/2021,2021.0
18,North Carolina (ACC),9,8-1,160,117,277,0.578,04/07/2021,2021.0
19,Jacksonville (SoCon),9,5-4,135,104,239,0.565,04/07/2021,2021.0
20,LIU (NEC),7,5-2,111,87,198,0.561,04/07/2021,2021.0
21,Ohio St. (Big Ten),7,3-4,108,86,194,0.557,04/07/2021,2021.0
22,Michigan (Big Ten),7,2-5,110,89,199,0.553,04/07/2021,2021.0
23,Villanova (Big East),6,4-2,78,65,143,0.545,04/07/2021,2021.0
24,Utah (DI Independent),8,3-5,103,86,189,0.545,04/07/2021,2021.0
25,Penn St. (Big Ten),7,2-5,98,83,181,0.541,04/07/2021,2021.0
26,Loyola Maryland (Patriot),8,5-3,110,94,204,0.539,04/07/2021,2021.0
27,Stony Brook (America East),9,6-3,139,122,261,0.533,04/07/2021,2021.0
28,Massachusetts (CAA),5,3-2,69,62,131,0.527,04/07/2021,2021.0
29,Richmond (SoCon),8,4-4,111,100,211,0.526,04/07/2021,2021.0
30,Fairfield (CAA),7,2-5,103,95,198,0.520,04/07/2021,2021.0
31,Colgate (Patriot),6,2-4,88,82,170,0.518,04/07/2021,2021.0
32,UAlbany (America East),7,5-2,97,95,192,0.505,04/07/2021,2021.0
33,UMBC (America East),6,5-1,65,67,132,0.492,04/07/2021,2021.0
34,Johns Hopkins (Big Ten),7,2-5,87,91,178,0.489,04/07/2021,2021.0
35,Delaware (CAA),8,7-1,111,117,228,0.487,04/07/2021,2021.0
36,Drexel (CAA),6,4-2,86,92,178,0.483,04/07/2021,2021.0
37,Mount St. Mary's (NEC),9,2-7,101,112,213,0.474,04/07/2021,2021.0
38,High Point (SoCon),8,3-5,124,141,265,0.468,04/07/2021,2021.0
39,Cleveland St. (DI Independent),6,2-4,60,69,129,0.465,04/07/2021,2021.0
40,Marist (MAAC),1,1-0,13,15,28,0.464,04/07/2021,2021.0
41,Syracuse (ACC),7,4-3,100,116,216,0.463,04/07/2021,2021.0
42,Maryland (Big Ten),7,7-0,94,111,205,0.459,04/07/2021,2021.0
43,Lafayette (Patriot),6,0-6,74,88,162,0.457,04/07/2021,2021.0
44,Providence (Big East),9,3-6,113,135,248,0.456,04/07/2021,2021.0
45,Boston U. (Patriot),7,5-2,81,98,179,0.453,04/07/2021,2021.0
46,Navy (Patriot),4,3-1,42,51,93,0.452,04/07/2021,2021.0
47,Air Force (SoCon),8,2-6,91,113,204,0.446,04/07/2021,2021.0
48,Bucknell (Patriot),5,1-4,61,77,138,0.442,04/07/2021,2021.0
49,Holy Cross (Patriot),6,2-4,62,80,142,0.437,04/07/2021,2021.0
50,Army West Point (Patriot),6,4-2,64,87,151,0.424,04/07/2021,2021.0
51,Hartford (America East),5,0-5,55,75,130,0.423,04/07/2021,2021.0
52,Rutgers (Big Ten),7,5-2,86,123,209,0.411,04/07/2021,2021.0
53,Towson (CAA),9,3-6,83,131,214,0.388,04/07/2021,2021.0
54,UMass Lowell (America East),6,1-5,63,104,167,0.377,04/07/2021,2021.0
55,Wagner (NEC),6,0-6,61,101,162,0.377,04/07/2021,2021.0
56,Robert Morris (DI Independent),9,4-5,108,181,289,0.374,04/07/2021,2021.0
57,Sacred Heart (NEC),8,1-7,74,131,205,0.361,04/07/2021,2021.0
58,St. Bonaventure (MAAC),6,2-4,46,83,129,0.357,04/07/2021,2021.0
59,NJIT (America East),7,1-6,57,115,172,0.331,04/07/2021,2021.0
60,VMI (SoCon),7,1-6,67,137,204,0.328,04/07/2021,2021.0
61,Marquette (Big East),7,1-6,54,121,175,0.309,04/07/2021,2021.0
62,Bellarmine (SoCon),11,2-9,73,176,249,0.293,04/07/2021,2021.0
63,St. John's (NY) (Big East),6,1-5,52,129,181,0.287,04/07/2021,2021.0
64,Siena (MAAC),5,0-5,28,71,99,0.283,04/07/2021,2021.0
65,Manhattan (MAAC),5,3-2,27,72,99,0.273,04/07/2021,2021.0
-,Merrimack (NEC),7,3-4,76,103,179,0.425,04/07/2021,2021.0
1,Notre Dame (ACC),6,5-1,108,44,152,0.711,04/04/2021,2021.0
2,Lehigh (Patriot),5,5-0,100,41,141,0.709,04/04/2021,2021.0
3,Monmouth (MAAC),5,4-1,73,30,103,0.709,04/04/2021,2021.0
4,Saint Joseph's (NEC),7,4-3,119,54,173,0.688,04/04/2021,2021.0
5,Vermont (America East),7,4-3,129,63,192,0.672,04/04/2021,2021.0
6,Hofstra (CAA),7,5-2,136,68,204,0.667,04/04/2021,2021.0
7,Detroit Mercy (MAAC),5,3-2,74,38,112,0.661,04/04/2021,2021.0
8,Hobart (NEC),4,3-1,67,37,104,0.644,04/04/2021,2021.0
9,Denver (Big East),10,8-2,179,99,278,0.644,04/04/2021,2021.0
10,Virginia (ACC),10,8-2,185,108,293,0.631,04/04/2021,2021.0
11,Binghamton (America East),5,3-2,66,39,105,0.629,04/04/2021,2021.0
12,Georgetown (Big East),8,7-1,127,76,203,0.626,04/04/2021,2021.0
13,Bryant (NEC),7,5-2,113,69,182,0.621,04/04/2021,2021.0
14,Duke (ACC),10,10-0,174,113,287,0.606,04/04/2021,2021.0
15,Quinnipiac (MAAC),3,1-2,33,22,55,0.600,04/04/2021,2021.0
16,Mercer (SoCon),9,4-5,137,95,232,0.591,04/04/2021,2021.0
17,Canisius (MAAC),4,2-2,50,36,86,0.581,04/04/2021,2021.0
18,North Carolina (ACC),9,8-1,160,117,277,0.578,04/04/2021,2021.0
19,Jacksonville (SoCon),9,5-4,135,104,239,0.565,04/04/2021,2021.0
20,LIU (NEC),7,5-2,111,87,198,0.561,04/04/2021,2021.0
21,Ohio St. (Big Ten),7,3-4,108,86,194,0.557,04/04/2021,2021.0
22,Michigan (Big Ten),7,2-5,110,89,199,0.553,04/04/2021,2021.0
23,Villanova (Big East),6,4-2,78,65,143,0.545,04/04/2021,2021.0
24,Utah (DI Independent),8,3-5,103,86,189,0.545,04/04/2021,2021.0
25,Penn St. (Big Ten),7,2-5,98,83,181,0.541,04/04/2021,2021.0
26,Loyola Maryland (Patriot),8,5-3,110,94,204,0.539,04/04/2021,2021.0
27,Stony Brook (America East),9,6-3,139,122,261,0.533,04/04/2021,2021.0
28,Massachusetts (CAA),5,3-2,69,62,131,0.527,04/04/2021,2021.0
29,Richmond (SoCon),8,4-4,111,100,211,0.526,04/04/2021,2021.0
30,Fairfield (CAA),7,2-5,103,95,198,0.520,04/04/2021,2021.0
31,Colgate (Patriot),6,2-4,88,82,170,0.518,04/04/2021,2021.0
32,UAlbany (America East),7,5-2,97,95,192,0.505,04/04/2021,2021.0
33,UMBC (America East),6,5-1,65,67,132,0.492,04/04/2021,2021.0
34,Johns Hopkins (Big Ten),7,2-5,87,91,178,0.489,04/04/2021,2021.0
35,Delaware (CAA),8,7-1,111,117,228,0.487,04/04/2021,2021.0
36,Drexel (CAA),6,4-2,86,92,178,0.483,04/04/2021,2021.0
37,High Point (SoCon),8,3-5,124,141,265,0.468,04/04/2021,2021.0
38,Cleveland St. (DI Independent),6,2-4,60,69,129,0.465,04/04/2021,2021.0
39,Marist (MAAC),1,1-0,13,15,28,0.464,04/04/2021,2021.0
40,Syracuse (ACC),7,4-3,100,116,216,0.463,04/04/2021,2021.0
41,Maryland (Big Ten),7,7-0,94,111,205,0.459,04/04/2021,2021.0
42,Lafayette (Patriot),6,0-6,74,88,162,0.457,04/04/2021,2021.0
43,Providence (Big East),9,3-6,113,135,248,0.456,04/04/2021,2021.0
44,Mount St. Mary's (NEC),8,1-7,84,101,185,0.454,04/04/2021,2021.0
45,Boston U. (Patriot),7,5-2,81,98,179,0.453,04/04/2021,2021.0
46,Navy (Patriot),4,3-1,42,51,93,0.452,04/04/2021,2021.0
47,Air Force (SoCon),8,2-6,91,113,204,0.446,04/04/2021,2021.0
48,Bucknell (Patriot),5,1-4,61,77,138,0.442,04/04/2021,2021.0
49,Holy Cross (Patriot),6,2-4,62,80,142,0.437,04/04/2021,2021.0
50,Army West Point (Patriot),6,4-2,64,87,151,0.424,04/04/2021,2021.0
51,Hartford (America East),5,0-5,55,75,130,0.423,04/04/2021,2021.0
52,Rutgers (Big Ten),7,5-2,86,123,209,0.411,04/04/2021,2021.0
53,Towson (CAA),9,3-6,83,131,214,0.388,04/04/2021,2021.0
54,UMass Lowell (America East),6,1-5,63,104,167,0.377,04/04/2021,2021.0
55,Wagner (NEC),6,0-6,61,101,162,0.377,04/04/2021,2021.0
56,St. Bonaventure (MAAC),5,2-3,39,66,105,0.371,04/04/2021,2021.0
57,Robert Morris (DI Independent),9,4-5,105,183,288,0.365,04/04/2021,2021.0
58,Sacred Heart (NEC),8,1-7,74,131,205,0.361,04/04/2021,2021.0
59,NJIT (America East),7,1-6,57,115,172,0.331,04/04/2021,2021.0
60,Siena (MAAC),4,0-4,27,57,84,0.321,04/04/2021,2021.0
61,VMI (SoCon),6,1-5,56,120,176,0.318,04/04/2021,2021.0
62,Marquette (Big East),7,1-6,54,121,175,0.309,04/04/2021,2021.0
63,Bellarmine (SoCon),11,2-9,73,176,249,0.293,04/04/2021,2021.0
64,St. John's (NY) (Big East),6,1-5,52,129,181,0.287,04/04/2021,2021.0
65,Manhattan (MAAC),5,3-2,27,72,99,0.273,04/04/2021,2021.0
-,Merrimack (NEC),7,3-4,76,103,179,0.425,04/04/2021,2021.0
1,Notre Dame (ACC),6,5-1,108,44,152,0.711,04/03/2021,2021.0
2,Lehigh (Patriot),5,5-0,100,41,141,0.709,04/03/2021,2021.0
3,Monmouth (MAAC),5,4-1,73,30,103,0.709,04/03/2021,2021.0
4,Saint Joseph's (NEC),7,4-3,119,54,173,0.688,04/03/2021,2021.0
5,Vermont (America East),7,4-3,129,63,192,0.672,04/03/2021,2021.0
6,Hofstra (CAA),7,5-2,136,68,204,0.667,04/03/2021,2021.0
7,Detroit Mercy (MAAC),5,3-2,74,38,112,0.661,04/03/2021,2021.0
8,Hobart (NEC),4,3-1,67,37,104,0.644,04/03/2021,2021.0
9,Denver (Big East),10,8-2,179,99,278,0.644,04/03/2021,2021.0
10,Virginia (ACC),10,8-2,185,108,293,0.631,04/03/2021,2021.0
11,Binghamton (America East),5,3-2,66,39,105,0.629,04/03/2021,2021.0
12,Georgetown (Big East),8,7-1,127,76,203,0.626,04/03/2021,2021.0
13,Bryant (NEC),7,5-2,113,69,182,0.621,04/03/2021,2021.0
14,Duke (ACC),10,10-0,174,113,287,0.606,04/03/2021,2021.0
15,Quinnipiac (MAAC),3,1-2,33,22,55,0.600,04/03/2021,2021.0
16,Mercer (SoCon),9,4-5,137,95,232,0.591,04/03/2021,2021.0
17,Canisius (MAAC),4,2-2,50,36,86,0.581,04/03/2021,2021.0
18,North Carolina (ACC),9,8-1,160,117,277,0.578,04/03/2021,2021.0
19,Jacksonville (SoCon),9,5-4,135,104,239,0.565,04/03/2021,2021.0
20,Michigan (Big Ten),6,1-5,98,76,174,0.563,04/03/2021,2021.0
21,LIU (NEC),7,5-2,111,87,198,0.561,04/03/2021,2021.0
22,Ohio St. (Big Ten),7,3-4,108,86,194,0.557,04/03/2021,2021.0
23,Villanova (Big East),6,4-2,78,65,143,0.545,04/03/2021,2021.0
24,Utah (DI Independent),8,3-5,103,86,189,0.545,04/03/2021,2021.0
25,Penn St. (Big Ten),7,2-5,98,83,181,0.541,04/03/2021,2021.0
26,Loyola Maryland (Patriot),8,5-3,110,94,204,0.539,04/03/2021,2021.0
27,Stony Brook (America East),9,6-3,139,122,261,0.533,04/03/2021,2021.0
28,Massachusetts (CAA),5,3-2,69,62,131,0.527,04/03/2021,2021.0
29,Richmond (SoCon),8,4-4,111,100,211,0.526,04/03/2021,2021.0
30,Fairfield (CAA),7,2-5,103,95,198,0.520,04/03/2021,2021.0
31,Colgate (Patriot),6,2-4,88,82,170,0.518,04/03/2021,2021.0
32,UAlbany (America East),7,5-2,97,95,192,0.505,04/03/2021,2021.0
33,UMBC (America East),6,5-1,65,67,132,0.492,04/03/2021,2021.0
34,Delaware (CAA),8,7-1,111,117,228,0.487,04/03/2021,2021.0
35,Johns Hopkins (Big Ten),6,2-4,74,79,153,0.484,04/03/2021,2021.0
36,Drexel (CAA),6,4-2,86,92,178,0.483,04/03/2021,2021.0
37,High Point (SoCon),8,3-5,124,141,265,0.468,04/03/2021,2021.0
38,Cleveland St. (DI Independent),6,2-4,60,69,129,0.465,04/03/2021,2021.0
39,Marist (MAAC),1,1-0,13,15,28,0.464,04/03/2021,2021.0
40,Syracuse (ACC),7,4-3,100,116,216,0.463,04/03/2021,2021.0
41,Maryland (Big Ten),7,7-0,94,111,205,0.459,04/03/2021,2021.0
42,Providence (Big East),9,3-6,113,135,248,0.456,04/03/2021,2021.0
43,Mount St. Mary's (NEC),8,1-7,84,101,185,0.454,04/03/2021,2021.0
44,Boston U. (Patriot),7,5-2,81,98,179,0.453,04/03/2021,2021.0
45,Navy (Patriot),4,3-1,42,51,93,0.452,04/03/2021,2021.0
46,Lafayette (Patriot),5,0-5,64,78,142,0.451,04/03/2021,2021.0
47,Air Force (SoCon),8,2-6,91,113,204,0.446,04/03/2021,2021.0
48,Bucknell (Patriot),5,1-4,61,77,138,0.442,04/03/2021,2021.0
49,Holy Cross (Patriot),5,1-4,52,70,122,0.426,04/03/2021,2021.0
50,Army West Point (Patriot),6,4-2,64,87,151,0.424,04/03/2021,2021.0
51,Hartford (America East),5,0-5,55,75,130,0.423,04/03/2021,2021.0
52,Rutgers (Big Ten),7,5-2,86,123,209,0.411,04/03/2021,2021.0
53,Towson (CAA),9,3-6,83,131,214,0.388,04/03/2021,2021.0
54,UMass Lowell (America East),6,1-5,63,104,167,0.377,04/03/2021,2021.0
55,Wagner (NEC),6,0-6,61,101,162,0.377,04/03/2021,2021.0
56,St. Bonaventure (MAAC),5,2-3,39,66,105,0.371,04/03/2021,2021.0
57,Robert Morris (DI Independent),9,4-5,105,183,288,0.365,04/03/2021,2021.0
58,Sacred Heart (NEC),8,1-7,74,131,205,0.361,04/03/2021,2021.0
59,NJIT (America East),7,1-6,57,115,172,0.331,04/03/2021,2021.0
60,Siena (MAAC),4,0-4,27,57,84,0.321,04/03/2021,2021.0
61,VMI (SoCon),6,1-5,56,120,176,0.318,04/03/2021,2021.0
62,Marquette (Big East),7,1-6,54,121,175,0.309,04/03/2021,2021.0
63,Bellarmine (SoCon),11,2-9,73,176,249,0.293,04/03/2021,2021.0
64,St. John's (NY) (Big East),6,1-5,52,129,181,0.287,04/03/2021,2021.0
65,Manhattan (MAAC),5,3-2,27,72,99,0.273,04/03/2021,2021.0
-,Merrimack (NEC),7,3-4,76,103,179,0.425,04/03/2021,2021.0
1,Monmouth (MAAC),4,3-1,65,18,83,0.783,04/02/2021,2021.0
2,Hobart (NEC),3,2-1,58,22,80,0.725,04/02/2021,2021.0
3,Notre Dame (ACC),5,4-1,85,35,120,0.708,04/02/2021,2021.0
4,Saint Joseph's (NEC),7,4-3,119,54,173,0.688,04/02/2021,2021.0
5,Lehigh (Patriot),4,4-0,77,37,114,0.675,04/02/2021,2021.0
6,Vermont (America East),6,4-2,114,56,170,0.671,04/02/2021,2021.0
7,Hofstra (CAA),6,4-2,123,63,186,0.661,04/02/2021,2021.0
8,Detroit Mercy (MAAC),5,3-2,74,38,112,0.661,04/02/2021,2021.0
9,Georgetown (Big East),7,6-1,111,64,175,0.634,04/02/2021,2021.0
10,Denver (Big East),9,7-2,160,93,253,0.632,04/02/2021,2021.0
11,Virginia (ACC),9,7-2,163,98,261,0.625,04/02/2021,2021.0
12,Bryant (NEC),6,5-1,98,60,158,0.620,04/02/2021,2021.0
13,Duke (ACC),10,10-0,174,113,287,0.606,04/02/2021,2021.0
14,Mercer (SoCon),8,3-5,121,80,201,0.602,04/02/2021,2021.0
15,Quinnipiac (MAAC),2,1-1,21,14,35,0.600,04/02/2021,2021.0
16,Canisius (MAAC),4,2-2,50,36,86,0.581,04/02/2021,2021.0
17,North Carolina (ACC),9,8-1,160,117,277,0.578,04/02/2021,2021.0
18,Richmond (SoCon),7,4-3,101,78,179,0.564,04/02/2021,2021.0
19,Utah (DI Independent),7,2-5,93,72,165,0.564,04/02/2021,2021.0
20,Michigan (Big Ten),6,1-5,98,76,174,0.563,04/02/2021,2021.0
21,Villanova (Big East),5,3-2,69,54,123,0.561,04/02/2021,2021.0
22,Jacksonville (SoCon),8,5-3,114,93,207,0.551,04/02/2021,2021.0
23,Binghamton (America East),4,2-2,45,37,82,0.549,04/02/2021,2021.0
24,LIU (NEC),6,5-1,93,77,170,0.547,04/02/2021,2021.0
25,Penn St. (Big Ten),6,2-4,81,71,152,0.533,04/02/2021,2021.0
26,Ohio St. (Big Ten),6,3-3,91,81,172,0.529,04/02/2021,2021.0
27,UMBC (America East),5,4-1,58,52,110,0.527,04/02/2021,2021.0
28,Fairfield (CAA),7,2-5,103,95,198,0.520,04/02/2021,2021.0
29,Loyola Maryland (Patriot),7,4-3,91,85,176,0.517,04/02/2021,2021.0
30,Massachusetts (CAA),4,3-1,54,51,105,0.514,04/02/2021,2021.0
31,Stony Brook (America East),8,5-3,120,114,234,0.513,04/02/2021,2021.0
32,Navy (Patriot),3,3-0,33,32,65,0.508,04/02/2021,2021.0
33,Colgate (Patriot),5,1-4,73,74,147,0.497,04/02/2021,2021.0
34,Syracuse (ACC),6,4-2,91,93,184,0.495,04/02/2021,2021.0
35,Drexel (CAA),5,3-2,75,77,152,0.493,04/02/2021,2021.0
36,Delaware (CAA),8,7-1,111,117,228,0.487,04/02/2021,2021.0
37,Army West Point (Patriot),5,4-1,60,64,124,0.484,04/02/2021,2021.0
38,Johns Hopkins (Big Ten),6,2-4,74,79,153,0.484,04/02/2021,2021.0
39,UAlbany (America East),6,4-2,79,87,166,0.476,04/02/2021,2021.0
40,Maryland (Big Ten),6,6-0,82,94,176,0.466,04/02/2021,2021.0
41,Marist (MAAC),1,1-0,13,15,28,0.464,04/02/2021,2021.0
42,Bucknell (Patriot),4,1-3,53,62,115,0.461,04/02/2021,2021.0
43,Hartford (America East),4,0-4,47,56,103,0.456,04/02/2021,2021.0
44,Mount St. Mary's (NEC),8,1-7,84,101,185,0.454,04/02/2021,2021.0
45,Lafayette (Patriot),5,0-5,64,78,142,0.451,04/02/2021,2021.0
46,Providence (Big East),8,3-5,100,126,226,0.442,04/02/2021,2021.0
47,Air Force (SoCon),7,2-5,76,97,173,0.439,04/02/2021,2021.0
48,Cleveland St. (DI Independent),5,1-4,46,59,105,0.438,04/02/2021,2021.0
49,High Point (SoCon),7,2-5,107,138,245,0.437,04/02/2021,2021.0
50,Rutgers (Big Ten),6,4-2,81,106,187,0.433,04/02/2021,2021.0
51,Boston U. (Patriot),6,5-1,67,88,155,0.432,04/02/2021,2021.0
52,Holy Cross (Patriot),5,1-4,52,70,122,0.426,04/02/2021,2021.0
53,Towson (CAA),8,3-5,78,118,196,0.398,04/02/2021,2021.0
54,UMass Lowell (America East),5,1-4,55,86,141,0.390,04/02/2021,2021.0
55,Wagner (NEC),6,0-6,61,101,162,0.377,04/02/2021,2021.0
56,St. Bonaventure (MAAC),5,2-3,39,66,105,0.371,04/02/2021,2021.0
57,NJIT (America East),6,1-5,55,94,149,0.369,04/02/2021,2021.0
58,Robert Morris (DI Independent),8,3-5,94,162,256,0.367,04/02/2021,2021.0
59,Sacred Heart (NEC),8,1-7,74,131,205,0.361,04/02/2021,2021.0
60,Siena (MAAC),4,0-4,27,57,84,0.321,04/02/2021,2021.0
61,Marquette (Big East),6,1-5,48,102,150,0.320,04/02/2021,2021.0
62,Bellarmine (SoCon),10,2-8,70,159,229,0.306,04/02/2021,2021.0
63,VMI (SoCon),5,1-4,46,106,152,0.303,04/02/2021,2021.0
64,Manhattan (MAAC),5,3-2,27,72,99,0.273,04/02/2021,2021.0
65,St. John's (NY) (Big East),5,1-4,40,111,151,0.265,04/02/2021,2021.0
-,Merrimack (NEC),6,2-4,66,85,151,0.437,04/02/2021,2021.0
1,Monmouth (MAAC),4,3-1,65,18,83,0.783,04/01/2021,2021.0
2,Hobart (NEC),3,2-1,58,22,80,0.725,04/01/2021,2021.0
3,Notre Dame (ACC),5,4-1,85,35,120,0.708,04/01/2021,2021.0
4,Saint Joseph's (NEC),7,4-3,119,54,173,0.688,04/01/2021,2021.0
5,Lehigh (Patriot),4,4-0,77,37,114,0.675,04/01/2021,2021.0
6,Detroit Mercy (MAAC),4,2-2,62,30,92,0.674,04/01/2021,2021.0
7,Vermont (America East),6,4-2,114,56,170,0.671,04/01/2021,2021.0
8,Hofstra (CAA),6,4-2,123,63,186,0.661,04/01/2021,2021.0
9,Canisius (MAAC),3,2-1,42,24,66,0.636,04/01/2021,2021.0
10,Georgetown (Big East),7,6-1,111,64,175,0.634,04/01/2021,2021.0
11,Denver (Big East),9,7-2,160,93,253,0.632,04/01/2021,2021.0
12,Virginia (ACC),9,7-2,163,98,261,0.625,04/01/2021,2021.0
13,Bryant (NEC),6,5-1,98,60,158,0.620,04/01/2021,2021.0
14,Duke (ACC),10,10-0,174,113,287,0.606,04/01/2021,2021.0
15,Mercer (SoCon),8,3-5,121,80,201,0.602,04/01/2021,2021.0
16,Quinnipiac (MAAC),2,1-1,21,14,35,0.600,04/01/2021,2021.0
17,North Carolina (ACC),9,8-1,160,117,277,0.578,04/01/2021,2021.0
18,Richmond (SoCon),7,4-3,101,78,179,0.564,04/01/2021,2021.0
19,Utah (DI Independent),7,2-5,93,72,165,0.564,04/01/2021,2021.0
20,Michigan (Big Ten),6,1-5,98,76,174,0.563,04/01/2021,2021.0
21,Villanova (Big East),5,3-2,69,54,123,0.561,04/01/2021,2021.0
22,Jacksonville (SoCon),8,5-3,114,93,207,0.551,04/01/2021,2021.0
23,Binghamton (America East),4,2-2,45,37,82,0.549,04/01/2021,2021.0
24,LIU (NEC),6,5-1,93,77,170,0.547,04/01/2021,2021.0
25,Fairfield (CAA),6,2-4,90,78,168,0.536,04/01/2021,2021.0
26,Penn St. (Big Ten),6,2-4,81,71,152,0.533,04/01/2021,2021.0
27,Ohio St. (Big Ten),6,3-3,91,81,172,0.529,04/01/2021,2021.0
28,UMBC (America East),5,4-1,58,52,110,0.527,04/01/2021,2021.0
29,Loyola Maryland (Patriot),7,4-3,91,85,176,0.517,04/01/2021,2021.0
30,Massachusetts (CAA),4,3-1,54,51,105,0.514,04/01/2021,2021.0
31,Stony Brook (America East),8,5-3,120,114,234,0.513,04/01/2021,2021.0
32,Navy (Patriot),3,3-0,33,32,65,0.508,04/01/2021,2021.0
33,Colgate (Patriot),5,1-4,73,74,147,0.497,04/01/2021,2021.0
34,Syracuse (ACC),6,4-2,91,93,184,0.495,04/01/2021,2021.0
35,Drexel (CAA),5,3-2,75,77,152,0.493,04/01/2021,2021.0
36,Army West Point (Patriot),5,4-1,60,64,124,0.484,04/01/2021,2021.0
37,Johns Hopkins (Big Ten),6,2-4,74,79,153,0.484,04/01/2021,2021.0
38,UAlbany (America East),6,4-2,79,87,166,0.476,04/01/2021,2021.0
39,Delaware (CAA),7,6-1,94,104,198,0.475,04/01/2021,2021.0
40,Maryland (Big Ten),6,6-0,82,94,176,0.466,04/01/2021,2021.0
41,Marist (MAAC),1,1-0,13,15,28,0.464,04/01/2021,2021.0
42,Bucknell (Patriot),4,1-3,53,62,115,0.461,04/01/2021,2021.0
43,Hartford (America East),4,0-4,47,56,103,0.456,04/01/2021,2021.0
44,Mount St. Mary's (NEC),8,1-7,84,101,185,0.454,04/01/2021,2021.0
45,Lafayette (Patriot),5,0-5,64,78,142,0.451,04/01/2021,2021.0
46,Providence (Big East),8,3-5,100,126,226,0.442,04/01/2021,2021.0
47,Air Force (SoCon),7,2-5,76,97,173,0.439,04/01/2021,2021.0
48,Cleveland St. (DI Independent),5,1-4,46,59,105,0.438,04/01/2021,2021.0
49,High Point (SoCon),7,2-5,107,138,245,0.437,04/01/2021,2021.0
50,Rutgers (Big Ten),6,4-2,81,106,187,0.433,04/01/2021,2021.0
51,Boston U. (Patriot),6,5-1,67,88,155,0.432,04/01/2021,2021.0
52,Holy Cross (Patriot),5,1-4,52,70,122,0.426,04/01/2021,2021.0
53,Towson (CAA),8,3-5,78,118,196,0.398,04/01/2021,2021.0
54,UMass Lowell (America East),5,1-4,55,86,141,0.390,04/01/2021,2021.0
55,Wagner (NEC),6,0-6,61,101,162,0.377,04/01/2021,2021.0
56,NJIT (America East),6,1-5,55,94,149,0.369,04/01/2021,2021.0
57,Robert Morris (DI Independent),8,3-5,94,162,256,0.367,04/01/2021,2021.0
58,Sacred Heart (NEC),8,1-7,74,131,205,0.361,04/01/2021,2021.0
59,Siena (MAAC),4,0-4,27,57,84,0.321,04/01/2021,2021.0
60,Marquette (Big East),6,1-5,48,102,150,0.320,04/01/2021,2021.0
61,Bellarmine (SoCon),10,2-8,70,159,229,0.306,04/01/2021,2021.0
62,VMI (SoCon),5,1-4,46,106,152,0.303,04/01/2021,2021.0
63,St. Bonaventure (MAAC),4,1-3,25,60,85,0.294,04/01/2021,2021.0
64,Manhattan (MAAC),4,3-1,21,58,79,0.266,04/01/2021,2021.0
65,St. John's (NY) (Big East),5,1-4,40,111,151,0.265,04/01/2021,2021.0
-,Merrimack (NEC),6,2-4,66,85,151,0.437,04/01/2021,2021.0
1,Monmouth (MAAC),4,3-1,65,18,83,0.783,03/30/2021,2021.0
2,Hobart (NEC),3,2-1,58,22,80,0.725,03/30/2021,2021.0
3,Notre Dame (ACC),5,4-1,85,35,120,0.708,03/30/2021,2021.0
4,Saint Joseph's (NEC),7,4-3,119,54,173,0.688,03/30/2021,2021.0
5,Lehigh (Patriot),4,4-0,77,37,114,0.675,03/30/2021,2021.0
6,Detroit Mercy (MAAC),4,2-2,62,30,92,0.674,03/30/2021,2021.0
7,Vermont (America East),6,4-2,114,56,170,0.671,03/30/2021,2021.0
8,Hofstra (CAA),6,4-2,123,63,186,0.661,03/30/2021,2021.0
9,Canisius (MAAC),3,2-1,42,24,66,0.636,03/30/2021,2021.0
10,Georgetown (Big East),7,6-1,111,64,175,0.634,03/30/2021,2021.0
11,Denver (Big East),9,7-2,160,93,253,0.632,03/30/2021,2021.0
12,Virginia (ACC),9,7-2,163,98,261,0.625,03/30/2021,2021.0
13,Bryant (NEC),6,5-1,98,60,158,0.620,03/30/2021,2021.0
14,Duke (ACC),9,9-0,159,103,262,0.607,03/30/2021,2021.0
15,Mercer (SoCon),8,3-5,121,80,201,0.602,03/30/2021,2021.0
16,Quinnipiac (MAAC),2,1-1,21,14,35,0.600,03/30/2021,2021.0
17,North Carolina (ACC),8,8-0,150,102,252,0.595,03/30/2021,2021.0
18,Richmond (SoCon),7,4-3,101,78,179,0.564,03/30/2021,2021.0
19,Utah (DI Independent),7,2-5,93,72,165,0.564,03/30/2021,2021.0
20,Michigan (Big Ten),6,1-5,98,76,174,0.563,03/30/2021,2021.0
21,Villanova (Big East),5,3-2,69,54,123,0.561,03/30/2021,2021.0
22,Jacksonville (SoCon),8,5-3,114,93,207,0.551,03/30/2021,2021.0
23,Binghamton (America East),4,2-2,45,37,82,0.549,03/30/2021,2021.0
24,LIU (NEC),6,5-1,93,77,170,0.547,03/30/2021,2021.0
25,Fairfield (CAA),6,2-4,90,78,168,0.536,03/30/2021,2021.0
26,Penn St. (Big Ten),6,2-4,81,71,152,0.533,03/30/2021,2021.0
27,Ohio St. (Big Ten),6,3-3,91,81,172,0.529,03/30/2021,2021.0
28,UMBC (America East),5,4-1,58,52,110,0.527,03/30/2021,2021.0
29,Loyola Maryland (Patriot),7,4-3,91,85,176,0.517,03/30/2021,2021.0
30,Massachusetts (CAA),4,3-1,54,51,105,0.514,03/30/2021,2021.0
31,Stony Brook (America East),8,5-3,120,114,234,0.513,03/30/2021,2021.0
32,Navy (Patriot),3,3-0,33,32,65,0.508,03/30/2021,2021.0
33,Colgate (Patriot),5,1-4,73,74,147,0.497,03/30/2021,2021.0
34,Syracuse (ACC),6,4-2,91,93,184,0.495,03/30/2021,2021.0
35,Drexel (CAA),5,3-2,75,77,152,0.493,03/30/2021,2021.0
36,Army West Point (Patriot),5,4-1,60,64,124,0.484,03/30/2021,2021.0
37,Johns Hopkins (Big Ten),6,2-4,74,79,153,0.484,03/30/2021,2021.0
38,UAlbany (America East),6,4-2,79,87,166,0.476,03/30/2021,2021.0
39,Delaware (CAA),7,6-1,94,104,198,0.475,03/30/2021,2021.0
40,Maryland (Big Ten),6,6-0,82,94,176,0.466,03/30/2021,2021.0
41,Marist (MAAC),1,1-0,13,15,28,0.464,03/30/2021,2021.0
42,Bucknell (Patriot),4,1-3,53,62,115,0.461,03/30/2021,2021.0
43,Hartford (America East),4,0-4,47,56,103,0.456,03/30/2021,2021.0
44,Mount St. Mary's (NEC),8,1-7,84,101,185,0.454,03/30/2021,2021.0
45,Lafayette (Patriot),5,0-5,64,78,142,0.451,03/30/2021,2021.0
46,Providence (Big East),8,3-5,100,126,226,0.442,03/30/2021,2021.0
47,Air Force (SoCon),7,2-5,76,97,173,0.439,03/30/2021,2021.0
48,Cleveland St. (DI Independent),5,1-4,46,59,105,0.438,03/30/2021,2021.0
49,High Point (SoCon),7,2-5,107,138,245,0.437,03/30/2021,2021.0
50,Rutgers (Big Ten),6,4-2,81,106,187,0.433,03/30/2021,2021.0
51,Boston U. (Patriot),6,5-1,67,88,155,0.432,03/30/2021,2021.0
52,Holy Cross (Patriot),5,1-4,52,70,122,0.426,03/30/2021,2021.0
53,Towson (CAA),8,3-5,78,118,196,0.398,03/30/2021,2021.0
54,UMass Lowell (America East),5,1-4,55,86,141,0.390,03/30/2021,2021.0
55,Wagner (NEC),6,0-6,61,101,162,0.377,03/30/2021,2021.0
56,NJIT (America East),6,1-5,55,94,149,0.369,03/30/2021,2021.0
57,Robert Morris (DI Independent),8,3-5,94,162,256,0.367,03/30/2021,2021.0
58,Sacred Heart (NEC),8,1-7,74,131,205,0.361,03/30/2021,2021.0
59,Siena (MAAC),4,0-4,27,57,84,0.321,03/30/2021,2021.0
60,Marquette (Big East),6,1-5,48,102,150,0.320,03/30/2021,2021.0
61,Bellarmine (SoCon),10,2-8,70,159,229,0.306,03/30/2021,2021.0
62,VMI (SoCon),5,1-4,46,106,152,0.303,03/30/2021,2021.0
63,St. Bonaventure (MAAC),4,1-3,25,60,85,0.294,03/30/2021,2021.0
64,Manhattan (MAAC),4,3-1,21,58,79,0.266,03/30/2021,2021.0
65,St. John's (NY) (Big East),5,1-4,40,111,151,0.265,03/30/2021,2021.0
-,Merrimack (NEC),6,2-4,66,85,151,0.437,03/30/2021,2021.0
1,Monmouth (MAAC),4,3-1,65,18,83,0.783,03/28/2021,2021.0
2,Hobart (NEC),3,2-1,58,22,80,0.725,03/28/2021,2021.0
3,Notre Dame (ACC),5,4-1,85,35,120,0.708,03/28/2021,2021.0
4,Saint Joseph's (NEC),7,4-3,119,54,173,0.688,03/28/2021,2021.0
5,Hofstra (CAA),5,4-1,107,50,157,0.682,03/28/2021,2021.0
6,Lehigh (Patriot),4,4-0,77,37,114,0.675,03/28/2021,2021.0
7,Detroit Mercy (MAAC),4,2-2,62,30,92,0.674,03/28/2021,2021.0
8,Vermont (America East),6,4-2,114,56,170,0.671,03/28/2021,2021.0
9,Canisius (MAAC),3,2-1,42,24,66,0.636,03/28/2021,2021.0
10,Georgetown (Big East),7,6-1,111,64,175,0.634,03/28/2021,2021.0
11,Denver (Big East),9,7-2,160,93,253,0.632,03/28/2021,2021.0
12,Virginia (ACC),9,7-2,163,98,261,0.625,03/28/2021,2021.0
13,Bryant (NEC),6,5-1,98,60,158,0.620,03/28/2021,2021.0
14,Duke (ACC),9,9-0,159,103,262,0.607,03/28/2021,2021.0
15,Mercer (SoCon),8,3-5,121,80,201,0.602,03/28/2021,2021.0
16,Quinnipiac (MAAC),2,1-1,21,14,35,0.600,03/28/2021,2021.0
17,North Carolina (ACC),8,8-0,150,102,252,0.595,03/28/2021,2021.0
18,Richmond (SoCon),7,4-3,101,78,179,0.564,03/28/2021,2021.0
19,Utah (DI Independent),7,2-5,93,72,165,0.564,03/28/2021,2021.0
20,Michigan (Big Ten),6,1-5,98,76,174,0.563,03/28/2021,2021.0
21,Villanova (Big East),5,3-2,69,54,123,0.561,03/28/2021,2021.0
22,Jacksonville (SoCon),8,5-3,114,93,207,0.551,03/28/2021,2021.0
23,Binghamton (America East),4,2-2,45,37,82,0.549,03/28/2021,2021.0
24,LIU (NEC),6,5-1,93,77,170,0.547,03/28/2021,2021.0
25,Massachusetts (CAA),3,2-1,41,35,76,0.539,03/28/2021,2021.0
26,Fairfield (CAA),6,2-4,90,78,168,0.536,03/28/2021,2021.0
27,Penn St. (Big Ten),6,2-4,81,71,152,0.533,03/28/2021,2021.0
28,Ohio St. (Big Ten),6,3-3,91,81,172,0.529,03/28/2021,2021.0
29,UMBC (America East),5,4-1,58,52,110,0.527,03/28/2021,2021.0
30,Loyola Maryland (Patriot),7,4-3,91,85,176,0.517,03/28/2021,2021.0
31,Stony Brook (America East),8,5-3,120,114,234,0.513,03/28/2021,2021.0
32,Navy (Patriot),3,3-0,33,32,65,0.508,03/28/2021,2021.0
33,Colgate (Patriot),5,1-4,73,74,147,0.497,03/28/2021,2021.0
34,Syracuse (ACC),6,4-2,91,93,184,0.495,03/28/2021,2021.0
35,Drexel (CAA),5,3-2,75,77,152,0.493,03/28/2021,2021.0
36,Army West Point (Patriot),5,4-1,60,64,124,0.484,03/28/2021,2021.0
37,Johns Hopkins (Big Ten),6,2-4,74,79,153,0.484,03/28/2021,2021.0
38,UAlbany (America East),6,4-2,79,87,166,0.476,03/28/2021,2021.0
39,Delaware (CAA),7,6-1,94,104,198,0.475,03/28/2021,2021.0
40,Maryland (Big Ten),6,6-0,82,94,176,0.466,03/28/2021,2021.0
41,Marist (MAAC),1,1-0,13,15,28,0.464,03/28/2021,2021.0
42,Bucknell (Patriot),4,1-3,53,62,115,0.461,03/28/2021,2021.0
43,Hartford (America East),4,0-4,47,56,103,0.456,03/28/2021,2021.0
44,Mount St. Mary's (NEC),8,1-7,84,101,185,0.454,03/28/2021,2021.0
45,Lafayette (Patriot),5,0-5,64,78,142,0.451,03/28/2021,2021.0
46,Providence (Big East),8,3-5,100,126,226,0.442,03/28/2021,2021.0
47,Air Force (SoCon),7,2-5,76,97,173,0.439,03/28/2021,2021.0
48,Cleveland St. (DI Independent),5,1-4,46,59,105,0.438,03/28/2021,2021.0
49,High Point (SoCon),7,2-5,107,138,245,0.437,03/28/2021,2021.0
50,Rutgers (Big Ten),6,4-2,81,106,187,0.433,03/28/2021,2021.0
51,Boston U. (Patriot),6,5-1,67,88,155,0.432,03/28/2021,2021.0
52,Holy Cross (Patriot),5,1-4,52,70,122,0.426,03/28/2021,2021.0
53,Towson (CAA),8,3-5,78,118,196,0.398,03/28/2021,2021.0
54,UMass Lowell (America East),5,1-4,55,86,141,0.390,03/28/2021,2021.0
55,Wagner (NEC),6,0-6,61,101,162,0.377,03/28/2021,2021.0
56,NJIT (America East),6,1-5,55,94,149,0.369,03/28/2021,2021.0
57,Robert Morris (DI Independent),8,3-5,94,162,256,0.367,03/28/2021,2021.0
58,Sacred Heart (NEC),8,1-7,74,131,205,0.361,03/28/2021,2021.0
59,Siena (MAAC),4,0-4,27,57,84,0.321,03/28/2021,2021.0
60,Marquette (Big East),6,1-5,48,102,150,0.320,03/28/2021,2021.0
61,Bellarmine (SoCon),10,2-8,70,159,229,0.306,03/28/2021,2021.0
62,VMI (SoCon),5,1-4,46,106,152,0.303,03/28/2021,2021.0
63,St. Bonaventure (MAAC),4,1-3,25,60,85,0.294,03/28/2021,2021.0
64,Manhattan (MAAC),4,3-1,21,58,79,0.266,03/28/2021,2021.0
65,St. John's (NY) (Big East),5,1-4,40,111,151,0.265,03/28/2021,2021.0
-,Merrimack (NEC),6,2-4,66,85,151,0.437,03/28/2021,2021.0
1,Monmouth (MAAC),4,3-1,65,18,83,0.783,03/27/2021,2021.0
2,Hobart (NEC),3,2-1,58,22,80,0.725,03/27/2021,2021.0
3,Notre Dame (ACC),5,4-1,85,35,120,0.708,03/27/2021,2021.0
4,Saint Joseph's (NEC),7,4-3,119,54,173,0.688,03/27/2021,2021.0
5,Hofstra (CAA),5,4-1,107,50,157,0.682,03/27/2021,2021.0
6,Detroit Mercy (MAAC),4,2-2,62,30,92,0.674,03/27/2021,2021.0
7,Vermont (America East),6,4-2,114,56,170,0.671,03/27/2021,2021.0
7,Lehigh (Patriot),3,3-0,57,28,85,0.671,03/27/2021,2021.0
9,Canisius (MAAC),3,2-1,42,24,66,0.636,03/27/2021,2021.0
10,Georgetown (Big East),7,6-1,111,64,175,0.634,03/27/2021,2021.0
11,Denver (Big East),9,7-2,160,93,253,0.632,03/27/2021,2021.0
12,Virginia (ACC),9,7-2,163,98,261,0.625,03/27/2021,2021.0
13,Bryant (NEC),6,5-1,98,60,158,0.620,03/27/2021,2021.0
14,Duke (ACC),9,9-0,159,103,262,0.607,03/27/2021,2021.0
15,Mercer (SoCon),8,3-5,121,80,201,0.602,03/27/2021,2021.0
16,Quinnipiac (MAAC),2,1-1,21,14,35,0.600,03/27/2021,2021.0
17,North Carolina (ACC),8,8-0,150,102,252,0.595,03/27/2021,2021.0
18,Navy (Patriot),2,2-0,24,17,41,0.585,03/27/2021,2021.0
19,Richmond (SoCon),7,4-3,101,78,179,0.564,03/27/2021,2021.0
20,Utah (DI Independent),7,2-5,93,72,165,0.564,03/27/2021,2021.0
21,Michigan (Big Ten),6,1-5,98,76,174,0.563,03/27/2021,2021.0
22,Villanova (Big East),5,3-2,69,54,123,0.561,03/27/2021,2021.0
23,Jacksonville (SoCon),8,5-3,114,93,207,0.551,03/27/2021,2021.0
24,Binghamton (America East),4,2-2,45,37,82,0.549,03/27/2021,2021.0
25,LIU (NEC),6,5-1,93,77,170,0.547,03/27/2021,2021.0
26,Colgate (Patriot),4,1-3,64,54,118,0.542,03/27/2021,2021.0
27,Massachusetts (CAA),3,2-1,41,35,76,0.539,03/27/2021,2021.0
28,Fairfield (CAA),6,2-4,90,78,168,0.536,03/27/2021,2021.0
29,Johns Hopkins (Big Ten),5,2-3,69,61,130,0.531,03/27/2021,2021.0
30,Ohio St. (Big Ten),6,3-3,91,81,172,0.529,03/27/2021,2021.0
31,UMBC (America East),5,4-1,58,52,110,0.527,03/27/2021,2021.0
32,Loyola Maryland (Patriot),7,4-3,91,85,176,0.517,03/27/2021,2021.0
33,Stony Brook (America East),8,5-3,120,114,234,0.513,03/27/2021,2021.0
34,Syracuse (ACC),6,4-2,91,93,184,0.495,03/27/2021,2021.0
35,Drexel (CAA),5,3-2,75,77,152,0.493,03/27/2021,2021.0
36,Penn St. (Big Ten),5,1-4,63,66,129,0.488,03/27/2021,2021.0
37,Army West Point (Patriot),5,4-1,60,64,124,0.484,03/27/2021,2021.0
38,UAlbany (America East),6,4-2,79,87,166,0.476,03/27/2021,2021.0
39,Delaware (CAA),7,6-1,94,104,198,0.475,03/27/2021,2021.0
40,Marist (MAAC),1,1-0,13,15,28,0.464,03/27/2021,2021.0
41,Hartford (America East),4,0-4,47,56,103,0.456,03/27/2021,2021.0
42,Mount St. Mary's (NEC),8,1-7,84,101,185,0.454,03/27/2021,2021.0
43,Lafayette (Patriot),5,0-5,64,78,142,0.451,03/27/2021,2021.0
44,Maryland (Big Ten),5,5-0,67,84,151,0.444,03/27/2021,2021.0
45,Providence (Big East),8,3-5,100,126,226,0.442,03/27/2021,2021.0
46,Air Force (SoCon),7,2-5,76,97,173,0.439,03/27/2021,2021.0
47,Rutgers (Big Ten),5,4-1,71,91,162,0.438,03/27/2021,2021.0
48,Cleveland St. (DI Independent),5,1-4,46,59,105,0.438,03/27/2021,2021.0
49,High Point (SoCon),7,2-5,107,138,245,0.437,03/27/2021,2021.0
50,Boston U. (Patriot),6,5-1,67,88,155,0.432,03/27/2021,2021.0
51,Holy Cross (Patriot),5,1-4,52,70,122,0.426,03/27/2021,2021.0
52,Bucknell (Patriot),3,1-2,38,53,91,0.418,03/27/2021,2021.0
53,Towson (CAA),8,3-5,78,118,196,0.398,03/27/2021,2021.0
54,UMass Lowell (America East),5,1-4,55,86,141,0.390,03/27/2021,2021.0
55,Wagner (NEC),6,0-6,61,101,162,0.377,03/27/2021,2021.0
56,NJIT (America East),6,1-5,55,94,149,0.369,03/27/2021,2021.0
57,Robert Morris (DI Independent),8,3-5,94,162,256,0.367,03/27/2021,2021.0
58,Sacred Heart (NEC),8,1-7,74,131,205,0.361,03/27/2021,2021.0
59,Siena (MAAC),4,0-4,27,57,84,0.321,03/27/2021,2021.0
60,Marquette (Big East),6,1-5,48,102,150,0.320,03/27/2021,2021.0
61,Bellarmine (SoCon),10,2-8,70,159,229,0.306,03/27/2021,2021.0
62,VMI (SoCon),5,1-4,46,106,152,0.303,03/27/2021,2021.0
63,St. Bonaventure (MAAC),4,1-3,25,60,85,0.294,03/27/2021,2021.0
64,Manhattan (MAAC),4,3-1,21,58,79,0.266,03/27/2021,2021.0
65,St. John's (NY) (Big East),5,1-4,40,111,151,0.265,03/27/2021,2021.0
-,Merrimack (NEC),6,2-4,66,85,151,0.437,03/27/2021,2021.0
1,Monmouth (MAAC),4,3-1,65,18,83,0.783,03/26/2021,2021.0
2,Notre Dame (ACC),4,4-0,73,22,95,0.768,03/26/2021,2021.0
3,Hobart (NEC),3,2-1,58,22,80,0.725,03/26/2021,2021.0
4,Saint Joseph's (NEC),6,3-3,99,43,142,0.697,03/26/2021,2021.0
5,Hofstra (CAA),5,4-1,107,50,157,0.682,03/26/2021,2021.0
6,Lehigh (Patriot),3,3-0,57,28,85,0.671,03/26/2021,2021.0
7,Vermont (America East),5,3-2,95,49,144,0.660,03/26/2021,2021.0
8,Georgetown (Big East),6,5-1,101,55,156,0.647,03/26/2021,2021.0
9,Detroit Mercy (MAAC),3,1-2,45,25,70,0.643,03/26/2021,2021.0
10,Canisius (MAAC),3,2-1,42,24,66,0.636,03/26/2021,2021.0
11,Virginia (ACC),8,6-2,150,86,236,0.636,03/26/2021,2021.0
12,Bryant (NEC),5,4-1,85,49,134,0.634,03/26/2021,2021.0
13,Duke (ACC),9,9-0,159,103,262,0.607,03/26/2021,2021.0
14,Denver (Big East),8,6-2,133,87,220,0.605,03/26/2021,2021.0
15,Utah (DI Independent),6,2-4,82,54,136,0.603,03/26/2021,2021.0
16,Mercer (SoCon),7,2-5,103,69,172,0.599,03/26/2021,2021.0
17,North Carolina (ACC),8,8-0,150,102,252,0.595,03/26/2021,2021.0
18,Navy (Patriot),2,2-0,24,17,41,0.585,03/26/2021,2021.0
19,Villanova (Big East),4,3-1,60,44,104,0.577,03/26/2021,2021.0
20,Michigan (Big Ten),5,1-4,85,65,150,0.567,03/26/2021,2021.0
21,Richmond (SoCon),7,4-3,101,78,179,0.564,03/26/2021,2021.0
22,UMBC (America East),4,3-1,51,42,93,0.548,03/26/2021,2021.0
23,Quinnipiac (MAAC),1,0-1,12,10,22,0.545,03/26/2021,2021.0
24,LIU (NEC),5,4-1,74,62,136,0.544,03/26/2021,2021.0
25,Colgate (Patriot),4,1-3,64,54,118,0.542,03/26/2021,2021.0
26,Ohio St. (Big Ten),5,2-3,80,68,148,0.541,03/26/2021,2021.0
27,Massachusetts (CAA),3,2-1,41,35,76,0.539,03/26/2021,2021.0
28,Binghamton (America East),3,2-1,35,30,65,0.538,03/26/2021,2021.0
29,Fairfield (CAA),6,2-4,90,78,168,0.536,03/26/2021,2021.0
30,Johns Hopkins (Big Ten),5,2-3,69,61,130,0.531,03/26/2021,2021.0
31,Hartford (America East),3,0-3,40,37,77,0.519,03/26/2021,2021.0
32,Stony Brook (America East),7,4-3,105,101,206,0.510,03/26/2021,2021.0
33,Jacksonville (SoCon),7,4-3,88,86,174,0.506,03/26/2021,2021.0
34,Syracuse (ACC),6,4-2,91,93,184,0.495,03/26/2021,2021.0
35,Loyola Maryland (Patriot),6,4-2,79,81,160,0.494,03/26/2021,2021.0
36,Penn St. (Big Ten),5,1-4,63,66,129,0.488,03/26/2021,2021.0
37,Providence (Big East),7,3-4,94,99,193,0.487,03/26/2021,2021.0
38,UAlbany (America East),5,4-1,66,72,138,0.478,03/26/2021,2021.0
39,Delaware (CAA),7,6-1,94,104,198,0.475,03/26/2021,2021.0
40,Mount St. Mary's (NEC),7,1-6,73,81,154,0.474,03/26/2021,2021.0
41,Marist (MAAC),1,1-0,13,15,28,0.464,03/26/2021,2021.0
42,Holy Cross (Patriot),4,1-3,47,56,103,0.456,03/26/2021,2021.0
43,Maryland (Big Ten),5,5-0,67,84,151,0.444,03/26/2021,2021.0
44,Drexel (CAA),4,2-2,52,66,118,0.441,03/26/2021,2021.0
45,Rutgers (Big Ten),5,4-1,71,91,162,0.438,03/26/2021,2021.0
46,Army West Point (Patriot),4,3-1,46,59,105,0.438,03/26/2021,2021.0
47,High Point (SoCon),7,2-5,107,138,245,0.437,03/26/2021,2021.0
48,Boston U. (Patriot),5,4-1,56,73,129,0.434,03/26/2021,2021.0
49,Lafayette (Patriot),4,0-4,49,67,116,0.422,03/26/2021,2021.0
50,Bucknell (Patriot),3,1-2,38,53,91,0.418,03/26/2021,2021.0
51,Air Force (SoCon),6,1-5,64,91,155,0.413,03/26/2021,2021.0
52,Towson (CAA),7,2-5,74,106,180,0.411,03/26/2021,2021.0
53,Cleveland St. (DI Independent),4,1-3,34,52,86,0.395,03/26/2021,2021.0
54,UMass Lowell (America East),4,1-3,43,70,113,0.381,03/26/2021,2021.0
55,Robert Morris (DI Independent),7,3-4,83,139,222,0.374,03/26/2021,2021.0
56,Sacred Heart (NEC),8,1-7,74,131,205,0.361,03/26/2021,2021.0
57,Wagner (NEC),5,0-5,46,82,128,0.359,03/26/2021,2021.0
58,Siena (MAAC),3,0-3,22,40,62,0.355,03/26/2021,2021.0
59,VMI (SoCon),4,1-3,39,80,119,0.328,03/26/2021,2021.0
60,NJIT (America East),5,0-5,39,82,121,0.322,03/26/2021,2021.0
61,Marquette (Big East),5,0-5,41,90,131,0.313,03/26/2021,2021.0
62,Bellarmine (SoCon),9,2-7,64,147,211,0.303,03/26/2021,2021.0
63,St. Bonaventure (MAAC),3,1-2,21,51,72,0.292,03/26/2021,2021.0
64,Manhattan (MAAC),4,3-1,21,58,79,0.266,03/26/2021,2021.0
65,St. John's (NY) (Big East),5,1-4,40,111,151,0.265,03/26/2021,2021.0
-,Merrimack (NEC),5,2-3,55,72,127,0.433,03/26/2021,2021.0
1,Monmouth (MAAC),3,3-0,48,14,62,0.774,03/25/2021,2021.0
2,Notre Dame (ACC),4,4-0,73,22,95,0.768,03/25/2021,2021.0
3,Hobart (NEC),3,2-1,58,22,80,0.725,03/25/2021,2021.0
4,Saint Joseph's (NEC),6,3-3,99,43,142,0.697,03/25/2021,2021.0
5,Hofstra (CAA),4,3-1,89,43,132,0.674,03/25/2021,2021.0
6,Lehigh (Patriot),3,3-0,57,28,85,0.671,03/25/2021,2021.0
7,Vermont (America East),5,3-2,95,49,144,0.660,03/25/2021,2021.0
8,Georgetown (Big East),6,5-1,101,55,156,0.647,03/25/2021,2021.0
9,Detroit Mercy (MAAC),3,1-2,45,25,70,0.643,03/25/2021,2021.0
10,Canisius (MAAC),3,2-1,42,24,66,0.636,03/25/2021,2021.0
11,Virginia (ACC),8,6-2,150,86,236,0.636,03/25/2021,2021.0
12,Bryant (NEC),5,4-1,85,49,134,0.634,03/25/2021,2021.0
13,Duke (ACC),9,9-0,159,103,262,0.607,03/25/2021,2021.0
14,Denver (Big East),8,6-2,133,87,220,0.605,03/25/2021,2021.0
15,Utah (DI Independent),6,2-4,82,54,136,0.603,03/25/2021,2021.0
16,Mercer (SoCon),7,2-5,103,69,172,0.599,03/25/2021,2021.0
17,North Carolina (ACC),8,8-0,150,102,252,0.595,03/25/2021,2021.0
18,Navy (Patriot),2,2-0,24,17,41,0.585,03/25/2021,2021.0
19,Fairfield (CAA),5,2-3,83,60,143,0.580,03/25/2021,2021.0
20,Villanova (Big East),4,3-1,60,44,104,0.577,03/25/2021,2021.0
21,Michigan (Big Ten),5,1-4,85,65,150,0.567,03/25/2021,2021.0
22,Richmond (SoCon),6,3-3,83,65,148,0.561,03/25/2021,2021.0
23,UMBC (America East),4,3-1,51,42,93,0.548,03/25/2021,2021.0
24,Quinnipiac (MAAC),1,0-1,12,10,22,0.545,03/25/2021,2021.0
25,LIU (NEC),5,4-1,74,62,136,0.544,03/25/2021,2021.0
26,Colgate (Patriot),4,1-3,64,54,118,0.542,03/25/2021,2021.0
27,Ohio St. (Big Ten),5,2-3,80,68,148,0.541,03/25/2021,2021.0
28,Massachusetts (CAA),3,2-1,41,35,76,0.539,03/25/2021,2021.0
29,Binghamton (America East),3,2-1,35,30,65,0.538,03/25/2021,2021.0
30,Johns Hopkins (Big Ten),5,2-3,69,61,130,0.531,03/25/2021,2021.0
31,Hartford (America East),3,0-3,40,37,77,0.519,03/25/2021,2021.0
32,Stony Brook (America East),7,4-3,105,101,206,0.510,03/25/2021,2021.0
33,Jacksonville (SoCon),7,4-3,88,86,174,0.506,03/25/2021,2021.0
34,Syracuse (ACC),6,4-2,91,93,184,0.495,03/25/2021,2021.0
35,Loyola Maryland (Patriot),6,4-2,79,81,160,0.494,03/25/2021,2021.0
36,Penn St. (Big Ten),5,1-4,63,66,129,0.488,03/25/2021,2021.0
37,Providence (Big East),7,3-4,94,99,193,0.487,03/25/2021,2021.0
38,UAlbany (America East),5,4-1,66,72,138,0.478,03/25/2021,2021.0
39,Delaware (CAA),7,6-1,94,104,198,0.475,03/25/2021,2021.0
40,Mount St. Mary's (NEC),7,1-6,73,81,154,0.474,03/25/2021,2021.0
41,Marist (MAAC),1,1-0,13,15,28,0.464,03/25/2021,2021.0
42,Holy Cross (Patriot),4,1-3,47,56,103,0.456,03/25/2021,2021.0
43,Maryland (Big Ten),5,5-0,67,84,151,0.444,03/25/2021,2021.0
44,Drexel (CAA),4,2-2,52,66,118,0.441,03/25/2021,2021.0
45,High Point (SoCon),6,2-4,94,120,214,0.439,03/25/2021,2021.0
46,Rutgers (Big Ten),5,4-1,71,91,162,0.438,03/25/2021,2021.0
47,Army West Point (Patriot),4,3-1,46,59,105,0.438,03/25/2021,2021.0
48,Boston U. (Patriot),5,4-1,56,73,129,0.434,03/25/2021,2021.0
49,Lafayette (Patriot),4,0-4,49,67,116,0.422,03/25/2021,2021.0
50,Bucknell (Patriot),3,1-2,38,53,91,0.418,03/25/2021,2021.0
51,Air Force (SoCon),6,1-5,64,91,155,0.413,03/25/2021,2021.0
52,Towson (CAA),7,2-5,74,106,180,0.411,03/25/2021,2021.0
53,Cleveland St. (DI Independent),4,1-3,34,52,86,0.395,03/25/2021,2021.0
54,UMass Lowell (America East),4,1-3,43,70,113,0.381,03/25/2021,2021.0
55,Robert Morris (DI Independent),7,3-4,83,139,222,0.374,03/25/2021,2021.0
56,Sacred Heart (NEC),8,1-7,74,131,205,0.361,03/25/2021,2021.0
57,Wagner (NEC),5,0-5,46,82,128,0.359,03/25/2021,2021.0
58,Siena (MAAC),3,0-3,22,40,62,0.355,03/25/2021,2021.0
59,VMI (SoCon),4,1-3,39,80,119,0.328,03/25/2021,2021.0
60,NJIT (America East),5,0-5,39,82,121,0.322,03/25/2021,2021.0
61,Marquette (Big East),5,0-5,41,90,131,0.313,03/25/2021,2021.0
62,Bellarmine (SoCon),9,2-7,64,147,211,0.303,03/25/2021,2021.0
63,Manhattan (MAAC),3,2-1,17,41,58,0.293,03/25/2021,2021.0
64,St. Bonaventure (MAAC),3,1-2,21,51,72,0.292,03/25/2021,2021.0
65,St. John's (NY) (Big East),5,1-4,40,111,151,0.265,03/25/2021,2021.0
-,Merrimack (NEC),5,2-3,55,72,127,0.433,03/25/2021,2021.0
1,Monmouth (MAAC),3,3-0,48,14,62,0.774,03/24/2021,2021.0
2,Notre Dame (ACC),4,4-0,73,22,95,0.768,03/24/2021,2021.0
3,Hobart (NEC),3,2-1,58,22,80,0.725,03/24/2021,2021.0
4,Saint Joseph's (NEC),6,3-3,99,43,142,0.697,03/24/2021,2021.0
5,Hofstra (CAA),4,3-1,89,43,132,0.674,03/24/2021,2021.0
6,Lehigh (Patriot),3,3-0,57,28,85,0.671,03/24/2021,2021.0
7,Vermont (America East),5,3-2,95,49,144,0.660,03/24/2021,2021.0
8,Georgetown (Big East),6,5-1,101,55,156,0.647,03/24/2021,2021.0
9,Detroit Mercy (MAAC),3,1-2,45,25,70,0.643,03/24/2021,2021.0
10,Canisius (MAAC),3,2-1,42,24,66,0.636,03/24/2021,2021.0
11,Virginia (ACC),8,6-2,150,86,236,0.636,03/24/2021,2021.0
12,Bryant (NEC),5,4-1,85,49,134,0.634,03/24/2021,2021.0
13,Denver (Big East),8,6-2,133,87,220,0.605,03/24/2021,2021.0
14,Utah (DI Independent),6,2-4,82,54,136,0.603,03/24/2021,2021.0
15,Mercer (SoCon),7,2-5,103,69,172,0.599,03/24/2021,2021.0
16,North Carolina (ACC),8,8-0,150,102,252,0.595,03/24/2021,2021.0
17,Duke (ACC),8,8-0,135,95,230,0.587,03/24/2021,2021.0
18,Navy (Patriot),2,2-0,24,17,41,0.585,03/24/2021,2021.0
19,Fairfield (CAA),5,2-3,83,60,143,0.580,03/24/2021,2021.0
20,Villanova (Big East),4,3-1,60,44,104,0.577,03/24/2021,2021.0
21,Michigan (Big Ten),5,1-4,85,65,150,0.567,03/24/2021,2021.0
22,Richmond (SoCon),6,3-3,83,65,148,0.561,03/24/2021,2021.0
23,UMBC (America East),4,3-1,51,42,93,0.548,03/24/2021,2021.0
24,Syracuse (ACC),5,4-1,83,69,152,0.546,03/24/2021,2021.0
25,Quinnipiac (MAAC),1,0-1,12,10,22,0.545,03/24/2021,2021.0
26,LIU (NEC),5,4-1,74,62,136,0.544,03/24/2021,2021.0
27,Colgate (Patriot),4,1-3,64,54,118,0.542,03/24/2021,2021.0
28,Ohio St. (Big Ten),5,2-3,80,68,148,0.541,03/24/2021,2021.0
29,Massachusetts (CAA),3,2-1,41,35,76,0.539,03/24/2021,2021.0
30,Binghamton (America East),3,2-1,35,30,65,0.538,03/24/2021,2021.0
31,Johns Hopkins (Big Ten),5,2-3,69,61,130,0.531,03/24/2021,2021.0
32,Hartford (America East),3,0-3,40,37,77,0.519,03/24/2021,2021.0
33,Stony Brook (America East),7,4-3,105,101,206,0.510,03/24/2021,2021.0
34,Jacksonville (SoCon),7,4-3,88,86,174,0.506,03/24/2021,2021.0
35,Loyola Maryland (Patriot),6,4-2,79,81,160,0.494,03/24/2021,2021.0
36,Penn St. (Big Ten),5,1-4,63,66,129,0.488,03/24/2021,2021.0
37,Providence (Big East),7,3-4,94,99,193,0.487,03/24/2021,2021.0
38,UAlbany (America East),5,4-1,66,72,138,0.478,03/24/2021,2021.0
39,Delaware (CAA),7,6-1,94,104,198,0.475,03/24/2021,2021.0
40,Mount St. Mary's (NEC),7,1-6,73,81,154,0.474,03/24/2021,2021.0
41,Marist (MAAC),1,1-0,13,15,28,0.464,03/24/2021,2021.0
42,Holy Cross (Patriot),4,1-3,47,56,103,0.456,03/24/2021,2021.0
43,Maryland (Big Ten),5,5-0,67,84,151,0.444,03/24/2021,2021.0
44,Drexel (CAA),4,2-2,52,66,118,0.441,03/24/2021,2021.0
45,High Point (SoCon),6,2-4,94,120,214,0.439,03/24/2021,2021.0
46,Rutgers (Big Ten),5,4-1,71,91,162,0.438,03/24/2021,2021.0
47,Army West Point (Patriot),4,3-1,46,59,105,0.438,03/24/2021,2021.0
48,Boston U. (Patriot),5,4-1,56,73,129,0.434,03/24/2021,2021.0
49,Lafayette (Patriot),4,0-4,49,67,116,0.422,03/24/2021,2021.0
50,Bucknell (Patriot),3,1-2,38,53,91,0.418,03/24/2021,2021.0
51,Air Force (SoCon),6,1-5,64,91,155,0.413,03/24/2021,2021.0
52,Towson (CAA),7,2-5,74,106,180,0.411,03/24/2021,2021.0
53,Cleveland St. (DI Independent),4,1-3,34,52,86,0.395,03/24/2021,2021.0
54,UMass Lowell (America East),4,1-3,43,70,113,0.381,03/24/2021,2021.0
55,Robert Morris (DI Independent),7,3-4,83,139,222,0.374,03/24/2021,2021.0
56,Sacred Heart (NEC),8,1-7,74,131,205,0.361,03/24/2021,2021.0
57,Wagner (NEC),5,0-5,46,82,128,0.359,03/24/2021,2021.0
58,Siena (MAAC),3,0-3,22,40,62,0.355,03/24/2021,2021.0
59,VMI (SoCon),4,1-3,39,80,119,0.328,03/24/2021,2021.0
60,NJIT (America East),5,0-5,39,82,121,0.322,03/24/2021,2021.0
61,Marquette (Big East),5,0-5,41,90,131,0.313,03/24/2021,2021.0
62,Bellarmine (SoCon),9,2-7,64,147,211,0.303,03/24/2021,2021.0
63,Manhattan (MAAC),3,2-1,17,41,58,0.293,03/24/2021,2021.0
64,St. Bonaventure (MAAC),3,1-2,21,51,72,0.292,03/24/2021,2021.0
65,St. John's (NY) (Big East),5,1-4,40,111,151,0.265,03/24/2021,2021.0
-,Merrimack (NEC),5,2-3,55,72,127,0.433,03/24/2021,2021.0
1,Monmouth (MAAC),3,3-0,48,14,62,0.774,03/23/2021,2021.0
2,Notre Dame (ACC),4,4-0,73,22,95,0.768,03/23/2021,2021.0
3,Hobart (NEC),3,2-1,58,22,80,0.725,03/23/2021,2021.0
4,Saint Joseph's (NEC),6,3-3,99,43,142,0.697,03/23/2021,2021.0
5,Hofstra (CAA),4,3-1,89,43,132,0.674,03/23/2021,2021.0
6,Lehigh (Patriot),3,3-0,57,28,85,0.671,03/23/2021,2021.0
7,Vermont (America East),5,3-2,95,49,144,0.660,03/23/2021,2021.0
8,Georgetown (Big East),6,5-1,101,55,156,0.647,03/23/2021,2021.0
9,Detroit Mercy (MAAC),3,1-2,45,25,70,0.643,03/23/2021,2021.0
10,Canisius (MAAC),3,2-1,42,24,66,0.636,03/23/2021,2021.0
11,Virginia (ACC),8,6-2,150,86,236,0.636,03/23/2021,2021.0
12,Bryant (NEC),5,4-1,85,49,134,0.634,03/23/2021,2021.0
13,Binghamton (America East),2,1-1,29,18,47,0.617,03/23/2021,2021.0
14,Denver (Big East),8,6-2,133,87,220,0.605,03/23/2021,2021.0
15,Utah (DI Independent),6,2-4,82,54,136,0.603,03/23/2021,2021.0
16,Mercer (SoCon),7,2-5,103,69,172,0.599,03/23/2021,2021.0
17,North Carolina (ACC),8,8-0,150,102,252,0.595,03/23/2021,2021.0
18,Duke (ACC),8,8-0,135,95,230,0.587,03/23/2021,2021.0
19,Navy (Patriot),2,2-0,24,17,41,0.585,03/23/2021,2021.0
20,Fairfield (CAA),5,2-3,83,60,143,0.580,03/23/2021,2021.0
21,Villanova (Big East),4,3-1,60,44,104,0.577,03/23/2021,2021.0
22,Michigan (Big Ten),5,1-4,85,65,150,0.567,03/23/2021,2021.0
23,Richmond (SoCon),6,3-3,83,65,148,0.561,03/23/2021,2021.0
24,Syracuse (ACC),5,4-1,83,69,152,0.546,03/23/2021,2021.0
25,Quinnipiac (MAAC),1,0-1,12,10,22,0.545,03/23/2021,2021.0
26,LIU (NEC),5,4-1,74,62,136,0.544,03/23/2021,2021.0
27,Colgate (Patriot),4,1-3,64,54,118,0.542,03/23/2021,2021.0
28,Ohio St. (Big Ten),5,2-3,80,68,148,0.541,03/23/2021,2021.0
29,Massachusetts (CAA),3,2-1,41,35,76,0.539,03/23/2021,2021.0
30,Johns Hopkins (Big Ten),5,2-3,69,61,130,0.531,03/23/2021,2021.0
31,UMBC (America East),3,3-0,39,36,75,0.520,03/23/2021,2021.0
32,Hartford (America East),3,0-3,40,37,77,0.519,03/23/2021,2021.0
33,Stony Brook (America East),7,4-3,105,101,206,0.510,03/23/2021,2021.0
34,Jacksonville (SoCon),7,4-3,88,86,174,0.506,03/23/2021,2021.0
35,Loyola Maryland (Patriot),6,4-2,79,81,160,0.494,03/23/2021,2021.0
36,Penn St. (Big Ten),5,1-4,63,66,129,0.488,03/23/2021,2021.0
37,Providence (Big East),7,3-4,94,99,193,0.487,03/23/2021,2021.0
38,UAlbany (America East),5,4-1,66,72,138,0.478,03/23/2021,2021.0
39,Delaware (CAA),7,6-1,94,104,198,0.475,03/23/2021,2021.0
40,Mount St. Mary's (NEC),7,1-6,73,81,154,0.474,03/23/2021,2021.0
41,Marist (MAAC),1,1-0,13,15,28,0.464,03/23/2021,2021.0
42,Holy Cross (Patriot),4,1-3,47,56,103,0.456,03/23/2021,2021.0
43,Maryland (Big Ten),5,5-0,67,84,151,0.444,03/23/2021,2021.0
44,High Point (SoCon),6,2-4,94,120,214,0.439,03/23/2021,2021.0
45,Rutgers (Big Ten),5,4-1,71,91,162,0.438,03/23/2021,2021.0
46,Army West Point (Patriot),4,3-1,46,59,105,0.438,03/23/2021,2021.0
47,Boston U. (Patriot),5,4-1,56,73,129,0.434,03/23/2021,2021.0
48,Drexel (CAA),3,1-2,35,48,83,0.422,03/23/2021,2021.0
49,Bucknell (Patriot),3,1-2,38,53,91,0.418,03/23/2021,2021.0
50,Air Force (SoCon),6,1-5,64,91,155,0.413,03/23/2021,2021.0
51,Towson (CAA),7,2-5,74,106,180,0.411,03/23/2021,2021.0
52,Cleveland St. (DI Independent),4,1-3,34,52,86,0.395,03/23/2021,2021.0
53,Lafayette (Patriot),3,0-3,31,50,81,0.383,03/23/2021,2021.0
54,UMass Lowell (America East),4,1-3,43,70,113,0.381,03/23/2021,2021.0
55,Robert Morris (DI Independent),7,3-4,83,139,222,0.374,03/23/2021,2021.0
56,Sacred Heart (NEC),8,1-7,74,131,205,0.361,03/23/2021,2021.0
57,Wagner (NEC),5,0-5,46,82,128,0.359,03/23/2021,2021.0
58,Siena (MAAC),3,0-3,22,40,62,0.355,03/23/2021,2021.0
59,VMI (SoCon),4,1-3,39,80,119,0.328,03/23/2021,2021.0
60,NJIT (America East),5,0-5,39,82,121,0.322,03/23/2021,2021.0
61,Marquette (Big East),5,0-5,41,90,131,0.313,03/23/2021,2021.0
62,Bellarmine (SoCon),9,2-7,64,147,211,0.303,03/23/2021,2021.0
63,Manhattan (MAAC),3,2-1,17,41,58,0.293,03/23/2021,2021.0
64,St. Bonaventure (MAAC),3,1-2,21,51,72,0.292,03/23/2021,2021.0
65,St. John's (NY) (Big East),5,1-4,40,111,151,0.265,03/23/2021,2021.0
-,Merrimack (NEC),5,2-3,55,72,127,0.433,03/23/2021,2021.0
1,Monmouth (MAAC),3,3-0,48,14,62,0.774,03/21/2021,2021.0
2,Notre Dame (ACC),4,4-0,73,22,95,0.768,03/21/2021,2021.0
3,Hobart (NEC),3,2-1,58,22,80,0.725,03/21/2021,2021.0
4,Saint Joseph's (NEC),6,3-3,99,43,142,0.697,03/21/2021,2021.0
5,Hofstra (CAA),4,3-1,89,43,132,0.674,03/21/2021,2021.0
6,Lehigh (Patriot),3,3-0,57,28,85,0.671,03/21/2021,2021.0
7,Vermont (America East),5,3-2,95,49,144,0.660,03/21/2021,2021.0
8,Georgetown (Big East),6,5-1,101,55,156,0.647,03/21/2021,2021.0
9,Detroit Mercy (MAAC),3,1-2,45,25,70,0.643,03/21/2021,2021.0
10,Canisius (MAAC),3,2-1,42,24,66,0.636,03/21/2021,2021.0
11,Virginia (ACC),8,6-2,150,86,236,0.636,03/21/2021,2021.0
12,Bryant (NEC),5,4-1,85,49,134,0.634,03/21/2021,2021.0
13,Binghamton (America East),2,1-1,29,18,47,0.617,03/21/2021,2021.0
14,Denver (Big East),8,6-2,133,87,220,0.605,03/21/2021,2021.0
15,Utah (DI Independent),6,2-4,82,54,136,0.603,03/21/2021,2021.0
16,Mercer (SoCon),7,2-5,103,69,172,0.599,03/21/2021,2021.0
17,North Carolina (ACC),8,8-0,150,102,252,0.595,03/21/2021,2021.0
18,Duke (ACC),8,8-0,135,95,230,0.587,03/21/2021,2021.0
19,Navy (Patriot),2,2-0,24,17,41,0.585,03/21/2021,2021.0
20,Fairfield (CAA),5,2-3,83,60,143,0.580,03/21/2021,2021.0
21,Villanova (Big East),4,3-1,60,44,104,0.577,03/21/2021,2021.0
22,Massachusetts (CAA),2,2-0,27,20,47,0.574,03/21/2021,2021.0
23,Michigan (Big Ten),5,1-4,85,65,150,0.567,03/21/2021,2021.0
24,Richmond (SoCon),6,3-3,83,65,148,0.561,03/21/2021,2021.0
25,Syracuse (ACC),5,4-1,83,69,152,0.546,03/21/2021,2021.0
26,Quinnipiac (MAAC),1,0-1,12,10,22,0.545,03/21/2021,2021.0
27,LIU (NEC),5,4-1,74,62,136,0.544,03/21/2021,2021.0
28,Colgate (Patriot),4,1-3,64,54,118,0.542,03/21/2021,2021.0
29,Ohio St. (Big Ten),5,2-3,80,68,148,0.541,03/21/2021,2021.0
30,Johns Hopkins (Big Ten),5,2-3,69,61,130,0.531,03/21/2021,2021.0
31,UMBC (America East),3,3-0,39,36,75,0.520,03/21/2021,2021.0
32,Hartford (America East),3,0-3,40,37,77,0.519,03/21/2021,2021.0
33,Stony Brook (America East),7,4-3,105,101,206,0.510,03/21/2021,2021.0
34,Jacksonville (SoCon),7,4-3,88,86,174,0.506,03/21/2021,2021.0
35,Loyola Maryland (Patriot),6,4-2,79,81,160,0.494,03/21/2021,2021.0
36,Penn St. (Big Ten),5,1-4,63,66,129,0.488,03/21/2021,2021.0
37,Providence (Big East),7,3-4,94,99,193,0.487,03/21/2021,2021.0
38,Delaware (CAA),7,6-1,94,104,198,0.475,03/21/2021,2021.0
39,Mount St. Mary's (NEC),7,1-6,73,81,154,0.474,03/21/2021,2021.0
40,UAlbany (America East),4,3-1,51,58,109,0.468,03/21/2021,2021.0
41,Marist (MAAC),1,1-0,13,15,28,0.464,03/21/2021,2021.0
42,Holy Cross (Patriot),4,1-3,47,56,103,0.456,03/21/2021,2021.0
43,Maryland (Big Ten),5,5-0,67,84,151,0.444,03/21/2021,2021.0
44,High Point (SoCon),6,2-4,94,120,214,0.439,03/21/2021,2021.0
45,Rutgers (Big Ten),5,4-1,71,91,162,0.438,03/21/2021,2021.0
46,Army West Point (Patriot),4,3-1,46,59,105,0.438,03/21/2021,2021.0
47,Boston U. (Patriot),5,4-1,56,73,129,0.434,03/21/2021,2021.0
48,Drexel (CAA),3,1-2,35,48,83,0.422,03/21/2021,2021.0
49,Bucknell (Patriot),3,1-2,38,53,91,0.418,03/21/2021,2021.0
50,Air Force (SoCon),6,1-5,64,91,155,0.413,03/21/2021,2021.0
51,Towson (CAA),7,2-5,74,106,180,0.411,03/21/2021,2021.0
52,Cleveland St. (DI Independent),4,1-3,34,52,86,0.395,03/21/2021,2021.0
53,Lafayette (Patriot),3,0-3,31,50,81,0.383,03/21/2021,2021.0
54,UMass Lowell (America East),4,1-3,43,70,113,0.381,03/21/2021,2021.0
55,Robert Morris (DI Independent),7,3-4,83,139,222,0.374,03/21/2021,2021.0
56,Sacred Heart (NEC),8,1-7,74,131,205,0.361,03/21/2021,2021.0
57,Wagner (NEC),5,0-5,46,82,128,0.359,03/21/2021,2021.0
58,Siena (MAAC),3,0-3,22,40,62,0.355,03/21/2021,2021.0
59,VMI (SoCon),4,1-3,39,80,119,0.328,03/21/2021,2021.0
60,NJIT (America East),5,0-5,39,82,121,0.322,03/21/2021,2021.0
61,Marquette (Big East),5,0-5,41,90,131,0.313,03/21/2021,2021.0
62,Bellarmine (SoCon),9,2-7,64,147,211,0.303,03/21/2021,2021.0
63,Manhattan (MAAC),3,2-1,17,41,58,0.293,03/21/2021,2021.0
64,St. Bonaventure (MAAC),3,1-2,21,51,72,0.292,03/21/2021,2021.0
65,St. John's (NY) (Big East),5,1-4,40,111,151,0.265,03/21/2021,2021.0
-,Merrimack (NEC),5,2-3,55,72,127,0.433,03/21/2021,2021.0
1,Monmouth (MAAC),3,3-0,48,14,62,0.774,03/20/2021,2021.0
2,Notre Dame (ACC),4,4-0,73,22,95,0.768,03/20/2021,2021.0
3,Hobart (NEC),3,2-1,58,22,80,0.725,03/20/2021,2021.0
4,Saint Joseph's (NEC),6,3-3,99,43,142,0.697,03/20/2021,2021.0
5,Hofstra (CAA),4,3-1,89,43,132,0.674,03/20/2021,2021.0
6,Lehigh (Patriot),3,3-0,57,28,85,0.671,03/20/2021,2021.0
7,Vermont (America East),5,3-2,95,49,144,0.660,03/20/2021,2021.0
8,Georgetown (Big East),6,5-1,101,55,156,0.647,03/20/2021,2021.0
9,Detroit Mercy (MAAC),3,1-2,45,25,70,0.643,03/20/2021,2021.0
10,Mercer (SoCon),6,2-4,94,53,147,0.639,03/20/2021,2021.0
11,Canisius (MAAC),3,2-1,42,24,66,0.636,03/20/2021,2021.0
12,Virginia (ACC),8,6-2,150,86,236,0.636,03/20/2021,2021.0
13,Binghamton (America East),2,1-1,29,18,47,0.617,03/20/2021,2021.0
14,Bryant (NEC),4,3-1,66,42,108,0.611,03/20/2021,2021.0
15,Denver (Big East),8,6-2,133,87,220,0.605,03/20/2021,2021.0
16,Utah (DI Independent),6,2-4,82,54,136,0.603,03/20/2021,2021.0
17,North Carolina (ACC),8,8-0,150,102,252,0.595,03/20/2021,2021.0
18,Duke (ACC),8,8-0,135,95,230,0.587,03/20/2021,2021.0
19,Navy (Patriot),2,2-0,24,17,41,0.585,03/20/2021,2021.0
20,Fairfield (CAA),5,2-3,83,60,143,0.580,03/20/2021,2021.0
21,Villanova (Big East),4,3-1,60,44,104,0.577,03/20/2021,2021.0
22,Massachusetts (CAA),2,2-0,27,20,47,0.574,03/20/2021,2021.0
23,Michigan (Big Ten),5,1-4,85,65,150,0.567,03/20/2021,2021.0
24,Richmond (SoCon),6,3-3,83,65,148,0.561,03/20/2021,2021.0
25,Quinnipiac (MAAC),1,0-1,12,10,22,0.545,03/20/2021,2021.0
26,LIU (NEC),5,4-1,74,62,136,0.544,03/20/2021,2021.0
27,Syracuse (ACC),5,4-1,82,69,151,0.543,03/20/2021,2021.0
28,Colgate (Patriot),4,1-3,64,54,118,0.542,03/20/2021,2021.0
29,Ohio St. (Big Ten),5,2-3,80,68,148,0.541,03/20/2021,2021.0
30,Johns Hopkins (Big Ten),5,2-3,69,61,130,0.531,03/20/2021,2021.0
31,UMBC (America East),3,3-0,39,36,75,0.520,03/20/2021,2021.0
32,Hartford (America East),3,0-3,40,37,77,0.519,03/20/2021,2021.0
33,Stony Brook (America East),7,4-3,105,101,206,0.510,03/20/2021,2021.0
34,Loyola Maryland (Patriot),6,4-2,79,81,160,0.494,03/20/2021,2021.0
35,Penn St. (Big Ten),5,1-4,63,66,129,0.488,03/20/2021,2021.0
36,Providence (Big East),7,3-4,94,99,193,0.487,03/20/2021,2021.0
37,Jacksonville (SoCon),6,3-3,72,77,149,0.483,03/20/2021,2021.0
38,Delaware (CAA),7,6-1,94,104,198,0.475,03/20/2021,2021.0
39,Mount St. Mary's (NEC),7,1-6,73,81,154,0.474,03/20/2021,2021.0
40,UAlbany (America East),4,3-1,51,58,109,0.468,03/20/2021,2021.0
41,Marist (MAAC),1,1-0,13,15,28,0.464,03/20/2021,2021.0
42,Holy Cross (Patriot),4,1-3,47,55,102,0.461,03/20/2021,2021.0
43,Maryland (Big Ten),5,5-0,67,84,151,0.444,03/20/2021,2021.0
44,High Point (SoCon),6,2-4,94,120,214,0.439,03/20/2021,2021.0
45,Rutgers (Big Ten),5,4-1,71,91,162,0.438,03/20/2021,2021.0
46,Army West Point (Patriot),4,3-1,46,59,105,0.438,03/20/2021,2021.0
47,Boston U. (Patriot),5,4-1,56,73,129,0.434,03/20/2021,2021.0
48,Drexel (CAA),3,1-2,35,48,83,0.422,03/20/2021,2021.0
49,Bucknell (Patriot),3,1-2,38,53,91,0.418,03/20/2021,2021.0
50,Air Force (SoCon),6,1-5,64,91,155,0.413,03/20/2021,2021.0
51,Towson (CAA),7,2-5,74,106,180,0.411,03/20/2021,2021.0
52,Cleveland St. (DI Independent),4,1-3,34,52,86,0.395,03/20/2021,2021.0
53,Lafayette (Patriot),3,0-3,31,50,81,0.383,03/20/2021,2021.0
54,Wagner (NEC),4,0-4,39,63,102,0.382,03/20/2021,2021.0
55,UMass Lowell (America East),4,1-3,43,70,113,0.381,03/20/2021,2021.0
56,Robert Morris (DI Independent),7,3-4,83,139,222,0.374,03/20/2021,2021.0
57,Sacred Heart (NEC),8,1-7,74,131,205,0.361,03/20/2021,2021.0
58,Siena (MAAC),3,0-3,22,40,62,0.355,03/20/2021,2021.0
59,VMI (SoCon),4,1-3,39,80,119,0.328,03/20/2021,2021.0
60,NJIT (America East),5,0-5,39,82,121,0.322,03/20/2021,2021.0
61,Marquette (Big East),5,0-5,41,90,131,0.313,03/20/2021,2021.0
62,Bellarmine (SoCon),9,2-7,64,147,211,0.303,03/20/2021,2021.0
63,Manhattan (MAAC),3,2-1,17,41,58,0.293,03/20/2021,2021.0
64,St. Bonaventure (MAAC),3,1-2,21,51,72,0.292,03/20/2021,2021.0
65,St. John's (NY) (Big East),5,1-4,40,111,151,0.265,03/20/2021,2021.0
-,Merrimack (NEC),5,2-3,55,72,127,0.433,03/20/2021,2021.0
1,Notre Dame (ACC),3,3-0,51,16,67,0.761,03/19/2021,2021.0
2,Monmouth (MAAC),2,2-0,24,9,33,0.727,03/19/2021,2021.0
3,Binghamton (America East),1,1-0,13,5,18,0.722,03/19/2021,2021.0
4,Hobart (NEC),2,1-1,39,16,55,0.709,03/19/2021,2021.0
5,Hofstra (CAA),4,3-1,89,43,132,0.674,03/19/2021,2021.0
6,Lehigh (Patriot),3,3-0,57,28,85,0.671,03/19/2021,2021.0
7,Saint Joseph's (NEC),5,2-3,81,42,123,0.659,03/19/2021,2021.0
8,Mercer (SoCon),6,2-4,94,53,147,0.639,03/19/2021,2021.0
9,Georgetown (Big East),5,4-1,83,47,130,0.638,03/19/2021,2021.0
10,Canisius (MAAC),2,1-1,25,15,40,0.625,03/19/2021,2021.0
11,Vermont (America East),4,2-2,75,47,122,0.615,03/19/2021,2021.0
12,Detroit Mercy (MAAC),2,1-1,30,19,49,0.612,03/19/2021,2021.0
13,Bryant (NEC),4,3-1,66,42,108,0.611,03/19/2021,2021.0
14,Virginia (ACC),7,5-2,127,81,208,0.611,03/19/2021,2021.0
15,Denver (Big East),8,6-2,133,87,220,0.605,03/19/2021,2021.0
16,Utah (DI Independent),6,2-4,82,54,136,0.603,03/19/2021,2021.0
17,North Carolina (ACC),7,7-0,137,91,228,0.601,03/19/2021,2021.0
18,Duke (ACC),8,8-0,135,95,230,0.587,03/19/2021,2021.0
19,Navy (Patriot),2,2-0,24,17,41,0.585,03/19/2021,2021.0
20,Fairfield (CAA),5,2-3,83,60,143,0.580,03/19/2021,2021.0
21,Villanova (Big East),4,3-1,60,44,104,0.577,03/19/2021,2021.0
22,Michigan (Big Ten),4,0-4,68,53,121,0.562,03/19/2021,2021.0
23,UMBC (America East),2,2-0,27,22,49,0.551,03/19/2021,2021.0
24,Richmond (SoCon),5,2-3,67,55,122,0.549,03/19/2021,2021.0
25,Quinnipiac (MAAC),1,0-1,12,10,22,0.545,03/19/2021,2021.0
26,Colgate (Patriot),3,1-2,49,41,90,0.544,03/19/2021,2021.0
27,Massachusetts (CAA),1,1-0,13,11,24,0.542,03/19/2021,2021.0
28,LIU (NEC),4,3-1,60,51,111,0.541,03/19/2021,2021.0
29,Syracuse (ACC),4,3-1,67,60,127,0.528,03/19/2021,2021.0
30,Mount St. Mary's (NEC),6,1-5,67,62,129,0.519,03/19/2021,2021.0
31,Providence (Big East),6,3-3,86,81,167,0.515,03/19/2021,2021.0
32,Penn St. (Big Ten),4,1-3,51,49,100,0.510,03/19/2021,2021.0
33,Hartford (America East),2,0-2,26,25,51,0.510,03/19/2021,2021.0
34,Johns Hopkins (Big Ten),4,2-2,52,51,103,0.505,03/19/2021,2021.0
35,Ohio St. (Big Ten),4,2-2,61,60,121,0.504,03/19/2021,2021.0
36,Holy Cross (Patriot),3,1-2,38,40,78,0.487,03/19/2021,2021.0
37,Stony Brook (America East),6,3-3,86,91,177,0.486,03/19/2021,2021.0
38,Jacksonville (SoCon),6,3-3,72,77,149,0.483,03/19/2021,2021.0
39,Cleveland St. (DI Independent),3,1-2,28,30,58,0.483,03/19/2021,2021.0
40,Maryland (Big Ten),4,4-0,59,65,124,0.476,03/19/2021,2021.0
41,UAlbany (America East),3,2-1,38,42,80,0.475,03/19/2021,2021.0
42,Delaware (CAA),6,5-1,80,90,170,0.471,03/19/2021,2021.0
43,Marist (MAAC),1,1-0,13,15,28,0.464,03/19/2021,2021.0
44,Loyola Maryland (Patriot),5,3-2,57,66,123,0.463,03/19/2021,2021.0
45,Rutgers (Big Ten),4,3-1,61,74,135,0.452,03/19/2021,2021.0
46,High Point (SoCon),6,2-4,94,120,214,0.439,03/19/2021,2021.0
47,Army West Point (Patriot),4,3-1,46,59,105,0.438,03/19/2021,2021.0
48,Drexel (CAA),2,1-1,26,34,60,0.433,03/19/2021,2021.0
49,Bucknell (Patriot),2,1-1,23,31,54,0.426,03/19/2021,2021.0
50,Boston U. (Patriot),4,3-1,43,58,101,0.426,03/19/2021,2021.0
51,Air Force (SoCon),5,1-4,53,78,131,0.405,03/19/2021,2021.0
52,Robert Morris (DI Independent),6,3-3,78,116,194,0.402,03/19/2021,2021.0
53,Towson (CAA),6,2-4,60,92,152,0.395,03/19/2021,2021.0
54,UMass Lowell (America East),3,1-2,33,51,84,0.393,03/19/2021,2021.0
55,Lafayette (Patriot),3,0-3,31,50,81,0.383,03/19/2021,2021.0
56,Wagner (NEC),4,0-4,39,63,102,0.382,03/19/2021,2021.0
57,NJIT (America East),4,0-4,37,62,99,0.374,03/19/2021,2021.0
58,St. Bonaventure (MAAC),2,1-1,16,27,43,0.372,03/19/2021,2021.0
59,Siena (MAAC),2,0-2,13,23,36,0.361,03/19/2021,2021.0
60,Sacred Heart (NEC),7,1-6,63,117,180,0.350,03/19/2021,2021.0
61,VMI (SoCon),4,1-3,39,80,119,0.328,03/19/2021,2021.0
62,Marquette (Big East),5,0-5,41,90,131,0.313,03/19/2021,2021.0
63,Manhattan (MAAC),2,1-1,11,26,37,0.297,03/19/2021,2021.0
64,Bellarmine (SoCon),8,2-6,54,131,185,0.292,03/19/2021,2021.0
65,St. John's (NY) (Big East),5,1-4,40,111,151,0.265,03/19/2021,2021.0
-,Merrimack (NEC),4,2-2,54,54,108,0.500,03/19/2021,2021.0
1,Notre Dame (ACC),3,3-0,51,16,67,0.761,03/17/2021,2021.0
2,Monmouth (MAAC),2,2-0,24,9,33,0.727,03/17/2021,2021.0
3,Binghamton (America East),1,1-0,13,5,18,0.722,03/17/2021,2021.0
4,Hobart (NEC),2,1-1,39,16,55,0.709,03/17/2021,2021.0
5,Hofstra (CAA),4,3-1,89,43,132,0.674,03/17/2021,2021.0
6,Lehigh (Patriot),3,3-0,57,28,85,0.671,03/17/2021,2021.0
7,Saint Joseph's (NEC),5,2-3,81,42,123,0.659,03/17/2021,2021.0
8,Mercer (SoCon),6,2-4,94,53,147,0.639,03/17/2021,2021.0
9,Georgetown (Big East),5,4-1,83,47,130,0.638,03/17/2021,2021.0
10,Canisius (MAAC),2,1-1,25,15,40,0.625,03/17/2021,2021.0
11,Vermont (America East),4,2-2,75,47,122,0.615,03/17/2021,2021.0
12,Detroit Mercy (MAAC),2,1-1,30,19,49,0.612,03/17/2021,2021.0
13,Bryant (NEC),4,3-1,66,42,108,0.611,03/17/2021,2021.0
14,Virginia (ACC),7,5-2,127,81,208,0.611,03/17/2021,2021.0
15,Denver (Big East),8,6-2,133,87,220,0.605,03/17/2021,2021.0
16,Utah (DI Independent),6,2-4,82,54,136,0.603,03/17/2021,2021.0
17,North Carolina (ACC),7,7-0,137,91,228,0.601,03/17/2021,2021.0
18,Duke (ACC),8,8-0,135,95,230,0.587,03/17/2021,2021.0
19,Navy (Patriot),2,2-0,24,17,41,0.585,03/17/2021,2021.0
20,Fairfield (CAA),5,2-3,83,60,143,0.580,03/17/2021,2021.0
21,Villanova (Big East),4,3-1,60,44,104,0.577,03/17/2021,2021.0
22,Michigan (Big Ten),4,0-4,68,53,121,0.562,03/17/2021,2021.0
23,UMBC (America East),2,2-0,27,22,49,0.551,03/17/2021,2021.0
24,Richmond (SoCon),5,2-3,67,55,122,0.549,03/17/2021,2021.0
25,Quinnipiac (MAAC),1,0-1,12,10,22,0.545,03/17/2021,2021.0
26,Colgate (Patriot),3,1-2,49,41,90,0.544,03/17/2021,2021.0
27,Massachusetts (CAA),1,1-0,13,11,24,0.542,03/17/2021,2021.0
28,LIU (NEC),4,3-1,60,51,111,0.541,03/17/2021,2021.0
29,Syracuse (ACC),4,3-1,67,60,127,0.528,03/17/2021,2021.0
30,Mount St. Mary's (NEC),6,1-5,67,62,129,0.519,03/17/2021,2021.0
31,Providence (Big East),6,3-3,86,81,167,0.515,03/17/2021,2021.0
32,Penn St. (Big Ten),4,1-3,51,49,100,0.510,03/17/2021,2021.0
33,Hartford (America East),2,0-2,26,25,51,0.510,03/17/2021,2021.0
34,Johns Hopkins (Big Ten),4,2-2,52,51,103,0.505,03/17/2021,2021.0
35,Ohio St. (Big Ten),4,2-2,61,60,121,0.504,03/17/2021,2021.0
36,Holy Cross (Patriot),3,1-2,38,40,78,0.487,03/17/2021,2021.0
37,Stony Brook (America East),6,3-3,86,91,177,0.486,03/17/2021,2021.0
38,Jacksonville (SoCon),6,3-3,72,77,149,0.483,03/17/2021,2021.0
39,Cleveland St. (DI Independent),3,1-2,28,30,58,0.483,03/17/2021,2021.0
40,Maryland (Big Ten),4,4-0,59,65,124,0.476,03/17/2021,2021.0
41,UAlbany (America East),3,2-1,38,42,80,0.475,03/17/2021,2021.0
42,Delaware (CAA),6,5-1,80,90,170,0.471,03/17/2021,2021.0
43,Marist (MAAC),1,1-0,13,15,28,0.464,03/17/2021,2021.0
44,Loyola Maryland (Patriot),5,3-2,57,66,123,0.463,03/17/2021,2021.0
45,Rutgers (Big Ten),4,3-1,61,74,135,0.452,03/17/2021,2021.0
46,Army West Point (Patriot),4,3-1,46,59,105,0.438,03/17/2021,2021.0
47,Drexel (CAA),2,1-1,26,34,60,0.433,03/17/2021,2021.0
48,Bucknell (Patriot),2,1-1,23,31,54,0.426,03/17/2021,2021.0
49,Boston U. (Patriot),4,3-1,43,58,101,0.426,03/17/2021,2021.0
50,Air Force (SoCon),5,1-4,53,78,131,0.405,03/17/2021,2021.0
51,Robert Morris (DI Independent),6,3-3,78,116,194,0.402,03/17/2021,2021.0
52,Towson (CAA),6,2-4,60,92,152,0.395,03/17/2021,2021.0
53,UMass Lowell (America East),3,1-2,33,51,84,0.393,03/17/2021,2021.0
54,High Point (SoCon),5,1-4,69,109,178,0.388,03/17/2021,2021.0
55,Lafayette (Patriot),3,0-3,31,50,81,0.383,03/17/2021,2021.0
56,Wagner (NEC),4,0-4,39,63,102,0.382,03/17/2021,2021.0
57,NJIT (America East),4,0-4,37,62,99,0.374,03/17/2021,2021.0
58,St. Bonaventure (MAAC),2,1-1,16,27,43,0.372,03/17/2021,2021.0
59,Siena (MAAC),2,0-2,13,23,36,0.361,03/17/2021,2021.0
60,Sacred Heart (NEC),7,1-6,63,117,180,0.350,03/17/2021,2021.0
61,VMI (SoCon),3,1-2,28,55,83,0.337,03/17/2021,2021.0
62,Marquette (Big East),5,0-5,41,90,131,0.313,03/17/2021,2021.0
63,Manhattan (MAAC),2,1-1,11,26,37,0.297,03/17/2021,2021.0
64,Bellarmine (SoCon),8,2-6,54,131,185,0.292,03/17/2021,2021.0
65,St. John's (NY) (Big East),5,1-4,40,111,151,0.265,03/17/2021,2021.0
-,Merrimack (NEC),4,2-2,54,54,108,0.500,03/17/2021,2021.0
1,Notre Dame (ACC),2,2-0,40,11,51,0.784,03/16/2021,2021.0
2,Monmouth (MAAC),2,2-0,24,9,33,0.727,03/16/2021,2021.0
3,Binghamton (America East),1,1-0,13,5,18,0.722,03/16/2021,2021.0
4,Hobart (NEC),2,1-1,39,16,55,0.709,03/16/2021,2021.0
5,Hofstra (CAA),4,3-1,89,43,132,0.674,03/16/2021,2021.0
6,Lehigh (Patriot),3,3-0,57,28,85,0.671,03/16/2021,2021.0
7,Saint Joseph's (NEC),5,2-3,81,42,123,0.659,03/16/2021,2021.0
8,Mercer (SoCon),6,2-4,94,53,147,0.639,03/16/2021,2021.0
9,Georgetown (Big East),5,4-1,83,47,130,0.638,03/16/2021,2021.0
10,Canisius (MAAC),2,1-1,25,15,40,0.625,03/16/2021,2021.0
11,Vermont (America East),4,2-2,75,47,122,0.615,03/16/2021,2021.0
12,Detroit Mercy (MAAC),2,1-1,30,19,49,0.612,03/16/2021,2021.0
13,Bryant (NEC),4,3-1,66,42,108,0.611,03/16/2021,2021.0
14,Virginia (ACC),7,5-2,127,81,208,0.611,03/16/2021,2021.0
15,Denver (Big East),8,6-2,133,87,220,0.605,03/16/2021,2021.0
16,Utah (DI Independent),6,2-4,82,54,136,0.603,03/16/2021,2021.0
17,North Carolina (ACC),7,7-0,137,91,228,0.601,03/16/2021,2021.0
18,Duke (ACC),8,8-0,135,95,230,0.587,03/16/2021,2021.0
19,Navy (Patriot),2,2-0,24,17,41,0.585,03/16/2021,2021.0
20,Villanova (Big East),4,3-1,60,44,104,0.577,03/16/2021,2021.0
21,Michigan (Big Ten),4,0-4,68,53,121,0.562,03/16/2021,2021.0
22,Fairfield (CAA),4,1-3,66,52,118,0.559,03/16/2021,2021.0
23,UMBC (America East),2,2-0,27,22,49,0.551,03/16/2021,2021.0
24,Richmond (SoCon),5,2-3,67,55,122,0.549,03/16/2021,2021.0
25,Quinnipiac (MAAC),1,0-1,12,10,22,0.545,03/16/2021,2021.0
26,Colgate (Patriot),3,1-2,49,41,90,0.544,03/16/2021,2021.0
27,Massachusetts (CAA),1,1-0,13,11,24,0.542,03/16/2021,2021.0
28,LIU (NEC),4,3-1,60,51,111,0.541,03/16/2021,2021.0
29,Syracuse (ACC),4,3-1,67,60,127,0.528,03/16/2021,2021.0
30,Mount St. Mary's (NEC),6,1-5,67,62,129,0.519,03/16/2021,2021.0
31,Providence (Big East),6,3-3,86,81,167,0.515,03/16/2021,2021.0
32,Penn St. (Big Ten),4,1-3,51,49,100,0.510,03/16/2021,2021.0
33,Hartford (America East),2,0-2,26,25,51,0.510,03/16/2021,2021.0
34,Johns Hopkins (Big Ten),4,2-2,52,51,103,0.505,03/16/2021,2021.0
35,Ohio St. (Big Ten),4,2-2,61,60,121,0.504,03/16/2021,2021.0
36,Holy Cross (Patriot),3,1-2,38,40,78,0.487,03/16/2021,2021.0
37,Stony Brook (America East),6,3-3,86,91,177,0.486,03/16/2021,2021.0
38,Jacksonville (SoCon),6,3-3,72,77,149,0.483,03/16/2021,2021.0
39,Cleveland St. (DI Independent),3,1-2,28,30,58,0.483,03/16/2021,2021.0
40,Maryland (Big Ten),4,4-0,59,65,124,0.476,03/16/2021,2021.0
41,UAlbany (America East),3,2-1,38,42,80,0.475,03/16/2021,2021.0
42,Delaware (CAA),6,5-1,80,90,170,0.471,03/16/2021,2021.0
43,Marist (MAAC),1,1-0,13,15,28,0.464,03/16/2021,2021.0
44,Loyola Maryland (Patriot),5,3-2,57,66,123,0.463,03/16/2021,2021.0
45,Rutgers (Big Ten),4,3-1,61,74,135,0.452,03/16/2021,2021.0
46,Army West Point (Patriot),4,3-1,46,59,105,0.438,03/16/2021,2021.0
47,Drexel (CAA),2,1-1,26,34,60,0.433,03/16/2021,2021.0
48,Bucknell (Patriot),2,1-1,23,31,54,0.426,03/16/2021,2021.0
49,Boston U. (Patriot),4,3-1,43,58,101,0.426,03/16/2021,2021.0
50,Air Force (SoCon),5,1-4,53,78,131,0.405,03/16/2021,2021.0
51,Robert Morris (DI Independent),6,3-3,78,116,194,0.402,03/16/2021,2021.0
52,Towson (CAA),6,2-4,60,92,152,0.395,03/16/2021,2021.0
53,UMass Lowell (America East),3,1-2,33,51,84,0.393,03/16/2021,2021.0
54,High Point (SoCon),5,1-4,69,109,178,0.388,03/16/2021,2021.0
55,Lafayette (Patriot),3,0-3,31,50,81,0.383,03/16/2021,2021.0
56,Wagner (NEC),4,0-4,39,63,102,0.382,03/16/2021,2021.0
57,NJIT (America East),4,0-4,37,62,99,0.374,03/16/2021,2021.0
58,St. Bonaventure (MAAC),2,1-1,16,27,43,0.372,03/16/2021,2021.0
59,Siena (MAAC),2,0-2,13,23,36,0.361,03/16/2021,2021.0
60,Sacred Heart (NEC),6,1-5,55,100,155,0.355,03/16/2021,2021.0
61,VMI (SoCon),3,1-2,28,55,83,0.337,03/16/2021,2021.0
62,Marquette (Big East),4,0-4,36,79,115,0.313,03/16/2021,2021.0
63,Manhattan (MAAC),2,1-1,11,26,37,0.297,03/16/2021,2021.0
64,Bellarmine (SoCon),8,2-6,54,131,185,0.292,03/16/2021,2021.0
65,St. John's (NY) (Big East),5,1-4,40,111,151,0.265,03/16/2021,2021.0
-,Merrimack (NEC),4,2-2,54,54,108,0.500,03/16/2021,2021.0
1,Notre Dame (ACC),2,2-0,40,11,51,0.784,03/14/2021,2021.0
2,Monmouth (MAAC),2,2-0,24,9,33,0.727,03/14/2021,2021.0
3,Binghamton (America East),1,1-0,13,5,18,0.722,03/14/2021,2021.0
4,Hobart (NEC),2,1-1,39,16,55,0.709,03/14/2021,2021.0
5,Georgetown (Big East),4,4-0,72,34,106,0.679,03/14/2021,2021.0
6,Hofstra (CAA),4,3-1,89,43,132,0.674,03/14/2021,2021.0
7,Lehigh (Patriot),3,3-0,57,28,85,0.671,03/14/2021,2021.0
8,Saint Joseph's (NEC),5,2-3,81,42,123,0.659,03/14/2021,2021.0
9,Mercer (SoCon),6,2-4,94,53,147,0.639,03/14/2021,2021.0
10,Canisius (MAAC),2,1-1,25,15,40,0.625,03/14/2021,2021.0
11,Vermont (America East),4,2-2,75,47,122,0.615,03/14/2021,2021.0
12,Denver (Big East),7,5-2,120,76,196,0.612,03/14/2021,2021.0
12,Detroit Mercy (MAAC),2,1-1,30,19,49,0.612,03/14/2021,2021.0
14,Bryant (NEC),4,3-1,66,42,108,0.611,03/14/2021,2021.0
15,Virginia (ACC),7,5-2,127,81,208,0.611,03/14/2021,2021.0
16,Utah (DI Independent),6,2-4,82,54,136,0.603,03/14/2021,2021.0
17,North Carolina (ACC),7,7-0,137,91,228,0.601,03/14/2021,2021.0
18,Duke (ACC),8,8-0,135,95,230,0.587,03/14/2021,2021.0
19,Navy (Patriot),2,2-0,24,17,41,0.585,03/14/2021,2021.0
20,Villanova (Big East),4,3-1,60,44,104,0.577,03/14/2021,2021.0
21,Michigan (Big Ten),4,0-4,68,53,121,0.562,03/14/2021,2021.0
22,Fairfield (CAA),4,1-3,66,52,118,0.559,03/14/2021,2021.0
23,UMBC (America East),2,2-0,27,22,49,0.551,03/14/2021,2021.0
24,Richmond (SoCon),5,2-3,67,55,122,0.549,03/14/2021,2021.0
25,Quinnipiac (MAAC),1,0-1,12,10,22,0.545,03/14/2021,2021.0
26,Colgate (Patriot),3,1-2,49,41,90,0.544,03/14/2021,2021.0
27,Massachusetts (CAA),1,1-0,13,11,24,0.542,03/14/2021,2021.0
28,LIU (NEC),4,3-1,60,51,111,0.541,03/14/2021,2021.0
29,Syracuse (ACC),4,3-1,67,60,127,0.528,03/14/2021,2021.0
30,Mount St. Mary's (NEC),6,1-5,67,62,129,0.519,03/14/2021,2021.0
31,Providence (Big East),6,3-3,86,81,167,0.515,03/14/2021,2021.0
32,Penn St. (Big Ten),4,1-3,51,49,100,0.510,03/14/2021,2021.0
33,Hartford (America East),2,0-2,26,25,51,0.510,03/14/2021,2021.0
34,Johns Hopkins (Big Ten),4,2-2,52,51,103,0.505,03/14/2021,2021.0
35,Ohio St. (Big Ten),4,2-2,61,60,121,0.504,03/14/2021,2021.0
36,Holy Cross (Patriot),3,1-2,38,40,78,0.487,03/14/2021,2021.0
37,Stony Brook (America East),6,3-3,86,91,177,0.486,03/14/2021,2021.0
38,Jacksonville (SoCon),6,3-3,72,77,149,0.483,03/14/2021,2021.0
39,Cleveland St. (DI Independent),3,1-2,28,30,58,0.483,03/14/2021,2021.0
40,Maryland (Big Ten),4,4-0,59,65,124,0.476,03/14/2021,2021.0
41,UAlbany (America East),3,2-1,38,42,80,0.475,03/14/2021,2021.0
42,Delaware (CAA),6,5-1,80,90,170,0.471,03/14/2021,2021.0
43,Marist (MAAC),1,1-0,13,15,28,0.464,03/14/2021,2021.0
44,Loyola Maryland (Patriot),5,3-2,57,66,123,0.463,03/14/2021,2021.0
45,Rutgers (Big Ten),4,3-1,61,74,135,0.452,03/14/2021,2021.0
46,Army West Point (Patriot),4,3-1,46,59,105,0.438,03/14/2021,2021.0
47,Drexel (CAA),2,1-1,26,34,60,0.433,03/14/2021,2021.0
48,Bucknell (Patriot),2,1-1,23,31,54,0.426,03/14/2021,2021.0
49,Boston U. (Patriot),4,3-1,43,58,101,0.426,03/14/2021,2021.0
50,Air Force (SoCon),5,1-4,53,78,131,0.405,03/14/2021,2021.0
51,Robert Morris (DI Independent),6,3-3,78,116,194,0.402,03/14/2021,2021.0
52,Towson (CAA),6,2-4,60,92,152,0.395,03/14/2021,2021.0
53,UMass Lowell (America East),3,1-2,33,51,84,0.393,03/14/2021,2021.0
54,High Point (SoCon),5,1-4,69,109,178,0.388,03/14/2021,2021.0
55,Lafayette (Patriot),3,0-3,31,50,81,0.383,03/14/2021,2021.0
56,Wagner (NEC),4,0-4,39,63,102,0.382,03/14/2021,2021.0
57,NJIT (America East),4,0-4,37,62,99,0.374,03/14/2021,2021.0
58,St. Bonaventure (MAAC),2,1-1,16,27,43,0.372,03/14/2021,2021.0
59,Siena (MAAC),2,0-2,13,23,36,0.361,03/14/2021,2021.0
60,Sacred Heart (NEC),6,1-5,55,100,155,0.355,03/14/2021,2021.0
61,VMI (SoCon),3,1-2,28,55,83,0.337,03/14/2021,2021.0
62,Marquette (Big East),4,0-4,36,79,115,0.313,03/14/2021,2021.0
63,Manhattan (MAAC),2,1-1,11,26,37,0.297,03/14/2021,2021.0
64,Bellarmine (SoCon),8,2-6,54,131,185,0.292,03/14/2021,2021.0
65,St. John's (NY) (Big East),5,1-4,40,111,151,0.265,03/14/2021,2021.0
-,Merrimack (NEC),4,2-2,54,54,108,0.500,03/14/2021,2021.0
1,Notre Dame (ACC),2,2-0,40,11,51,0.784,03/13/2021,2021.0
2,Monmouth (MAAC),2,2-0,24,9,33,0.727,03/13/2021,2021.0
3,Binghamton (America East),1,1-0,13,5,18,0.722,03/13/2021,2021.0
4,Hobart (NEC),2,1-1,39,16,55,0.709,03/13/2021,2021.0
5,Georgetown (Big East),4,4-0,72,34,106,0.679,03/13/2021,2021.0
6,Lehigh (Patriot),2,2-0,38,18,56,0.679,03/13/2021,2021.0
7,Hofstra (CAA),4,3-1,89,43,132,0.674,03/13/2021,2021.0
8,Saint Joseph's (NEC),5,2-3,81,42,123,0.659,03/13/2021,2021.0
9,Mercer (SoCon),6,2-4,94,53,147,0.639,03/13/2021,2021.0
10,Canisius (MAAC),2,1-1,25,15,40,0.625,03/13/2021,2021.0
11,Vermont (America East),4,2-2,75,47,122,0.615,03/13/2021,2021.0
12,Denver (Big East),7,5-2,120,76,196,0.612,03/13/2021,2021.0
12,Detroit Mercy (MAAC),2,1-1,30,19,49,0.612,03/13/2021,2021.0
14,Bryant (NEC),4,3-1,66,42,108,0.611,03/13/2021,2021.0
15,Virginia (ACC),7,5-2,127,81,208,0.611,03/13/2021,2021.0
16,Utah (DI Independent),6,2-4,82,54,136,0.603,03/13/2021,2021.0
17,North Carolina (ACC),7,7-0,137,91,228,0.601,03/13/2021,2021.0
18,Navy (Patriot),2,2-0,24,17,41,0.585,03/13/2021,2021.0
19,Fairfield (CAA),3,1-2,55,39,94,0.585,03/13/2021,2021.0
20,Duke (ACC),7,7-0,118,85,203,0.581,03/13/2021,2021.0
21,Michigan (Big Ten),3,0-3,55,40,95,0.579,03/13/2021,2021.0
22,UMBC (America East),2,2-0,27,22,49,0.551,03/13/2021,2021.0
23,Richmond (SoCon),5,2-3,67,55,122,0.549,03/13/2021,2021.0
24,Quinnipiac (MAAC),1,0-1,12,10,22,0.545,03/13/2021,2021.0
25,Colgate (Patriot),3,1-2,49,41,90,0.544,03/13/2021,2021.0
26,LIU (NEC),4,3-1,60,51,111,0.541,03/13/2021,2021.0
27,Syracuse (ACC),4,3-1,67,60,127,0.528,03/13/2021,2021.0
28,Bucknell (Patriot),1,1-0,13,12,25,0.520,03/13/2021,2021.0
29,Mount St. Mary's (NEC),6,1-5,67,62,129,0.519,03/13/2021,2021.0
30,Providence (Big East),6,3-3,86,81,167,0.515,03/13/2021,2021.0
31,Villanova (Big East),3,2-1,38,36,74,0.514,03/13/2021,2021.0
32,Penn St. (Big Ten),4,1-3,51,49,100,0.510,03/13/2021,2021.0
33,Hartford (America East),2,0-2,26,25,51,0.510,03/13/2021,2021.0
34,Jacksonville (SoCon),5,3-2,62,60,122,0.508,03/13/2021,2021.0
35,Ohio St. (Big Ten),3,1-2,48,47,95,0.505,03/13/2021,2021.0
36,Johns Hopkins (Big Ten),4,2-2,52,51,103,0.505,03/13/2021,2021.0
37,Holy Cross (Patriot),3,1-2,38,40,78,0.487,03/13/2021,2021.0
38,Cleveland St. (DI Independent),3,1-2,28,30,58,0.483,03/13/2021,2021.0
39,Maryland (Big Ten),4,4-0,59,65,124,0.476,03/13/2021,2021.0
40,UAlbany (America East),3,2-1,38,42,80,0.475,03/13/2021,2021.0
41,Delaware (CAA),6,5-1,80,90,170,0.471,03/13/2021,2021.0
42,Marist (MAAC),1,1-0,13,15,28,0.464,03/13/2021,2021.0
43,Loyola Maryland (Patriot),5,3-2,57,66,123,0.463,03/13/2021,2021.0
44,Rutgers (Big Ten),4,3-1,61,74,135,0.452,03/13/2021,2021.0
45,Stony Brook (America East),5,2-3,70,86,156,0.449,03/13/2021,2021.0
46,Army West Point (Patriot),4,3-1,46,59,105,0.438,03/13/2021,2021.0
47,Drexel (CAA),2,1-1,26,34,60,0.433,03/13/2021,2021.0
48,Boston U. (Patriot),4,3-1,43,58,101,0.426,03/13/2021,2021.0
49,NJIT (America East),3,0-3,32,46,78,0.410,03/13/2021,2021.0
50,Air Force (SoCon),5,1-4,53,78,131,0.405,03/13/2021,2021.0
51,Robert Morris (DI Independent),6,3-3,78,116,194,0.402,03/13/2021,2021.0
52,Towson (CAA),6,2-4,60,92,152,0.395,03/13/2021,2021.0
53,UMass Lowell (America East),3,1-2,33,51,84,0.393,03/13/2021,2021.0
54,High Point (SoCon),5,1-4,69,109,178,0.388,03/13/2021,2021.0
55,Lafayette (Patriot),3,0-3,31,50,81,0.383,03/13/2021,2021.0
56,Wagner (NEC),4,0-4,39,63,102,0.382,03/13/2021,2021.0
57,St. Bonaventure (MAAC),2,1-1,16,27,43,0.372,03/13/2021,2021.0
58,Siena (MAAC),2,0-2,13,23,36,0.361,03/13/2021,2021.0
59,Sacred Heart (NEC),6,1-5,55,100,155,0.355,03/13/2021,2021.0
60,VMI (SoCon),3,1-2,28,55,83,0.337,03/13/2021,2021.0
61,Marquette (Big East),4,0-4,36,79,115,0.313,03/13/2021,2021.0
62,Manhattan (MAAC),2,1-1,11,26,37,0.297,03/13/2021,2021.0
63,Bellarmine (SoCon),8,2-6,54,131,185,0.292,03/13/2021,2021.0
64,St. John's (NY) (Big East),4,1-3,32,89,121,0.264,03/13/2021,2021.0
-,Merrimack (NEC),4,2-2,54,54,108,0.500,03/13/2021,2021.0
1,Notre Dame (ACC),2,2-0,40,11,51,0.784,03/12/2021,2021.0
2,Binghamton (America East),1,1-0,13,5,18,0.722,03/12/2021,2021.0
3,Monmouth (MAAC),1,1-0,11,5,16,0.688,03/12/2021,2021.0
4,Saint Joseph's (NEC),4,1-3,67,31,98,0.684,03/12/2021,2021.0
5,Hobart (NEC),1,1-0,17,8,25,0.680,03/12/2021,2021.0
6,Georgetown (Big East),4,4-0,72,34,106,0.679,03/12/2021,2021.0
7,Lehigh (Patriot),2,2-0,38,18,56,0.679,03/12/2021,2021.0
8,Hofstra (CAA),4,3-1,89,43,132,0.674,03/12/2021,2021.0
9,LIU (NEC),3,2-1,52,29,81,0.642,03/12/2021,2021.0
10,Mercer (SoCon),6,2-4,94,53,147,0.639,03/12/2021,2021.0
11,Vermont (America East),3,1-2,58,36,94,0.617,03/12/2021,2021.0
12,Denver (Big East),7,5-2,120,76,196,0.612,03/12/2021,2021.0
13,Bryant (NEC),4,3-1,66,42,108,0.611,03/12/2021,2021.0
14,Virginia (ACC),7,5-2,127,81,208,0.611,03/12/2021,2021.0
15,North Carolina (ACC),7,7-0,137,91,228,0.601,03/12/2021,2021.0
16,Navy (Patriot),2,2-0,24,17,41,0.585,03/12/2021,2021.0
17,Fairfield (CAA),3,1-2,55,39,94,0.585,03/12/2021,2021.0
18,Duke (ACC),7,7-0,118,85,203,0.581,03/12/2021,2021.0
19,Michigan (Big Ten),3,0-3,55,40,95,0.579,03/12/2021,2021.0
20,UMBC (America East),2,2-0,27,22,49,0.551,03/12/2021,2021.0
21,Quinnipiac (MAAC),1,0-1,12,10,22,0.545,03/12/2021,2021.0
22,Colgate (Patriot),3,1-2,49,41,90,0.544,03/12/2021,2021.0
23,Penn St. (Big Ten),3,1-2,42,36,78,0.538,03/12/2021,2021.0
24,Detroit Mercy (MAAC),1,0-1,15,13,28,0.536,03/12/2021,2021.0
25,Utah (DI Independent),5,1-4,58,51,109,0.532,03/12/2021,2021.0
26,Syracuse (ACC),4,3-1,67,60,127,0.528,03/12/2021,2021.0
27,Canisius (MAAC),1,1-0,10,9,19,0.526,03/12/2021,2021.0
28,Bucknell (Patriot),1,1-0,13,12,25,0.520,03/12/2021,2021.0
29,Mount St. Mary's (NEC),6,1-5,67,62,129,0.519,03/12/2021,2021.0
30,UAlbany (America East),2,2-0,27,25,52,0.519,03/12/2021,2021.0
31,Villanova (Big East),3,2-1,38,36,74,0.514,03/12/2021,2021.0
32,Jacksonville (SoCon),5,3-2,62,60,122,0.508,03/12/2021,2021.0
33,Ohio St. (Big Ten),3,1-2,48,47,95,0.505,03/12/2021,2021.0
34,Holy Cross (Patriot),3,1-2,38,40,78,0.487,03/12/2021,2021.0
35,Delaware (CAA),5,4-1,66,70,136,0.485,03/12/2021,2021.0
36,Providence (Big East),5,2-3,69,74,143,0.483,03/12/2021,2021.0
37,Johns Hopkins (Big Ten),3,1-2,39,42,81,0.481,03/12/2021,2021.0
38,Hartford (America East),1,0-1,12,13,25,0.480,03/12/2021,2021.0
39,Siena (MAAC),1,0-1,9,10,19,0.474,03/12/2021,2021.0
40,Marist (MAAC),1,1-0,13,15,28,0.464,03/12/2021,2021.0
41,VMI (SoCon),2,1-1,24,28,52,0.462,03/12/2021,2021.0
42,Maryland (Big Ten),3,3-0,41,48,89,0.461,03/12/2021,2021.0
43,St. Bonaventure (MAAC),1,1-0,10,12,22,0.455,03/12/2021,2021.0
44,Stony Brook (America East),5,2-3,70,86,156,0.449,03/12/2021,2021.0
45,Rutgers (Big Ten),3,3-0,44,56,100,0.440,03/12/2021,2021.0
46,Richmond (SoCon),4,1-3,40,51,91,0.440,03/12/2021,2021.0
47,Army West Point (Patriot),4,3-1,46,59,105,0.438,03/12/2021,2021.0
48,Cleveland St. (DI Independent),2,0-2,20,26,46,0.435,03/12/2021,2021.0
49,Loyola Maryland (Patriot),4,2-2,42,56,98,0.429,03/12/2021,2021.0
50,Boston U. (Patriot),4,3-1,43,58,101,0.426,03/12/2021,2021.0
51,NJIT (America East),3,0-3,32,46,78,0.410,03/12/2021,2021.0
52,Robert Morris (DI Independent),5,2-3,65,99,164,0.396,03/12/2021,2021.0
53,Towson (CAA),6,2-4,60,92,152,0.395,03/12/2021,2021.0
54,High Point (SoCon),5,1-4,69,109,178,0.388,03/12/2021,2021.0
55,Lafayette (Patriot),2,0-2,21,35,56,0.375,03/12/2021,2021.0
56,Wagner (NEC),3,0-3,30,52,82,0.366,03/12/2021,2021.0
57,UMass Lowell (America East),2,0-2,21,37,58,0.362,03/12/2021,2021.0
58,Air Force (SoCon),4,1-3,36,65,101,0.356,03/12/2021,2021.0
59,Sacred Heart (NEC),5,1-4,44,86,130,0.338,03/12/2021,2021.0
60,Marquette (Big East),3,0-3,29,62,91,0.319,03/12/2021,2021.0
61,Manhattan (MAAC),1,0-1,5,11,16,0.313,03/12/2021,2021.0
62,Bellarmine (SoCon),7,2-5,50,123,173,0.289,03/12/2021,2021.0
63,St. John's (NY) (Big East),4,1-3,32,89,121,0.264,03/12/2021,2021.0
64,Drexel (CAA),1,1-0,6,20,26,0.231,03/12/2021,2021.0
-,Merrimack (NEC),3,1-2,43,45,88,0.489,03/12/2021,2021.0
1,Notre Dame (ACC),2,2-0,40,11,51,0.784,03/11/2021,2021.0
2,Binghamton (America East),1,1-0,13,5,18,0.722,03/11/2021,2021.0
3,Monmouth (MAAC),1,1-0,11,5,16,0.688,03/11/2021,2021.0
4,Saint Joseph's (NEC),4,1-3,67,31,98,0.684,03/11/2021,2021.0
5,Hobart (NEC),1,1-0,17,8,25,0.680,03/11/2021,2021.0
6,Georgetown (Big East),4,4-0,72,34,106,0.679,03/11/2021,2021.0
7,Lehigh (Patriot),2,2-0,38,18,56,0.679,03/11/2021,2021.0
8,Hofstra (CAA),4,3-1,89,43,132,0.674,03/11/2021,2021.0
9,LIU (NEC),3,2-1,52,29,81,0.642,03/11/2021,2021.0
10,Mercer (SoCon),6,2-4,94,53,147,0.639,03/11/2021,2021.0
11,Vermont (America East),3,1-2,58,36,94,0.617,03/11/2021,2021.0
12,Denver (Big East),7,5-2,120,76,196,0.612,03/11/2021,2021.0
13,Bryant (NEC),4,3-1,66,42,108,0.611,03/11/2021,2021.0
14,Virginia (ACC),7,5-2,127,81,208,0.611,03/11/2021,2021.0
15,North Carolina (ACC),7,7-0,137,91,228,0.601,03/11/2021,2021.0
16,Navy (Patriot),2,2-0,24,17,41,0.585,03/11/2021,2021.0
17,Fairfield (CAA),3,1-2,55,39,94,0.585,03/11/2021,2021.0
18,Duke (ACC),7,7-0,118,85,203,0.581,03/11/2021,2021.0
19,Michigan (Big Ten),3,0-3,55,40,95,0.579,03/11/2021,2021.0
20,UMBC (America East),2,2-0,27,22,49,0.551,03/11/2021,2021.0
21,Quinnipiac (MAAC),1,0-1,12,10,22,0.545,03/11/2021,2021.0
22,Colgate (Patriot),3,1-2,49,41,90,0.544,03/11/2021,2021.0
23,Penn St. (Big Ten),3,1-2,42,36,78,0.538,03/11/2021,2021.0
24,Detroit Mercy (MAAC),1,0-1,15,13,28,0.536,03/11/2021,2021.0
25,Utah (DI Independent),5,1-4,58,51,109,0.532,03/11/2021,2021.0
26,Canisius (MAAC),1,1-0,10,9,19,0.526,03/11/2021,2021.0
27,Bucknell (Patriot),1,1-0,13,12,25,0.520,03/11/2021,2021.0
28,Mount St. Mary's (NEC),6,1-5,67,62,129,0.519,03/11/2021,2021.0
29,UAlbany (America East),2,2-0,27,25,52,0.519,03/11/2021,2021.0
30,Villanova (Big East),3,2-1,38,36,74,0.514,03/11/2021,2021.0
31,Syracuse (ACC),3,2-1,50,48,98,0.510,03/11/2021,2021.0
32,Jacksonville (SoCon),5,3-2,62,60,122,0.508,03/11/2021,2021.0
33,Ohio St. (Big Ten),3,1-2,48,47,95,0.505,03/11/2021,2021.0
34,Boston U. (Patriot),3,2-1,37,38,75,0.493,03/11/2021,2021.0
35,Delaware (CAA),5,4-1,66,70,136,0.485,03/11/2021,2021.0
36,Providence (Big East),5,2-3,69,74,143,0.483,03/11/2021,2021.0
37,Johns Hopkins (Big Ten),3,1-2,39,42,81,0.481,03/11/2021,2021.0
38,Hartford (America East),1,0-1,12,13,25,0.480,03/11/2021,2021.0
39,Siena (MAAC),1,0-1,9,10,19,0.474,03/11/2021,2021.0
40,Marist (MAAC),1,1-0,13,15,28,0.464,03/11/2021,2021.0
41,VMI (SoCon),2,1-1,24,28,52,0.462,03/11/2021,2021.0
42,Maryland (Big Ten),3,3-0,41,48,89,0.461,03/11/2021,2021.0
43,Stony Brook (America East),4,2-2,58,69,127,0.457,03/11/2021,2021.0
44,St. Bonaventure (MAAC),1,1-0,10,12,22,0.455,03/11/2021,2021.0
45,Rutgers (Big Ten),3,3-0,44,56,100,0.440,03/11/2021,2021.0
46,Richmond (SoCon),4,1-3,40,51,91,0.440,03/11/2021,2021.0
47,Army West Point (Patriot),4,3-1,46,59,105,0.438,03/11/2021,2021.0
48,Cleveland St. (DI Independent),2,0-2,20,26,46,0.435,03/11/2021,2021.0
49,Loyola Maryland (Patriot),4,2-2,42,56,98,0.429,03/11/2021,2021.0
50,NJIT (America East),3,0-3,32,46,78,0.410,03/11/2021,2021.0
51,Robert Morris (DI Independent),5,2-3,65,99,164,0.396,03/11/2021,2021.0
52,Towson (CAA),6,2-4,60,92,152,0.395,03/11/2021,2021.0
53,High Point (SoCon),5,1-4,69,109,178,0.388,03/11/2021,2021.0
54,Lafayette (Patriot),2,0-2,21,35,56,0.375,03/11/2021,2021.0
55,Wagner (NEC),3,0-3,30,52,82,0.366,03/11/2021,2021.0
56,UMass Lowell (America East),2,0-2,21,37,58,0.362,03/11/2021,2021.0
57,Air Force (SoCon),4,1-3,36,65,101,0.356,03/11/2021,2021.0
58,Holy Cross (Patriot),2,1-1,18,34,52,0.346,03/11/2021,2021.0
59,Sacred Heart (NEC),5,1-4,44,86,130,0.338,03/11/2021,2021.0
60,Marquette (Big East),3,0-3,29,62,91,0.319,03/11/2021,2021.0
61,Manhattan (MAAC),1,0-1,5,11,16,0.313,03/11/2021,2021.0
62,Bellarmine (SoCon),7,2-5,50,123,173,0.289,03/11/2021,2021.0
63,St. John's (NY) (Big East),4,1-3,32,89,121,0.264,03/11/2021,2021.0
64,Drexel (CAA),1,1-0,6,20,26,0.231,03/11/2021,2021.0
-,Merrimack (NEC),3,1-2,43,45,88,0.489,03/11/2021,2021.0
1,Notre Dame (ACC),2,2-0,40,11,51,0.784,03/10/2021,2021.0
2,Binghamton (America East),1,1-0,13,5,18,0.722,03/10/2021,2021.0
3,Monmouth (MAAC),1,1-0,11,5,16,0.688,03/10/2021,2021.0
4,Saint Joseph's (NEC),4,1-3,67,31,98,0.684,03/10/2021,2021.0
5,Hobart (NEC),1,1-0,17,8,25,0.680,03/10/2021,2021.0
6,Georgetown (Big East),4,4-0,72,34,106,0.679,03/10/2021,2021.0
7,Lehigh (Patriot),2,2-0,38,18,56,0.679,03/10/2021,2021.0
8,Hofstra (CAA),4,3-1,89,43,132,0.674,03/10/2021,2021.0
9,North Carolina (ACC),6,6-0,126,70,196,0.643,03/10/2021,2021.0
10,LIU (NEC),3,2-1,52,29,81,0.642,03/10/2021,2021.0
11,Mercer (SoCon),6,2-4,94,53,147,0.639,03/10/2021,2021.0
12,Vermont (America East),3,1-2,58,36,94,0.617,03/10/2021,2021.0
13,Denver (Big East),7,5-2,120,76,196,0.612,03/10/2021,2021.0
14,Bryant (NEC),4,3-1,66,42,108,0.611,03/10/2021,2021.0
15,Virginia (ACC),6,5-1,106,70,176,0.602,03/10/2021,2021.0
16,Navy (Patriot),2,2-0,24,17,41,0.585,03/10/2021,2021.0
17,Fairfield (CAA),3,1-2,55,39,94,0.585,03/10/2021,2021.0
18,Duke (ACC),7,7-0,118,85,203,0.581,03/10/2021,2021.0
19,Michigan (Big Ten),3,0-3,55,40,95,0.579,03/10/2021,2021.0
20,UMBC (America East),2,2-0,27,22,49,0.551,03/10/2021,2021.0
21,Quinnipiac (MAAC),1,0-1,12,10,22,0.545,03/10/2021,2021.0
22,Colgate (Patriot),3,1-2,49,41,90,0.544,03/10/2021,2021.0
23,Penn St. (Big Ten),3,1-2,42,36,78,0.538,03/10/2021,2021.0
24,Detroit Mercy (MAAC),1,0-1,15,13,28,0.536,03/10/2021,2021.0
25,Utah (DI Independent),5,1-4,58,51,109,0.532,03/10/2021,2021.0
26,Canisius (MAAC),1,1-0,10,9,19,0.526,03/10/2021,2021.0
27,Bucknell (Patriot),1,1-0,13,12,25,0.520,03/10/2021,2021.0
28,Mount St. Mary's (NEC),6,1-5,67,62,129,0.519,03/10/2021,2021.0
29,UAlbany (America East),2,2-0,27,25,52,0.519,03/10/2021,2021.0
30,Villanova (Big East),3,2-1,38,36,74,0.514,03/10/2021,2021.0
31,Syracuse (ACC),3,2-1,50,48,98,0.510,03/10/2021,2021.0
32,Jacksonville (SoCon),5,3-2,62,60,122,0.508,03/10/2021,2021.0
33,Ohio St. (Big Ten),3,1-2,48,47,95,0.505,03/10/2021,2021.0
34,Boston U. (Patriot),3,2-1,37,38,75,0.493,03/10/2021,2021.0
35,Delaware (CAA),5,4-1,66,70,136,0.485,03/10/2021,2021.0
36,Providence (Big East),5,2-3,69,74,143,0.483,03/10/2021,2021.0
37,Johns Hopkins (Big Ten),3,1-2,39,42,81,0.481,03/10/2021,2021.0
38,Hartford (America East),1,0-1,12,13,25,0.480,03/10/2021,2021.0
39,Siena (MAAC),1,0-1,9,10,19,0.474,03/10/2021,2021.0
40,Marist (MAAC),1,1-0,13,15,28,0.464,03/10/2021,2021.0
41,VMI (SoCon),2,1-1,24,28,52,0.462,03/10/2021,2021.0
42,Maryland (Big Ten),3,3-0,41,48,89,0.461,03/10/2021,2021.0
43,Stony Brook (America East),4,2-2,58,69,127,0.457,03/10/2021,2021.0
44,St. Bonaventure (MAAC),1,1-0,10,12,22,0.455,03/10/2021,2021.0
45,Rutgers (Big Ten),3,3-0,44,56,100,0.440,03/10/2021,2021.0
46,Richmond (SoCon),4,1-3,40,51,91,0.440,03/10/2021,2021.0
47,Army West Point (Patriot),4,3-1,46,59,105,0.438,03/10/2021,2021.0
48,Cleveland St. (DI Independent),2,0-2,20,26,46,0.435,03/10/2021,2021.0
49,Loyola Maryland (Patriot),4,2-2,42,56,98,0.429,03/10/2021,2021.0
50,NJIT (America East),3,0-3,32,46,78,0.410,03/10/2021,2021.0
51,Robert Morris (DI Independent),5,2-3,65,99,164,0.396,03/10/2021,2021.0
52,Towson (CAA),6,2-4,60,92,152,0.395,03/10/2021,2021.0
53,High Point (SoCon),5,1-4,69,109,178,0.388,03/10/2021,2021.0
54,Lafayette (Patriot),2,0-2,21,35,56,0.375,03/10/2021,2021.0
55,Wagner (NEC),3,0-3,30,52,82,0.366,03/10/2021,2021.0
56,UMass Lowell (America East),2,0-2,21,37,58,0.362,03/10/2021,2021.0
57,Air Force (SoCon),4,1-3,36,65,101,0.356,03/10/2021,2021.0
58,Holy Cross (Patriot),2,1-1,18,34,52,0.346,03/10/2021,2021.0
59,Sacred Heart (NEC),5,1-4,44,86,130,0.338,03/10/2021,2021.0
60,Marquette (Big East),3,0-3,29,62,91,0.319,03/10/2021,2021.0
61,Manhattan (MAAC),1,0-1,5,11,16,0.313,03/10/2021,2021.0
62,Bellarmine (SoCon),7,2-5,50,123,173,0.289,03/10/2021,2021.0
63,St. John's (NY) (Big East),4,1-3,32,89,121,0.264,03/10/2021,2021.0
64,Drexel (CAA),1,1-0,6,20,26,0.231,03/10/2021,2021.0
-,Merrimack (NEC),3,1-2,43,45,88,0.489,03/10/2021,2021.0
1,Notre Dame (ACC),2,2-0,40,11,51,0.784,03/09/2021,2021.0
2,Binghamton (America East),1,1-0,13,5,18,0.722,03/09/2021,2021.0
3,Monmouth (MAAC),1,1-0,11,5,16,0.688,03/09/2021,2021.0
4,Saint Joseph's (NEC),4,1-3,67,31,98,0.684,03/09/2021,2021.0
5,Hobart (NEC),1,1-0,17,8,25,0.680,03/09/2021,2021.0
6,Georgetown (Big East),4,4-0,72,34,106,0.679,03/09/2021,2021.0
7,Lehigh (Patriot),2,2-0,38,18,56,0.679,03/09/2021,2021.0
8,Hofstra (CAA),4,3-1,89,43,132,0.674,03/09/2021,2021.0
9,North Carolina (ACC),6,6-0,126,70,196,0.643,03/09/2021,2021.0
10,LIU (NEC),3,2-1,52,29,81,0.642,03/09/2021,2021.0
11,Mercer (SoCon),6,2-4,94,53,147,0.639,03/09/2021,2021.0
12,Vermont (America East),3,1-2,58,36,94,0.617,03/09/2021,2021.0
13,Denver (Big East),7,5-2,120,76,196,0.612,03/09/2021,2021.0
14,Bryant (NEC),4,3-1,66,42,108,0.611,03/09/2021,2021.0
15,Virginia (ACC),6,5-1,106,70,176,0.602,03/09/2021,2021.0
16,Navy (Patriot),2,2-0,24,17,41,0.585,03/09/2021,2021.0
17,Michigan (Big Ten),3,0-3,55,40,95,0.579,03/09/2021,2021.0
18,Duke (ACC),6,6-0,94,70,164,0.573,03/09/2021,2021.0
19,UMBC (America East),2,2-0,27,22,49,0.551,03/09/2021,2021.0
20,Quinnipiac (MAAC),1,0-1,12,10,22,0.545,03/09/2021,2021.0
21,Colgate (Patriot),3,1-2,49,41,90,0.544,03/09/2021,2021.0
22,Penn St. (Big Ten),3,1-2,42,36,78,0.538,03/09/2021,2021.0
23,Fairfield (CAA),2,0-2,36,31,67,0.537,03/09/2021,2021.0
24,Detroit Mercy (MAAC),1,0-1,15,13,28,0.536,03/09/2021,2021.0
25,Utah (DI Independent),5,1-4,58,51,109,0.532,03/09/2021,2021.0
26,Canisius (MAAC),1,1-0,10,9,19,0.526,03/09/2021,2021.0
27,Bucknell (Patriot),1,1-0,13,12,25,0.520,03/09/2021,2021.0
28,Mount St. Mary's (NEC),6,1-5,67,62,129,0.519,03/09/2021,2021.0
29,UAlbany (America East),2,2-0,27,25,52,0.519,03/09/2021,2021.0
30,Villanova (Big East),3,2-1,38,36,74,0.514,03/09/2021,2021.0
31,Syracuse (ACC),3,2-1,50,48,98,0.510,03/09/2021,2021.0
32,Jacksonville (SoCon),5,3-2,62,60,122,0.508,03/09/2021,2021.0
33,Ohio St. (Big Ten),3,1-2,48,47,95,0.505,03/09/2021,2021.0
34,Boston U. (Patriot),3,2-1,37,38,75,0.493,03/09/2021,2021.0
35,Delaware (CAA),5,4-1,66,70,136,0.485,03/09/2021,2021.0
36,Providence (Big East),5,2-3,69,74,143,0.483,03/09/2021,2021.0
37,Johns Hopkins (Big Ten),3,1-2,39,42,81,0.481,03/09/2021,2021.0
38,Hartford (America East),1,0-1,12,13,25,0.480,03/09/2021,2021.0
39,Siena (MAAC),1,0-1,9,10,19,0.474,03/09/2021,2021.0
40,Marist (MAAC),1,1-0,13,15,28,0.464,03/09/2021,2021.0
41,VMI (SoCon),2,1-1,24,28,52,0.462,03/09/2021,2021.0
42,Maryland (Big Ten),3,3-0,41,48,89,0.461,03/09/2021,2021.0
43,Stony Brook (America East),4,2-2,58,69,127,0.457,03/09/2021,2021.0
44,St. Bonaventure (MAAC),1,1-0,10,12,22,0.455,03/09/2021,2021.0
45,Lafayette (Patriot),1,0-1,13,16,29,0.448,03/09/2021,2021.0
46,Rutgers (Big Ten),3,3-0,44,56,100,0.440,03/09/2021,2021.0
47,Richmond (SoCon),4,1-3,40,51,91,0.440,03/09/2021,2021.0
48,Army West Point (Patriot),4,3-1,46,59,105,0.438,03/09/2021,2021.0
49,Cleveland St. (DI Independent),2,0-2,20,26,46,0.435,03/09/2021,2021.0
50,Loyola Maryland (Patriot),4,2-2,42,56,98,0.429,03/09/2021,2021.0
51,NJIT (America East),3,0-3,32,46,78,0.410,03/09/2021,2021.0
52,Robert Morris (DI Independent),5,2-3,65,99,164,0.396,03/09/2021,2021.0
53,Towson (CAA),6,2-4,60,92,152,0.395,03/09/2021,2021.0
54,High Point (SoCon),4,1-3,54,85,139,0.388,03/09/2021,2021.0
55,Wagner (NEC),3,0-3,30,52,82,0.366,03/09/2021,2021.0
56,UMass Lowell (America East),2,0-2,21,37,58,0.362,03/09/2021,2021.0
57,Air Force (SoCon),4,1-3,36,65,101,0.356,03/09/2021,2021.0
58,Holy Cross (Patriot),2,1-1,18,34,52,0.346,03/09/2021,2021.0
59,Sacred Heart (NEC),5,1-4,44,86,130,0.338,03/09/2021,2021.0
60,Marquette (Big East),3,0-3,29,62,91,0.319,03/09/2021,2021.0
61,Manhattan (MAAC),1,0-1,5,11,16,0.313,03/09/2021,2021.0
62,Bellarmine (SoCon),7,2-5,50,123,173,0.289,03/09/2021,2021.0
63,St. John's (NY) (Big East),4,1-3,32,89,121,0.264,03/09/2021,2021.0
64,Drexel (CAA),1,1-0,6,20,26,0.231,03/09/2021,2021.0
-,Merrimack (NEC),3,1-2,43,45,88,0.489,03/09/2021,2021.0
1,Notre Dame (ACC),2,2-0,40,11,51,0.784,03/07/2021,2021.0
2,Binghamton (America East),1,1-0,13,5,18,0.722,03/07/2021,2021.0
3,Monmouth (MAAC),1,1-0,11,5,16,0.688,03/07/2021,2021.0
4,Hobart (NEC),1,1-0,17,8,25,0.680,03/07/2021,2021.0
5,Georgetown (Big East),4,4-0,72,34,106,0.679,03/07/2021,2021.0
6,Lehigh (Patriot),2,2-0,38,18,56,0.679,03/07/2021,2021.0
7,Hofstra (CAA),4,3-1,89,43,132,0.674,03/07/2021,2021.0
8,Saint Joseph's (NEC),3,0-3,49,24,73,0.671,03/07/2021,2021.0
9,North Carolina (ACC),6,6-0,126,70,196,0.643,03/07/2021,2021.0
10,LIU (NEC),3,2-1,52,29,81,0.642,03/07/2021,2021.0
11,Mercer (SoCon),6,2-4,94,53,147,0.639,03/07/2021,2021.0
12,Vermont (America East),3,1-2,58,36,94,0.617,03/07/2021,2021.0
13,Denver (Big East),7,5-2,120,76,196,0.612,03/07/2021,2021.0
14,Bryant (NEC),4,3-1,66,42,108,0.611,03/07/2021,2021.0
15,Virginia (ACC),6,5-1,106,70,176,0.602,03/07/2021,2021.0
16,Navy (Patriot),2,2-0,24,17,41,0.585,03/07/2021,2021.0
17,Michigan (Big Ten),3,0-3,55,40,95,0.579,03/07/2021,2021.0
18,Duke (ACC),6,6-0,94,70,164,0.573,03/07/2021,2021.0
19,VMI (SoCon),1,1-0,16,13,29,0.552,03/07/2021,2021.0
20,UMBC (America East),2,2-0,27,22,49,0.551,03/07/2021,2021.0
21,Quinnipiac (MAAC),1,0-1,12,10,22,0.545,03/07/2021,2021.0
22,Colgate (Patriot),3,1-2,49,41,90,0.544,03/07/2021,2021.0
23,Penn St. (Big Ten),3,1-2,42,36,78,0.538,03/07/2021,2021.0
24,Fairfield (CAA),2,0-2,36,31,67,0.537,03/07/2021,2021.0
25,Detroit Mercy (MAAC),1,0-1,15,13,28,0.536,03/07/2021,2021.0
26,Utah (DI Independent),5,1-4,58,51,109,0.532,03/07/2021,2021.0
27,Canisius (MAAC),1,1-0,10,9,19,0.526,03/07/2021,2021.0
28,Bucknell (Patriot),1,1-0,13,12,25,0.520,03/07/2021,2021.0
29,Mount St. Mary's (NEC),6,1-5,67,62,129,0.519,03/07/2021,2021.0
30,UAlbany (America East),2,2-0,27,25,52,0.519,03/07/2021,2021.0
31,Villanova (Big East),3,2-1,38,36,74,0.514,03/07/2021,2021.0
32,Syracuse (ACC),3,2-1,50,48,98,0.510,03/07/2021,2021.0
33,Jacksonville (SoCon),5,3-2,62,60,122,0.508,03/07/2021,2021.0
34,Ohio St. (Big Ten),3,1-2,48,47,95,0.505,03/07/2021,2021.0
35,Boston U. (Patriot),3,2-1,37,38,75,0.493,03/07/2021,2021.0
36,Delaware (CAA),5,4-1,66,70,136,0.485,03/07/2021,2021.0
37,Providence (Big East),5,2-3,69,74,143,0.483,03/07/2021,2021.0
38,Johns Hopkins (Big Ten),3,1-2,39,42,81,0.481,03/07/2021,2021.0
39,Hartford (America East),1,0-1,12,13,25,0.480,03/07/2021,2021.0
40,Siena (MAAC),1,0-1,9,10,19,0.474,03/07/2021,2021.0
41,Marist (MAAC),1,1-0,13,15,28,0.464,03/07/2021,2021.0
42,Maryland (Big Ten),3,3-0,41,48,89,0.461,03/07/2021,2021.0
43,Stony Brook (America East),4,2-2,58,69,127,0.457,03/07/2021,2021.0
44,St. Bonaventure (MAAC),1,1-0,10,12,22,0.455,03/07/2021,2021.0
45,Lafayette (Patriot),1,0-1,13,16,29,0.448,03/07/2021,2021.0
46,Rutgers (Big Ten),3,3-0,44,56,100,0.440,03/07/2021,2021.0
47,Richmond (SoCon),4,1-3,40,51,91,0.440,03/07/2021,2021.0
48,Army West Point (Patriot),4,3-1,46,59,105,0.438,03/07/2021,2021.0
49,Cleveland St. (DI Independent),2,0-2,20,26,46,0.435,03/07/2021,2021.0
50,Loyola Maryland (Patriot),4,2-2,42,56,98,0.429,03/07/2021,2021.0
51,NJIT (America East),3,0-3,32,46,78,0.410,03/07/2021,2021.0
52,Wagner (NEC),2,0-2,23,34,57,0.404,03/07/2021,2021.0
53,Robert Morris (DI Independent),5,2-3,65,99,164,0.396,03/07/2021,2021.0
54,Towson (CAA),6,2-4,60,92,152,0.395,03/07/2021,2021.0
55,High Point (SoCon),4,1-3,54,85,139,0.388,03/07/2021,2021.0
56,UMass Lowell (America East),2,0-2,21,37,58,0.362,03/07/2021,2021.0
57,Air Force (SoCon),4,1-3,36,65,101,0.356,03/07/2021,2021.0
58,Holy Cross (Patriot),2,1-1,18,34,52,0.346,03/07/2021,2021.0
59,Sacred Heart (NEC),5,1-4,44,86,130,0.338,03/07/2021,2021.0
60,Marquette (Big East),3,0-3,29,62,91,0.319,03/07/2021,2021.0
61,Manhattan (MAAC),1,0-1,5,11,16,0.313,03/07/2021,2021.0
62,St. John's (NY) (Big East),4,1-3,32,89,121,0.264,03/07/2021,2021.0
63,Bellarmine (SoCon),6,1-5,35,115,150,0.233,03/07/2021,2021.0
64,Drexel (CAA),1,1-0,6,20,26,0.231,03/07/2021,2021.0
-,Merrimack (NEC),3,1-2,43,45,88,0.489,03/07/2021,2021.0
1,Notre Dame (ACC),2,2-0,40,11,51,0.784,03/06/2021,2021.0
2,Binghamton (America East),1,1-0,13,5,18,0.722,03/06/2021,2021.0
3,Monmouth (MAAC),1,1-0,11,5,16,0.688,03/06/2021,2021.0
4,Hobart (NEC),1,1-0,17,8,25,0.680,03/06/2021,2021.0
5,Georgetown (Big East),4,4-0,72,34,106,0.679,03/06/2021,2021.0
6,Lehigh (Patriot),2,2-0,38,18,56,0.679,03/06/2021,2021.0
7,Hofstra (CAA),4,3-1,89,43,132,0.674,03/06/2021,2021.0
8,Saint Joseph's (NEC),3,0-3,49,24,73,0.671,03/06/2021,2021.0
9,North Carolina (ACC),6,6-0,126,70,196,0.643,03/06/2021,2021.0
10,LIU (NEC),3,2-1,52,29,81,0.642,03/06/2021,2021.0
11,Mercer (SoCon),6,2-4,94,53,147,0.639,03/06/2021,2021.0
12,Vermont (America East),3,1-2,58,36,94,0.617,03/06/2021,2021.0
13,Denver (Big East),7,5-2,120,76,196,0.612,03/06/2021,2021.0
14,Bryant (NEC),4,3-1,66,42,108,0.611,03/06/2021,2021.0
15,Virginia (ACC),6,5-1,106,70,176,0.602,03/06/2021,2021.0
16,Navy (Patriot),2,2-0,24,17,41,0.585,03/06/2021,2021.0
17,Duke (ACC),5,5-0,82,59,141,0.582,03/06/2021,2021.0
18,Michigan (Big Ten),3,0-3,55,40,95,0.579,03/06/2021,2021.0
19,VMI (SoCon),1,1-0,16,13,29,0.552,03/06/2021,2021.0
20,UMBC (America East),2,2-0,27,22,49,0.551,03/06/2021,2021.0
21,Quinnipiac (MAAC),1,0-1,12,10,22,0.545,03/06/2021,2021.0
22,Colgate (Patriot),3,1-2,49,41,90,0.544,03/06/2021,2021.0
23,Penn St. (Big Ten),3,1-2,42,36,78,0.538,03/06/2021,2021.0
24,Fairfield (CAA),2,0-2,36,31,67,0.537,03/06/2021,2021.0
25,Detroit Mercy (MAAC),1,0-1,15,13,28,0.536,03/06/2021,2021.0
26,Utah (DI Independent),5,1-4,58,51,109,0.532,03/06/2021,2021.0
27,Canisius (MAAC),1,1-0,10,9,19,0.526,03/06/2021,2021.0
28,Mount St. Mary's (NEC),6,1-5,67,62,129,0.519,03/06/2021,2021.0
29,UAlbany (America East),2,2-0,27,25,52,0.519,03/06/2021,2021.0
30,Syracuse (ACC),3,2-1,50,48,98,0.510,03/06/2021,2021.0
31,Villanova (Big East),2,1-1,27,26,53,0.509,03/06/2021,2021.0
32,Jacksonville (SoCon),5,3-2,62,60,122,0.508,03/06/2021,2021.0
33,Ohio St. (Big Ten),3,1-2,48,47,95,0.505,03/06/2021,2021.0
34,Boston U. (Patriot),3,2-1,37,38,75,0.493,03/06/2021,2021.0
35,Delaware (CAA),5,4-1,66,70,136,0.485,03/06/2021,2021.0
36,Providence (Big East),4,2-2,59,63,122,0.484,03/06/2021,2021.0
37,Johns Hopkins (Big Ten),3,1-2,39,42,81,0.481,03/06/2021,2021.0
38,Hartford (America East),1,0-1,12,13,25,0.480,03/06/2021,2021.0
39,Siena (MAAC),1,0-1,9,10,19,0.474,03/06/2021,2021.0
40,Marist (MAAC),1,1-0,13,15,28,0.464,03/06/2021,2021.0
41,Maryland (Big Ten),3,3-0,41,48,89,0.461,03/06/2021,2021.0
42,Stony Brook (America East),4,2-2,58,69,127,0.457,03/06/2021,2021.0
43,St. Bonaventure (MAAC),1,1-0,10,12,22,0.455,03/06/2021,2021.0
44,Lafayette (Patriot),1,0-1,13,16,29,0.448,03/06/2021,2021.0
45,Rutgers (Big Ten),3,3-0,44,56,100,0.440,03/06/2021,2021.0
46,Army West Point (Patriot),4,3-1,46,59,105,0.438,03/06/2021,2021.0
47,Loyola Maryland (Patriot),4,2-2,42,56,98,0.429,03/06/2021,2021.0
48,Richmond (SoCon),3,1-2,29,39,68,0.426,03/06/2021,2021.0
49,NJIT (America East),3,0-3,32,46,78,0.410,03/06/2021,2021.0
50,Wagner (NEC),2,0-2,23,34,57,0.404,03/06/2021,2021.0
51,Robert Morris (DI Independent),5,2-3,65,99,164,0.396,03/06/2021,2021.0
52,Towson (CAA),6,2-4,60,92,152,0.395,03/06/2021,2021.0
53,High Point (SoCon),4,1-3,54,85,139,0.388,03/06/2021,2021.0
54,Cleveland St. (DI Independent),1,0-1,8,13,21,0.381,03/06/2021,2021.0
55,UMass Lowell (America East),2,0-2,21,37,58,0.362,03/06/2021,2021.0
56,Air Force (SoCon),4,1-3,36,65,101,0.356,03/06/2021,2021.0
57,Holy Cross (Patriot),2,1-1,18,34,52,0.346,03/06/2021,2021.0
58,Sacred Heart (NEC),5,1-4,44,86,130,0.338,03/06/2021,2021.0
59,Marquette (Big East),3,0-3,29,62,91,0.319,03/06/2021,2021.0
60,Manhattan (MAAC),1,0-1,5,11,16,0.313,03/06/2021,2021.0
61,St. John's (NY) (Big East),4,1-3,32,89,121,0.264,03/06/2021,2021.0
62,Bellarmine (SoCon),6,1-5,35,115,150,0.233,03/06/2021,2021.0
63,Drexel (CAA),1,1-0,6,20,26,0.231,03/06/2021,2021.0
-,Merrimack (NEC),3,1-2,43,45,88,0.489,03/06/2021,2021.0
1,Notre Dame (ACC),1,1-0,23,7,30,0.767,03/03/2021,2021.0
2,LIU (NEC),2,1-1,38,16,54,0.704,03/03/2021,2021.0
3,Mercer (SoCon),5,2-3,82,37,119,0.689,03/03/2021,2021.0
4,Hofstra (CAA),4,3-1,89,43,132,0.674,03/03/2021,2021.0
5,Saint Joseph's (NEC),3,0-3,49,24,73,0.671,03/03/2021,2021.0
6,North Carolina (ACC),5,5-0,110,58,168,0.655,03/03/2021,2021.0
7,Syracuse (ACC),2,1-1,40,24,64,0.625,03/03/2021,2021.0
8,Penn St. (Big Ten),2,0-2,29,18,47,0.617,03/03/2021,2021.0
9,Bryant (NEC),3,2-1,46,30,76,0.605,03/03/2021,2021.0
10,Georgetown (Big East),3,3-0,42,28,70,0.600,03/03/2021,2021.0
11,Lehigh (Patriot),1,1-0,22,15,37,0.595,03/03/2021,2021.0
12,Denver (Big East),6,4-2,98,69,167,0.587,03/03/2021,2021.0
13,Navy (Patriot),2,2-0,24,17,41,0.585,03/03/2021,2021.0
14,Duke (ACC),5,5-0,82,59,141,0.582,03/03/2021,2021.0
15,Virginia (ACC),5,4-1,85,63,148,0.574,03/03/2021,2021.0
16,Fairfield (CAA),1,0-1,21,16,37,0.568,03/03/2021,2021.0
17,Mount St. Mary's (NEC),5,1-4,59,45,104,0.567,03/03/2021,2021.0
18,Vermont (America East),2,1-1,34,26,60,0.567,03/03/2021,2021.0
19,Utah (DI Independent),4,1-3,52,43,95,0.547,03/03/2021,2021.0
20,Boston U. (Patriot),2,2-0,26,22,48,0.542,03/03/2021,2021.0
21,UMBC (America East),1,1-0,10,9,19,0.526,03/03/2021,2021.0
22,UAlbany (America East),1,1-0,14,13,27,0.519,03/03/2021,2021.0
23,Michigan (Big Ten),2,0-2,29,27,56,0.518,03/03/2021,2021.0
24,Johns Hopkins (Big Ten),2,1-1,25,24,49,0.510,03/03/2021,2021.0
25,Villanova (Big East),2,1-1,27,26,53,0.509,03/03/2021,2021.0
26,Rutgers (Big Ten),2,2-0,31,30,61,0.508,03/03/2021,2021.0
27,Jacksonville (SoCon),4,2-2,54,54,108,0.500,03/03/2021,2021.0
28,Loyola Maryland (Patriot),3,2-1,39,40,79,0.494,03/03/2021,2021.0
29,Providence (Big East),4,2-2,59,63,122,0.484,03/03/2021,2021.0
30,Delaware (CAA),4,3-1,51,55,106,0.481,03/03/2021,2021.0
31,Ohio St. (Big Ten),2,1-1,30,34,64,0.469,03/03/2021,2021.0
32,Stony Brook (America East),3,2-1,45,52,97,0.464,03/03/2021,2021.0
33,Colgate (Patriot),2,0-2,29,34,63,0.460,03/03/2021,2021.0
34,NJIT (America East),2,0-2,27,33,60,0.450,03/03/2021,2021.0
35,Holy Cross (Patriot),1,1-0,11,14,25,0.440,03/03/2021,2021.0
36,Richmond (SoCon),3,1-2,29,39,68,0.426,03/03/2021,2021.0
37,Marquette (Big East),2,0-2,23,32,55,0.418,03/03/2021,2021.0
38,Maryland (Big Ten),2,2-0,23,34,57,0.404,03/03/2021,2021.0
38,Wagner (NEC),2,0-2,23,34,57,0.404,03/03/2021,2021.0
40,Air Force (SoCon),3,1-2,29,44,73,0.397,03/03/2021,2021.0
41,Robert Morris (DI Independent),5,2-3,65,99,164,0.396,03/03/2021,2021.0
42,High Point (SoCon),4,1-3,54,85,139,0.388,03/03/2021,2021.0
43,Army West Point (Patriot),3,2-1,30,48,78,0.385,03/03/2021,2021.0
44,Cleveland St. (DI Independent),1,0-1,8,13,21,0.381,03/03/2021,2021.0
45,UMass Lowell (America East),2,0-2,21,37,58,0.362,03/03/2021,2021.0
46,Towson (CAA),5,2-3,40,86,126,0.317,03/03/2021,2021.0
47,Sacred Heart (NEC),4,1-3,31,72,103,0.301,03/03/2021,2021.0
48,St. John's (NY) (Big East),3,1-2,25,67,92,0.272,03/03/2021,2021.0
49,Bellarmine (SoCon),5,1-4,31,98,129,0.240,03/03/2021,2021.0
-,Merrimack (NEC),2,1-1,31,25,56,0.554,03/03/2021,2021.0
1,Notre Dame (ACC),1,1-0,23,7,30,0.767,03/02/2021,2021.0
2,LIU (NEC),2,1-1,38,16,54,0.704,03/02/2021,2021.0
3,Mercer (SoCon),5,2-3,82,37,119,0.689,03/02/2021,2021.0
4,Hofstra (CAA),4,3-1,89,43,132,0.674,03/02/2021,2021.0
5,Saint Joseph's (NEC),3,0-3,49,24,73,0.671,03/02/2021,2021.0
6,North Carolina (ACC),5,5-0,110,58,168,0.655,03/02/2021,2021.0
7,Syracuse (ACC),2,1-1,40,24,64,0.625,03/02/2021,2021.0
8,Bryant (NEC),3,2-1,47,29,76,0.618,03/02/2021,2021.0
9,Penn St. (Big Ten),2,0-2,29,18,47,0.617,03/02/2021,2021.0
10,Georgetown (Big East),3,3-0,43,27,70,0.614,03/02/2021,2021.0
11,Lehigh (Patriot),1,1-0,22,15,37,0.595,03/02/2021,2021.0
12,Denver (Big East),6,4-2,98,69,167,0.587,03/02/2021,2021.0
13,Navy (Patriot),2,2-0,24,17,41,0.585,03/02/2021,2021.0
14,Duke (ACC),5,5-0,82,59,141,0.582,03/02/2021,2021.0
15,Mount St. Mary's (NEC),5,1-4,58,46,104,0.558,03/02/2021,2021.0
16,Virginia (ACC),4,3-1,68,55,123,0.553,03/02/2021,2021.0
17,Utah (DI Independent),4,1-3,52,43,95,0.547,03/02/2021,2021.0
18,Boston U. (Patriot),2,2-0,26,22,48,0.542,03/02/2021,2021.0
19,UMBC (America East),1,1-0,10,9,19,0.526,03/02/2021,2021.0
20,UAlbany (America East),1,1-0,14,13,27,0.519,03/02/2021,2021.0
21,Michigan (Big Ten),2,0-2,29,27,56,0.518,03/02/2021,2021.0
22,Johns Hopkins (Big Ten),2,1-1,25,24,49,0.510,03/02/2021,2021.0
23,Villanova (Big East),2,1-1,27,26,53,0.509,03/02/2021,2021.0
24,Rutgers (Big Ten),2,2-0,31,30,61,0.508,03/02/2021,2021.0
25,Providence (Big East),3,1-2,43,42,85,0.506,03/02/2021,2021.0
26,Jacksonville (SoCon),4,2-2,54,54,108,0.500,03/02/2021,2021.0
27,Loyola Maryland (Patriot),3,2-1,39,40,79,0.494,03/02/2021,2021.0
28,Delaware (CAA),4,3-1,51,55,106,0.481,03/02/2021,2021.0
29,Ohio St. (Big Ten),2,1-1,30,34,64,0.469,03/02/2021,2021.0
30,Stony Brook (America East),3,2-1,45,52,97,0.464,03/02/2021,2021.0
31,Colgate (Patriot),2,0-2,29,34,63,0.460,03/02/2021,2021.0
32,NJIT (America East),2,0-2,27,33,60,0.450,03/02/2021,2021.0
33,Vermont (America East),1,0-1,13,16,29,0.448,03/02/2021,2021.0
34,Holy Cross (Patriot),1,1-0,11,14,25,0.440,03/02/2021,2021.0
35,Richmond (SoCon),3,1-2,29,39,68,0.426,03/02/2021,2021.0
36,Marquette (Big East),2,0-2,23,32,55,0.418,03/02/2021,2021.0
37,High Point (SoCon),3,1-2,46,68,114,0.404,03/02/2021,2021.0
37,Maryland (Big Ten),2,2-0,23,34,57,0.404,03/02/2021,2021.0
37,Wagner (NEC),2,0-2,23,34,57,0.404,03/02/2021,2021.0
40,Air Force (SoCon),3,1-2,29,44,73,0.397,03/02/2021,2021.0
41,Robert Morris (DI Independent),5,2-3,65,99,164,0.396,03/02/2021,2021.0
42,Army West Point (Patriot),3,2-1,30,48,78,0.385,03/02/2021,2021.0
43,Cleveland St. (DI Independent),1,0-1,8,13,21,0.381,03/02/2021,2021.0
44,UMass Lowell (America East),1,0-1,10,17,27,0.370,03/02/2021,2021.0
45,Towson (CAA),5,2-3,40,86,126,0.317,03/02/2021,2021.0
46,Sacred Heart (NEC),4,1-3,31,72,103,0.301,03/02/2021,2021.0
47,St. John's (NY) (Big East),3,1-2,25,67,92,0.272,03/02/2021,2021.0
48,Bellarmine (SoCon),5,1-4,31,98,129,0.240,03/02/2021,2021.0
-,Merrimack (NEC),2,1-1,31,25,56,0.554,03/02/2021,2021.0
1,Notre Dame (ACC),1,1-0,23,7,30,0.767,02/28/2021,2021.0
2,Hofstra (CAA),3,2-1,74,30,104,0.712,02/28/2021,2021.0
3,LIU (NEC),2,1-1,38,16,54,0.704,02/28/2021,2021.0
4,Georgetown (Big East),2,2-0,30,14,44,0.682,02/28/2021,2021.0
5,Mercer (SoCon),5,2-3,81,38,119,0.681,02/28/2021,2021.0
6,Saint Joseph's (NEC),3,0-3,49,24,73,0.671,02/28/2021,2021.0
7,North Carolina (ACC),5,5-0,110,58,168,0.655,02/28/2021,2021.0
8,Syracuse (ACC),2,1-1,40,24,64,0.625,02/28/2021,2021.0
9,Bryant (NEC),3,2-1,47,29,76,0.618,02/28/2021,2021.0
10,Penn St. (Big Ten),2,0-2,29,18,47,0.617,02/28/2021,2021.0
11,Lehigh (Patriot),1,1-0,22,15,37,0.595,02/28/2021,2021.0
12,Denver (Big East),6,4-2,98,69,167,0.587,02/28/2021,2021.0
13,Navy (Patriot),2,2-0,24,17,41,0.585,02/28/2021,2021.0
14,Duke (ACC),5,5-0,82,59,141,0.582,02/28/2021,2021.0
15,Mount St. Mary's (NEC),4,1-3,45,33,78,0.577,02/28/2021,2021.0
16,Virginia (ACC),4,3-1,68,55,123,0.553,02/28/2021,2021.0
17,Utah (DI Independent),4,1-3,52,43,95,0.547,02/28/2021,2021.0
18,Boston U. (Patriot),2,2-0,26,22,48,0.542,02/28/2021,2021.0
19,UMBC (America East),1,1-0,10,9,19,0.526,02/28/2021,2021.0
20,UAlbany (America East),1,1-0,14,13,27,0.519,02/28/2021,2021.0
21,Michigan (Big Ten),2,0-2,29,27,56,0.518,02/28/2021,2021.0
22,Johns Hopkins (Big Ten),2,1-1,25,24,49,0.510,02/28/2021,2021.0
23,Villanova (Big East),2,1-1,27,26,53,0.509,02/28/2021,2021.0
24,Rutgers (Big Ten),2,2-0,31,30,61,0.508,02/28/2021,2021.0
25,Providence (Big East),3,1-2,43,42,85,0.506,02/28/2021,2021.0
26,Jacksonville (SoCon),4,2-2,54,54,108,0.500,02/28/2021,2021.0
27,Loyola Maryland (Patriot),3,2-1,39,40,79,0.494,02/28/2021,2021.0
28,Delaware (CAA),4,3-1,51,55,106,0.481,02/28/2021,2021.0
29,Ohio St. (Big Ten),2,1-1,30,34,64,0.469,02/28/2021,2021.0
30,Stony Brook (America East),3,2-1,45,52,97,0.464,02/28/2021,2021.0
31,Colgate (Patriot),2,0-2,29,34,63,0.460,02/28/2021,2021.0
32,NJIT (America East),2,0-2,27,33,60,0.450,02/28/2021,2021.0
33,Vermont (America East),1,0-1,13,16,29,0.448,02/28/2021,2021.0
34,Holy Cross (Patriot),1,1-0,11,14,25,0.440,02/28/2021,2021.0
35,Cleveland St. (DI Independent),1,0-1,9,12,21,0.429,02/28/2021,2021.0
36,Richmond (SoCon),3,1-2,29,39,68,0.426,02/28/2021,2021.0
37,Marquette (Big East),2,0-2,23,32,55,0.418,02/28/2021,2021.0
38,High Point (SoCon),3,1-2,46,68,114,0.404,02/28/2021,2021.0
38,Maryland (Big Ten),2,2-0,23,34,57,0.404,02/28/2021,2021.0
40,Air Force (SoCon),3,1-2,29,44,73,0.397,02/28/2021,2021.0
41,Army West Point (Patriot),3,2-1,30,48,78,0.385,02/28/2021,2021.0
42,UMass Lowell (America East),1,0-1,10,17,27,0.370,02/28/2021,2021.0
43,Robert Morris (DI Independent),4,1-3,49,87,136,0.360,02/28/2021,2021.0
44,Wagner (NEC),1,0-1,10,19,29,0.345,02/28/2021,2021.0
45,Towson (CAA),5,2-3,40,86,126,0.317,02/28/2021,2021.0
46,Sacred Heart (NEC),4,1-3,31,72,103,0.301,02/28/2021,2021.0
47,St. John's (NY) (Big East),3,1-2,25,67,92,0.272,02/28/2021,2021.0
48,Bellarmine (SoCon),4,1-3,19,82,101,0.188,02/28/2021,2021.0
-,Merrimack (NEC),2,1-1,31,25,56,0.554,02/28/2021,2021.0
1,Notre Dame (ACC),1,1-0,23,7,30,0.767,02/27/2021,2021.0
2,Hofstra (CAA),3,2-1,74,30,104,0.712,02/27/2021,2021.0
3,Mercer (SoCon),4,1-3,69,29,98,0.704,02/27/2021,2021.0
4,LIU (NEC),2,1-1,38,16,54,0.704,02/27/2021,2021.0
5,Georgetown (Big East),2,2-0,30,14,44,0.682,02/27/2021,2021.0
6,Saint Joseph's (NEC),3,0-3,49,24,73,0.671,02/27/2021,2021.0
7,Bryant (NEC),2,1-1,31,16,47,0.660,02/27/2021,2021.0
8,North Carolina (ACC),5,5-0,110,58,168,0.655,02/27/2021,2021.0
9,Syracuse (ACC),2,1-1,40,24,64,0.625,02/27/2021,2021.0
10,Penn St. (Big Ten),2,0-2,29,18,47,0.617,02/27/2021,2021.0
11,Lehigh (Patriot),1,1-0,22,15,37,0.595,02/27/2021,2021.0
12,Denver (Big East),6,4-2,98,69,167,0.587,02/27/2021,2021.0
13,Duke (ACC),5,5-0,82,59,141,0.582,02/27/2021,2021.0
14,Mount St. Mary's (NEC),4,1-3,45,33,78,0.577,02/27/2021,2021.0
15,Jacksonville (SoCon),3,2-1,48,37,85,0.565,02/27/2021,2021.0
16,Virginia (ACC),4,3-1,68,55,123,0.553,02/27/2021,2021.0
17,Utah (DI Independent),4,1-3,52,43,95,0.547,02/27/2021,2021.0
18,Boston U. (Patriot),2,2-0,26,22,48,0.542,02/27/2021,2021.0
19,UMBC (America East),1,1-0,10,9,19,0.526,02/27/2021,2021.0
20,UAlbany (America East),1,1-0,14,13,27,0.519,02/27/2021,2021.0
21,Michigan (Big Ten),2,0-2,29,27,56,0.518,02/27/2021,2021.0
22,Johns Hopkins (Big Ten),2,1-1,25,24,49,0.510,02/27/2021,2021.0
23,Villanova (Big East),2,1-1,27,26,53,0.509,02/27/2021,2021.0
24,Rutgers (Big Ten),2,2-0,31,30,61,0.508,02/27/2021,2021.0
25,Providence (Big East),3,1-2,43,42,85,0.506,02/27/2021,2021.0
26,Loyola Maryland (Patriot),3,2-1,39,40,79,0.494,02/27/2021,2021.0
27,Ohio St. (Big Ten),2,1-1,30,34,64,0.469,02/27/2021,2021.0
28,Stony Brook (America East),3,2-1,45,52,97,0.464,02/27/2021,2021.0
29,Colgate (Patriot),2,0-2,29,34,63,0.460,02/27/2021,2021.0
30,NJIT (America East),2,0-2,27,33,60,0.450,02/27/2021,2021.0
31,Holy Cross (Patriot),1,1-0,11,14,25,0.440,02/27/2021,2021.0
32,Richmond (SoCon),3,1-2,29,39,68,0.426,02/27/2021,2021.0
33,Marquette (Big East),2,0-2,23,32,55,0.418,02/27/2021,2021.0
34,High Point (SoCon),3,1-2,46,68,114,0.404,02/27/2021,2021.0
34,Maryland (Big Ten),2,2-0,23,34,57,0.404,02/27/2021,2021.0
36,Air Force (SoCon),3,1-2,29,44,73,0.397,02/27/2021,2021.0
37,Delaware (CAA),3,2-1,30,47,77,0.390,02/27/2021,2021.0
38,Navy (Patriot),1,1-0,7,11,18,0.389,02/27/2021,2021.0
39,Army West Point (Patriot),3,2-1,30,48,78,0.385,02/27/2021,2021.0
40,UMass Lowell (America East),1,0-1,10,17,27,0.370,02/27/2021,2021.0
41,Robert Morris (DI Independent),4,1-3,49,87,136,0.360,02/27/2021,2021.0
42,Wagner (NEC),1,0-1,10,19,29,0.345,02/27/2021,2021.0
43,Towson (CAA),5,2-3,40,86,126,0.317,02/27/2021,2021.0
44,Sacred Heart (NEC),4,1-3,31,72,103,0.301,02/27/2021,2021.0
45,St. John's (NY) (Big East),3,1-2,25,67,92,0.272,02/27/2021,2021.0
46,Bellarmine (SoCon),3,1-2,11,61,72,0.153,02/27/2021,2021.0
-,Merrimack (NEC),2,1-1,31,25,56,0.554,02/27/2021,2021.0
1,LIU (NEC),1,0-1,19,6,25,0.760,02/26/2021,2021.0
2,Hofstra (CAA),2,1-1,47,16,63,0.746,02/26/2021,2021.0
3,Mercer (SoCon),4,1-3,69,29,98,0.704,02/26/2021,2021.0
4,Saint Joseph's (NEC),2,0-2,35,16,51,0.686,02/26/2021,2021.0
5,North Carolina (ACC),4,4-0,85,42,127,0.669,02/26/2021,2021.0
6,Bryant (NEC),2,1-1,31,16,47,0.660,02/26/2021,2021.0
7,Virginia (ACC),3,3-0,57,33,90,0.633,02/26/2021,2021.0
8,Penn St. (Big Ten),2,0-2,29,18,47,0.617,02/26/2021,2021.0
9,Georgetown (Big East),1,1-0,12,8,20,0.600,02/26/2021,2021.0
10,Providence (Big East),2,1-1,29,20,49,0.592,02/26/2021,2021.0
11,Syracuse (ACC),1,0-1,18,13,31,0.581,02/26/2021,2021.0
12,Denver (Big East),5,3-2,76,55,131,0.580,02/26/2021,2021.0
13,Mount St. Mary's (NEC),4,1-3,45,33,78,0.577,02/26/2021,2021.0
14,Duke (ACC),4,4-0,65,49,114,0.570,02/26/2021,2021.0
15,Jacksonville (SoCon),3,2-1,48,37,85,0.565,02/26/2021,2021.0
16,Utah (DI Independent),3,1-2,36,28,64,0.563,02/26/2021,2021.0
17,Stony Brook (America East),2,2-0,31,25,56,0.554,02/26/2021,2021.0
18,Johns Hopkins (Big Ten),1,0-1,14,12,26,0.538,02/26/2021,2021.0
19,UMBC (America East),1,1-0,10,9,19,0.526,02/26/2021,2021.0
20,NJIT (America East),1,0-1,12,11,23,0.522,02/26/2021,2021.0
21,Boston U. (Patriot),1,1-0,15,14,29,0.517,02/26/2021,2021.0
22,Michigan (Big Ten),1,0-1,17,16,33,0.515,02/26/2021,2021.0
23,Loyola Maryland (Patriot),2,1-1,24,24,48,0.500,02/26/2021,2021.0
24,Rutgers (Big Ten),1,1-0,11,12,23,0.478,02/26/2021,2021.0
25,Ohio St. (Big Ten),1,1-0,12,14,26,0.462,02/26/2021,2021.0
26,Colgate (Patriot),1,0-1,16,20,36,0.444,02/26/2021,2021.0
27,Air Force (SoCon),2,1-1,19,27,46,0.413,02/26/2021,2021.0
28,High Point (SoCon),2,1-1,30,43,73,0.411,02/26/2021,2021.0
29,Marquette (Big East),1,0-1,9,13,22,0.409,02/26/2021,2021.0
30,Maryland (Big Ten),2,2-0,23,34,57,0.404,02/26/2021,2021.0
31,Villanova (Big East),1,0-1,8,12,20,0.400,02/26/2021,2021.0
32,Robert Morris (DI Independent),3,1-2,42,64,106,0.396,02/26/2021,2021.0
33,Army West Point (Patriot),2,1-1,22,34,56,0.393,02/26/2021,2021.0
34,Delaware (CAA),3,2-1,30,47,77,0.390,02/26/2021,2021.0
35,Navy (Patriot),1,1-0,7,11,18,0.389,02/26/2021,2021.0
36,Richmond (SoCon),2,0-2,15,28,43,0.349,02/26/2021,2021.0
37,Towson (CAA),4,2-2,29,72,101,0.287,02/26/2021,2021.0
38,St. John's (NY) (Big East),2,1-1,19,49,68,0.279,02/26/2021,2021.0
39,Sacred Heart (NEC),3,1-2,17,61,78,0.218,02/26/2021,2021.0
40,Bellarmine (SoCon),3,1-2,11,61,72,0.153,02/26/2021,2021.0
-,Merrimack (NEC),1,0-1,14,15,29,0.483,02/26/2021,2021.0
1,LIU (NEC),1,0-1,19,6,25,0.760,02/24/2021,2021.0
2,Hofstra (CAA),2,1-1,47,16,63,0.746,02/24/2021,2021.0
3,Mercer (SoCon),4,1-3,69,29,98,0.704,02/24/2021,2021.0
4,Saint Joseph's (NEC),2,0-2,35,16,51,0.686,02/24/2021,2021.0
5,North Carolina (ACC),4,4-0,85,42,127,0.669,02/24/2021,2021.0
6,Bryant (NEC),2,1-1,31,16,47,0.660,02/24/2021,2021.0
7,Virginia (ACC),3,3-0,57,33,90,0.633,02/24/2021,2021.0
8,Mount St. Mary's (NEC),3,1-2,36,23,59,0.610,02/24/2021,2021.0
9,Georgetown (Big East),1,1-0,12,8,20,0.600,02/24/2021,2021.0
10,Providence (Big East),2,1-1,29,20,49,0.592,02/24/2021,2021.0
11,Syracuse (ACC),1,0-1,18,13,31,0.581,02/24/2021,2021.0
12,Denver (Big East),5,3-2,76,55,131,0.580,02/24/2021,2021.0
13,Duke (ACC),4,4-0,65,49,114,0.570,02/24/2021,2021.0
14,Jacksonville (SoCon),3,2-1,48,37,85,0.565,02/24/2021,2021.0
15,Utah (DI Independent),3,1-2,36,28,64,0.563,02/24/2021,2021.0
16,Stony Brook (America East),2,2-0,31,25,56,0.554,02/24/2021,2021.0
17,Johns Hopkins (Big Ten),1,0-1,14,12,26,0.538,02/24/2021,2021.0
18,NJIT (America East),1,0-1,12,11,23,0.522,02/24/2021,2021.0
18,Penn St. (Big Ten),1,0-1,12,11,23,0.522,02/24/2021,2021.0
20,Boston U. (Patriot),1,1-0,15,14,29,0.517,02/24/2021,2021.0
21,Michigan (Big Ten),1,0-1,17,16,33,0.515,02/24/2021,2021.0
22,Loyola Maryland (Patriot),2,1-1,24,24,48,0.500,02/24/2021,2021.0
23,Maryland (Big Ten),1,1-0,16,17,33,0.485,02/24/2021,2021.0
24,Rutgers (Big Ten),1,1-0,11,12,23,0.478,02/24/2021,2021.0
25,Ohio St. (Big Ten),1,1-0,12,14,26,0.462,02/24/2021,2021.0
26,Colgate (Patriot),1,0-1,16,20,36,0.444,02/24/2021,2021.0
27,Air Force (SoCon),2,1-1,19,27,46,0.413,02/24/2021,2021.0
28,High Point (SoCon),2,1-1,30,43,73,0.411,02/24/2021,2021.0
29,Marquette (Big East),1,0-1,9,13,22,0.409,02/24/2021,2021.0
30,Villanova (Big East),1,0-1,8,12,20,0.400,02/24/2021,2021.0
31,Robert Morris (DI Independent),3,1-2,42,64,106,0.396,02/24/2021,2021.0
32,Army West Point (Patriot),2,1-1,22,34,56,0.393,02/24/2021,2021.0
33,Delaware (CAA),3,2-1,30,47,77,0.390,02/24/2021,2021.0
34,Navy (Patriot),1,1-0,7,11,18,0.389,02/24/2021,2021.0
35,Richmond (SoCon),2,0-2,15,28,43,0.349,02/24/2021,2021.0
36,Towson (CAA),4,2-2,29,72,101,0.287,02/24/2021,2021.0
37,St. John's (NY) (Big East),2,1-1,19,49,68,0.279,02/24/2021,2021.0
38,Sacred Heart (NEC),3,1-2,17,61,78,0.218,02/24/2021,2021.0
39,Bellarmine (SoCon),3,1-2,11,61,72,0.153,02/24/2021,2021.0
-,Merrimack (NEC),1,0-1,14,15,29,0.483,02/24/2021,2021.0
1,LIU (NEC),1,0-1,19,6,25,0.760,02/24/2021,2021.0
2,Hofstra (CAA),2,1-1,47,16,63,0.746,02/24/2021,2021.0
3,Mercer (SoCon),4,1-3,69,29,98,0.704,02/24/2021,2021.0
4,Saint Joseph's (NEC),2,0-2,35,16,51,0.686,02/24/2021,2021.0
5,North Carolina (ACC),4,4-0,85,42,127,0.669,02/24/2021,2021.0
6,Bryant (NEC),2,1-1,31,16,47,0.660,02/24/2021,2021.0
7,Virginia (ACC),3,3-0,57,33,90,0.633,02/24/2021,2021.0
8,Mount St. Mary's (NEC),3,1-2,36,23,59,0.610,02/24/2021,2021.0
9,Georgetown (Big East),1,1-0,12,8,20,0.600,02/24/2021,2021.0
10,Providence (Big East),2,1-1,29,20,49,0.592,02/24/2021,2021.0
11,Syracuse (ACC),1,0-1,18,13,31,0.581,02/24/2021,2021.0
12,Denver (Big East),5,3-2,76,55,131,0.580,02/24/2021,2021.0
13,Duke (ACC),4,4-0,65,49,114,0.570,02/24/2021,2021.0
14,Jacksonville (SoCon),3,2-1,48,37,85,0.565,02/24/2021,2021.0
15,Utah (DI Independent),3,1-2,36,28,64,0.563,02/24/2021,2021.0
16,Stony Brook (America East),2,2-0,31,25,56,0.554,02/24/2021,2021.0
17,Johns Hopkins (Big Ten),1,0-1,14,12,26,0.538,02/24/2021,2021.0
18,NJIT (America East),1,0-1,12,11,23,0.522,02/24/2021,2021.0
18,Penn St. (Big Ten),1,0-1,12,11,23,0.522,02/24/2021,2021.0
20,Boston U. (Patriot),1,1-0,15,14,29,0.517,02/24/2021,2021.0
21,Michigan (Big Ten),1,0-1,17,16,33,0.515,02/24/2021,2021.0
22,Loyola Maryland (Patriot),2,1-1,24,24,48,0.500,02/24/2021,2021.0
23,Maryland (Big Ten),1,1-0,16,17,33,0.485,02/24/2021,2021.0
24,Rutgers (Big Ten),1,1-0,11,12,23,0.478,02/24/2021,2021.0
25,Ohio St. (Big Ten),1,1-0,12,14,26,0.462,02/24/2021,2021.0
26,Colgate (Patriot),1,0-1,16,20,36,0.444,02/24/2021,2021.0
27,Air Force (SoCon),2,1-1,19,27,46,0.413,02/24/2021,2021.0
28,High Point (SoCon),2,1-1,30,43,73,0.411,02/24/2021,2021.0
29,Marquette (Big East),1,0-1,9,13,22,0.409,02/24/2021,2021.0
30,Villanova (Big East),1,0-1,8,12,20,0.400,02/24/2021,2021.0
31,Robert Morris (DI Independent),3,1-2,42,64,106,0.396,02/24/2021,2021.0
32,Army West Point (Patriot),2,1-1,22,34,56,0.393,02/24/2021,2021.0
33,Delaware (CAA),3,2-1,30,47,77,0.390,02/24/2021,2021.0
34,Navy (Patriot),1,1-0,7,11,18,0.389,02/24/2021,2021.0
35,Richmond (SoCon),2,0-2,15,28,43,0.349,02/24/2021,2021.0
36,Towson (CAA),4,2-2,29,72,101,0.287,02/24/2021,2021.0
37,St. John's (NY) (Big East),2,1-1,19,49,68,0.279,02/24/2021,2021.0
38,Sacred Heart (NEC),3,1-2,17,61,78,0.218,02/24/2021,2021.0
39,Bellarmine (SoCon),3,1-2,11,61,72,0.153,02/24/2021,2021.0
-,Merrimack (NEC),1,0-1,14,15,29,0.483,02/24/2021,2021.0
1,Hofstra (CAA),2,1-1,47,16,63,0.746,02/23/2021,2021.0
2,Saint Joseph's (NEC),2,0-2,36,15,51,0.706,02/23/2021,2021.0
3,Mercer (SoCon),4,1-3,69,29,98,0.704,02/23/2021,2021.0
4,North Carolina (ACC),4,4-0,85,42,127,0.669,02/23/2021,2021.0
5,Bryant (NEC),2,1-1,31,16,47,0.660,02/23/2021,2021.0
6,Virginia (ACC),3,3-0,57,33,90,0.633,02/23/2021,2021.0
7,Mount St. Mary's (NEC),2,1-1,24,15,39,0.615,02/23/2021,2021.0
8,Georgetown (Big East),1,1-0,12,8,20,0.600,02/23/2021,2021.0
9,Providence (Big East),2,1-1,29,20,49,0.592,02/23/2021,2021.0
10,Syracuse (ACC),1,0-1,18,13,31,0.581,02/23/2021,2021.0
11,Denver (Big East),5,3-2,76,55,131,0.580,02/23/2021,2021.0
12,Duke (ACC),4,4-0,65,49,114,0.570,02/23/2021,2021.0
13,Jacksonville (SoCon),3,2-1,48,37,85,0.565,02/23/2021,2021.0
14,Utah (DI Independent),3,1-2,36,28,64,0.563,02/23/2021,2021.0
15,Stony Brook (America East),2,2-0,31,25,56,0.554,02/23/2021,2021.0
16,Johns Hopkins (Big Ten),1,0-1,14,12,26,0.538,02/23/2021,2021.0
17,NJIT (America East),1,0-1,12,11,23,0.522,02/23/2021,2021.0
17,Penn St. (Big Ten),1,0-1,12,11,23,0.522,02/23/2021,2021.0
19,Boston U. (Patriot),1,1-0,15,14,29,0.517,02/23/2021,2021.0
20,Michigan (Big Ten),1,0-1,17,16,33,0.515,02/23/2021,2021.0
21,Loyola Maryland (Patriot),2,1-1,24,24,48,0.500,02/23/2021,2021.0
22,Maryland (Big Ten),1,1-0,16,17,33,0.485,02/23/2021,2021.0
23,Rutgers (Big Ten),1,1-0,11,12,23,0.478,02/23/2021,2021.0
24,Ohio St. (Big Ten),1,1-0,12,14,26,0.462,02/23/2021,2021.0
25,Colgate (Patriot),1,0-1,16,20,36,0.444,02/23/2021,2021.0
26,Air Force (SoCon),2,1-1,19,27,46,0.413,02/23/2021,2021.0
27,High Point (SoCon),2,1-1,30,43,73,0.411,02/23/2021,2021.0
28,Marquette (Big East),1,0-1,9,13,22,0.409,02/23/2021,2021.0
29,Villanova (Big East),1,0-1,8,12,20,0.400,02/23/2021,2021.0
30,Robert Morris (DI Independent),3,1-2,42,64,106,0.396,02/23/2021,2021.0
31,Army West Point (Patriot),2,1-1,22,34,56,0.393,02/23/2021,2021.0
32,Navy (Patriot),1,1-0,7,11,18,0.389,02/23/2021,2021.0
33,Delaware (CAA),3,2-1,29,48,77,0.377,02/23/2021,2021.0
34,Richmond (SoCon),2,0-2,15,28,43,0.349,02/23/2021,2021.0
35,St. John's (NY) (Big East),2,1-1,19,49,68,0.279,02/23/2021,2021.0
36,Towson (CAA),3,1-2,21,60,81,0.259,02/23/2021,2021.0
37,Sacred Heart (NEC),2,0-2,11,42,53,0.208,02/23/2021,2021.0
38,Bellarmine (SoCon),3,1-2,11,61,72,0.153,02/23/2021,2021.0
-,Merrimack (NEC),1,0-1,14,15,29,0.483,02/23/2021,2021.0
1,Hofstra (CAA),2,1-1,47,16,63,0.746,02/21/2021,2021.0
2,Saint Joseph's (NEC),1,0-1,13,5,18,0.722,02/21/2021,2021.0
3,Mercer (SoCon),4,1-3,69,29,98,0.704,02/21/2021,2021.0
4,North Carolina (ACC),4,4-0,85,42,127,0.669,02/21/2021,2021.0
5,Bryant (NEC),2,1-1,31,16,47,0.660,02/21/2021,2021.0
6,Virginia (ACC),3,3-0,57,33,90,0.633,02/21/2021,2021.0
7,Mount St. Mary's (NEC),2,1-1,24,15,39,0.615,02/21/2021,2021.0
8,Georgetown (Big East),1,1-0,12,8,20,0.600,02/21/2021,2021.0
9,Providence (Big East),2,1-1,29,20,49,0.592,02/21/2021,2021.0
10,Syracuse (ACC),1,0-1,18,13,31,0.581,02/21/2021,2021.0
11,Denver (Big East),5,3-2,76,55,131,0.580,02/21/2021,2021.0
12,Duke (ACC),4,4-0,65,49,114,0.570,02/21/2021,2021.0
13,Jacksonville (SoCon),3,2-1,48,37,85,0.565,02/21/2021,2021.0
14,Utah (DI Independent),3,1-2,36,28,64,0.563,02/21/2021,2021.0
15,Stony Brook (America East),2,2-0,31,25,56,0.554,02/21/2021,2021.0
16,Johns Hopkins (Big Ten),1,0-1,14,12,26,0.538,02/21/2021,2021.0
17,NJIT (America East),1,0-1,12,11,23,0.522,02/21/2021,2021.0
17,Penn St. (Big Ten),1,0-1,12,11,23,0.522,02/21/2021,2021.0
19,Boston U. (Patriot),1,1-0,15,14,29,0.517,02/21/2021,2021.0
20,Michigan (Big Ten),1,0-1,17,16,33,0.515,02/21/2021,2021.0
21,Loyola Maryland (Patriot),2,1-1,24,24,48,0.500,02/21/2021,2021.0
22,Maryland (Big Ten),1,1-0,16,17,33,0.485,02/21/2021,2021.0
23,Rutgers (Big Ten),1,1-0,11,12,23,0.478,02/21/2021,2021.0
24,Ohio St. (Big Ten),1,1-0,12,14,26,0.462,02/21/2021,2021.0
25,Colgate (Patriot),1,0-1,16,20,36,0.444,02/21/2021,2021.0
26,Delaware (CAA),2,1-1,19,25,44,0.432,02/21/2021,2021.0
27,Air Force (SoCon),2,1-1,19,27,46,0.413,02/21/2021,2021.0
28,High Point (SoCon),2,1-1,30,43,73,0.411,02/21/2021,2021.0
29,Marquette (Big East),1,0-1,9,13,22,0.409,02/21/2021,2021.0
30,Villanova (Big East),1,0-1,8,12,20,0.400,02/21/2021,2021.0
31,Robert Morris (DI Independent),3,1-2,42,64,106,0.396,02/21/2021,2021.0
32,Army West Point (Patriot),2,1-1,22,34,56,0.393,02/21/2021,2021.0
33,Navy (Patriot),1,1-0,7,11,18,0.389,02/21/2021,2021.0
34,Richmond (SoCon),2,0-2,15,28,43,0.349,02/21/2021,2021.0
35,St. John's (NY) (Big East),2,1-1,19,49,68,0.279,02/21/2021,2021.0
36,Towson (CAA),3,1-2,21,60,81,0.259,02/21/2021,2021.0
37,Sacred Heart (NEC),2,0-2,11,42,53,0.208,02/21/2021,2021.0
38,Bellarmine (SoCon),3,1-2,11,61,72,0.153,02/21/2021,2021.0
-,Merrimack (NEC),1,0-1,14,15,29,0.483,02/21/2021,2021.0
1,Hofstra (CAA),2,1-1,47,16,63,0.746,02/20/2021,2021.0
2,Saint Joseph's (NEC),1,0-1,13,5,18,0.722,02/20/2021,2021.0
3,Mercer (SoCon),3,1-2,50,20,70,0.714,02/20/2021,2021.0
4,Jacksonville (SoCon),2,1-1,39,18,57,0.684,02/20/2021,2021.0
5,North Carolina (ACC),3,3-0,67,34,101,0.663,02/20/2021,2021.0
6,Bryant (NEC),2,1-1,31,16,47,0.660,02/20/2021,2021.0
7,Virginia (ACC),3,3-0,57,33,90,0.633,02/20/2021,2021.0
8,Mount St. Mary's (NEC),2,1-1,24,15,39,0.615,02/20/2021,2021.0
9,Denver (Big East),5,3-2,76,55,131,0.580,02/20/2021,2021.0
10,Duke (ACC),4,4-0,65,49,114,0.570,02/20/2021,2021.0
11,Utah (DI Independent),3,1-2,36,28,64,0.563,02/20/2021,2021.0
12,Stony Brook (America East),2,2-0,31,25,56,0.554,02/20/2021,2021.0
13,Johns Hopkins (Big Ten),1,0-1,14,12,26,0.538,02/20/2021,2021.0
14,NJIT (America East),1,0-1,12,11,23,0.522,02/20/2021,2021.0
14,Penn St. (Big Ten),1,0-1,12,11,23,0.522,02/20/2021,2021.0
16,Boston U. (Patriot),1,1-0,15,14,29,0.517,02/20/2021,2021.0
17,Michigan (Big Ten),1,0-1,17,16,33,0.515,02/20/2021,2021.0
18,Loyola Maryland (Patriot),2,1-1,24,24,48,0.500,02/20/2021,2021.0
19,Maryland (Big Ten),1,1-0,16,17,33,0.485,02/20/2021,2021.0
20,Rutgers (Big Ten),1,1-0,11,12,23,0.478,02/20/2021,2021.0
21,Ohio St. (Big Ten),1,1-0,12,14,26,0.462,02/20/2021,2021.0
22,Delaware (CAA),2,1-1,19,25,44,0.432,02/20/2021,2021.0
23,Air Force (SoCon),2,1-1,19,27,46,0.413,02/20/2021,2021.0
24,Richmond (SoCon),1,0-1,7,10,17,0.412,02/20/2021,2021.0
25,High Point (SoCon),2,1-1,30,43,73,0.411,02/20/2021,2021.0
26,Marquette (Big East),1,0-1,9,13,22,0.409,02/20/2021,2021.0
27,Navy (Patriot),1,1-0,7,11,18,0.389,02/20/2021,2021.0
28,Providence (Big East),1,0-1,8,13,21,0.381,02/20/2021,2021.0
29,Army West Point (Patriot),1,0-1,9,16,25,0.360,02/20/2021,2021.0
30,Robert Morris (DI Independent),2,0-2,22,48,70,0.314,02/20/2021,2021.0
31,St. John's (NY) (Big East),1,1-0,12,28,40,0.300,02/20/2021,2021.0
32,Towson (CAA),3,1-2,21,60,81,0.259,02/20/2021,2021.0
33,Sacred Heart (NEC),2,0-2,11,42,53,0.208,02/20/2021,2021.0
34,Bellarmine (SoCon),3,1-2,11,61,72,0.153,02/20/2021,2021.0
-,Merrimack (NEC),1,0-1,14,15,29,0.483,02/20/2021,2021.0
1,Stony Brook (America East),1,1-0,23,7,30,0.767,02/17/2021,2021.0
2,Saint Joseph's (NEC),1,0-1,13,5,18,0.722,02/17/2021,2021.0
3,Mercer (SoCon),3,1-2,50,20,70,0.714,02/17/2021,2021.0
4,Hofstra (CAA),1,0-1,28,12,40,0.700,02/17/2021,2021.0
5,Jacksonville (SoCon),2,1-1,39,18,57,0.684,02/17/2021,2021.0
6,Virginia (ACC),2,2-0,40,19,59,0.678,02/17/2021,2021.0
7,Mount St. Mary's (NEC),1,1-0,14,7,21,0.667,02/17/2021,2021.0
8,North Carolina (ACC),3,3-0,67,34,101,0.663,02/17/2021,2021.0
9,Utah (DI Independent),2,1-1,27,15,42,0.643,02/17/2021,2021.0
10,Bryant (NEC),1,1-0,13,8,21,0.619,02/17/2021,2021.0
11,Loyola Maryland (Patriot),1,1-0,10,7,17,0.588,02/17/2021,2021.0
12,Denver (Big East),4,2-2,63,46,109,0.578,02/17/2021,2021.0
13,Duke (ACC),3,3-0,42,43,85,0.494,02/17/2021,2021.0
14,Richmond (SoCon),1,0-1,7,10,17,0.412,02/17/2021,2021.0
15,High Point (SoCon),2,1-1,30,43,73,0.411,02/17/2021,2021.0
16,Providence (Big East),1,0-1,8,13,21,0.381,02/17/2021,2021.0
17,Army West Point (Patriot),1,0-1,9,16,25,0.360,02/17/2021,2021.0
18,Delaware (CAA),1,0-1,7,14,21,0.333,02/17/2021,2021.0
19,Robert Morris (DI Independent),2,0-2,22,48,70,0.314,02/17/2021,2021.0
20,St. John's (NY) (Big East),1,1-0,12,28,40,0.300,02/17/2021,2021.0
21,Towson (CAA),2,1-1,15,37,52,0.288,02/17/2021,2021.0
22,Air Force (SoCon),1,0-1,6,18,24,0.250,02/17/2021,2021.0
23,Sacred Heart (NEC),1,0-1,7,23,30,0.233,02/17/2021,2021.0
24,Bellarmine (SoCon),3,1-2,11,61,72,0.153,02/17/2021,2021.0
1,Stony Brook (America East),1,1-0,23,7,30,0.767,02/16/2021,2021.0
2,Saint Joseph's (NEC),1,0-1,13,5,18,0.722,02/16/2021,2021.0
3,Mercer (SoCon),3,1-2,50,20,70,0.714,02/16/2021,2021.0
4,Hofstra (CAA),1,0-1,28,12,40,0.700,02/16/2021,2021.0
5,Jacksonville (SoCon),2,1-1,39,18,57,0.684,02/16/2021,2021.0
6,Virginia (ACC),2,2-0,40,19,59,0.678,02/16/2021,2021.0
7,North Carolina (ACC),3,3-0,67,34,101,0.663,02/16/2021,2021.0
8,Utah (DI Independent),2,1-1,27,15,42,0.643,02/16/2021,2021.0
9,Bryant (NEC),1,1-0,13,8,21,0.619,02/16/2021,2021.0
10,Loyola Maryland (Patriot),1,1-0,10,7,17,0.588,02/16/2021,2021.0
11,Denver (Big East),4,2-2,63,46,109,0.578,02/16/2021,2021.0
12,Duke (ACC),3,3-0,42,43,85,0.494,02/16/2021,2021.0
13,Richmond (SoCon),1,0-1,7,10,17,0.412,02/16/2021,2021.0
14,High Point (SoCon),2,1-1,30,43,73,0.411,02/16/2021,2021.0
15,Providence (Big East),1,0-1,8,13,21,0.381,02/16/2021,2021.0
16,Army West Point (Patriot),1,0-1,9,16,25,0.360,02/16/2021,2021.0
17,Robert Morris (DI Independent),2,0-2,22,48,70,0.314,02/16/2021,2021.0
18,St. John's (NY) (Big East),1,1-0,12,28,40,0.300,02/16/2021,2021.0
19,Towson (CAA),2,1-1,15,37,52,0.288,02/16/2021,2021.0
20,Air Force (SoCon),1,0-1,6,18,24,0.250,02/16/2021,2021.0
21,Sacred Heart (NEC),1,0-1,7,23,30,0.233,02/16/2021,2021.0
22,Bellarmine (SoCon),3,1-2,11,61,72,0.153,02/16/2021,2021.0
1,Stony Brook (America East),1,1-0,23,7,30,0.767,02/14/2021,2021.0
2,Saint Joseph's (NEC),1,0-1,13,5,18,0.722,02/14/2021,2021.0
3,Mercer (SoCon),3,1-2,50,20,70,0.714,02/14/2021,2021.0
4,Hofstra (CAA),1,0-1,28,12,40,0.700,02/14/2021,2021.0
5,Virginia (ACC),2,2-0,40,19,59,0.678,02/14/2021,2021.0
6,Jacksonville (SoCon),2,1-1,38,19,57,0.667,02/14/2021,2021.0
7,High Point (SoCon),1,1-0,25,13,38,0.658,02/14/2021,2021.0
8,Utah (DI Independent),2,1-1,27,15,42,0.643,02/14/2021,2021.0
9,Bryant (NEC),1,1-0,13,8,21,0.619,02/14/2021,2021.0
10,Loyola Maryland (Patriot),1,1-0,10,7,17,0.588,02/14/2021,2021.0
11,Denver (Big East),4,2-2,63,46,109,0.578,02/14/2021,2021.0
12,North Carolina (ACC),2,2-0,37,29,66,0.561,02/14/2021,2021.0
13,Duke (ACC),3,3-0,42,43,85,0.494,02/14/2021,2021.0
14,Richmond (SoCon),1,0-1,7,10,17,0.412,02/14/2021,2021.0
15,Providence (Big East),1,0-1,8,13,21,0.381,02/14/2021,2021.0
16,Army West Point (Patriot),1,0-1,9,16,25,0.360,02/14/2021,2021.0
17,Robert Morris (DI Independent),2,0-2,22,48,70,0.314,02/14/2021,2021.0
18,St. John's (NY) (Big East),1,1-0,12,28,40,0.300,02/14/2021,2021.0
19,Towson (CAA),2,1-1,15,37,52,0.288,02/14/2021,2021.0
20,Air Force (SoCon),1,0-1,6,18,24,0.250,02/14/2021,2021.0
21,Sacred Heart (NEC),1,0-1,7,23,30,0.233,02/14/2021,2021.0
22,Bellarmine (SoCon),3,1-2,12,60,72,0.167,02/14/2021,2021.0
1,Stony Brook (America East),1,1-0,23,7,30,0.767,02/13/2021,2021.0
2,Saint Joseph's (NEC),1,0-1,13,5,18,0.722,02/13/2021,2021.0
3,Mercer (SoCon),3,1-2,50,20,70,0.714,02/13/2021,2021.0
4,Virginia (ACC),1,1-0,24,10,34,0.706,02/13/2021,2021.0
5,Hofstra (CAA),1,0-1,28,12,40,0.700,02/13/2021,2021.0
6,Jacksonville (SoCon),2,1-1,38,19,57,0.667,02/13/2021,2021.0
7,High Point (SoCon),1,1-0,25,13,38,0.658,02/13/2021,2021.0
8,Utah (DI Independent),2,1-1,27,15,42,0.643,02/13/2021,2021.0
9,Bryant (NEC),1,1-0,13,8,21,0.619,02/13/2021,2021.0
10,Denver (Big East),4,2-2,63,46,109,0.578,02/13/2021,2021.0
11,North Carolina (ACC),2,2-0,37,29,66,0.561,02/13/2021,2021.0
12,Duke (ACC),3,3-0,42,43,85,0.494,02/13/2021,2021.0
13,Providence (Big East),1,0-1,8,13,21,0.381,02/13/2021,2021.0
14,Robert Morris (DI Independent),2,0-2,22,48,70,0.314,02/13/2021,2021.0
15,St. John's (NY) (Big East),1,1-0,12,28,40,0.300,02/13/2021,2021.0
16,Towson (CAA),2,1-1,15,37,52,0.288,02/13/2021,2021.0
17,Air Force (SoCon),1,0-1,6,18,24,0.250,02/13/2021,2021.0
18,Sacred Heart (NEC),1,0-1,7,23,30,0.233,02/13/2021,2021.0
19,Bellarmine (SoCon),3,1-2,12,60,72,0.167,02/13/2021,2021.0
1,Jacksonville (SoCon),1,1-0,27,4,31,0.871,02/10/2021,2021.0
2,Mercer (SoCon),2,1-1,35,7,42,0.833,02/10/2021,2021.0
3,Virginia (ACC),1,1-0,24,10,34,0.706,02/10/2021,2021.0
4,Utah (DI Independent),2,1-1,27,15,42,0.643,02/10/2021,2021.0
5,North Carolina (ACC),1,1-0,22,18,40,0.550,02/10/2021,2021.0
6,Denver (Big East),3,1-2,45,40,85,0.529,02/10/2021,2021.0
7,Duke (ACC),2,2-0,29,28,57,0.509,02/10/2021,2021.0
8,Towson (CAA),1,0-1,10,24,34,0.294,02/10/2021,2021.0
9,Robert Morris (DI Independent),1,0-1,9,23,32,0.281,02/10/2021,2021.0
10,Bellarmine (SoCon),3,1-2,12,60,72,0.167,02/10/2021,2021.0
1,Mercer (SoCon),2,1-1,35,7,42,0.833,02/07/2021,2021.0
2,Virginia (ACC),1,1-0,24,10,34,0.706,02/07/2021,2021.0
3,Utah (DI Independent),2,1-1,27,15,42,0.643,02/07/2021,2021.0
4,North Carolina (ACC),1,1-0,22,18,40,0.550,02/07/2021,2021.0
5,Denver (Big East),3,1-2,45,40,85,0.529,02/07/2021,2021.0
6,Duke (ACC),2,2-0,29,28,57,0.509,02/07/2021,2021.0
7,Towson (CAA),1,0-1,10,24,34,0.294,02/07/2021,2021.0
8,Robert Morris (DI Independent),1,0-1,9,23,32,0.281,02/07/2021,2021.0
9,Bellarmine (SoCon),2,1-1,8,33,41,0.195,02/07/2021,2021.0
1,Mercer (SoCon),2,1-1,35,7,42,0.833,02/06/2021,2021.0
2,Virginia (ACC),1,1-0,24,10,34,0.706,02/06/2021,2021.0
3,Utah (DI Independent),2,1-1,27,15,42,0.643,02/06/2021,2021.0
4,Denver (Big East),2,1-1,27,18,45,0.600,02/06/2021,2021.0
5,Towson (CAA),1,0-1,10,24,34,0.294,02/06/2021,2021.0
6,Duke (ACC),1,1-0,6,19,25,0.240,02/06/2021,2021.0
7,Bellarmine (SoCon),2,1-1,8,33,41,0.195,02/06/2021,2021.0
1,Mercer (SoCon),1,0-1,18,1,19,0.947,02/05/2021,2021.0
2,Denver (Big East),2,1-1,27,18,45,0.600,02/05/2021,2021.0
2,Utah (DI Independent),1,0-1,12,8,20,0.600,02/05/2021,2021.0
4,Duke (ACC),1,1-0,6,19,25,0.240,02/05/2021,2021.0
5,Bellarmine (SoCon),1,1-0,1,18,19,0.053,02/05/2021,2021.0
1,Mercer (SoCon),1,0-1,18,1,19,0.947,01/30/2021,2021.0
2,Utah (DI Independent),1,0-1,12,8,20,0.600,01/30/2021,2021.0
3,Denver (Big East),1,1-0,8,12,20,0.400,01/30/2021,2021.0
4,Bellarmine (SoCon),1,1-0,1,18,19,0.053,01/30/2021,2021.0
1,Saint Joseph's (NEC),18,14-4,318,169,487,0.653,05/30/2022-Final Statistics,2022.0
2,Maryland (Big Ten),18,18-0,346,201,547,0.633,05/30/2022-Final Statistics,2022.0
3,Lehigh (Patriot),15,8-7,228,138,366,0.623,05/30/2022-Final Statistics,2022.0
4,Vermont (America East),19,12-7,295,192,487,0.606,05/30/2022-Final Statistics,2022.0
5,Georgetown (Big East),17,15-2,268,186,454,0.590,05/30/2022-Final Statistics,2022.0
6,Ohio St. (Big Ten),16,10-6,266,188,454,0.586,05/30/2022-Final Statistics,2022.0
7,Michigan (Big Ten),15,7-8,250,179,429,0.583,05/30/2022-Final Statistics,2022.0
8,Massachusetts (CAA),14,8-6,213,155,368,0.579,05/30/2022-Final Statistics,2022.0
9,Syracuse (ACC),14,4-10,253,185,438,0.578,05/30/2022-Final Statistics,2022.0
10,Villanova (Big East),15,9-6,246,180,426,0.577,05/30/2022-Final Statistics,2022.0
11,Marquette (Big East),15,4-11,231,173,404,0.572,05/30/2022-Final Statistics,2022.0
12,Denver (Big East),15,9-6,237,189,426,0.556,05/30/2022-Final Statistics,2022.0
13,Bryant (NEC),15,8-7,218,174,392,0.556,05/30/2022-Final Statistics,2022.0
14,Virginia (ACC),16,12-4,275,220,495,0.556,05/30/2022-Final Statistics,2022.0
15,Hobart (NEC),13,7-6,207,169,376,0.551,05/30/2022-Final Statistics,2022.0
16,Duke (ACC),17,11-6,275,229,504,0.546,05/30/2022-Final Statistics,2022.0
17,Yale (Ivy League),17,12-5,287,242,529,0.543,05/30/2022-Final Statistics,2022.0
18,Colgate (Patriot),13,4-9,171,147,318,0.538,05/30/2022-Final Statistics,2022.0
19,Dartmouth (Ivy League),13,4-9,173,149,322,0.537,05/30/2022-Final Statistics,2022.0
20,Loyola Maryland (Patriot),16,8-8,230,199,429,0.536,05/30/2022-Final Statistics,2022.0
21,Utah (ASUN),14,10-4,211,183,394,0.536,05/30/2022-Final Statistics,2022.0
22,Army West Point (Patriot),16,12-4,244,217,461,0.529,05/30/2022-Final Statistics,2022.0
23,Boston U. (Patriot),17,12-5,244,218,462,0.528,05/30/2022-Final Statistics,2022.0
24,Quinnipiac (MAAC),13,2-11,190,175,365,0.521,05/30/2022-Final Statistics,2022.0
25,Stony Brook (America East),14,9-5,205,189,394,0.520,05/30/2022-Final Statistics,2022.0
26,Richmond (SoCon),16,11-5,228,211,439,0.519,05/30/2022-Final Statistics,2022.0
27,Robert Morris (ASUN),16,10-6,239,224,463,0.516,05/30/2022-Final Statistics,2022.0
28,North Carolina (ACC),14,8-6,201,189,390,0.515,05/30/2022-Final Statistics,2022.0
29,LIU (NEC),15,7-8,194,183,377,0.515,05/30/2022-Final Statistics,2022.0
30,Monmouth (MAAC),12,5-7,127,120,247,0.514,05/30/2022-Final Statistics,2022.0
31,Mercer (SoCon),15,5-10,209,200,409,0.511,05/30/2022-Final Statistics,2022.0
32,Fairfield (CAA),14,7-7,218,209,427,0.511,05/30/2022-Final Statistics,2022.0
33,Jacksonville (SoCon),17,14-3,238,229,467,0.510,05/30/2022-Final Statistics,2022.0
34,UMBC (America East),13,6-7,160,155,315,0.508,05/30/2022-Final Statistics,2022.0
35,UMass Lowell (America East),13,2-11,184,179,363,0.507,05/30/2022-Final Statistics,2022.0
36,Penn (Ivy League),16,11-5,216,211,427,0.506,05/30/2022-Final Statistics,2022.0
37,St. Bonaventure (MAAC),15,11-4,175,175,350,0.500,05/30/2022-Final Statistics,2022.0
38,Princeton (Ivy League),16,11-5,233,235,468,0.498,05/30/2022-Final Statistics,2022.0
39,UAlbany (America East),15,5-10,207,211,418,0.495,05/30/2022-Final Statistics,2022.0
40,Johns Hopkins (Big Ten),16,7-9,212,217,429,0.494,05/30/2022-Final Statistics,2022.0
41,Siena (MAAC),15,6-9,179,185,364,0.492,05/30/2022-Final Statistics,2022.0
42,Air Force (ASUN),15,8-7,180,187,367,0.490,05/30/2022-Final Statistics,2022.0
43,Bucknell (Patriot),15,9-6,206,216,422,0.488,05/30/2022-Final Statistics,2022.0
44,Binghamton (America East),14,5-9,175,186,361,0.485,05/30/2022-Final Statistics,2022.0
45,Brown (Ivy League),16,10-6,217,233,450,0.482,05/30/2022-Final Statistics,2022.0
46,Canisius (MAAC),14,2-12,180,197,377,0.477,05/30/2022-Final Statistics,2022.0
47,Navy (Patriot),15,9-6,173,191,364,0.475,05/30/2022-Final Statistics,2022.0
48,Rutgers (Big Ten),19,15-4,266,295,561,0.474,05/30/2022-Final Statistics,2022.0
49,Cornell (Ivy League),19,14-5,244,282,526,0.464,05/30/2022-Final Statistics,2022.0
50,Delaware (CAA),19,13-6,241,284,525,0.459,05/30/2022-Final Statistics,2022.0
51,High Point (SoCon),15,7-8,195,231,426,0.458,05/30/2022-Final Statistics,2022.0
52,Mount St. Mary's (NEC),15,5-10,165,196,361,0.457,05/30/2022-Final Statistics,2022.0
53,Cleveland St. (ASUN),13,3-10,159,189,348,0.457,05/30/2022-Final Statistics,2022.0
54,Notre Dame (ACC),12,8-4,153,183,336,0.455,05/30/2022-Final Statistics,2022.0
55,Marist (MAAC),15,7-8,174,210,384,0.453,05/30/2022-Final Statistics,2022.0
56,NJIT (America East),13,0-13,147,178,325,0.452,05/30/2022-Final Statistics,2022.0
57,Providence (Big East),14,6-8,179,221,400,0.448,05/30/2022-Final Statistics,2022.0
58,Hofstra (CAA),15,6-9,165,204,369,0.447,05/30/2022-Final Statistics,2022.0
59,Holy Cross (Patriot),14,1-13,178,224,402,0.443,05/30/2022-Final Statistics,2022.0
60,Towson (CAA),16,7-9,185,239,424,0.436,05/30/2022-Final Statistics,2022.0
61,Penn St. (Big Ten),14,3-11,168,223,391,0.430,05/30/2022-Final Statistics,2022.0
62,Lafayette (Patriot),15,4-11,193,257,450,0.429,05/30/2022-Final Statistics,2022.0
63,Detroit Mercy (ASUN),11,2-9,124,167,291,0.426,05/30/2022-Final Statistics,2022.0
64,Hampton (SoCon),10,0-10,119,170,289,0.412,05/30/2022-Final Statistics,2022.0
65,Bellarmine (ASUN),17,4-13,180,264,444,0.405,05/30/2022-Final Statistics,2022.0
66,Sacred Heart (NEC),13,3-10,147,223,370,0.397,05/30/2022-Final Statistics,2022.0
67,Harvard (Ivy League),13,8-5,145,220,365,0.397,05/30/2022-Final Statistics,2022.0
68,VMI (SoCon),15,4-11,155,237,392,0.395,05/30/2022-Final Statistics,2022.0
69,Drexel (CAA),14,6-8,151,248,399,0.378,05/30/2022-Final Statistics,2022.0
70,Wagner (NEC),12,3-9,94,158,252,0.373,05/30/2022-Final Statistics,2022.0
71,St. John's (NY) (Big East),14,2-12,152,274,426,0.357,05/30/2022-Final Statistics,2022.0
72,Manhattan (MAAC),15,8-7,101,237,338,0.299,05/30/2022-Final Statistics,2022.0
-,Merrimack (NEC),12,6-6,136,145,281,0.484,05/30/2022-Final Statistics,2022.0
1,Penn (Ivy League),2,1-1,33,16,49,0.673,05/11/2022 - 05/30/2022-2022 NCAA DI MLA Championship,2022.0
2,Maryland (Big Ten),4,4-0,67,38,105,0.638,05/11/2022 - 05/30/2022-2022 NCAA DI MLA Championship,2022.0
3,Ohio St. (Big Ten),1,0-1,17,10,27,0.630,05/11/2022 - 05/30/2022-2022 NCAA DI MLA Championship,2022.0
4,Georgetown (Big East),1,0-1,14,9,23,0.609,05/11/2022 - 05/30/2022-2022 NCAA DI MLA Championship,2022.0
5,Saint Joseph's (NEC),1,0-1,22,15,37,0.595,05/11/2022 - 05/30/2022-2022 NCAA DI MLA Championship,2022.0
6,Vermont (America East),2,1-1,29,23,52,0.558,05/11/2022 - 05/30/2022-2022 NCAA DI MLA Championship,2022.0
7,Princeton (Ivy League),3,2-1,40,32,72,0.556,05/11/2022 - 05/30/2022-2022 NCAA DI MLA Championship,2022.0
8,Rutgers (Big Ten),3,2-1,44,43,87,0.506,05/11/2022 - 05/30/2022-2022 NCAA DI MLA Championship,2022.0
9,Cornell (Ivy League),4,3-1,50,50,100,0.500,05/11/2022 - 05/30/2022-2022 NCAA DI MLA Championship,2022.0
10,Virginia (ACC),2,1-1,30,32,62,0.484,05/11/2022 - 05/30/2022-2022 NCAA DI MLA Championship,2022.0
11,Yale (Ivy League),2,1-1,30,35,65,0.462,05/11/2022 - 05/30/2022-2022 NCAA DI MLA Championship,2022.0
12,Delaware (CAA),3,2-1,35,42,77,0.455,05/11/2022 - 05/30/2022-2022 NCAA DI MLA Championship,2022.0
13,Robert Morris (ASUN),1,0-1,12,20,32,0.375,05/11/2022 - 05/30/2022-2022 NCAA DI MLA Championship,2022.0
14,Brown (Ivy League),1,0-1,11,20,31,0.355,05/11/2022 - 05/30/2022-2022 NCAA DI MLA Championship,2022.0
15,Richmond (SoCon),1,0-1,8,17,25,0.320,05/11/2022 - 05/30/2022-2022 NCAA DI MLA Championship,2022.0
16,Harvard (Ivy League),1,0-1,10,22,32,0.313,05/11/2022 - 05/30/2022-2022 NCAA DI MLA Championship,2022.0
17,Boston U. (Patriot),1,0-1,4,16,20,0.200,05/11/2022 - 05/30/2022-2022 NCAA DI MLA Championship,2022.0
18,Manhattan (MAAC),1,0-1,3,19,22,0.136,05/11/2022 - 05/30/2022-2022 NCAA DI MLA Championship,2022.0
1,Saint Joseph's (NEC),18,14-4,318,169,487,0.653,05/22/2022,2022.0
2,Maryland (Big Ten),16,16-0,320,183,503,0.636,05/22/2022,2022.0
3,Lehigh (Patriot),15,8-7,228,138,366,0.623,05/22/2022,2022.0
4,Vermont (America East),19,12-7,295,192,487,0.606,05/22/2022,2022.0
5,Georgetown (Big East),17,15-2,268,186,454,0.590,05/22/2022,2022.0
6,Ohio St. (Big Ten),16,10-6,266,188,454,0.586,05/22/2022,2022.0
7,Michigan (Big Ten),15,7-8,250,179,429,0.583,05/22/2022,2022.0
8,Massachusetts (CAA),14,8-6,213,155,368,0.579,05/22/2022,2022.0
9,Syracuse (ACC),14,4-10,253,185,438,0.578,05/22/2022,2022.0
10,Villanova (Big East),15,9-6,246,180,426,0.577,05/22/2022,2022.0
11,Marquette (Big East),15,4-11,231,173,404,0.572,05/22/2022,2022.0
12,Denver (Big East),15,9-6,237,189,426,0.556,05/22/2022,2022.0
13,Bryant (NEC),15,8-7,218,174,392,0.556,05/22/2022,2022.0
14,Virginia (ACC),16,12-4,275,220,495,0.556,05/22/2022,2022.0
15,Hobart (NEC),13,7-6,207,169,376,0.551,05/22/2022,2022.0
16,Duke (ACC),17,11-6,275,229,504,0.546,05/22/2022,2022.0
17,Yale (Ivy League),17,12-5,287,242,529,0.543,05/22/2022,2022.0
18,Colgate (Patriot),13,4-9,171,147,318,0.538,05/22/2022,2022.0
19,Dartmouth (Ivy League),13,4-9,173,149,322,0.537,05/22/2022,2022.0
20,Loyola Maryland (Patriot),16,8-8,230,199,429,0.536,05/22/2022,2022.0
21,Utah (ASUN),14,10-4,211,183,394,0.536,05/22/2022,2022.0
22,Army West Point (Patriot),16,12-4,244,217,461,0.529,05/22/2022,2022.0
23,Boston U. (Patriot),17,12-5,244,218,462,0.528,05/22/2022,2022.0
24,Quinnipiac (MAAC),13,2-11,190,175,365,0.521,05/22/2022,2022.0
25,Stony Brook (America East),14,9-5,205,189,394,0.520,05/22/2022,2022.0
26,Richmond (SoCon),16,11-5,228,211,439,0.519,05/22/2022,2022.0
27,Robert Morris (ASUN),16,10-6,239,224,463,0.516,05/22/2022,2022.0
28,North Carolina (ACC),14,8-6,201,189,390,0.515,05/22/2022,2022.0
29,LIU (NEC),15,7-8,194,183,377,0.515,05/22/2022,2022.0
30,Monmouth (MAAC),12,5-7,127,120,247,0.514,05/22/2022,2022.0
31,Mercer (SoCon),15,5-10,209,200,409,0.511,05/22/2022,2022.0
32,Fairfield (CAA),14,7-7,218,209,427,0.511,05/22/2022,2022.0
33,Jacksonville (SoCon),17,14-3,238,229,467,0.510,05/22/2022,2022.0
34,UMBC (America East),13,6-7,160,155,315,0.508,05/22/2022,2022.0
35,UMass Lowell (America East),13,2-11,184,179,363,0.507,05/22/2022,2022.0
36,Penn (Ivy League),16,11-5,216,211,427,0.506,05/22/2022,2022.0
37,Princeton (Ivy League),15,11-4,222,222,444,0.500,05/22/2022,2022.0
37,St. Bonaventure (MAAC),15,11-4,175,175,350,0.500,05/22/2022,2022.0
39,UAlbany (America East),15,5-10,207,211,418,0.495,05/22/2022,2022.0
40,Johns Hopkins (Big Ten),16,7-9,212,217,429,0.494,05/22/2022,2022.0
41,Siena (MAAC),15,6-9,179,185,364,0.492,05/22/2022,2022.0
42,Air Force (ASUN),15,8-7,180,187,367,0.490,05/22/2022,2022.0
43,Bucknell (Patriot),15,9-6,206,216,422,0.488,05/22/2022,2022.0
44,Binghamton (America East),14,5-9,175,186,361,0.485,05/22/2022,2022.0
45,Brown (Ivy League),16,10-6,217,233,450,0.482,05/22/2022,2022.0
46,Canisius (MAAC),14,2-12,180,197,377,0.477,05/22/2022,2022.0
47,Rutgers (Big Ten),18,15-3,252,278,530,0.475,05/22/2022,2022.0
48,Navy (Patriot),15,9-6,173,191,364,0.475,05/22/2022,2022.0
49,Cornell (Ivy League),17,13-4,220,255,475,0.463,05/22/2022,2022.0
50,Delaware (CAA),19,13-6,241,284,525,0.459,05/22/2022,2022.0
51,High Point (SoCon),15,7-8,195,231,426,0.458,05/22/2022,2022.0
52,Mount St. Mary's (NEC),15,5-10,165,196,361,0.457,05/22/2022,2022.0
53,Cleveland St. (ASUN),13,3-10,159,189,348,0.457,05/22/2022,2022.0
54,Notre Dame (ACC),12,8-4,153,183,336,0.455,05/22/2022,2022.0
55,Marist (MAAC),15,7-8,174,210,384,0.453,05/22/2022,2022.0
56,NJIT (America East),13,0-13,147,178,325,0.452,05/22/2022,2022.0
57,Providence (Big East),14,6-8,179,221,400,0.448,05/22/2022,2022.0
58,Hofstra (CAA),15,6-9,165,204,369,0.447,05/22/2022,2022.0
59,Holy Cross (Patriot),14,1-13,178,224,402,0.443,05/22/2022,2022.0
60,Towson (CAA),16,7-9,185,239,424,0.436,05/22/2022,2022.0
61,Penn St. (Big Ten),14,3-11,168,223,391,0.430,05/22/2022,2022.0
62,Lafayette (Patriot),15,4-11,193,257,450,0.429,05/22/2022,2022.0
63,Detroit Mercy (ASUN),11,2-9,124,167,291,0.426,05/22/2022,2022.0
64,Hampton (SoCon),10,0-10,119,170,289,0.412,05/22/2022,2022.0
65,Bellarmine (ASUN),17,4-13,180,264,444,0.405,05/22/2022,2022.0
66,Sacred Heart (NEC),13,3-10,147,223,370,0.397,05/22/2022,2022.0
67,Harvard (Ivy League),13,8-5,145,220,365,0.397,05/22/2022,2022.0
68,VMI (SoCon),15,4-11,155,237,392,0.395,05/22/2022,2022.0
69,Drexel (CAA),14,6-8,151,248,399,0.378,05/22/2022,2022.0
70,Wagner (NEC),12,3-9,94,158,252,0.373,05/22/2022,2022.0
71,St. John's (NY) (Big East),14,2-12,152,274,426,0.357,05/22/2022,2022.0
72,Manhattan (MAAC),15,8-7,101,237,338,0.299,05/22/2022,2022.0
-,Merrimack (NEC),12,6-6,136,145,281,0.484,05/22/2022,2022.0
1,Saint Joseph's (NEC),18,14-4,318,169,487,0.653,05/21/2022,2022.0
2,Maryland (Big Ten),15,15-0,299,173,472,0.633,05/21/2022,2022.0
3,Lehigh (Patriot),15,8-7,228,138,366,0.623,05/21/2022,2022.0
4,Vermont (America East),19,12-7,295,192,487,0.606,05/21/2022,2022.0
5,Georgetown (Big East),17,15-2,268,186,454,0.590,05/21/2022,2022.0
6,Ohio St. (Big Ten),16,10-6,266,188,454,0.586,05/21/2022,2022.0
7,Michigan (Big Ten),15,7-8,250,179,429,0.583,05/21/2022,2022.0
8,Massachusetts (CAA),14,8-6,213,155,368,0.579,05/21/2022,2022.0
9,Syracuse (ACC),14,4-10,253,185,438,0.578,05/21/2022,2022.0
10,Villanova (Big East),15,9-6,246,180,426,0.577,05/21/2022,2022.0
11,Marquette (Big East),15,4-11,231,173,404,0.572,05/21/2022,2022.0
12,Virginia (ACC),15,12-3,265,199,464,0.571,05/21/2022,2022.0
13,Denver (Big East),15,9-6,237,189,426,0.556,05/21/2022,2022.0
14,Bryant (NEC),15,8-7,218,174,392,0.556,05/21/2022,2022.0
15,Hobart (NEC),13,7-6,207,169,376,0.551,05/21/2022,2022.0
16,Duke (ACC),17,11-6,275,229,504,0.546,05/21/2022,2022.0
17,Yale (Ivy League),17,12-5,287,242,529,0.543,05/21/2022,2022.0
18,Colgate (Patriot),13,4-9,171,147,318,0.538,05/21/2022,2022.0
19,Dartmouth (Ivy League),13,4-9,173,149,322,0.537,05/21/2022,2022.0
20,Loyola Maryland (Patriot),16,8-8,230,199,429,0.536,05/21/2022,2022.0
21,Utah (ASUN),14,10-4,211,183,394,0.536,05/21/2022,2022.0
22,Army West Point (Patriot),16,12-4,244,217,461,0.529,05/21/2022,2022.0
23,Boston U. (Patriot),17,12-5,244,218,462,0.528,05/21/2022,2022.0
24,Quinnipiac (MAAC),13,2-11,190,175,365,0.521,05/21/2022,2022.0
25,Stony Brook (America East),14,9-5,205,189,394,0.520,05/21/2022,2022.0
26,Richmond (SoCon),16,11-5,228,211,439,0.519,05/21/2022,2022.0
27,Robert Morris (ASUN),16,10-6,239,224,463,0.516,05/21/2022,2022.0
28,North Carolina (ACC),14,8-6,201,189,390,0.515,05/21/2022,2022.0
29,LIU (NEC),15,7-8,194,183,377,0.515,05/21/2022,2022.0
30,Monmouth (MAAC),12,5-7,127,120,247,0.514,05/21/2022,2022.0
31,Mercer (SoCon),15,5-10,209,200,409,0.511,05/21/2022,2022.0
32,Fairfield (CAA),14,7-7,218,209,427,0.511,05/21/2022,2022.0
33,Jacksonville (SoCon),17,14-3,238,229,467,0.510,05/21/2022,2022.0
34,UMBC (America East),13,6-7,160,155,315,0.508,05/21/2022,2022.0
35,UMass Lowell (America East),13,2-11,184,179,363,0.507,05/21/2022,2022.0
36,Penn (Ivy League),16,11-5,216,211,427,0.506,05/21/2022,2022.0
37,Princeton (Ivy League),15,11-4,222,222,444,0.500,05/21/2022,2022.0
37,St. Bonaventure (MAAC),15,11-4,175,175,350,0.500,05/21/2022,2022.0
39,UAlbany (America East),15,5-10,207,211,418,0.495,05/21/2022,2022.0
40,Johns Hopkins (Big Ten),16,7-9,212,217,429,0.494,05/21/2022,2022.0
41,Siena (MAAC),15,6-9,179,185,364,0.492,05/21/2022,2022.0
42,Air Force (ASUN),15,8-7,180,187,367,0.490,05/21/2022,2022.0
43,Bucknell (Patriot),15,9-6,206,216,422,0.488,05/21/2022,2022.0
44,Binghamton (America East),14,5-9,175,186,361,0.485,05/21/2022,2022.0
45,Brown (Ivy League),16,10-6,217,233,450,0.482,05/21/2022,2022.0
46,Canisius (MAAC),14,2-12,180,197,377,0.477,05/21/2022,2022.0
47,Rutgers (Big Ten),18,15-3,252,278,530,0.475,05/21/2022,2022.0
48,Navy (Patriot),15,9-6,173,191,364,0.475,05/21/2022,2022.0
49,Delaware (CAA),18,13-5,235,268,503,0.467,05/21/2022,2022.0
50,High Point (SoCon),15,7-8,195,231,426,0.458,05/21/2022,2022.0
51,Mount St. Mary's (NEC),15,5-10,165,196,361,0.457,05/21/2022,2022.0
52,Cleveland St. (ASUN),13,3-10,159,189,348,0.457,05/21/2022,2022.0
53,Notre Dame (ACC),12,8-4,153,183,336,0.455,05/21/2022,2022.0
54,Marist (MAAC),15,7-8,174,210,384,0.453,05/21/2022,2022.0
55,NJIT (America East),13,0-13,147,178,325,0.452,05/21/2022,2022.0
56,Cornell (Ivy League),16,12-4,204,249,453,0.450,05/21/2022,2022.0
57,Providence (Big East),14,6-8,179,221,400,0.448,05/21/2022,2022.0
58,Hofstra (CAA),15,6-9,165,204,369,0.447,05/21/2022,2022.0
59,Holy Cross (Patriot),14,1-13,178,224,402,0.443,05/21/2022,2022.0
60,Towson (CAA),16,7-9,185,239,424,0.436,05/21/2022,2022.0
61,Penn St. (Big Ten),14,3-11,168,223,391,0.430,05/21/2022,2022.0
62,Lafayette (Patriot),15,4-11,193,257,450,0.429,05/21/2022,2022.0
63,Detroit Mercy (ASUN),11,2-9,124,167,291,0.426,05/21/2022,2022.0
64,Hampton (SoCon),10,0-10,119,170,289,0.412,05/21/2022,2022.0
65,Bellarmine (ASUN),17,4-13,180,264,444,0.405,05/21/2022,2022.0
66,Sacred Heart (NEC),13,3-10,147,223,370,0.397,05/21/2022,2022.0
67,Harvard (Ivy League),13,8-5,145,220,365,0.397,05/21/2022,2022.0
68,VMI (SoCon),15,4-11,155,237,392,0.395,05/21/2022,2022.0
69,Drexel (CAA),14,6-8,151,248,399,0.378,05/21/2022,2022.0
70,Wagner (NEC),12,3-9,94,158,252,0.373,05/21/2022,2022.0
71,St. John's (NY) (Big East),14,2-12,152,274,426,0.357,05/21/2022,2022.0
72,Manhattan (MAAC),15,8-7,101,237,338,0.299,05/21/2022,2022.0
-,Merrimack (NEC),12,6-6,136,145,281,0.484,05/21/2022,2022.0
1,Saint Joseph's (NEC),18,14-4,318,169,487,0.653,05/15/2022,2022.0
2,Maryland (Big Ten),15,15-0,299,173,472,0.633,05/15/2022,2022.0
3,Lehigh (Patriot),15,8-7,228,138,366,0.623,05/15/2022,2022.0
4,Vermont (America East),19,12-7,295,192,487,0.606,05/15/2022,2022.0
5,Georgetown (Big East),17,15-2,268,186,454,0.590,05/15/2022,2022.0
6,Ohio St. (Big Ten),16,10-6,266,188,454,0.586,05/15/2022,2022.0
7,Michigan (Big Ten),15,7-8,250,179,429,0.583,05/15/2022,2022.0
8,Massachusetts (CAA),14,8-6,213,155,368,0.579,05/15/2022,2022.0
9,Syracuse (ACC),14,4-10,253,185,438,0.578,05/15/2022,2022.0
10,Villanova (Big East),15,9-6,246,180,426,0.577,05/15/2022,2022.0
11,Marquette (Big East),15,4-11,231,173,404,0.572,05/15/2022,2022.0
12,Virginia (ACC),15,12-3,265,199,464,0.571,05/15/2022,2022.0
13,Denver (Big East),15,9-6,237,189,426,0.556,05/15/2022,2022.0
14,Bryant (NEC),15,8-7,218,174,392,0.556,05/15/2022,2022.0
15,Hobart (NEC),13,7-6,207,169,376,0.551,05/15/2022,2022.0
16,Duke (ACC),17,11-6,275,229,504,0.546,05/15/2022,2022.0
17,Yale (Ivy League),16,12-4,272,229,501,0.543,05/15/2022,2022.0
18,Colgate (Patriot),13,4-9,171,147,318,0.538,05/15/2022,2022.0
19,Dartmouth (Ivy League),13,4-9,173,149,322,0.537,05/15/2022,2022.0
20,Loyola Maryland (Patriot),16,8-8,230,199,429,0.536,05/15/2022,2022.0
21,Utah (ASUN),14,10-4,211,183,394,0.536,05/15/2022,2022.0
22,Army West Point (Patriot),16,12-4,244,217,461,0.529,05/15/2022,2022.0
23,Boston U. (Patriot),17,12-5,244,218,462,0.528,05/15/2022,2022.0
24,Quinnipiac (MAAC),13,2-11,190,175,365,0.521,05/15/2022,2022.0
25,Stony Brook (America East),14,9-5,205,189,394,0.520,05/15/2022,2022.0
26,Richmond (SoCon),16,11-5,228,211,439,0.519,05/15/2022,2022.0
27,Robert Morris (ASUN),16,10-6,239,224,463,0.516,05/15/2022,2022.0
28,North Carolina (ACC),14,8-6,201,189,390,0.515,05/15/2022,2022.0
29,LIU (NEC),15,7-8,194,183,377,0.515,05/15/2022,2022.0
30,Monmouth (MAAC),12,5-7,127,120,247,0.514,05/15/2022,2022.0
31,Mercer (SoCon),15,5-10,209,200,409,0.511,05/15/2022,2022.0
32,Fairfield (CAA),14,7-7,218,209,427,0.511,05/15/2022,2022.0
33,Jacksonville (SoCon),17,14-3,238,229,467,0.510,05/15/2022,2022.0
34,UMBC (America East),13,6-7,160,155,315,0.508,05/15/2022,2022.0
35,UMass Lowell (America East),13,2-11,184,179,363,0.507,05/15/2022,2022.0
36,Princeton (Ivy League),14,10-4,209,207,416,0.502,05/15/2022,2022.0
37,St. Bonaventure (MAAC),15,11-4,175,175,350,0.500,05/15/2022,2022.0
38,Penn (Ivy League),15,11-4,200,203,403,0.496,05/15/2022,2022.0
39,UAlbany (America East),15,5-10,207,211,418,0.495,05/15/2022,2022.0
40,Johns Hopkins (Big Ten),16,7-9,212,217,429,0.494,05/15/2022,2022.0
41,Siena (MAAC),15,6-9,179,185,364,0.492,05/15/2022,2022.0
42,Air Force (ASUN),15,8-7,180,187,367,0.490,05/15/2022,2022.0
43,Bucknell (Patriot),15,9-6,206,216,422,0.488,05/15/2022,2022.0
44,Binghamton (America East),14,5-9,175,186,361,0.485,05/15/2022,2022.0
45,Brown (Ivy League),16,10-6,217,233,450,0.482,05/15/2022,2022.0
46,Rutgers (Big Ten),17,14-3,244,262,506,0.482,05/15/2022,2022.0
47,Canisius (MAAC),14,2-12,180,197,377,0.477,05/15/2022,2022.0
48,Navy (Patriot),15,9-6,173,191,364,0.475,05/15/2022,2022.0
49,Delaware (CAA),18,13-5,235,268,503,0.467,05/15/2022,2022.0
50,High Point (SoCon),15,7-8,195,231,426,0.458,05/15/2022,2022.0
51,Mount St. Mary's (NEC),15,5-10,165,196,361,0.457,05/15/2022,2022.0
52,Cleveland St. (ASUN),13,3-10,159,189,348,0.457,05/15/2022,2022.0
53,Notre Dame (ACC),12,8-4,153,183,336,0.455,05/15/2022,2022.0
54,Marist (MAAC),15,7-8,174,210,384,0.453,05/15/2022,2022.0
55,NJIT (America East),13,0-13,147,178,325,0.452,05/15/2022,2022.0
56,Cornell (Ivy League),16,12-4,204,249,453,0.450,05/15/2022,2022.0
57,Providence (Big East),14,6-8,179,221,400,0.448,05/15/2022,2022.0
58,Hofstra (CAA),15,6-9,165,204,369,0.447,05/15/2022,2022.0
59,Holy Cross (Patriot),14,1-13,178,224,402,0.443,05/15/2022,2022.0
60,Towson (CAA),16,7-9,185,239,424,0.436,05/15/2022,2022.0
61,Penn St. (Big Ten),14,3-11,168,223,391,0.430,05/15/2022,2022.0
62,Lafayette (Patriot),15,4-11,193,257,450,0.429,05/15/2022,2022.0
63,Detroit Mercy (ASUN),11,2-9,124,167,291,0.426,05/15/2022,2022.0
64,Hampton (SoCon),10,0-10,119,170,289,0.412,05/15/2022,2022.0
65,Bellarmine (ASUN),17,4-13,180,264,444,0.405,05/15/2022,2022.0
66,Sacred Heart (NEC),13,3-10,147,223,370,0.397,05/15/2022,2022.0
67,Harvard (Ivy League),13,8-5,145,220,365,0.397,05/15/2022,2022.0
68,VMI (SoCon),15,4-11,155,237,392,0.395,05/15/2022,2022.0
69,Drexel (CAA),14,6-8,151,248,399,0.378,05/15/2022,2022.0
70,Wagner (NEC),12,3-9,94,158,252,0.373,05/15/2022,2022.0
71,St. John's (NY) (Big East),14,2-12,152,274,426,0.357,05/15/2022,2022.0
72,Manhattan (MAAC),15,8-7,101,237,338,0.299,05/15/2022,2022.0
-,Merrimack (NEC),12,6-6,136,145,281,0.484,05/15/2022,2022.0
1,Saint Joseph's (NEC),17,14-3,296,154,450,0.658,05/11/2022,2022.0
2,Maryland (Big Ten),14,14-0,279,163,442,0.631,05/11/2022,2022.0
3,Vermont (America East),18,12-6,285,172,457,0.624,05/11/2022,2022.0
4,Lehigh (Patriot),15,8-7,228,138,366,0.623,05/11/2022,2022.0
5,Georgetown (Big East),16,15-1,254,177,431,0.589,05/11/2022,2022.0
6,Ohio St. (Big Ten),15,10-5,249,178,427,0.583,05/11/2022,2022.0
7,Michigan (Big Ten),15,7-8,250,179,429,0.583,05/11/2022,2022.0
8,Massachusetts (CAA),14,8-6,213,155,368,0.579,05/11/2022,2022.0
9,Syracuse (ACC),14,4-10,253,185,438,0.578,05/11/2022,2022.0
10,Villanova (Big East),15,9-6,246,180,426,0.577,05/11/2022,2022.0
11,Marquette (Big East),15,4-11,231,173,404,0.572,05/11/2022,2022.0
12,Virginia (ACC),14,11-3,245,188,433,0.566,05/11/2022,2022.0
13,Denver (Big East),15,9-6,237,189,426,0.556,05/11/2022,2022.0
14,Bryant (NEC),15,8-7,218,174,392,0.556,05/11/2022,2022.0
15,Yale (Ivy League),15,11-4,257,207,464,0.554,05/11/2022,2022.0
16,Hobart (NEC),13,7-6,207,169,376,0.551,05/11/2022,2022.0
17,Duke (ACC),17,11-6,275,229,504,0.546,05/11/2022,2022.0
18,Boston U. (Patriot),16,12-4,240,202,442,0.543,05/11/2022,2022.0
19,Colgate (Patriot),13,4-9,171,147,318,0.538,05/11/2022,2022.0
20,Dartmouth (Ivy League),13,4-9,173,149,322,0.537,05/11/2022,2022.0
21,Loyola Maryland (Patriot),16,8-8,230,199,429,0.536,05/11/2022,2022.0
22,Utah (ASUN),14,10-4,211,183,394,0.536,05/11/2022,2022.0
23,Richmond (SoCon),15,11-4,220,194,414,0.531,05/11/2022,2022.0
24,Army West Point (Patriot),16,12-4,244,217,461,0.529,05/11/2022,2022.0
25,Quinnipiac (MAAC),13,2-11,190,175,365,0.521,05/11/2022,2022.0
26,Stony Brook (America East),14,9-5,205,189,394,0.520,05/11/2022,2022.0
27,Robert Morris (ASUN),16,10-6,239,224,463,0.516,05/11/2022,2022.0
28,North Carolina (ACC),14,8-6,201,189,390,0.515,05/11/2022,2022.0
29,LIU (NEC),15,7-8,194,183,377,0.515,05/11/2022,2022.0
30,Monmouth (MAAC),12,5-7,127,120,247,0.514,05/11/2022,2022.0
31,Mercer (SoCon),15,5-10,209,200,409,0.511,05/11/2022,2022.0
32,Fairfield (CAA),14,7-7,218,209,427,0.511,05/11/2022,2022.0
33,Jacksonville (SoCon),17,14-3,238,229,467,0.510,05/11/2022,2022.0
34,UMBC (America East),13,6-7,160,155,315,0.508,05/11/2022,2022.0
35,UMass Lowell (America East),13,2-11,184,179,363,0.507,05/11/2022,2022.0
36,St. Bonaventure (MAAC),15,11-4,175,175,350,0.500,05/11/2022,2022.0
37,UAlbany (America East),15,5-10,207,211,418,0.495,05/11/2022,2022.0
38,Johns Hopkins (Big Ten),16,7-9,212,217,429,0.494,05/11/2022,2022.0
39,Siena (MAAC),15,6-9,179,185,364,0.492,05/11/2022,2022.0
40,Brown (Ivy League),15,10-5,206,213,419,0.492,05/11/2022,2022.0
41,Air Force (ASUN),15,8-7,180,187,367,0.490,05/11/2022,2022.0
42,Bucknell (Patriot),15,9-6,206,216,422,0.488,05/11/2022,2022.0
43,Princeton (Ivy League),13,9-4,193,203,396,0.487,05/11/2022,2022.0
44,Binghamton (America East),14,5-9,175,186,361,0.485,05/11/2022,2022.0
45,Penn (Ivy League),14,10-4,183,195,378,0.484,05/11/2022,2022.0
46,Canisius (MAAC),14,2-12,180,197,377,0.477,05/11/2022,2022.0
47,Navy (Patriot),15,9-6,173,191,364,0.475,05/11/2022,2022.0
48,Delaware (CAA),17,12-5,226,254,480,0.471,05/11/2022,2022.0
49,Rutgers (Big Ten),16,13-3,222,252,474,0.468,05/11/2022,2022.0
50,High Point (SoCon),15,7-8,195,231,426,0.458,05/11/2022,2022.0
51,Mount St. Mary's (NEC),15,5-10,165,196,361,0.457,05/11/2022,2022.0
52,Cleveland St. (ASUN),13,3-10,159,189,348,0.457,05/11/2022,2022.0
53,Cornell (Ivy League),15,11-4,194,232,426,0.455,05/11/2022,2022.0
54,Notre Dame (ACC),12,8-4,153,183,336,0.455,05/11/2022,2022.0
55,Marist (MAAC),15,7-8,174,210,384,0.453,05/11/2022,2022.0
56,NJIT (America East),13,0-13,147,178,325,0.452,05/11/2022,2022.0
57,Providence (Big East),14,6-8,179,221,400,0.448,05/11/2022,2022.0
58,Hofstra (CAA),15,6-9,165,204,369,0.447,05/11/2022,2022.0
59,Holy Cross (Patriot),14,1-13,178,224,402,0.443,05/11/2022,2022.0
60,Towson (CAA),16,7-9,185,239,424,0.436,05/11/2022,2022.0
61,Penn St. (Big Ten),14,3-11,168,223,391,0.430,05/11/2022,2022.0
62,Lafayette (Patriot),15,4-11,193,257,450,0.429,05/11/2022,2022.0
63,Detroit Mercy (ASUN),11,2-9,124,167,291,0.426,05/11/2022,2022.0
64,Hampton (SoCon),10,0-10,119,170,289,0.412,05/11/2022,2022.0
65,Bellarmine (ASUN),17,4-13,180,264,444,0.405,05/11/2022,2022.0
65,Harvard (Ivy League),12,8-4,135,198,333,0.405,05/11/2022,2022.0
67,Sacred Heart (NEC),13,3-10,147,223,370,0.397,05/11/2022,2022.0
68,VMI (SoCon),15,4-11,155,237,392,0.395,05/11/2022,2022.0
69,Drexel (CAA),14,6-8,151,248,399,0.378,05/11/2022,2022.0
70,Wagner (NEC),12,3-9,94,158,252,0.373,05/11/2022,2022.0
71,St. John's (NY) (Big East),14,2-12,152,274,426,0.357,05/11/2022,2022.0
72,Manhattan (MAAC),15,8-7,101,237,338,0.299,05/11/2022,2022.0
-,Merrimack (NEC),12,6-6,136,145,281,0.484,05/11/2022,2022.0
1,Saint Joseph's (NEC),17,14-3,296,154,450,0.658,05/08/2022,2022.0
2,Maryland (Big Ten),14,14-0,279,163,442,0.631,05/08/2022,2022.0
3,Lehigh (Patriot),15,8-7,228,138,366,0.623,05/08/2022,2022.0
4,Vermont (America East),17,11-6,266,169,435,0.611,05/08/2022,2022.0
5,Georgetown (Big East),16,15-1,254,177,431,0.589,05/08/2022,2022.0
6,Ohio St. (Big Ten),15,10-5,249,178,427,0.583,05/08/2022,2022.0
7,Michigan (Big Ten),15,7-8,250,179,429,0.583,05/08/2022,2022.0
8,Massachusetts (CAA),14,8-6,213,155,368,0.579,05/08/2022,2022.0
9,Syracuse (ACC),14,4-10,253,185,438,0.578,05/08/2022,2022.0
10,Villanova (Big East),15,9-6,246,180,426,0.577,05/08/2022,2022.0
11,Marquette (Big East),15,4-11,231,173,404,0.572,05/08/2022,2022.0
12,Virginia (ACC),14,11-3,245,188,433,0.566,05/08/2022,2022.0
13,Denver (Big East),15,9-6,237,189,426,0.556,05/08/2022,2022.0
14,Bryant (NEC),15,8-7,218,174,392,0.556,05/08/2022,2022.0
15,Yale (Ivy League),15,11-4,257,207,464,0.554,05/08/2022,2022.0
16,Hobart (NEC),13,7-6,207,169,376,0.551,05/08/2022,2022.0
17,Duke (ACC),17,11-6,275,229,504,0.546,05/08/2022,2022.0
18,Boston U. (Patriot),16,12-4,240,202,442,0.543,05/08/2022,2022.0
19,Colgate (Patriot),13,4-9,171,147,318,0.538,05/08/2022,2022.0
20,Dartmouth (Ivy League),13,4-9,173,149,322,0.537,05/08/2022,2022.0
21,Loyola Maryland (Patriot),16,8-8,230,199,429,0.536,05/08/2022,2022.0
22,Utah (ASUN),14,10-4,211,183,394,0.536,05/08/2022,2022.0
23,Richmond (SoCon),15,11-4,220,194,414,0.531,05/08/2022,2022.0
24,Army West Point (Patriot),16,12-4,244,217,461,0.529,05/08/2022,2022.0
25,Robert Morris (ASUN),15,10-5,227,204,431,0.527,05/08/2022,2022.0
26,Quinnipiac (MAAC),13,2-11,190,175,365,0.521,05/08/2022,2022.0
27,Stony Brook (America East),14,9-5,205,189,394,0.520,05/08/2022,2022.0
28,North Carolina (ACC),14,8-6,201,189,390,0.515,05/08/2022,2022.0
29,LIU (NEC),15,7-8,194,183,377,0.515,05/08/2022,2022.0
30,Monmouth (MAAC),12,5-7,127,120,247,0.514,05/08/2022,2022.0
31,Mercer (SoCon),15,5-10,209,200,409,0.511,05/08/2022,2022.0
32,Fairfield (CAA),14,7-7,218,209,427,0.511,05/08/2022,2022.0
33,Jacksonville (SoCon),17,14-3,238,229,467,0.510,05/08/2022,2022.0
34,UMBC (America East),13,6-7,160,155,315,0.508,05/08/2022,2022.0
35,UMass Lowell (America East),13,2-11,184,179,363,0.507,05/08/2022,2022.0
36,St. Bonaventure (MAAC),15,11-4,175,175,350,0.500,05/08/2022,2022.0
37,UAlbany (America East),15,5-10,207,211,418,0.495,05/08/2022,2022.0
38,Johns Hopkins (Big Ten),16,7-9,212,217,429,0.494,05/08/2022,2022.0
39,Siena (MAAC),15,6-9,179,185,364,0.492,05/08/2022,2022.0
40,Brown (Ivy League),15,10-5,206,213,419,0.492,05/08/2022,2022.0
41,Air Force (ASUN),15,8-7,180,187,367,0.490,05/08/2022,2022.0
42,Bucknell (Patriot),15,9-6,206,216,422,0.488,05/08/2022,2022.0
43,Princeton (Ivy League),13,9-4,193,203,396,0.487,05/08/2022,2022.0
44,Binghamton (America East),14,5-9,175,186,361,0.485,05/08/2022,2022.0
45,Penn (Ivy League),14,10-4,183,195,378,0.484,05/08/2022,2022.0
46,Canisius (MAAC),14,2-12,180,197,377,0.477,05/08/2022,2022.0
47,Navy (Patriot),15,9-6,173,191,364,0.475,05/08/2022,2022.0
48,Rutgers (Big Ten),16,13-3,222,252,474,0.468,05/08/2022,2022.0
49,Delaware (CAA),16,11-5,206,242,448,0.460,05/08/2022,2022.0
50,High Point (SoCon),15,7-8,195,231,426,0.458,05/08/2022,2022.0
51,Mount St. Mary's (NEC),15,5-10,165,196,361,0.457,05/08/2022,2022.0
52,Cleveland St. (ASUN),13,3-10,159,189,348,0.457,05/08/2022,2022.0
53,Cornell (Ivy League),15,11-4,194,232,426,0.455,05/08/2022,2022.0
54,Notre Dame (ACC),12,8-4,153,183,336,0.455,05/08/2022,2022.0
55,Marist (MAAC),15,7-8,174,210,384,0.453,05/08/2022,2022.0
56,NJIT (America East),13,0-13,147,178,325,0.452,05/08/2022,2022.0
57,Providence (Big East),14,6-8,179,221,400,0.448,05/08/2022,2022.0
58,Hofstra (CAA),15,6-9,165,204,369,0.447,05/08/2022,2022.0
59,Holy Cross (Patriot),14,1-13,178,224,402,0.443,05/08/2022,2022.0
60,Towson (CAA),16,7-9,185,239,424,0.436,05/08/2022,2022.0
61,Penn St. (Big Ten),14,3-11,168,223,391,0.430,05/08/2022,2022.0
62,Lafayette (Patriot),15,4-11,193,257,450,0.429,05/08/2022,2022.0
63,Detroit Mercy (ASUN),11,2-9,124,167,291,0.426,05/08/2022,2022.0
64,Hampton (SoCon),10,0-10,119,170,289,0.412,05/08/2022,2022.0
65,Bellarmine (ASUN),17,4-13,180,264,444,0.405,05/08/2022,2022.0
65,Harvard (Ivy League),12,8-4,135,198,333,0.405,05/08/2022,2022.0
67,Sacred Heart (NEC),13,3-10,147,223,370,0.397,05/08/2022,2022.0
68,VMI (SoCon),15,4-11,155,237,392,0.395,05/08/2022,2022.0
69,Drexel (CAA),14,6-8,151,248,399,0.378,05/08/2022,2022.0
70,Wagner (NEC),12,3-9,94,158,252,0.373,05/08/2022,2022.0
71,St. John's (NY) (Big East),14,2-12,152,274,426,0.357,05/08/2022,2022.0
72,Manhattan (MAAC),14,8-6,98,218,316,0.310,05/08/2022,2022.0
-,Merrimack (NEC),12,6-6,136,145,281,0.484,05/08/2022,2022.0
1,Saint Joseph's (NEC),16,13-3,284,143,427,0.665,05/05/2022,2022.0
2,Maryland (Big Ten),13,13-0,258,156,414,0.623,05/05/2022,2022.0
3,Lehigh (Patriot),14,8-6,210,128,338,0.621,05/05/2022,2022.0
4,Vermont (America East),16,10-6,252,156,408,0.618,05/05/2022,2022.0
5,Georgetown (Big East),15,14-1,239,162,401,0.596,05/05/2022,2022.0
6,Villanova (Big East),14,9-5,231,165,396,0.583,05/05/2022,2022.0
7,Ohio St. (Big Ten),15,10-5,249,178,427,0.583,05/05/2022,2022.0
8,Michigan (Big Ten),15,7-8,250,179,429,0.583,05/05/2022,2022.0
9,Massachusetts (CAA),14,8-6,213,155,368,0.579,05/05/2022,2022.0
10,Syracuse (ACC),14,4-10,253,185,438,0.578,05/05/2022,2022.0
11,Marquette (Big East),15,4-11,231,173,404,0.572,05/05/2022,2022.0
12,Boston U. (Patriot),14,10-4,221,166,387,0.571,05/05/2022,2022.0
13,Virginia (ACC),14,11-3,245,188,433,0.566,05/05/2022,2022.0
14,Denver (Big East),15,9-6,237,189,426,0.556,05/05/2022,2022.0
15,Bryant (NEC),15,8-7,218,174,392,0.556,05/05/2022,2022.0
16,Yale (Ivy League),13,10-3,226,181,407,0.555,05/05/2022,2022.0
17,Hobart (NEC),12,7-5,196,157,353,0.555,05/05/2022,2022.0
18,Duke (ACC),16,11-5,259,213,472,0.549,05/05/2022,2022.0
19,Utah (ASUN),13,10-3,193,162,355,0.544,05/05/2022,2022.0
20,Colgate (Patriot),13,4-9,171,147,318,0.538,05/05/2022,2022.0
21,Loyola Maryland (Patriot),15,8-7,214,184,398,0.538,05/05/2022,2022.0
22,Dartmouth (Ivy League),13,4-9,173,149,322,0.537,05/05/2022,2022.0
23,Richmond (SoCon),14,10-4,195,171,366,0.533,05/05/2022,2022.0
24,Army West Point (Patriot),14,11-3,211,192,403,0.524,05/05/2022,2022.0
25,Robert Morris (ASUN),14,9-5,205,187,392,0.523,05/05/2022,2022.0
26,Quinnipiac (MAAC),13,2-11,190,175,365,0.521,05/05/2022,2022.0
27,Stony Brook (America East),14,9-5,205,189,394,0.520,05/05/2022,2022.0
28,North Carolina (ACC),14,8-6,201,189,390,0.515,05/05/2022,2022.0
29,LIU (NEC),15,7-8,194,183,377,0.515,05/05/2022,2022.0
30,Monmouth (MAAC),12,5-7,127,120,247,0.514,05/05/2022,2022.0
31,UMBC (America East),12,6-6,139,132,271,0.513,05/05/2022,2022.0
32,Mercer (SoCon),15,5-10,209,200,409,0.511,05/05/2022,2022.0
33,Fairfield (CAA),14,7-7,218,209,427,0.511,05/05/2022,2022.0
34,UMass Lowell (America East),13,2-11,184,179,363,0.507,05/05/2022,2022.0
35,Jacksonville (SoCon),16,14-2,225,220,445,0.506,05/05/2022,2022.0
36,UAlbany (America East),15,5-10,207,211,418,0.495,05/05/2022,2022.0
37,Johns Hopkins (Big Ten),16,7-9,212,217,429,0.494,05/05/2022,2022.0
38,Brown (Ivy League),14,10-4,193,199,392,0.492,05/05/2022,2022.0
39,Siena (MAAC),15,6-9,179,185,364,0.492,05/05/2022,2022.0
40,Air Force (ASUN),15,8-7,180,187,367,0.490,05/05/2022,2022.0
41,St. Bonaventure (MAAC),14,11-3,162,169,331,0.489,05/05/2022,2022.0
42,Bucknell (Patriot),15,9-6,206,216,422,0.488,05/05/2022,2022.0
43,Princeton (Ivy League),13,9-4,193,203,396,0.487,05/05/2022,2022.0
44,Binghamton (America East),14,5-9,166,178,344,0.483,05/05/2022,2022.0
45,Rutgers (Big Ten),15,13-2,215,231,446,0.482,05/05/2022,2022.0
46,Canisius (MAAC),14,2-12,180,197,377,0.477,05/05/2022,2022.0
47,Penn (Ivy League),12,8-4,154,169,323,0.477,05/05/2022,2022.0
48,Navy (Patriot),15,9-6,173,191,364,0.475,05/05/2022,2022.0
49,High Point (SoCon),15,7-8,185,215,400,0.463,05/05/2022,2022.0
50,Cornell (Ivy League),14,11-3,183,214,397,0.461,05/05/2022,2022.0
51,Mount St. Mary's (NEC),15,5-10,165,196,361,0.457,05/05/2022,2022.0
52,Cleveland St. (ASUN),13,3-10,159,189,348,0.457,05/05/2022,2022.0
53,Marist (MAAC),15,7-8,174,210,384,0.453,05/05/2022,2022.0
54,NJIT (America East),13,0-13,147,178,325,0.452,05/05/2022,2022.0
55,Notre Dame (ACC),11,7-4,137,167,304,0.451,05/05/2022,2022.0
56,Delaware (CAA),15,10-5,192,235,427,0.450,05/05/2022,2022.0
57,Providence (Big East),14,6-8,179,221,400,0.448,05/05/2022,2022.0
58,Hofstra (CAA),15,6-9,165,204,369,0.447,05/05/2022,2022.0
59,Holy Cross (Patriot),14,1-13,178,224,402,0.443,05/05/2022,2022.0
60,Towson (CAA),15,7-8,178,225,403,0.442,05/05/2022,2022.0
61,Penn St. (Big Ten),14,3-11,168,223,391,0.430,05/05/2022,2022.0
62,Lafayette (Patriot),15,4-11,193,257,450,0.429,05/05/2022,2022.0
63,Detroit Mercy (ASUN),11,2-9,124,167,291,0.426,05/05/2022,2022.0
64,Hampton (SoCon),10,0-10,119,170,289,0.412,05/05/2022,2022.0
65,Bellarmine (ASUN),17,4-13,181,263,444,0.408,05/05/2022,2022.0
66,Harvard (Ivy League),12,8-4,135,198,333,0.405,05/05/2022,2022.0
67,Sacred Heart (NEC),13,3-10,147,223,370,0.397,05/05/2022,2022.0
68,VMI (SoCon),15,4-11,155,237,392,0.395,05/05/2022,2022.0
69,Drexel (CAA),14,6-8,151,248,399,0.378,05/05/2022,2022.0
70,Wagner (NEC),12,3-9,94,158,252,0.373,05/05/2022,2022.0
71,St. John's (NY) (Big East),14,2-12,152,274,426,0.357,05/05/2022,2022.0
72,Manhattan (MAAC),13,7-6,92,205,297,0.310,05/05/2022,2022.0
-,Merrimack (NEC),12,6-6,136,145,281,0.484,05/05/2022,2022.0
1,Saint Joseph's (NEC),15,12-3,269,134,403,0.667,05/03/2022,2022.0
2,Maryland (Big Ten),12,12-0,244,141,385,0.634,05/03/2022,2022.0
3,Vermont (America East),15,9-6,242,140,382,0.634,05/03/2022,2022.0
4,Lehigh (Patriot),14,8-6,210,128,338,0.621,05/03/2022,2022.0
5,Georgetown (Big East),14,13-1,230,147,377,0.610,05/03/2022,2022.0
6,Villanova (Big East),13,8-5,216,148,364,0.593,05/03/2022,2022.0
7,Ohio St. (Big Ten),14,10-4,236,165,401,0.589,05/03/2022,2022.0
8,Michigan (Big Ten),15,7-8,250,179,429,0.583,05/03/2022,2022.0
9,Syracuse (ACC),14,4-10,253,185,438,0.578,05/03/2022,2022.0
10,Massachusetts (CAA),13,8-5,193,143,336,0.574,05/03/2022,2022.0
11,Boston U. (Patriot),14,10-4,221,166,387,0.571,05/03/2022,2022.0
12,Marquette (Big East),14,4-10,216,164,380,0.568,05/03/2022,2022.0
13,Bryant (NEC),14,8-6,206,157,363,0.567,05/03/2022,2022.0
14,Virginia (ACC),14,11-3,245,188,433,0.566,05/03/2022,2022.0
15,Denver (Big East),14,9-5,220,174,394,0.558,05/03/2022,2022.0
16,Yale (Ivy League),13,10-3,226,181,407,0.555,05/03/2022,2022.0
17,Hobart (NEC),11,6-5,179,145,324,0.552,05/03/2022,2022.0
18,Duke (ACC),16,11-5,259,213,472,0.549,05/03/2022,2022.0
19,Colgate (Patriot),13,4-9,171,147,318,0.538,05/03/2022,2022.0
20,Loyola Maryland (Patriot),15,8-7,214,184,398,0.538,05/03/2022,2022.0
21,Dartmouth (Ivy League),13,4-9,173,149,322,0.537,05/03/2022,2022.0
22,Richmond (SoCon),13,9-4,195,171,366,0.533,05/03/2022,2022.0
23,Utah (ASUN),12,9-3,175,154,329,0.532,05/03/2022,2022.0
24,Robert Morris (ASUN),13,8-5,197,175,372,0.530,05/03/2022,2022.0
25,LIU (NEC),14,7-7,185,168,353,0.524,05/03/2022,2022.0
26,Army West Point (Patriot),14,11-3,211,192,403,0.524,05/03/2022,2022.0
27,Quinnipiac (MAAC),13,2-11,190,175,365,0.521,05/03/2022,2022.0
28,Stony Brook (America East),14,9-5,205,189,394,0.520,05/03/2022,2022.0
29,North Carolina (ACC),14,8-6,201,189,390,0.515,05/03/2022,2022.0
30,Monmouth (MAAC),12,5-7,127,120,247,0.514,05/03/2022,2022.0
31,UMBC (America East),11,5-6,139,132,271,0.513,05/03/2022,2022.0
32,Mercer (SoCon),15,5-10,209,200,409,0.511,05/03/2022,2022.0
33,Fairfield (CAA),14,7-7,218,209,427,0.511,05/03/2022,2022.0
34,UMass Lowell (America East),13,2-11,184,179,363,0.507,05/03/2022,2022.0
35,St. Bonaventure (MAAC),13,10-3,155,151,306,0.507,05/03/2022,2022.0
36,Johns Hopkins (Big Ten),15,7-8,197,203,400,0.493,05/03/2022,2022.0
37,Brown (Ivy League),14,10-4,193,199,392,0.492,05/03/2022,2022.0
38,Jacksonville (SoCon),15,13-2,209,216,425,0.492,05/03/2022,2022.0
39,Bucknell (Patriot),15,9-6,206,216,422,0.488,05/03/2022,2022.0
40,Princeton (Ivy League),13,9-4,193,203,396,0.487,05/03/2022,2022.0
41,UAlbany (America East),14,5-9,191,201,392,0.487,05/03/2022,2022.0
42,Air Force (ASUN),14,8-6,168,179,347,0.484,05/03/2022,2022.0
43,Binghamton (America East),13,5-8,166,178,344,0.483,05/03/2022,2022.0
44,Rutgers (Big Ten),14,12-2,202,218,420,0.481,05/03/2022,2022.0
45,Canisius (MAAC),14,2-12,180,197,377,0.477,05/03/2022,2022.0
46,Penn (Ivy League),12,8-4,154,169,323,0.477,05/03/2022,2022.0
47,Navy (Patriot),15,9-6,173,191,364,0.475,05/03/2022,2022.0
48,Siena (MAAC),14,6-8,161,178,339,0.475,05/03/2022,2022.0
49,High Point (SoCon),14,7-7,185,215,400,0.463,05/03/2022,2022.0
50,Cornell (Ivy League),14,11-3,183,214,397,0.461,05/03/2022,2022.0
51,Mount St. Mary's (NEC),15,5-10,165,196,361,0.457,05/03/2022,2022.0
52,Cleveland St. (ASUN),13,3-10,159,189,348,0.457,05/03/2022,2022.0
53,NJIT (America East),13,0-13,147,178,325,0.452,05/03/2022,2022.0
54,Notre Dame (ACC),11,7-4,137,167,304,0.451,05/03/2022,2022.0
55,Providence (Big East),14,6-8,179,221,400,0.448,05/03/2022,2022.0
56,Towson (CAA),14,6-8,166,205,371,0.447,05/03/2022,2022.0
57,Hofstra (CAA),15,6-9,165,204,369,0.447,05/03/2022,2022.0
58,Holy Cross (Patriot),14,1-13,178,224,402,0.443,05/03/2022,2022.0
59,Marist (MAAC),14,7-7,153,202,355,0.431,05/03/2022,2022.0
60,Penn St. (Big Ten),14,3-11,168,223,391,0.430,05/03/2022,2022.0
61,Lafayette (Patriot),15,4-11,193,257,450,0.429,05/03/2022,2022.0
62,Delaware (CAA),14,9-5,157,210,367,0.428,05/03/2022,2022.0
63,Detroit Mercy (ASUN),11,2-9,124,167,291,0.426,05/03/2022,2022.0
64,Bellarmine (ASUN),16,4-12,173,245,418,0.414,05/03/2022,2022.0
65,Hampton (SoCon),10,0-10,119,170,289,0.412,05/03/2022,2022.0
66,VMI (SoCon),14,4-10,151,221,372,0.406,05/03/2022,2022.0
67,Harvard (Ivy League),12,8-4,135,198,333,0.405,05/03/2022,2022.0
68,Sacred Heart (NEC),13,3-10,147,223,370,0.397,05/03/2022,2022.0
69,Wagner (NEC),12,3-9,94,158,252,0.373,05/03/2022,2022.0
70,Drexel (CAA),13,6-7,126,213,339,0.372,05/03/2022,2022.0
71,St. John's (NY) (Big East),14,2-12,152,274,426,0.357,05/03/2022,2022.0
72,Manhattan (MAAC),12,6-6,84,184,268,0.313,05/03/2022,2022.0
-,Merrimack (NEC),12,6-6,136,145,281,0.484,05/03/2022,2022.0
1,Saint Joseph's (NEC),15,12-3,269,134,403,0.667,05/01/2022,2022.0
2,Maryland (Big Ten),12,12-0,244,141,385,0.634,05/01/2022,2022.0
3,Vermont (America East),15,9-6,242,140,382,0.634,05/01/2022,2022.0
4,Lehigh (Patriot),13,7-6,194,118,312,0.622,05/01/2022,2022.0
5,Georgetown (Big East),14,13-1,230,147,377,0.610,05/01/2022,2022.0
6,Villanova (Big East),13,8-5,216,148,364,0.593,05/01/2022,2022.0
7,Ohio St. (Big Ten),14,10-4,236,165,401,0.589,05/01/2022,2022.0
8,Michigan (Big Ten),15,7-8,250,179,429,0.583,05/01/2022,2022.0
9,Syracuse (ACC),14,4-10,253,185,438,0.578,05/01/2022,2022.0
10,Massachusetts (CAA),13,8-5,193,143,336,0.574,05/01/2022,2022.0
11,Boston U. (Patriot),14,10-4,221,166,387,0.571,05/01/2022,2022.0
12,Marquette (Big East),14,4-10,216,164,380,0.568,05/01/2022,2022.0
13,Bryant (NEC),14,8-6,206,157,363,0.567,05/01/2022,2022.0
14,Virginia (ACC),14,11-3,245,188,433,0.566,05/01/2022,2022.0
15,Denver (Big East),14,9-5,220,174,394,0.558,05/01/2022,2022.0
16,Yale (Ivy League),13,10-3,226,181,407,0.555,05/01/2022,2022.0
17,Hobart (NEC),11,6-5,179,145,324,0.552,05/01/2022,2022.0
18,Duke (ACC),16,11-5,259,213,472,0.549,05/01/2022,2022.0
19,Colgate (Patriot),13,4-9,171,147,318,0.538,05/01/2022,2022.0
20,Dartmouth (Ivy League),13,4-9,173,149,322,0.537,05/01/2022,2022.0
21,Richmond (SoCon),13,9-4,195,171,366,0.533,05/01/2022,2022.0
22,Loyola Maryland (Patriot),14,7-7,200,176,376,0.532,05/01/2022,2022.0
22,Utah (ASUN),12,9-3,175,154,329,0.532,05/01/2022,2022.0
24,Robert Morris (ASUN),13,8-5,197,175,372,0.530,05/01/2022,2022.0
25,LIU (NEC),14,7-7,185,168,353,0.524,05/01/2022,2022.0
26,Army West Point (Patriot),14,11-3,211,192,403,0.524,05/01/2022,2022.0
27,Quinnipiac (MAAC),13,2-11,190,175,365,0.521,05/01/2022,2022.0
28,Stony Brook (America East),14,9-5,205,189,394,0.520,05/01/2022,2022.0
29,North Carolina (ACC),14,8-6,201,189,390,0.515,05/01/2022,2022.0
30,Monmouth (MAAC),12,5-7,127,120,247,0.514,05/01/2022,2022.0
31,UMBC (America East),11,5-6,139,132,271,0.513,05/01/2022,2022.0
32,Mercer (SoCon),15,5-10,209,200,409,0.511,05/01/2022,2022.0
33,Fairfield (CAA),14,7-7,218,209,427,0.511,05/01/2022,2022.0
34,UMass Lowell (America East),13,2-11,184,179,363,0.507,05/01/2022,2022.0
35,St. Bonaventure (MAAC),13,10-3,155,151,306,0.507,05/01/2022,2022.0
36,Bucknell (Patriot),14,9-5,198,202,400,0.495,05/01/2022,2022.0
37,Johns Hopkins (Big Ten),15,7-8,197,203,400,0.493,05/01/2022,2022.0
38,Brown (Ivy League),14,10-4,193,199,392,0.492,05/01/2022,2022.0
39,Jacksonville (SoCon),15,13-2,209,216,425,0.492,05/01/2022,2022.0
40,Princeton (Ivy League),13,9-4,193,203,396,0.487,05/01/2022,2022.0
41,UAlbany (America East),14,5-9,191,201,392,0.487,05/01/2022,2022.0
42,Air Force (ASUN),14,8-6,168,179,347,0.484,05/01/2022,2022.0
43,Binghamton (America East),13,5-8,166,178,344,0.483,05/01/2022,2022.0
44,Navy (Patriot),14,9-5,163,175,338,0.482,05/01/2022,2022.0
45,Rutgers (Big Ten),14,12-2,202,218,420,0.481,05/01/2022,2022.0
46,Canisius (MAAC),14,2-12,180,197,377,0.477,05/01/2022,2022.0
47,Penn (Ivy League),12,8-4,154,169,323,0.477,05/01/2022,2022.0
48,Siena (MAAC),14,6-8,161,178,339,0.475,05/01/2022,2022.0
49,High Point (SoCon),14,7-7,185,215,400,0.463,05/01/2022,2022.0
50,Cornell (Ivy League),14,11-3,183,214,397,0.461,05/01/2022,2022.0
51,Mount St. Mary's (NEC),15,5-10,165,196,361,0.457,05/01/2022,2022.0
52,Cleveland St. (ASUN),13,3-10,159,189,348,0.457,05/01/2022,2022.0
53,NJIT (America East),13,0-13,147,178,325,0.452,05/01/2022,2022.0
54,Notre Dame (ACC),11,7-4,137,167,304,0.451,05/01/2022,2022.0
55,Providence (Big East),14,6-8,179,221,400,0.448,05/01/2022,2022.0
56,Towson (CAA),14,6-8,166,205,371,0.447,05/01/2022,2022.0
57,Hofstra (CAA),15,6-9,165,204,369,0.447,05/01/2022,2022.0
58,Holy Cross (Patriot),14,1-13,178,224,402,0.443,05/01/2022,2022.0
59,Marist (MAAC),14,7-7,153,202,355,0.431,05/01/2022,2022.0
60,Penn St. (Big Ten),14,3-11,168,223,391,0.430,05/01/2022,2022.0
61,Lafayette (Patriot),15,4-11,193,257,450,0.429,05/01/2022,2022.0
62,Delaware (CAA),14,9-5,157,210,367,0.428,05/01/2022,2022.0
63,Detroit Mercy (ASUN),11,2-9,124,167,291,0.426,05/01/2022,2022.0
64,Bellarmine (ASUN),16,4-12,173,245,418,0.414,05/01/2022,2022.0
65,Hampton (SoCon),10,0-10,119,170,289,0.412,05/01/2022,2022.0
66,VMI (SoCon),14,4-10,151,221,372,0.406,05/01/2022,2022.0
67,Harvard (Ivy League),12,8-4,135,198,333,0.405,05/01/2022,2022.0
68,Sacred Heart (NEC),13,3-10,147,223,370,0.397,05/01/2022,2022.0
69,Wagner (NEC),12,3-9,94,158,252,0.373,05/01/2022,2022.0
70,Drexel (CAA),13,6-7,126,213,339,0.372,05/01/2022,2022.0
71,St. John's (NY) (Big East),14,2-12,152,274,426,0.357,05/01/2022,2022.0
72,Manhattan (MAAC),12,6-6,84,184,268,0.313,05/01/2022,2022.0
-,Merrimack (NEC),12,6-6,136,145,281,0.484,05/01/2022,2022.0
1,Saint Joseph's (NEC),14,11-3,253,120,373,0.678,04/28/2022,2022.0
2,Lehigh (Patriot),12,7-5,183,101,284,0.644,04/28/2022,2022.0
3,Maryland (Big Ten),12,12-0,244,141,385,0.634,04/28/2022,2022.0
4,Vermont (America East),14,8-6,220,130,350,0.629,04/28/2022,2022.0
5,Georgetown (Big East),13,12-1,219,135,354,0.619,04/28/2022,2022.0
6,Villanova (Big East),12,8-4,204,137,341,0.598,04/28/2022,2022.0
7,Ohio St. (Big Ten),13,9-4,221,150,371,0.596,04/28/2022,2022.0
8,Michigan (Big Ten),14,7-7,235,164,399,0.589,04/28/2022,2022.0
9,Boston U. (Patriot),13,10-3,206,149,355,0.580,04/28/2022,2022.0
10,Marquette (Big East),13,4-9,203,149,352,0.577,04/28/2022,2022.0
11,Syracuse (ACC),13,4-9,234,172,406,0.576,04/28/2022,2022.0
12,Virginia (ACC),14,11-3,245,188,433,0.566,04/28/2022,2022.0
13,Massachusetts (CAA),12,7-5,176,136,312,0.564,04/28/2022,2022.0
14,Denver (Big East),13,8-5,205,161,366,0.560,04/28/2022,2022.0
15,Bryant (NEC),13,7-6,188,149,337,0.558,04/28/2022,2022.0
16,Dartmouth (Ivy League),12,4-8,165,132,297,0.556,04/28/2022,2022.0
17,Yale (Ivy League),12,9-3,204,168,372,0.548,04/28/2022,2022.0
18,Duke (ACC),15,10-5,239,199,438,0.546,04/28/2022,2022.0
19,Colgate (Patriot),12,3-9,157,132,289,0.543,04/28/2022,2022.0
20,Stony Brook (America East),13,9-4,195,167,362,0.539,04/28/2022,2022.0
21,Utah (ASUN),11,8-3,162,140,302,0.536,04/28/2022,2022.0
22,Hobart (NEC),10,5-5,161,140,301,0.535,04/28/2022,2022.0
23,Robert Morris (ASUN),12,7-5,181,158,339,0.534,04/28/2022,2022.0
24,Loyola Maryland (Patriot),13,6-7,183,165,348,0.526,04/28/2022,2022.0
25,North Carolina (ACC),13,8-5,187,169,356,0.525,04/28/2022,2022.0
26,Quinnipiac (MAAC),12,2-10,176,160,336,0.524,04/28/2022,2022.0
27,St. Bonaventure (MAAC),12,9-3,145,132,277,0.523,04/28/2022,2022.0
28,Army West Point (Patriot),13,10-3,194,177,371,0.523,04/28/2022,2022.0
29,Richmond (SoCon),12,8-4,175,161,336,0.521,04/28/2022,2022.0
30,Monmouth (MAAC),11,5-6,117,109,226,0.518,04/28/2022,2022.0
31,LIU (NEC),13,6-7,167,159,326,0.512,04/28/2022,2022.0
32,Fairfield (CAA),13,7-6,203,195,398,0.510,04/28/2022,2022.0
33,UMBC (America East),10,4-6,120,119,239,0.502,04/28/2022,2022.0
34,Bucknell (Patriot),13,9-4,189,189,378,0.500,04/28/2022,2022.0
35,UMass Lowell (America East),12,1-11,170,173,343,0.496,04/28/2022,2022.0
36,Mercer (SoCon),14,4-10,188,192,380,0.495,04/28/2022,2022.0
37,Binghamton (America East),12,5-7,160,164,324,0.494,04/28/2022,2022.0
38,Jacksonville (SoCon),15,13-2,209,216,425,0.492,04/28/2022,2022.0
39,Johns Hopkins (Big Ten),14,6-8,182,191,373,0.488,04/28/2022,2022.0
40,Princeton (Ivy League),12,9-3,174,185,359,0.485,04/28/2022,2022.0
41,Penn (Ivy League),11,7-4,141,150,291,0.485,04/28/2022,2022.0
42,Rutgers (Big Ten),14,12-2,202,218,420,0.481,04/28/2022,2022.0
43,Brown (Ivy League),13,9-4,176,191,367,0.480,04/28/2022,2022.0
44,UAlbany (America East),13,5-8,172,188,360,0.478,04/28/2022,2022.0
45,High Point (SoCon),13,7-6,177,194,371,0.477,04/28/2022,2022.0
46,Navy (Patriot),13,8-5,150,166,316,0.475,04/28/2022,2022.0
47,Air Force (ASUN),13,7-6,155,172,327,0.474,04/28/2022,2022.0
48,Mount St. Mary's (NEC),14,5-9,160,178,338,0.473,04/28/2022,2022.0
49,Siena (MAAC),13,5-8,146,164,310,0.471,04/28/2022,2022.0
50,Canisius (MAAC),13,2-11,161,187,348,0.463,04/28/2022,2022.0
51,Cornell (Ivy League),13,10-3,165,195,360,0.458,04/28/2022,2022.0
52,NJIT (America East),12,0-12,134,159,293,0.457,04/28/2022,2022.0
53,Notre Dame (ACC),10,6-4,124,148,272,0.456,04/28/2022,2022.0
54,Hofstra (CAA),14,5-9,152,185,337,0.451,04/28/2022,2022.0
55,Cleveland St. (ASUN),12,3-9,142,173,315,0.451,04/28/2022,2022.0
56,Holy Cross (Patriot),13,1-12,163,210,373,0.437,04/28/2022,2022.0
57,Delaware (CAA),13,8-5,161,210,371,0.434,04/28/2022,2022.0
58,Towson (CAA),13,6-7,147,192,339,0.434,04/28/2022,2022.0
59,Lafayette (Patriot),15,4-11,193,257,450,0.429,04/28/2022,2022.0
60,Penn St. (Big Ten),13,3-10,156,208,364,0.429,04/28/2022,2022.0
61,Marist (MAAC),13,6-7,142,192,334,0.425,04/28/2022,2022.0
62,Providence (Big East),13,5-8,152,210,362,0.420,04/28/2022,2022.0
63,Bellarmine (ASUN),15,4-11,166,232,398,0.417,04/28/2022,2022.0
64,Detroit Mercy (ASUN),10,2-8,110,154,264,0.417,04/28/2022,2022.0
65,VMI (SoCon),13,4-9,141,201,342,0.412,04/28/2022,2022.0
66,Hampton (SoCon),10,0-10,119,170,289,0.412,04/28/2022,2022.0
67,Harvard (Ivy League),11,8-3,122,176,298,0.409,04/28/2022,2022.0
68,Sacred Heart (NEC),12,3-9,138,205,343,0.402,04/28/2022,2022.0
69,Drexel (CAA),12,6-6,134,214,348,0.385,04/28/2022,2022.0
70,Wagner (NEC),11,3-8,86,140,226,0.381,04/28/2022,2022.0
71,St. John's (NY) (Big East),13,2-11,141,247,388,0.363,04/28/2022,2022.0
72,Manhattan (MAAC),12,6-6,84,184,268,0.313,04/28/2022,2022.0
-,Merrimack (NEC),11,6-5,122,129,251,0.486,04/28/2022,2022.0
1,Saint Joseph's (NEC),14,11-3,253,120,373,0.678,04/26/2022,2022.0
2,Lehigh (Patriot),12,7-5,183,101,284,0.644,04/26/2022,2022.0
3,Maryland (Big Ten),12,12-0,244,141,385,0.634,04/26/2022,2022.0
4,Vermont (America East),14,8-6,220,130,350,0.629,04/26/2022,2022.0
5,Georgetown (Big East),13,12-1,219,135,354,0.619,04/26/2022,2022.0
6,Villanova (Big East),12,8-4,204,137,341,0.598,04/26/2022,2022.0
7,Ohio St. (Big Ten),13,9-4,221,150,371,0.596,04/26/2022,2022.0
8,Michigan (Big Ten),14,7-7,235,164,399,0.589,04/26/2022,2022.0
9,Boston U. (Patriot),13,10-3,206,149,355,0.580,04/26/2022,2022.0
10,Marquette (Big East),13,4-9,203,149,352,0.577,04/26/2022,2022.0
11,Syracuse (ACC),13,4-9,234,172,406,0.576,04/26/2022,2022.0
12,Massachusetts (CAA),12,7-5,176,136,312,0.564,04/26/2022,2022.0
13,Denver (Big East),13,8-5,205,161,366,0.560,04/26/2022,2022.0
14,Bryant (NEC),13,7-6,188,149,337,0.558,04/26/2022,2022.0
15,Dartmouth (Ivy League),12,4-8,165,132,297,0.556,04/26/2022,2022.0
16,Virginia (ACC),13,10-3,220,179,399,0.551,04/26/2022,2022.0
17,Yale (Ivy League),12,9-3,204,168,372,0.548,04/26/2022,2022.0
18,Duke (ACC),15,10-5,239,199,438,0.546,04/26/2022,2022.0
19,Colgate (Patriot),12,3-9,157,132,289,0.543,04/26/2022,2022.0
20,Stony Brook (America East),13,9-4,195,167,362,0.539,04/26/2022,2022.0
21,Utah (ASUN),11,8-3,162,140,302,0.536,04/26/2022,2022.0
22,Hobart (NEC),10,5-5,161,140,301,0.535,04/26/2022,2022.0
23,Robert Morris (ASUN),12,7-5,181,158,339,0.534,04/26/2022,2022.0
24,Loyola Maryland (Patriot),13,6-7,183,165,348,0.526,04/26/2022,2022.0
25,North Carolina (ACC),13,8-5,187,169,356,0.525,04/26/2022,2022.0
26,Quinnipiac (MAAC),12,2-10,176,160,336,0.524,04/26/2022,2022.0
27,St. Bonaventure (MAAC),12,9-3,145,132,277,0.523,04/26/2022,2022.0
28,Army West Point (Patriot),13,10-3,194,177,371,0.523,04/26/2022,2022.0
29,Richmond (SoCon),12,8-4,175,161,336,0.521,04/26/2022,2022.0
30,Monmouth (MAAC),11,5-6,117,109,226,0.518,04/26/2022,2022.0
31,LIU (NEC),13,6-7,167,159,326,0.512,04/26/2022,2022.0
32,Fairfield (CAA),13,7-6,203,195,398,0.510,04/26/2022,2022.0
33,UMBC (America East),10,4-6,120,119,239,0.502,04/26/2022,2022.0
34,Bucknell (Patriot),13,9-4,189,189,378,0.500,04/26/2022,2022.0
35,UMass Lowell (America East),12,1-11,170,173,343,0.496,04/26/2022,2022.0
36,Mercer (SoCon),14,4-10,188,192,380,0.495,04/26/2022,2022.0
37,Binghamton (America East),12,5-7,160,164,324,0.494,04/26/2022,2022.0
38,Jacksonville (SoCon),15,13-2,209,216,425,0.492,04/26/2022,2022.0
39,Johns Hopkins (Big Ten),14,6-8,182,191,373,0.488,04/26/2022,2022.0
40,Princeton (Ivy League),12,9-3,174,185,359,0.485,04/26/2022,2022.0
41,Penn (Ivy League),11,7-4,141,150,291,0.485,04/26/2022,2022.0
42,Rutgers (Big Ten),14,12-2,202,218,420,0.481,04/26/2022,2022.0
43,Brown (Ivy League),13,9-4,176,191,367,0.480,04/26/2022,2022.0
44,UAlbany (America East),13,5-8,172,188,360,0.478,04/26/2022,2022.0
45,High Point (SoCon),13,7-6,177,194,371,0.477,04/26/2022,2022.0
46,Navy (Patriot),13,8-5,150,166,316,0.475,04/26/2022,2022.0
47,Air Force (ASUN),13,7-6,155,172,327,0.474,04/26/2022,2022.0
48,Mount St. Mary's (NEC),14,5-9,160,178,338,0.473,04/26/2022,2022.0
49,Siena (MAAC),13,5-8,146,164,310,0.471,04/26/2022,2022.0
50,Canisius (MAAC),13,2-11,161,187,348,0.463,04/26/2022,2022.0
51,Cornell (Ivy League),13,10-3,165,195,360,0.458,04/26/2022,2022.0
52,NJIT (America East),12,0-12,134,159,293,0.457,04/26/2022,2022.0
53,Notre Dame (ACC),10,6-4,124,148,272,0.456,04/26/2022,2022.0
54,Hofstra (CAA),14,5-9,152,185,337,0.451,04/26/2022,2022.0
55,Cleveland St. (ASUN),12,3-9,142,173,315,0.451,04/26/2022,2022.0
56,Lafayette (Patriot),14,4-10,184,232,416,0.442,04/26/2022,2022.0
57,Holy Cross (Patriot),13,1-12,163,210,373,0.437,04/26/2022,2022.0
58,Delaware (CAA),13,8-5,161,210,371,0.434,04/26/2022,2022.0
59,Towson (CAA),13,6-7,147,192,339,0.434,04/26/2022,2022.0
60,Penn St. (Big Ten),13,3-10,156,208,364,0.429,04/26/2022,2022.0
61,Marist (MAAC),13,6-7,142,192,334,0.425,04/26/2022,2022.0
62,Providence (Big East),13,5-8,152,210,362,0.420,04/26/2022,2022.0
63,Bellarmine (ASUN),15,4-11,166,232,398,0.417,04/26/2022,2022.0
64,Detroit Mercy (ASUN),10,2-8,110,154,264,0.417,04/26/2022,2022.0
65,VMI (SoCon),13,4-9,141,201,342,0.412,04/26/2022,2022.0
66,Hampton (SoCon),10,0-10,119,170,289,0.412,04/26/2022,2022.0
67,Harvard (Ivy League),11,8-3,122,176,298,0.409,04/26/2022,2022.0
68,Sacred Heart (NEC),12,3-9,138,205,343,0.402,04/26/2022,2022.0
69,Drexel (CAA),12,6-6,134,214,348,0.385,04/26/2022,2022.0
70,Wagner (NEC),11,3-8,86,140,226,0.381,04/26/2022,2022.0
71,St. John's (NY) (Big East),13,2-11,141,247,388,0.363,04/26/2022,2022.0
72,Manhattan (MAAC),12,6-6,84,184,268,0.313,04/26/2022,2022.0
-,Merrimack (NEC),11,6-5,122,129,251,0.486,04/26/2022,2022.0
1,Saint Joseph's (NEC),13,11-2,238,106,344,0.692,04/24/2022,2022.0
2,Lehigh (Patriot),12,7-5,183,101,284,0.644,04/24/2022,2022.0
3,Maryland (Big Ten),12,12-0,244,141,385,0.634,04/24/2022,2022.0
4,Vermont (America East),14,8-6,220,130,350,0.629,04/24/2022,2022.0
5,Georgetown (Big East),13,12-1,219,135,354,0.619,04/24/2022,2022.0
6,Villanova (Big East),12,8-4,204,137,341,0.598,04/24/2022,2022.0
7,Ohio St. (Big Ten),13,9-4,221,150,371,0.596,04/24/2022,2022.0
8,Michigan (Big Ten),14,7-7,235,164,399,0.589,04/24/2022,2022.0
9,Boston U. (Patriot),13,10-3,206,149,355,0.580,04/24/2022,2022.0
10,Marquette (Big East),13,4-9,203,149,352,0.577,04/24/2022,2022.0
11,Syracuse (ACC),13,4-9,234,172,406,0.576,04/24/2022,2022.0
12,Massachusetts (CAA),12,7-5,176,136,312,0.564,04/24/2022,2022.0
13,Denver (Big East),13,8-5,205,161,366,0.560,04/24/2022,2022.0
14,Bryant (NEC),12,7-5,172,136,308,0.558,04/24/2022,2022.0
15,Dartmouth (Ivy League),12,4-8,165,132,297,0.556,04/24/2022,2022.0
16,Virginia (ACC),13,10-3,220,179,399,0.551,04/24/2022,2022.0
17,Yale (Ivy League),11,8-3,183,152,335,0.546,04/24/2022,2022.0
18,Duke (ACC),15,10-5,239,199,438,0.546,04/24/2022,2022.0
19,Colgate (Patriot),12,3-9,157,132,289,0.543,04/24/2022,2022.0
20,Stony Brook (America East),13,9-4,195,167,362,0.539,04/24/2022,2022.0
21,Utah (ASUN),11,8-3,162,140,302,0.536,04/24/2022,2022.0
22,Quinnipiac (MAAC),11,2-9,160,139,299,0.535,04/24/2022,2022.0
23,Hobart (NEC),10,5-5,161,140,301,0.535,04/24/2022,2022.0
24,Robert Morris (ASUN),12,7-5,181,158,339,0.534,04/24/2022,2022.0
25,Loyola Maryland (Patriot),13,6-7,183,165,348,0.526,04/24/2022,2022.0
26,North Carolina (ACC),13,8-5,187,169,356,0.525,04/24/2022,2022.0
27,St. Bonaventure (MAAC),12,9-3,145,132,277,0.523,04/24/2022,2022.0
28,Army West Point (Patriot),13,10-3,194,177,371,0.523,04/24/2022,2022.0
29,Richmond (SoCon),12,8-4,175,161,336,0.521,04/24/2022,2022.0
30,Monmouth (MAAC),11,5-6,117,109,226,0.518,04/24/2022,2022.0
31,LIU (NEC),13,6-7,167,159,326,0.512,04/24/2022,2022.0
32,Fairfield (CAA),13,7-6,203,195,398,0.510,04/24/2022,2022.0
33,UMBC (America East),10,4-6,120,119,239,0.502,04/24/2022,2022.0
34,Bucknell (Patriot),13,9-4,189,189,378,0.500,04/24/2022,2022.0
35,UMass Lowell (America East),12,1-11,170,173,343,0.496,04/24/2022,2022.0
36,Mercer (SoCon),14,4-10,188,192,380,0.495,04/24/2022,2022.0
37,Binghamton (America East),12,5-7,160,164,324,0.494,04/24/2022,2022.0
38,Jacksonville (SoCon),15,13-2,209,216,425,0.492,04/24/2022,2022.0
39,Johns Hopkins (Big Ten),14,6-8,182,191,373,0.488,04/24/2022,2022.0
40,Penn (Ivy League),10,6-4,127,135,262,0.485,04/24/2022,2022.0
41,Princeton (Ivy League),12,9-3,174,185,359,0.485,04/24/2022,2022.0
42,Brown (Ivy League),12,8-4,163,175,338,0.482,04/24/2022,2022.0
43,Rutgers (Big Ten),14,12-2,202,218,420,0.481,04/24/2022,2022.0
44,UAlbany (America East),13,5-8,172,188,360,0.478,04/24/2022,2022.0
45,High Point (SoCon),13,7-6,177,194,371,0.477,04/24/2022,2022.0
46,Navy (Patriot),13,8-5,150,166,316,0.475,04/24/2022,2022.0
47,Air Force (ASUN),13,7-6,155,172,327,0.474,04/24/2022,2022.0
48,Mount St. Mary's (NEC),14,5-9,160,178,338,0.473,04/24/2022,2022.0
49,Siena (MAAC),13,5-8,146,164,310,0.471,04/24/2022,2022.0
50,Canisius (MAAC),13,2-11,161,187,348,0.463,04/24/2022,2022.0
51,Cornell (Ivy League),13,10-3,165,195,360,0.458,04/24/2022,2022.0
52,NJIT (America East),12,0-12,134,159,293,0.457,04/24/2022,2022.0
53,Notre Dame (ACC),10,6-4,124,148,272,0.456,04/24/2022,2022.0
54,Hofstra (CAA),14,5-9,152,185,337,0.451,04/24/2022,2022.0
55,Cleveland St. (ASUN),12,3-9,142,173,315,0.451,04/24/2022,2022.0
56,Lafayette (Patriot),14,4-10,184,232,416,0.442,04/24/2022,2022.0
57,Holy Cross (Patriot),13,1-12,163,210,373,0.437,04/24/2022,2022.0
58,Delaware (CAA),13,8-5,161,210,371,0.434,04/24/2022,2022.0
59,Towson (CAA),13,6-7,147,192,339,0.434,04/24/2022,2022.0
60,Penn St. (Big Ten),13,3-10,156,208,364,0.429,04/24/2022,2022.0
61,Marist (MAAC),13,6-7,142,192,334,0.425,04/24/2022,2022.0
62,Providence (Big East),13,5-8,152,210,362,0.420,04/24/2022,2022.0
63,Bellarmine (ASUN),15,4-11,166,232,398,0.417,04/24/2022,2022.0
64,Detroit Mercy (ASUN),10,2-8,110,154,264,0.417,04/24/2022,2022.0
65,VMI (SoCon),13,4-9,141,201,342,0.412,04/24/2022,2022.0
66,Hampton (SoCon),10,0-10,119,170,289,0.412,04/24/2022,2022.0
67,Harvard (Ivy League),11,8-3,122,176,298,0.409,04/24/2022,2022.0
68,Sacred Heart (NEC),12,3-9,138,205,343,0.402,04/24/2022,2022.0
69,Drexel (CAA),12,6-6,134,214,348,0.385,04/24/2022,2022.0
70,Wagner (NEC),11,3-8,86,140,226,0.381,04/24/2022,2022.0
71,St. John's (NY) (Big East),13,2-11,141,247,388,0.363,04/24/2022,2022.0
72,Manhattan (MAAC),12,6-6,84,184,268,0.313,04/24/2022,2022.0
-,Merrimack (NEC),11,6-5,122,129,251,0.486,04/24/2022,2022.0
1,Saint Joseph's (NEC),12,10-2,221,100,321,0.688,04/21/2022,2022.0
2,Lehigh (Patriot),11,7-4,175,88,263,0.665,04/21/2022,2022.0
3,Maryland (Big Ten),11,11-0,225,127,352,0.639,04/21/2022,2022.0
4,Vermont (America East),13,7-6,196,124,320,0.613,04/21/2022,2022.0
5,Villanova (Big East),11,7-4,193,126,319,0.605,04/21/2022,2022.0
6,Georgetown (Big East),12,11-1,193,128,321,0.601,04/21/2022,2022.0
7,Michigan (Big Ten),13,7-6,222,148,370,0.600,04/21/2022,2022.0
8,Ohio St. (Big Ten),12,8-4,205,137,342,0.599,04/21/2022,2022.0
9,Marquette (Big East),12,4-8,192,138,330,0.582,04/21/2022,2022.0
10,Syracuse (ACC),12,4-8,213,154,367,0.580,04/21/2022,2022.0
11,Boston U. (Patriot),12,9-3,193,141,334,0.578,04/21/2022,2022.0
12,Denver (Big East),12,7-5,194,150,344,0.564,04/21/2022,2022.0
13,Virginia (ACC),12,9-3,202,158,360,0.561,04/21/2022,2022.0
14,Massachusetts (CAA),11,6-5,160,127,287,0.557,04/21/2022,2022.0
15,Yale (Ivy League),10,7-3,165,136,301,0.548,04/21/2022,2022.0
16,Bryant (NEC),11,6-5,156,129,285,0.547,04/21/2022,2022.0
17,Duke (ACC),15,10-5,239,199,438,0.546,04/21/2022,2022.0
18,Quinnipiac (MAAC),10,2-8,150,127,277,0.542,04/21/2022,2022.0
19,Loyola Maryland (Patriot),12,5-7,175,149,324,0.540,04/21/2022,2022.0
20,Dartmouth (Ivy League),11,4-7,143,123,266,0.538,04/21/2022,2022.0
21,Colgate (Patriot),11,3-8,141,124,265,0.532,04/21/2022,2022.0
22,UMBC (America East),9,4-5,112,99,211,0.531,04/21/2022,2022.0
23,LIU (NEC),12,6-6,149,132,281,0.530,04/21/2022,2022.0
24,Army West Point (Patriot),12,10-2,181,163,344,0.526,04/21/2022,2022.0
25,North Carolina (ACC),13,8-5,187,169,356,0.525,04/21/2022,2022.0
26,Stony Brook (America East),12,8-4,175,159,334,0.524,04/21/2022,2022.0
27,Binghamton (America East),11,5-6,154,140,294,0.524,04/21/2022,2022.0
28,Utah (ASUN),10,7-3,144,131,275,0.524,04/21/2022,2022.0
29,Hobart (NEC),9,4-5,134,122,256,0.523,04/21/2022,2022.0
30,St. Bonaventure (MAAC),11,8-3,133,122,255,0.522,04/21/2022,2022.0
31,Robert Morris (ASUN),11,6-5,164,151,315,0.521,04/21/2022,2022.0
32,Richmond (SoCon),11,7-4,162,151,313,0.518,04/21/2022,2022.0
33,Fairfield (CAA),12,7-5,192,182,374,0.513,04/21/2022,2022.0
34,Penn (Ivy League),9,5-4,118,113,231,0.511,04/21/2022,2022.0
35,Monmouth (MAAC),10,5-5,104,103,207,0.502,04/21/2022,2022.0
36,Jacksonville (SoCon),14,12-2,199,202,401,0.496,04/21/2022,2022.0
37,UMass Lowell (America East),12,1-11,170,173,343,0.496,04/21/2022,2022.0
38,Bucknell (Patriot),12,8-4,168,171,339,0.496,04/21/2022,2022.0
39,Johns Hopkins (Big Ten),13,6-7,168,172,340,0.494,04/21/2022,2022.0
40,Mercer (SoCon),13,4-9,174,182,356,0.489,04/21/2022,2022.0
41,Air Force (ASUN),12,7-5,148,155,303,0.488,04/21/2022,2022.0
42,Brown (Ivy League),11,7-4,153,161,314,0.487,04/21/2022,2022.0
43,Mount St. Mary's (NEC),13,5-8,153,162,315,0.486,04/21/2022,2022.0
44,Princeton (Ivy League),11,9-2,156,167,323,0.483,04/21/2022,2022.0
45,High Point (SoCon),12,7-5,167,181,348,0.480,04/21/2022,2022.0
46,Rutgers (Big Ten),13,11-2,185,204,389,0.476,04/21/2022,2022.0
47,Navy (Patriot),12,7-5,136,153,289,0.471,04/21/2022,2022.0
48,Siena (MAAC),12,4-8,135,152,287,0.470,04/21/2022,2022.0
49,NJIT (America East),11,0-11,125,143,268,0.466,04/21/2022,2022.0
50,UAlbany (America East),11,4-7,140,161,301,0.465,04/21/2022,2022.0
51,Hofstra (CAA),13,5-8,143,169,312,0.458,04/21/2022,2022.0
52,Notre Dame (ACC),10,6-4,124,148,272,0.456,04/21/2022,2022.0
53,Canisius (MAAC),12,2-10,149,178,327,0.456,04/21/2022,2022.0
54,Cornell (Ivy League),12,10-2,151,185,336,0.449,04/21/2022,2022.0
55,Lafayette (Patriot),13,4-9,166,211,377,0.440,04/21/2022,2022.0
56,Cleveland St. (ASUN),11,3-8,125,161,286,0.437,04/21/2022,2022.0
57,Holy Cross (Patriot),12,1-11,151,199,350,0.431,04/21/2022,2022.0
58,Penn St. (Big Ten),12,3-9,142,191,333,0.426,04/21/2022,2022.0
59,Towson (CAA),12,5-7,134,181,315,0.425,04/21/2022,2022.0
60,Marist (MAAC),12,5-7,133,180,313,0.425,04/21/2022,2022.0
61,Bellarmine (ASUN),14,4-10,157,214,371,0.423,04/21/2022,2022.0
62,Delaware (CAA),12,7-5,143,195,338,0.423,04/21/2022,2022.0
63,Detroit Mercy (ASUN),9,1-8,98,137,235,0.417,04/21/2022,2022.0
64,Hampton (SoCon),9,0-9,108,151,259,0.417,04/21/2022,2022.0
65,Providence (Big East),12,5-7,141,199,340,0.415,04/21/2022,2022.0
66,Sacred Heart (NEC),11,3-8,132,188,320,0.413,04/21/2022,2022.0
67,Harvard (Ivy League),10,7-3,104,158,262,0.397,04/21/2022,2022.0
68,VMI (SoCon),12,3-9,122,190,312,0.391,04/21/2022,2022.0
69,Drexel (CAA),11,6-5,119,196,315,0.378,04/21/2022,2022.0
70,St. John's (NY) (Big East),12,2-10,134,221,355,0.377,04/21/2022,2022.0
71,Wagner (NEC),10,3-7,74,134,208,0.356,04/21/2022,2022.0
72,Manhattan (MAAC),11,5-6,78,171,249,0.313,04/21/2022,2022.0
-,Merrimack (NEC),10,5-5,116,117,233,0.498,04/21/2022,2022.0
1,Saint Joseph's (NEC),12,10-2,221,100,321,0.688,04/20/2022,2022.0
2,Lehigh (Patriot),11,7-4,175,88,263,0.665,04/20/2022,2022.0
3,Maryland (Big Ten),11,11-0,225,127,352,0.639,04/20/2022,2022.0
4,Vermont (America East),13,7-6,196,124,320,0.613,04/20/2022,2022.0
5,Villanova (Big East),11,7-4,193,126,319,0.605,04/20/2022,2022.0
6,Georgetown (Big East),12,11-1,193,128,321,0.601,04/20/2022,2022.0
7,Michigan (Big Ten),13,7-6,222,148,370,0.600,04/20/2022,2022.0
8,Ohio St. (Big Ten),12,8-4,205,137,342,0.599,04/20/2022,2022.0
9,Marquette (Big East),12,4-8,192,138,330,0.582,04/20/2022,2022.0
10,Syracuse (ACC),12,4-8,213,154,367,0.580,04/20/2022,2022.0
11,Boston U. (Patriot),12,9-3,193,141,334,0.578,04/20/2022,2022.0
12,Denver (Big East),12,7-5,194,150,344,0.564,04/20/2022,2022.0
13,Virginia (ACC),12,9-3,202,158,360,0.561,04/20/2022,2022.0
14,Massachusetts (CAA),11,6-5,160,127,287,0.557,04/20/2022,2022.0
15,Yale (Ivy League),10,7-3,165,136,301,0.548,04/20/2022,2022.0
16,Bryant (NEC),11,6-5,156,129,285,0.547,04/20/2022,2022.0
17,Duke (ACC),15,10-5,239,199,438,0.546,04/20/2022,2022.0
18,Quinnipiac (MAAC),10,2-8,150,127,277,0.542,04/20/2022,2022.0
19,Loyola Maryland (Patriot),12,5-7,175,149,324,0.540,04/20/2022,2022.0
20,Dartmouth (Ivy League),11,4-7,143,123,266,0.538,04/20/2022,2022.0
21,North Carolina (ACC),12,8-4,180,156,336,0.536,04/20/2022,2022.0
22,Colgate (Patriot),11,3-8,141,124,265,0.532,04/20/2022,2022.0
23,UMBC (America East),9,4-5,112,99,211,0.531,04/20/2022,2022.0
24,LIU (NEC),12,6-6,149,132,281,0.530,04/20/2022,2022.0
25,Army West Point (Patriot),12,10-2,181,163,344,0.526,04/20/2022,2022.0
26,Stony Brook (America East),12,8-4,175,159,334,0.524,04/20/2022,2022.0
27,Binghamton (America East),11,5-6,154,140,294,0.524,04/20/2022,2022.0
28,Utah (ASUN),10,7-3,144,131,275,0.524,04/20/2022,2022.0
29,Hobart (NEC),9,4-5,134,122,256,0.523,04/20/2022,2022.0
30,St. Bonaventure (MAAC),11,8-3,133,122,255,0.522,04/20/2022,2022.0
31,Robert Morris (ASUN),11,6-5,164,151,315,0.521,04/20/2022,2022.0
32,Richmond (SoCon),11,7-4,162,151,313,0.518,04/20/2022,2022.0
33,Fairfield (CAA),12,7-5,192,182,374,0.513,04/20/2022,2022.0
34,Penn (Ivy League),9,5-4,118,113,231,0.511,04/20/2022,2022.0
35,Monmouth (MAAC),10,5-5,104,103,207,0.502,04/20/2022,2022.0
36,Jacksonville (SoCon),14,12-2,199,202,401,0.496,04/20/2022,2022.0
37,UMass Lowell (America East),12,1-11,170,173,343,0.496,04/20/2022,2022.0
38,Bucknell (Patriot),12,8-4,168,171,339,0.496,04/20/2022,2022.0
39,Johns Hopkins (Big Ten),13,6-7,168,172,340,0.494,04/20/2022,2022.0
40,Mercer (SoCon),13,4-9,174,182,356,0.489,04/20/2022,2022.0
41,Air Force (ASUN),12,7-5,148,155,303,0.488,04/20/2022,2022.0
42,Brown (Ivy League),11,7-4,153,161,314,0.487,04/20/2022,2022.0
43,Mount St. Mary's (NEC),13,5-8,153,162,315,0.486,04/20/2022,2022.0
44,Princeton (Ivy League),11,9-2,156,167,323,0.483,04/20/2022,2022.0
45,High Point (SoCon),12,7-5,167,181,348,0.480,04/20/2022,2022.0
46,Rutgers (Big Ten),13,11-2,185,204,389,0.476,04/20/2022,2022.0
47,Navy (Patriot),12,7-5,136,153,289,0.471,04/20/2022,2022.0
48,Siena (MAAC),12,4-8,135,152,287,0.470,04/20/2022,2022.0
49,NJIT (America East),11,0-11,125,143,268,0.466,04/20/2022,2022.0
50,UAlbany (America East),11,4-7,140,161,301,0.465,04/20/2022,2022.0
51,Hofstra (CAA),13,5-8,143,169,312,0.458,04/20/2022,2022.0
52,Canisius (MAAC),12,2-10,149,178,327,0.456,04/20/2022,2022.0
53,Cornell (Ivy League),12,10-2,151,185,336,0.449,04/20/2022,2022.0
54,Notre Dame (ACC),9,5-4,111,141,252,0.440,04/20/2022,2022.0
55,Lafayette (Patriot),13,4-9,166,211,377,0.440,04/20/2022,2022.0
56,Cleveland St. (ASUN),11,3-8,125,161,286,0.437,04/20/2022,2022.0
57,Holy Cross (Patriot),12,1-11,151,199,350,0.431,04/20/2022,2022.0
58,Penn St. (Big Ten),12,3-9,142,191,333,0.426,04/20/2022,2022.0
59,Towson (CAA),12,5-7,134,181,315,0.425,04/20/2022,2022.0
60,Marist (MAAC),12,5-7,133,180,313,0.425,04/20/2022,2022.0
61,Bellarmine (ASUN),14,4-10,157,214,371,0.423,04/20/2022,2022.0
62,Delaware (CAA),12,7-5,143,195,338,0.423,04/20/2022,2022.0
63,Detroit Mercy (ASUN),9,1-8,98,137,235,0.417,04/20/2022,2022.0
64,Hampton (SoCon),9,0-9,108,151,259,0.417,04/20/2022,2022.0
65,Providence (Big East),12,5-7,141,199,340,0.415,04/20/2022,2022.0
66,Sacred Heart (NEC),11,3-8,132,188,320,0.413,04/20/2022,2022.0
67,Harvard (Ivy League),10,7-3,104,158,262,0.397,04/20/2022,2022.0
68,VMI (SoCon),12,3-9,122,190,312,0.391,04/20/2022,2022.0
69,Drexel (CAA),11,6-5,119,196,315,0.378,04/20/2022,2022.0
70,St. John's (NY) (Big East),12,2-10,134,221,355,0.377,04/20/2022,2022.0
71,Wagner (NEC),10,3-7,74,134,208,0.356,04/20/2022,2022.0
72,Manhattan (MAAC),11,5-6,78,171,249,0.313,04/20/2022,2022.0
-,Merrimack (NEC),10,5-5,116,117,233,0.498,04/20/2022,2022.0
1,Saint Joseph's (NEC),12,10-2,221,100,321,0.688,04/19/2022,2022.0
2,Lehigh (Patriot),11,7-4,175,88,263,0.665,04/19/2022,2022.0
3,Maryland (Big Ten),11,11-0,225,127,352,0.639,04/19/2022,2022.0
4,Vermont (America East),13,7-6,196,124,320,0.613,04/19/2022,2022.0
5,Villanova (Big East),11,7-4,193,126,319,0.605,04/19/2022,2022.0
6,Georgetown (Big East),12,11-1,193,128,321,0.601,04/19/2022,2022.0
7,Michigan (Big Ten),13,7-6,222,148,370,0.600,04/19/2022,2022.0
8,Ohio St. (Big Ten),12,8-4,205,137,342,0.599,04/19/2022,2022.0
9,Marquette (Big East),12,4-8,192,138,330,0.582,04/19/2022,2022.0
10,Syracuse (ACC),12,4-8,213,154,367,0.580,04/19/2022,2022.0
11,Boston U. (Patriot),12,9-3,193,141,334,0.578,04/19/2022,2022.0
12,Denver (Big East),12,7-5,194,150,344,0.564,04/19/2022,2022.0
13,Virginia (ACC),12,9-3,202,158,360,0.561,04/19/2022,2022.0
14,Massachusetts (CAA),11,6-5,160,127,287,0.557,04/19/2022,2022.0
15,Yale (Ivy League),10,7-3,165,136,301,0.548,04/19/2022,2022.0
16,Bryant (NEC),11,6-5,156,129,285,0.547,04/19/2022,2022.0
17,Duke (ACC),15,10-5,239,199,438,0.546,04/19/2022,2022.0
18,Quinnipiac (MAAC),10,2-8,150,127,277,0.542,04/19/2022,2022.0
19,Loyola Maryland (Patriot),12,5-7,175,149,324,0.540,04/19/2022,2022.0
20,Dartmouth (Ivy League),11,4-7,143,123,266,0.538,04/19/2022,2022.0
21,North Carolina (ACC),12,8-4,180,156,336,0.536,04/19/2022,2022.0
22,Colgate (Patriot),11,3-8,141,124,265,0.532,04/19/2022,2022.0
23,UMBC (America East),9,4-5,112,99,211,0.531,04/19/2022,2022.0
24,LIU (NEC),12,6-6,149,132,281,0.530,04/19/2022,2022.0
25,Army West Point (Patriot),12,10-2,181,163,344,0.526,04/19/2022,2022.0
26,Stony Brook (America East),12,8-4,175,159,334,0.524,04/19/2022,2022.0
27,Binghamton (America East),11,5-6,154,140,294,0.524,04/19/2022,2022.0
28,Utah (ASUN),10,7-3,144,131,275,0.524,04/19/2022,2022.0
29,Hobart (NEC),9,4-5,134,122,256,0.523,04/19/2022,2022.0
30,St. Bonaventure (MAAC),11,8-3,133,122,255,0.522,04/19/2022,2022.0
31,Robert Morris (ASUN),11,6-5,164,151,315,0.521,04/19/2022,2022.0
32,Richmond (SoCon),11,7-4,162,151,313,0.518,04/19/2022,2022.0
33,Fairfield (CAA),12,7-5,192,182,374,0.513,04/19/2022,2022.0
34,Penn (Ivy League),9,5-4,118,113,231,0.511,04/19/2022,2022.0
35,Monmouth (MAAC),10,5-5,104,103,207,0.502,04/19/2022,2022.0
36,Jacksonville (SoCon),14,12-2,199,202,401,0.496,04/19/2022,2022.0
37,Bucknell (Patriot),12,8-4,168,171,339,0.496,04/19/2022,2022.0
38,Johns Hopkins (Big Ten),13,6-7,168,172,340,0.494,04/19/2022,2022.0
39,UMass Lowell (America East),11,1-10,154,158,312,0.494,04/19/2022,2022.0
40,Mercer (SoCon),13,4-9,174,182,356,0.489,04/19/2022,2022.0
41,Air Force (ASUN),12,7-5,148,155,303,0.488,04/19/2022,2022.0
42,Brown (Ivy League),11,7-4,153,161,314,0.487,04/19/2022,2022.0
43,Mount St. Mary's (NEC),13,5-8,153,162,315,0.486,04/19/2022,2022.0
44,Princeton (Ivy League),11,9-2,156,167,323,0.483,04/19/2022,2022.0
45,High Point (SoCon),12,7-5,167,181,348,0.480,04/19/2022,2022.0
46,Rutgers (Big Ten),13,11-2,185,204,389,0.476,04/19/2022,2022.0
47,Navy (Patriot),12,7-5,136,153,289,0.471,04/19/2022,2022.0
48,Siena (MAAC),12,4-8,135,152,287,0.470,04/19/2022,2022.0
49,NJIT (America East),11,0-11,125,143,268,0.466,04/19/2022,2022.0
50,UAlbany (America East),11,4-7,140,161,301,0.465,04/19/2022,2022.0
51,Hofstra (CAA),13,5-8,143,169,312,0.458,04/19/2022,2022.0
52,Canisius (MAAC),12,2-10,149,178,327,0.456,04/19/2022,2022.0
53,Cornell (Ivy League),12,10-2,151,185,336,0.449,04/19/2022,2022.0
54,Notre Dame (ACC),9,5-4,111,141,252,0.440,04/19/2022,2022.0
55,Lafayette (Patriot),13,4-9,166,211,377,0.440,04/19/2022,2022.0
56,Cleveland St. (ASUN),11,3-8,125,161,286,0.437,04/19/2022,2022.0
57,Penn St. (Big Ten),12,3-9,142,191,333,0.426,04/19/2022,2022.0
58,Holy Cross (Patriot),11,0-11,136,183,319,0.426,04/19/2022,2022.0
59,Towson (CAA),12,5-7,134,181,315,0.425,04/19/2022,2022.0
60,Marist (MAAC),12,5-7,133,180,313,0.425,04/19/2022,2022.0
61,Bellarmine (ASUN),14,4-10,157,214,371,0.423,04/19/2022,2022.0
62,Delaware (CAA),12,7-5,143,195,338,0.423,04/19/2022,2022.0
63,Detroit Mercy (ASUN),9,1-8,98,137,235,0.417,04/19/2022,2022.0
64,Hampton (SoCon),9,0-9,108,151,259,0.417,04/19/2022,2022.0
65,Providence (Big East),12,5-7,141,199,340,0.415,04/19/2022,2022.0
66,Sacred Heart (NEC),11,3-8,132,188,320,0.413,04/19/2022,2022.0
67,Harvard (Ivy League),10,7-3,104,158,262,0.397,04/19/2022,2022.0
68,VMI (SoCon),12,3-9,122,190,312,0.391,04/19/2022,2022.0
69,Drexel (CAA),11,6-5,119,196,315,0.378,04/19/2022,2022.0
70,St. John's (NY) (Big East),12,2-10,134,221,355,0.377,04/19/2022,2022.0
71,Wagner (NEC),10,3-7,74,134,208,0.356,04/19/2022,2022.0
72,Manhattan (MAAC),11,5-6,78,171,249,0.313,04/19/2022,2022.0
-,Merrimack (NEC),10,5-5,116,117,233,0.498,04/19/2022,2022.0
1,Saint Joseph's (NEC),12,10-2,221,100,321,0.688,04/17/2022,2022.0
2,Lehigh (Patriot),11,7-4,175,88,263,0.665,04/17/2022,2022.0
3,Maryland (Big Ten),11,11-0,225,127,352,0.639,04/17/2022,2022.0
4,Vermont (America East),13,7-6,196,124,320,0.613,04/17/2022,2022.0
5,Georgetown (Big East),11,10-1,180,117,297,0.606,04/17/2022,2022.0
6,Villanova (Big East),11,7-4,193,126,319,0.605,04/17/2022,2022.0
7,Michigan (Big Ten),13,7-6,222,148,370,0.600,04/17/2022,2022.0
8,Ohio St. (Big Ten),12,8-4,205,137,342,0.599,04/17/2022,2022.0
9,Marquette (Big East),12,4-8,192,138,330,0.582,04/17/2022,2022.0
10,Syracuse (ACC),12,4-8,213,154,367,0.580,04/17/2022,2022.0
11,Boston U. (Patriot),12,9-3,193,141,334,0.578,04/17/2022,2022.0
12,Denver (Big East),12,7-5,194,150,344,0.564,04/17/2022,2022.0
13,Virginia (ACC),12,9-3,202,158,360,0.561,04/17/2022,2022.0
14,Massachusetts (CAA),11,6-5,160,127,287,0.557,04/17/2022,2022.0
15,Yale (Ivy League),10,7-3,165,136,301,0.548,04/17/2022,2022.0
16,Bryant (NEC),11,6-5,156,129,285,0.547,04/17/2022,2022.0
17,Loyola Maryland (Patriot),11,5-6,164,136,300,0.547,04/17/2022,2022.0
18,Duke (ACC),15,10-5,239,199,438,0.546,04/17/2022,2022.0
19,Quinnipiac (MAAC),10,2-8,150,127,277,0.542,04/17/2022,2022.0
20,Dartmouth (Ivy League),11,4-7,143,123,266,0.538,04/17/2022,2022.0
21,North Carolina (ACC),12,8-4,180,156,336,0.536,04/17/2022,2022.0
22,Colgate (Patriot),11,3-8,141,124,265,0.532,04/17/2022,2022.0
23,UMBC (America East),9,4-5,112,99,211,0.531,04/17/2022,2022.0
24,LIU (NEC),12,6-6,149,132,281,0.530,04/17/2022,2022.0
25,Army West Point (Patriot),12,10-2,181,163,344,0.526,04/17/2022,2022.0
26,Stony Brook (America East),12,8-4,175,159,334,0.524,04/17/2022,2022.0
27,Utah (ASUN),10,7-3,144,131,275,0.524,04/17/2022,2022.0
28,Hobart (NEC),9,4-5,134,122,256,0.523,04/17/2022,2022.0
29,St. Bonaventure (MAAC),11,8-3,133,122,255,0.522,04/17/2022,2022.0
30,Robert Morris (ASUN),11,6-5,164,151,315,0.521,04/17/2022,2022.0
31,Richmond (SoCon),11,7-4,162,151,313,0.518,04/17/2022,2022.0
32,Binghamton (America East),10,4-6,137,128,265,0.517,04/17/2022,2022.0
33,Fairfield (CAA),12,7-5,192,182,374,0.513,04/17/2022,2022.0
34,Penn (Ivy League),9,5-4,118,113,231,0.511,04/17/2022,2022.0
35,Monmouth (MAAC),10,5-5,104,103,207,0.502,04/17/2022,2022.0
36,Jacksonville (SoCon),14,12-2,199,202,401,0.496,04/17/2022,2022.0
37,Bucknell (Patriot),12,8-4,168,171,339,0.496,04/17/2022,2022.0
38,Johns Hopkins (Big Ten),13,6-7,168,172,340,0.494,04/17/2022,2022.0
39,UMass Lowell (America East),11,1-10,154,158,312,0.494,04/17/2022,2022.0
40,Mercer (SoCon),13,4-9,174,182,356,0.489,04/17/2022,2022.0
41,Air Force (ASUN),12,7-5,148,155,303,0.488,04/17/2022,2022.0
42,Brown (Ivy League),11,7-4,153,161,314,0.487,04/17/2022,2022.0
43,Mount St. Mary's (NEC),13,5-8,153,162,315,0.486,04/17/2022,2022.0
44,Princeton (Ivy League),11,9-2,156,167,323,0.483,04/17/2022,2022.0
45,High Point (SoCon),12,7-5,167,181,348,0.480,04/17/2022,2022.0
46,Rutgers (Big Ten),13,11-2,185,204,389,0.476,04/17/2022,2022.0
47,NJIT (America East),10,0-10,113,126,239,0.473,04/17/2022,2022.0
48,Navy (Patriot),12,7-5,136,153,289,0.471,04/17/2022,2022.0
49,Siena (MAAC),12,4-8,135,152,287,0.470,04/17/2022,2022.0
50,UAlbany (America East),11,4-7,140,161,301,0.465,04/17/2022,2022.0
51,Hofstra (CAA),13,5-8,143,169,312,0.458,04/17/2022,2022.0
52,Canisius (MAAC),12,2-10,149,178,327,0.456,04/17/2022,2022.0
53,Cornell (Ivy League),12,10-2,151,185,336,0.449,04/17/2022,2022.0
54,Notre Dame (ACC),9,5-4,111,141,252,0.440,04/17/2022,2022.0
55,Lafayette (Patriot),13,4-9,166,211,377,0.440,04/17/2022,2022.0
56,Cleveland St. (ASUN),11,3-8,125,161,286,0.437,04/17/2022,2022.0
57,Penn St. (Big Ten),12,3-9,142,191,333,0.426,04/17/2022,2022.0
58,Holy Cross (Patriot),11,0-11,136,183,319,0.426,04/17/2022,2022.0
59,Towson (CAA),12,5-7,134,181,315,0.425,04/17/2022,2022.0
60,Bellarmine (ASUN),14,4-10,157,214,371,0.423,04/17/2022,2022.0
61,Delaware (CAA),12,7-5,143,195,338,0.423,04/17/2022,2022.0
62,Marist (MAAC),12,5-7,131,182,313,0.419,04/17/2022,2022.0
63,Detroit Mercy (ASUN),9,1-8,98,137,235,0.417,04/17/2022,2022.0
64,Hampton (SoCon),9,0-9,108,151,259,0.417,04/17/2022,2022.0
65,Providence (Big East),12,5-7,141,199,340,0.415,04/17/2022,2022.0
66,Sacred Heart (NEC),11,3-8,132,188,320,0.413,04/17/2022,2022.0
67,Harvard (Ivy League),10,7-3,104,158,262,0.397,04/17/2022,2022.0
68,VMI (SoCon),12,3-9,122,190,312,0.391,04/17/2022,2022.0
69,Drexel (CAA),11,6-5,119,196,315,0.378,04/17/2022,2022.0
70,St. John's (NY) (Big East),12,2-10,134,221,355,0.377,04/17/2022,2022.0
71,Wagner (NEC),10,3-7,74,134,208,0.356,04/17/2022,2022.0
72,Manhattan (MAAC),11,5-6,80,169,249,0.321,04/17/2022,2022.0
-,Merrimack (NEC),10,5-5,116,117,233,0.498,04/17/2022,2022.0
1,Saint Joseph's (NEC),11,9-2,206,88,294,0.701,04/14/2022,2022.0
2,Lehigh (Patriot),10,7-3,162,82,244,0.664,04/14/2022,2022.0
3,Maryland (Big Ten),10,10-0,205,112,317,0.647,04/14/2022,2022.0
4,Vermont (America East),12,6-6,187,111,298,0.628,04/14/2022,2022.0
5,Georgetown (Big East),10,9-1,163,100,263,0.620,04/14/2022,2022.0
6,Ohio St. (Big Ten),11,8-3,190,117,307,0.619,04/14/2022,2022.0
7,Villanova (Big East),10,6-4,171,113,284,0.602,04/14/2022,2022.0
8,Boston U. (Patriot),11,8-3,183,124,307,0.596,04/14/2022,2022.0
9,Marquette (Big East),11,4-7,175,121,296,0.591,04/14/2022,2022.0
10,Michigan (Big Ten),12,7-5,201,139,340,0.591,04/14/2022,2022.0
11,Quinnipiac (MAAC),9,2-7,142,101,243,0.584,04/14/2022,2022.0
12,Syracuse (ACC),11,4-7,195,142,337,0.579,04/14/2022,2022.0
13,Denver (Big East),11,6-5,175,143,318,0.550,04/14/2022,2022.0
14,North Carolina (ACC),11,7-4,168,138,306,0.549,04/14/2022,2022.0
15,Colgate (Patriot),10,2-8,135,111,246,0.549,04/14/2022,2022.0
16,UMBC (America East),8,3-5,104,86,190,0.547,04/14/2022,2022.0
17,Duke (ACC),15,10-5,239,199,438,0.546,04/14/2022,2022.0
18,Massachusetts (CAA),10,6-4,139,116,255,0.545,04/14/2022,2022.0
19,Yale (Ivy League),9,7-2,144,121,265,0.543,04/14/2022,2022.0
20,Virginia (ACC),11,8-3,176,150,326,0.540,04/14/2022,2022.0
21,LIU (NEC),11,6-5,137,117,254,0.539,04/14/2022,2022.0
22,Loyola Maryland (Patriot),10,5-5,147,126,273,0.538,04/14/2022,2022.0
23,Bryant (NEC),10,5-5,133,118,251,0.530,04/14/2022,2022.0
24,Robert Morris (ASUN),10,6-4,151,134,285,0.530,04/14/2022,2022.0
25,Fairfield (CAA),11,6-5,181,161,342,0.529,04/14/2022,2022.0
26,Dartmouth (Ivy League),10,4-6,126,115,241,0.523,04/14/2022,2022.0
27,Binghamton (America East),9,4-5,131,120,251,0.522,04/14/2022,2022.0
28,Stony Brook (America East),11,7-4,167,153,320,0.522,04/14/2022,2022.0
29,Richmond (SoCon),10,6-4,145,133,278,0.522,04/14/2022,2022.0
30,Utah (ASUN),9,6-3,127,118,245,0.518,04/14/2022,2022.0
31,St. Bonaventure (MAAC),10,8-2,117,109,226,0.518,04/14/2022,2022.0
32,Hobart (NEC),8,3-5,119,112,231,0.515,04/14/2022,2022.0
33,Army West Point (Patriot),11,9-2,161,152,313,0.514,04/14/2022,2022.0
34,Monmouth (MAAC),9,4-5,97,98,195,0.497,04/14/2022,2022.0
35,Princeton (Ivy League),10,8-2,148,150,298,0.497,04/14/2022,2022.0
36,Brown (Ivy League),10,6-4,138,140,278,0.496,04/14/2022,2022.0
37,Rutgers (Big Ten),12,10-2,176,183,359,0.490,04/14/2022,2022.0
38,Mercer (SoCon),12,4-8,156,165,321,0.486,04/14/2022,2022.0
39,UMass Lowell (America East),10,1-9,141,150,291,0.485,04/14/2022,2022.0
40,Penn (Ivy League),8,4-4,100,109,209,0.478,04/14/2022,2022.0
41,Bucknell (Patriot),11,7-4,145,160,305,0.475,04/14/2022,2022.0
42,Air Force (ASUN),11,6-5,133,147,280,0.475,04/14/2022,2022.0
43,Siena (MAAC),11,3-8,122,136,258,0.473,04/14/2022,2022.0
44,NJIT (America East),10,0-10,113,126,239,0.473,04/14/2022,2022.0
45,Johns Hopkins (Big Ten),12,5-7,148,166,314,0.471,04/14/2022,2022.0
46,High Point (SoCon),11,6-5,147,167,314,0.468,04/14/2022,2022.0
47,Navy (Patriot),11,6-5,127,145,272,0.467,04/14/2022,2022.0
48,Mount St. Mary's (NEC),12,4-8,139,159,298,0.466,04/14/2022,2022.0
49,Hofstra (CAA),12,5-7,135,156,291,0.464,04/14/2022,2022.0
50,Jacksonville (SoCon),12,10-2,154,180,334,0.461,04/14/2022,2022.0
51,Cornell (Ivy League),11,10-1,140,165,305,0.459,04/14/2022,2022.0
52,Canisius (MAAC),11,2-9,144,171,315,0.457,04/14/2022,2022.0
53,UAlbany (America East),10,4-6,127,152,279,0.455,04/14/2022,2022.0
54,Cleveland St. (ASUN),10,3-7,117,146,263,0.445,04/14/2022,2022.0
55,Penn St. (Big Ten),11,3-8,136,171,307,0.443,04/14/2022,2022.0
56,Notre Dame (ACC),9,5-4,111,141,252,0.440,04/14/2022,2022.0
57,Lafayette (Patriot),12,4-8,158,202,360,0.439,04/14/2022,2022.0
58,Holy Cross (Patriot),10,0-10,125,160,285,0.439,04/14/2022,2022.0
59,Sacred Heart (NEC),10,3-7,121,165,286,0.423,04/14/2022,2022.0
60,Hampton (SoCon),7,0-7,81,111,192,0.422,04/14/2022,2022.0
61,Delaware (CAA),11,6-5,132,181,313,0.422,04/14/2022,2022.0
62,Providence (Big East),11,5-6,128,177,305,0.420,04/14/2022,2022.0
63,Bellarmine (ASUN),13,3-10,145,201,346,0.419,04/14/2022,2022.0
64,Harvard (Ivy League),9,7-2,100,140,240,0.417,04/14/2022,2022.0
65,Towson (CAA),11,5-6,120,170,290,0.414,04/14/2022,2022.0
66,Marist (MAAC),11,4-7,116,169,285,0.407,04/14/2022,2022.0
67,VMI (SoCon),11,3-8,113,165,278,0.406,04/14/2022,2022.0
68,Detroit Mercy (ASUN),8,1-7,85,125,210,0.405,04/14/2022,2022.0
69,St. John's (NY) (Big East),11,2-9,127,202,329,0.386,04/14/2022,2022.0
70,Wagner (NEC),9,3-6,71,120,191,0.372,04/14/2022,2022.0
71,Drexel (CAA),10,5-5,106,188,294,0.361,04/14/2022,2022.0
72,Manhattan (MAAC),10,5-5,67,154,221,0.303,04/14/2022,2022.0
-,Merrimack (NEC),9,5-4,106,102,208,0.510,04/14/2022,2022.0
1,Saint Joseph's (NEC),11,9-2,206,88,294,0.701,04/12/2022,2022.0
2,Lehigh (Patriot),10,7-3,162,82,244,0.664,04/12/2022,2022.0
3,Maryland (Big Ten),10,10-0,205,112,317,0.647,04/12/2022,2022.0
4,Vermont (America East),12,6-6,187,111,298,0.628,04/12/2022,2022.0
5,Georgetown (Big East),10,9-1,163,100,263,0.620,04/12/2022,2022.0
6,Ohio St. (Big Ten),11,8-3,190,117,307,0.619,04/12/2022,2022.0
7,Villanova (Big East),10,6-4,171,113,284,0.602,04/12/2022,2022.0
8,Boston U. (Patriot),11,8-3,183,124,307,0.596,04/12/2022,2022.0
9,Marquette (Big East),11,4-7,175,121,296,0.591,04/12/2022,2022.0
10,Michigan (Big Ten),12,7-5,201,139,340,0.591,04/12/2022,2022.0
11,Quinnipiac (MAAC),9,2-7,142,101,243,0.584,04/12/2022,2022.0
12,Syracuse (ACC),11,4-7,195,142,337,0.579,04/12/2022,2022.0
13,Duke (ACC),14,9-5,227,182,409,0.555,04/12/2022,2022.0
14,Denver (Big East),11,6-5,175,143,318,0.550,04/12/2022,2022.0
15,North Carolina (ACC),11,7-4,168,138,306,0.549,04/12/2022,2022.0
16,Colgate (Patriot),10,2-8,135,111,246,0.549,04/12/2022,2022.0
17,UMBC (America East),8,3-5,104,86,190,0.547,04/12/2022,2022.0
18,Massachusetts (CAA),10,6-4,139,116,255,0.545,04/12/2022,2022.0
19,Yale (Ivy League),9,7-2,144,121,265,0.543,04/12/2022,2022.0
20,LIU (NEC),11,6-5,137,117,254,0.539,04/12/2022,2022.0
21,Loyola Maryland (Patriot),10,5-5,147,126,273,0.538,04/12/2022,2022.0
22,Virginia (ACC),10,8-2,159,138,297,0.535,04/12/2022,2022.0
23,Bryant (NEC),10,5-5,133,118,251,0.530,04/12/2022,2022.0
24,Robert Morris (ASUN),10,6-4,151,134,285,0.530,04/12/2022,2022.0
25,Fairfield (CAA),11,6-5,181,161,342,0.529,04/12/2022,2022.0
26,Dartmouth (Ivy League),10,4-6,126,115,241,0.523,04/12/2022,2022.0
27,Binghamton (America East),9,4-5,131,120,251,0.522,04/12/2022,2022.0
28,Stony Brook (America East),11,7-4,167,153,320,0.522,04/12/2022,2022.0
29,Richmond (SoCon),10,6-4,145,133,278,0.522,04/12/2022,2022.0
30,Utah (ASUN),9,6-3,127,118,245,0.518,04/12/2022,2022.0
31,St. Bonaventure (MAAC),10,8-2,117,109,226,0.518,04/12/2022,2022.0
32,Hobart (NEC),8,3-5,119,112,231,0.515,04/12/2022,2022.0
33,Army West Point (Patriot),11,9-2,161,152,313,0.514,04/12/2022,2022.0
34,Monmouth (MAAC),9,4-5,97,98,195,0.497,04/12/2022,2022.0
35,Princeton (Ivy League),10,8-2,148,150,298,0.497,04/12/2022,2022.0
36,Brown (Ivy League),10,6-4,138,140,278,0.496,04/12/2022,2022.0
37,Rutgers (Big Ten),12,10-2,176,183,359,0.490,04/12/2022,2022.0
38,Mercer (SoCon),12,4-8,156,165,321,0.486,04/12/2022,2022.0
39,UMass Lowell (America East),10,1-9,141,150,291,0.485,04/12/2022,2022.0
40,Penn (Ivy League),8,4-4,100,109,209,0.478,04/12/2022,2022.0
41,Bucknell (Patriot),11,7-4,145,160,305,0.475,04/12/2022,2022.0
42,Air Force (ASUN),11,6-5,133,147,280,0.475,04/12/2022,2022.0
43,Siena (MAAC),11,3-8,122,136,258,0.473,04/12/2022,2022.0
44,NJIT (America East),10,0-10,113,126,239,0.473,04/12/2022,2022.0
45,Johns Hopkins (Big Ten),12,5-7,148,166,314,0.471,04/12/2022,2022.0
46,High Point (SoCon),11,6-5,147,167,314,0.468,04/12/2022,2022.0
47,Navy (Patriot),11,6-5,127,145,272,0.467,04/12/2022,2022.0
48,Mount St. Mary's (NEC),12,4-8,139,159,298,0.466,04/12/2022,2022.0
49,Hofstra (CAA),12,5-7,135,156,291,0.464,04/12/2022,2022.0
50,Jacksonville (SoCon),12,10-2,154,180,334,0.461,04/12/2022,2022.0
51,Cornell (Ivy League),11,10-1,140,165,305,0.459,04/12/2022,2022.0
52,Canisius (MAAC),11,2-9,144,171,315,0.457,04/12/2022,2022.0
53,UAlbany (America East),10,4-6,127,152,279,0.455,04/12/2022,2022.0
54,Cleveland St. (ASUN),10,3-7,117,146,263,0.445,04/12/2022,2022.0
55,Penn St. (Big Ten),11,3-8,136,171,307,0.443,04/12/2022,2022.0
56,Notre Dame (ACC),9,5-4,111,141,252,0.440,04/12/2022,2022.0
57,Lafayette (Patriot),12,4-8,158,202,360,0.439,04/12/2022,2022.0
58,Holy Cross (Patriot),10,0-10,125,160,285,0.439,04/12/2022,2022.0
59,Sacred Heart (NEC),10,3-7,121,165,286,0.423,04/12/2022,2022.0
60,Hampton (SoCon),7,0-7,81,111,192,0.422,04/12/2022,2022.0
61,Delaware (CAA),11,6-5,132,181,313,0.422,04/12/2022,2022.0
62,Providence (Big East),11,5-6,128,177,305,0.420,04/12/2022,2022.0
63,Bellarmine (ASUN),13,3-10,145,201,346,0.419,04/12/2022,2022.0
64,Harvard (Ivy League),9,7-2,100,140,240,0.417,04/12/2022,2022.0
65,Towson (CAA),11,5-6,120,170,290,0.414,04/12/2022,2022.0
66,Marist (MAAC),11,4-7,116,169,285,0.407,04/12/2022,2022.0
67,VMI (SoCon),11,3-8,113,165,278,0.406,04/12/2022,2022.0
68,Detroit Mercy (ASUN),8,1-7,85,125,210,0.405,04/12/2022,2022.0
69,St. John's (NY) (Big East),11,2-9,127,202,329,0.386,04/12/2022,2022.0
70,Wagner (NEC),9,3-6,71,120,191,0.372,04/12/2022,2022.0
71,Drexel (CAA),10,5-5,106,188,294,0.361,04/12/2022,2022.0
72,Manhattan (MAAC),10,5-5,67,154,221,0.303,04/12/2022,2022.0
-,Merrimack (NEC),9,5-4,106,102,208,0.510,04/12/2022,2022.0
1,Saint Joseph's (NEC),11,9-2,206,88,294,0.701,04/11/2022,2022.0
2,Lehigh (Patriot),10,7-3,162,82,244,0.664,04/11/2022,2022.0
3,Maryland (Big Ten),10,10-0,205,112,317,0.647,04/11/2022,2022.0
4,Vermont (America East),12,6-6,187,111,298,0.628,04/11/2022,2022.0
5,Georgetown (Big East),10,9-1,163,100,263,0.620,04/11/2022,2022.0
6,Ohio St. (Big Ten),11,8-3,190,117,307,0.619,04/11/2022,2022.0
7,Villanova (Big East),10,6-4,171,113,284,0.602,04/11/2022,2022.0
8,Marquette (Big East),10,4-6,160,106,266,0.602,04/11/2022,2022.0
9,Boston U. (Patriot),11,8-3,183,124,307,0.596,04/11/2022,2022.0
10,Michigan (Big Ten),12,7-5,201,139,340,0.591,04/11/2022,2022.0
11,Quinnipiac (MAAC),9,2-7,142,101,243,0.584,04/11/2022,2022.0
12,Syracuse (ACC),11,4-7,195,143,338,0.577,04/11/2022,2022.0
13,Duke (ACC),14,9-5,227,182,409,0.555,04/11/2022,2022.0
14,Denver (Big East),11,6-5,175,143,318,0.550,04/11/2022,2022.0
15,North Carolina (ACC),11,7-4,168,138,306,0.549,04/11/2022,2022.0
16,Colgate (Patriot),10,2-8,135,111,246,0.549,04/11/2022,2022.0
17,UMBC (America East),8,3-5,104,86,190,0.547,04/11/2022,2022.0
18,Massachusetts (CAA),10,6-4,139,116,255,0.545,04/11/2022,2022.0
19,Yale (Ivy League),9,7-2,144,121,265,0.543,04/11/2022,2022.0
20,LIU (NEC),11,6-5,137,117,254,0.539,04/11/2022,2022.0
21,Loyola Maryland (Patriot),10,5-5,147,126,273,0.538,04/11/2022,2022.0
22,Virginia (ACC),10,8-2,159,138,297,0.535,04/11/2022,2022.0
23,Bryant (NEC),10,5-5,133,118,251,0.530,04/11/2022,2022.0
24,Robert Morris (ASUN),10,6-4,151,134,285,0.530,04/11/2022,2022.0
25,Fairfield (CAA),11,6-5,181,161,342,0.529,04/11/2022,2022.0
26,Dartmouth (Ivy League),10,4-6,126,115,241,0.523,04/11/2022,2022.0
27,Binghamton (America East),9,4-5,131,120,251,0.522,04/11/2022,2022.0
28,Stony Brook (America East),11,7-4,167,153,320,0.522,04/11/2022,2022.0
29,Richmond (SoCon),10,6-4,145,133,278,0.522,04/11/2022,2022.0
30,Utah (ASUN),9,6-3,127,118,245,0.518,04/11/2022,2022.0
31,St. Bonaventure (MAAC),10,8-2,117,109,226,0.518,04/11/2022,2022.0
32,Hobart (NEC),8,3-5,119,112,231,0.515,04/11/2022,2022.0
33,Army West Point (Patriot),11,9-2,161,152,313,0.514,04/11/2022,2022.0
34,Monmouth (MAAC),9,4-5,97,98,195,0.497,04/11/2022,2022.0
35,Princeton (Ivy League),10,8-2,148,150,298,0.497,04/11/2022,2022.0
36,Brown (Ivy League),10,6-4,138,140,278,0.496,04/11/2022,2022.0
37,Rutgers (Big Ten),12,10-2,176,183,359,0.490,04/11/2022,2022.0
38,Mercer (SoCon),12,4-8,156,165,321,0.486,04/11/2022,2022.0
39,UMass Lowell (America East),10,1-9,141,150,291,0.485,04/11/2022,2022.0
40,Penn (Ivy League),8,4-4,100,109,209,0.478,04/11/2022,2022.0
41,Bucknell (Patriot),11,7-4,145,160,305,0.475,04/11/2022,2022.0
42,Air Force (ASUN),11,6-5,133,147,280,0.475,04/11/2022,2022.0
43,Siena (MAAC),11,3-8,122,136,258,0.473,04/11/2022,2022.0
44,Johns Hopkins (Big Ten),12,5-7,148,166,314,0.471,04/11/2022,2022.0
45,NJIT (America East),9,0-9,100,113,213,0.469,04/11/2022,2022.0
46,High Point (SoCon),11,6-5,147,167,314,0.468,04/11/2022,2022.0
47,Navy (Patriot),11,6-5,127,145,272,0.467,04/11/2022,2022.0
48,Mount St. Mary's (NEC),12,4-8,139,159,298,0.466,04/11/2022,2022.0
49,Hofstra (CAA),12,5-7,135,156,291,0.464,04/11/2022,2022.0
50,Jacksonville (SoCon),12,10-2,154,180,334,0.461,04/11/2022,2022.0
51,Cornell (Ivy League),11,10-1,141,165,306,0.461,04/11/2022,2022.0
52,Canisius (MAAC),11,2-9,144,171,315,0.457,04/11/2022,2022.0
53,UAlbany (America East),10,4-6,127,152,279,0.455,04/11/2022,2022.0
54,Cleveland St. (ASUN),10,3-7,117,146,263,0.445,04/11/2022,2022.0
55,Penn St. (Big Ten),11,3-8,136,171,307,0.443,04/11/2022,2022.0
56,Lafayette (Patriot),12,4-8,158,202,360,0.439,04/11/2022,2022.0
57,Holy Cross (Patriot),10,0-10,125,160,285,0.439,04/11/2022,2022.0
58,Notre Dame (ACC),8,4-4,96,126,222,0.432,04/11/2022,2022.0
59,Sacred Heart (NEC),10,3-7,121,165,286,0.423,04/11/2022,2022.0
60,Hampton (SoCon),7,0-7,81,111,192,0.422,04/11/2022,2022.0
61,Delaware (CAA),11,6-5,132,181,313,0.422,04/11/2022,2022.0
62,Providence (Big East),11,5-6,128,177,305,0.420,04/11/2022,2022.0
63,Bellarmine (ASUN),13,3-10,145,201,346,0.419,04/11/2022,2022.0
64,Harvard (Ivy League),9,7-2,100,140,240,0.417,04/11/2022,2022.0
65,Towson (CAA),11,5-6,120,170,290,0.414,04/11/2022,2022.0
66,VMI (SoCon),11,3-8,113,165,278,0.406,04/11/2022,2022.0
67,Detroit Mercy (ASUN),8,1-7,85,125,210,0.405,04/11/2022,2022.0
68,Marist (MAAC),10,3-7,103,156,259,0.398,04/11/2022,2022.0
69,St. John's (NY) (Big East),11,2-9,127,202,329,0.386,04/11/2022,2022.0
70,Wagner (NEC),9,3-6,71,120,191,0.372,04/11/2022,2022.0
71,Drexel (CAA),10,5-5,106,188,294,0.361,04/11/2022,2022.0
72,Manhattan (MAAC),10,5-5,67,154,221,0.303,04/11/2022,2022.0
-,Merrimack (NEC),9,5-4,106,102,208,0.510,04/11/2022,2022.0
1,Saint Joseph's (NEC),11,9-2,206,88,294,0.701,04/10/2022,2022.0
2,Lehigh (Patriot),10,7-3,162,82,244,0.664,04/10/2022,2022.0
3,Maryland (Big Ten),10,10-0,205,112,317,0.647,04/10/2022,2022.0
4,Vermont (America East),12,6-6,187,111,298,0.628,04/10/2022,2022.0
5,Georgetown (Big East),10,9-1,163,100,263,0.620,04/10/2022,2022.0
6,Ohio St. (Big Ten),11,8-3,190,117,307,0.619,04/10/2022,2022.0
7,Villanova (Big East),10,6-4,171,113,284,0.602,04/10/2022,2022.0
8,Marquette (Big East),10,4-6,160,106,266,0.602,04/10/2022,2022.0
9,Boston U. (Patriot),11,8-3,183,124,307,0.596,04/10/2022,2022.0
10,Michigan (Big Ten),12,7-5,201,139,340,0.591,04/10/2022,2022.0
11,Syracuse (ACC),10,4-6,179,125,304,0.589,04/10/2022,2022.0
12,Quinnipiac (MAAC),9,2-7,142,101,243,0.584,04/10/2022,2022.0
13,Duke (ACC),14,9-5,227,182,409,0.555,04/10/2022,2022.0
14,Denver (Big East),11,6-5,175,143,318,0.550,04/10/2022,2022.0
15,North Carolina (ACC),11,7-4,168,138,306,0.549,04/10/2022,2022.0
16,Colgate (Patriot),10,2-8,135,111,246,0.549,04/10/2022,2022.0
17,UMBC (America East),8,3-5,104,86,190,0.547,04/10/2022,2022.0
18,Massachusetts (CAA),10,6-4,139,116,255,0.545,04/10/2022,2022.0
19,Yale (Ivy League),9,7-2,144,121,265,0.543,04/10/2022,2022.0
20,LIU (NEC),11,6-5,137,117,254,0.539,04/10/2022,2022.0
21,Loyola Maryland (Patriot),10,5-5,147,126,273,0.538,04/10/2022,2022.0
22,Virginia (ACC),10,8-2,159,138,297,0.535,04/10/2022,2022.0
23,Bryant (NEC),10,5-5,133,118,251,0.530,04/10/2022,2022.0
24,Robert Morris (ASUN),10,6-4,151,134,285,0.530,04/10/2022,2022.0
25,Fairfield (CAA),11,6-5,181,161,342,0.529,04/10/2022,2022.0
26,Dartmouth (Ivy League),10,4-6,126,115,241,0.523,04/10/2022,2022.0
27,Binghamton (America East),9,4-5,131,120,251,0.522,04/10/2022,2022.0
28,Stony Brook (America East),11,7-4,167,153,320,0.522,04/10/2022,2022.0
29,Richmond (SoCon),10,6-4,145,133,278,0.522,04/10/2022,2022.0
30,Utah (ASUN),9,6-3,127,118,245,0.518,04/10/2022,2022.0
31,St. Bonaventure (MAAC),10,8-2,117,109,226,0.518,04/10/2022,2022.0
32,Hobart (NEC),8,3-5,119,112,231,0.515,04/10/2022,2022.0
33,Army West Point (Patriot),11,9-2,161,152,313,0.514,04/10/2022,2022.0
34,Monmouth (MAAC),9,4-5,97,98,195,0.497,04/10/2022,2022.0
35,Princeton (Ivy League),10,8-2,148,150,298,0.497,04/10/2022,2022.0
36,Brown (Ivy League),10,6-4,138,140,278,0.496,04/10/2022,2022.0
37,Rutgers (Big Ten),12,10-2,176,183,359,0.490,04/10/2022,2022.0
38,Mercer (SoCon),12,4-8,156,165,321,0.486,04/10/2022,2022.0
39,UMass Lowell (America East),10,1-9,141,150,291,0.485,04/10/2022,2022.0
40,Penn (Ivy League),8,4-4,100,109,209,0.478,04/10/2022,2022.0
41,Bucknell (Patriot),11,7-4,145,160,305,0.475,04/10/2022,2022.0
42,Air Force (ASUN),11,6-5,133,147,280,0.475,04/10/2022,2022.0
43,Siena (MAAC),11,3-8,122,136,258,0.473,04/10/2022,2022.0
44,Johns Hopkins (Big Ten),12,5-7,148,166,314,0.471,04/10/2022,2022.0
45,NJIT (America East),9,0-9,100,113,213,0.469,04/10/2022,2022.0
46,High Point (SoCon),11,6-5,147,167,314,0.468,04/10/2022,2022.0
47,Navy (Patriot),11,6-5,127,145,272,0.467,04/10/2022,2022.0
48,Mount St. Mary's (NEC),12,4-8,139,159,298,0.466,04/10/2022,2022.0
49,Hofstra (CAA),12,5-7,135,156,291,0.464,04/10/2022,2022.0
50,Jacksonville (SoCon),12,10-2,154,180,334,0.461,04/10/2022,2022.0
51,Canisius (MAAC),11,2-9,144,171,315,0.457,04/10/2022,2022.0
52,UAlbany (America East),10,4-6,127,152,279,0.455,04/10/2022,2022.0
53,Cornell (Ivy League),10,9-1,123,149,272,0.452,04/10/2022,2022.0
54,Cleveland St. (ASUN),10,3-7,117,146,263,0.445,04/10/2022,2022.0
55,Penn St. (Big Ten),11,3-8,136,171,307,0.443,04/10/2022,2022.0
56,Lafayette (Patriot),12,4-8,158,202,360,0.439,04/10/2022,2022.0
57,Holy Cross (Patriot),10,0-10,125,160,285,0.439,04/10/2022,2022.0
58,Notre Dame (ACC),8,4-4,96,126,222,0.432,04/10/2022,2022.0
59,Sacred Heart (NEC),10,3-7,121,165,286,0.423,04/10/2022,2022.0
60,Hampton (SoCon),7,0-7,81,111,192,0.422,04/10/2022,2022.0
61,Delaware (CAA),11,6-5,132,181,313,0.422,04/10/2022,2022.0
62,Providence (Big East),11,5-6,128,177,305,0.420,04/10/2022,2022.0
63,Bellarmine (ASUN),13,3-10,145,201,346,0.419,04/10/2022,2022.0
64,Harvard (Ivy League),9,7-2,100,140,240,0.417,04/10/2022,2022.0
65,Towson (CAA),11,5-6,120,170,290,0.414,04/10/2022,2022.0
66,VMI (SoCon),11,3-8,113,165,278,0.406,04/10/2022,2022.0
67,Detroit Mercy (ASUN),8,1-7,85,125,210,0.405,04/10/2022,2022.0
68,Marist (MAAC),10,3-7,103,156,259,0.398,04/10/2022,2022.0
69,St. John's (NY) (Big East),11,2-9,127,202,329,0.386,04/10/2022,2022.0
70,Wagner (NEC),9,3-6,71,120,191,0.372,04/10/2022,2022.0
71,Drexel (CAA),10,5-5,106,188,294,0.361,04/10/2022,2022.0
72,Manhattan (MAAC),10,5-5,67,154,221,0.303,04/10/2022,2022.0
-,Merrimack (NEC),9,5-4,106,102,208,0.510,04/10/2022,2022.0
1,Saint Joseph's (NEC),10,8-2,195,76,271,0.720,04/07/2022,2022.0
2,Lehigh (Patriot),9,6-3,142,75,217,0.654,04/07/2022,2022.0
3,Maryland (Big Ten),9,9-0,183,104,287,0.638,04/07/2022,2022.0
4,Ohio St. (Big Ten),10,7-3,175,106,281,0.623,04/07/2022,2022.0
5,Vermont (America East),11,5-6,162,100,262,0.618,04/07/2022,2022.0
6,Boston U. (Patriot),10,8-2,171,113,284,0.602,04/07/2022,2022.0
7,Villanova (Big East),9,6-3,154,104,258,0.597,04/07/2022,2022.0
8,Georgetown (Big East),9,8-1,142,98,240,0.592,04/07/2022,2022.0
9,Michigan (Big Ten),11,7-4,189,131,320,0.591,04/07/2022,2022.0
10,Syracuse (ACC),10,4-6,179,125,304,0.589,04/07/2022,2022.0
11,Marquette (Big East),9,3-6,132,95,227,0.581,04/07/2022,2022.0
12,Quinnipiac (MAAC),8,1-7,122,92,214,0.570,04/07/2022,2022.0
13,Denver (Big East),10,5-5,166,126,292,0.568,04/07/2022,2022.0
14,Colgate (Patriot),9,2-7,124,95,219,0.566,04/07/2022,2022.0
15,Duke (ACC),13,9-4,211,163,374,0.564,04/07/2022,2022.0
16,North Carolina (ACC),10,7-3,159,128,287,0.554,04/07/2022,2022.0
17,LIU (NEC),10,5-5,126,102,228,0.553,04/07/2022,2022.0
18,Dartmouth (Ivy League),9,4-5,115,96,211,0.545,04/07/2022,2022.0
19,Massachusetts (CAA),9,6-3,126,106,232,0.543,04/07/2022,2022.0
20,UMBC (America East),7,2-5,89,75,164,0.543,04/07/2022,2022.0
21,Virginia (ACC),9,7-2,149,129,278,0.536,04/07/2022,2022.0
22,Yale (Ivy League),8,6-2,125,110,235,0.532,04/07/2022,2022.0
23,Fairfield (CAA),10,6-4,160,141,301,0.532,04/07/2022,2022.0
24,Robert Morris (ASUN),9,5-4,138,122,260,0.531,04/07/2022,2022.0
25,Bryant (NEC),9,5-4,121,107,228,0.531,04/07/2022,2022.0
26,Loyola Maryland (Patriot),9,4-5,129,116,245,0.527,04/07/2022,2022.0
27,St. Bonaventure (MAAC),9,7-2,112,101,213,0.526,04/07/2022,2022.0
28,Binghamton (America East),9,4-5,131,120,251,0.522,04/07/2022,2022.0
29,Stony Brook (America East),10,6-4,148,136,284,0.521,04/07/2022,2022.0
30,Rutgers (Big Ten),11,10-1,168,161,329,0.511,04/07/2022,2022.0
31,UMass Lowell (America East),9,1-8,130,125,255,0.510,04/07/2022,2022.0
32,Utah (ASUN),8,5-3,110,106,216,0.509,04/07/2022,2022.0
33,Richmond (SoCon),9,6-3,128,124,252,0.508,04/07/2022,2022.0
34,Army West Point (Patriot),10,8-2,145,141,286,0.507,04/07/2022,2022.0
35,Brown (Ivy League),9,5-4,127,127,254,0.500,04/07/2022,2022.0
35,Hobart (NEC),7,2-5,107,107,214,0.500,04/07/2022,2022.0
37,Princeton (Ivy League),9,7-2,137,138,275,0.498,04/07/2022,2022.0
38,Bucknell (Patriot),10,7-3,138,140,278,0.496,04/07/2022,2022.0
39,Monmouth (MAAC),8,4-4,89,93,182,0.489,04/07/2022,2022.0
40,Navy (Patriot),10,6-4,117,127,244,0.480,04/07/2022,2022.0
41,Johns Hopkins (Big Ten),11,5-6,137,151,288,0.476,04/07/2022,2022.0
42,Mercer (SoCon),11,3-8,137,153,290,0.472,04/07/2022,2022.0
43,Canisius (MAAC),10,2-8,135,151,286,0.472,04/07/2022,2022.0
44,Jacksonville (SoCon),11,9-2,145,163,308,0.471,04/07/2022,2022.0
45,Penn (Ivy League),7,4-3,87,98,185,0.470,04/07/2022,2022.0
46,NJIT (America East),8,0-8,83,94,177,0.469,04/07/2022,2022.0
47,Air Force (ASUN),10,5-5,120,139,259,0.463,04/07/2022,2022.0
48,UAlbany (America East),9,4-5,116,137,253,0.458,04/07/2022,2022.0
49,Mount St. Mary's (NEC),11,4-7,124,148,272,0.456,04/07/2022,2022.0
50,Hofstra (CAA),11,4-7,120,144,264,0.455,04/07/2022,2022.0
51,Cleveland St. (ASUN),9,3-6,105,129,234,0.449,04/07/2022,2022.0
52,Providence (Big East),10,5-5,126,156,282,0.447,04/07/2022,2022.0
53,High Point (SoCon),10,5-5,129,160,289,0.446,04/07/2022,2022.0
54,Holy Cross (Patriot),9,0-9,112,139,251,0.446,04/07/2022,2022.0
55,Penn St. (Big Ten),10,2-8,128,159,287,0.446,04/07/2022,2022.0
56,Siena (MAAC),10,3-7,106,133,239,0.444,04/07/2022,2022.0
57,Cornell (Ivy League),9,8-1,105,138,243,0.432,04/07/2022,2022.0
58,Hampton (SoCon),6,0-6,69,92,161,0.429,04/07/2022,2022.0
59,Sacred Heart (NEC),9,3-6,113,151,264,0.428,04/07/2022,2022.0
60,Harvard (Ivy League),8,7-1,89,122,211,0.422,04/07/2022,2022.0
61,Lafayette (Patriot),11,3-8,137,189,326,0.420,04/07/2022,2022.0
62,Delaware (CAA),10,6-4,120,166,286,0.420,04/07/2022,2022.0
63,VMI (SoCon),10,3-7,106,147,253,0.419,04/07/2022,2022.0
64,Bellarmine (ASUN),12,3-9,133,188,321,0.414,04/07/2022,2022.0
65,Towson (CAA),10,4-6,110,157,267,0.412,04/07/2022,2022.0
66,Notre Dame (ACC),7,3-4,77,110,187,0.412,04/07/2022,2022.0
67,Detroit Mercy (ASUN),7,1-6,77,112,189,0.407,04/07/2022,2022.0
68,St. John's (NY) (Big East),10,2-8,116,174,290,0.400,04/07/2022,2022.0
69,Marist (MAAC),10,3-7,103,156,259,0.398,04/07/2022,2022.0
70,Wagner (NEC),8,3-5,66,108,174,0.379,04/07/2022,2022.0
71,Drexel (CAA),9,4-5,86,167,253,0.340,04/07/2022,2022.0
72,Manhattan (MAAC),9,4-5,64,138,202,0.317,04/07/2022,2022.0
-,Merrimack (NEC),8,4-4,92,94,186,0.495,04/07/2022,2022.0
1,Saint Joseph's (NEC),10,8-2,195,76,271,0.720,04/05/2022,2022.0
2,Lehigh (Patriot),9,6-3,142,75,217,0.654,04/05/2022,2022.0
3,Maryland (Big Ten),9,9-0,183,104,287,0.638,04/05/2022,2022.0
4,Ohio St. (Big Ten),10,7-3,175,106,281,0.623,04/05/2022,2022.0
5,Vermont (America East),11,5-6,162,100,262,0.618,04/05/2022,2022.0
6,Boston U. (Patriot),10,8-2,171,113,284,0.602,04/05/2022,2022.0
7,Villanova (Big East),9,6-3,154,104,258,0.597,04/05/2022,2022.0
8,Georgetown (Big East),9,8-1,142,98,240,0.592,04/05/2022,2022.0
9,Michigan (Big Ten),11,7-4,189,131,320,0.591,04/05/2022,2022.0
10,Syracuse (ACC),9,4-5,161,113,274,0.588,04/05/2022,2022.0
11,Marquette (Big East),9,3-6,132,95,227,0.581,04/05/2022,2022.0
12,Quinnipiac (MAAC),8,1-7,122,92,214,0.570,04/05/2022,2022.0
13,Denver (Big East),10,5-5,166,126,292,0.568,04/05/2022,2022.0
14,Colgate (Patriot),9,2-7,124,95,219,0.566,04/05/2022,2022.0
15,Duke (ACC),13,9-4,211,163,374,0.564,04/05/2022,2022.0
16,North Carolina (ACC),10,7-3,159,128,287,0.554,04/05/2022,2022.0
17,LIU (NEC),10,5-5,126,102,228,0.553,04/05/2022,2022.0
18,Dartmouth (Ivy League),9,4-5,115,96,211,0.545,04/05/2022,2022.0
19,Massachusetts (CAA),9,6-3,126,106,232,0.543,04/05/2022,2022.0
20,UMBC (America East),7,2-5,89,75,164,0.543,04/05/2022,2022.0
21,Virginia (ACC),9,7-2,149,129,278,0.536,04/05/2022,2022.0
22,Yale (Ivy League),8,6-2,125,110,235,0.532,04/05/2022,2022.0
23,Fairfield (CAA),10,6-4,160,141,301,0.532,04/05/2022,2022.0
24,Robert Morris (ASUN),9,5-4,138,122,260,0.531,04/05/2022,2022.0
25,Bryant (NEC),9,5-4,121,107,228,0.531,04/05/2022,2022.0
26,Loyola Maryland (Patriot),9,4-5,129,116,245,0.527,04/05/2022,2022.0
27,St. Bonaventure (MAAC),9,7-2,112,101,213,0.526,04/05/2022,2022.0
28,Binghamton (America East),9,4-5,131,120,251,0.522,04/05/2022,2022.0
29,Stony Brook (America East),10,6-4,148,136,284,0.521,04/05/2022,2022.0
30,Rutgers (Big Ten),11,10-1,168,161,329,0.511,04/05/2022,2022.0
31,UMass Lowell (America East),9,1-8,130,125,255,0.510,04/05/2022,2022.0
32,Utah (ASUN),8,5-3,110,106,216,0.509,04/05/2022,2022.0
33,Richmond (SoCon),9,6-3,128,124,252,0.508,04/05/2022,2022.0
34,Army West Point (Patriot),10,8-2,145,141,286,0.507,04/05/2022,2022.0
35,Brown (Ivy League),9,5-4,127,127,254,0.500,04/05/2022,2022.0
35,Hobart (NEC),7,2-5,107,107,214,0.500,04/05/2022,2022.0
37,Princeton (Ivy League),9,7-2,137,138,275,0.498,04/05/2022,2022.0
38,Bucknell (Patriot),10,7-3,138,140,278,0.496,04/05/2022,2022.0
39,Monmouth (MAAC),8,4-4,89,93,182,0.489,04/05/2022,2022.0
40,Navy (Patriot),10,6-4,117,127,244,0.480,04/05/2022,2022.0
41,Johns Hopkins (Big Ten),11,5-6,137,151,288,0.476,04/05/2022,2022.0
42,Mercer (SoCon),11,3-8,137,153,290,0.472,04/05/2022,2022.0
43,Canisius (MAAC),10,2-8,135,151,286,0.472,04/05/2022,2022.0
44,Jacksonville (SoCon),11,9-2,145,163,308,0.471,04/05/2022,2022.0
45,Penn (Ivy League),7,4-3,87,98,185,0.470,04/05/2022,2022.0
46,NJIT (America East),8,0-8,83,94,177,0.469,04/05/2022,2022.0
47,UAlbany (America East),8,3-5,104,119,223,0.466,04/05/2022,2022.0
48,Air Force (ASUN),10,5-5,120,139,259,0.463,04/05/2022,2022.0
49,Mount St. Mary's (NEC),11,4-7,124,148,272,0.456,04/05/2022,2022.0
50,Hofstra (CAA),11,4-7,120,144,264,0.455,04/05/2022,2022.0
51,Cleveland St. (ASUN),9,3-6,105,129,234,0.449,04/05/2022,2022.0
52,Providence (Big East),10,5-5,126,156,282,0.447,04/05/2022,2022.0
53,High Point (SoCon),10,5-5,129,160,289,0.446,04/05/2022,2022.0
54,Holy Cross (Patriot),9,0-9,112,139,251,0.446,04/05/2022,2022.0
55,Penn St. (Big Ten),10,2-8,128,159,287,0.446,04/05/2022,2022.0
56,Siena (MAAC),10,3-7,106,133,239,0.444,04/05/2022,2022.0
57,Cornell (Ivy League),9,8-1,105,138,243,0.432,04/05/2022,2022.0
58,Hampton (SoCon),6,0-6,69,92,161,0.429,04/05/2022,2022.0
59,Sacred Heart (NEC),9,3-6,113,151,264,0.428,04/05/2022,2022.0
60,Harvard (Ivy League),8,7-1,89,122,211,0.422,04/05/2022,2022.0
61,Lafayette (Patriot),11,3-8,137,189,326,0.420,04/05/2022,2022.0
62,Delaware (CAA),10,6-4,120,166,286,0.420,04/05/2022,2022.0
63,VMI (SoCon),10,3-7,106,147,253,0.419,04/05/2022,2022.0
64,Bellarmine (ASUN),12,3-9,133,188,321,0.414,04/05/2022,2022.0
65,Towson (CAA),10,4-6,110,157,267,0.412,04/05/2022,2022.0
66,Notre Dame (ACC),7,3-4,77,110,187,0.412,04/05/2022,2022.0
67,Detroit Mercy (ASUN),7,1-6,77,112,189,0.407,04/05/2022,2022.0
68,St. John's (NY) (Big East),10,2-8,116,174,290,0.400,04/05/2022,2022.0
69,Marist (MAAC),10,3-7,103,156,259,0.398,04/05/2022,2022.0
70,Wagner (NEC),8,3-5,66,108,174,0.379,04/05/2022,2022.0
71,Drexel (CAA),9,4-5,86,167,253,0.340,04/05/2022,2022.0
72,Manhattan (MAAC),9,4-5,64,138,202,0.317,04/05/2022,2022.0
-,Merrimack (NEC),8,4-4,92,94,186,0.495,04/05/2022,2022.0
1,Saint Joseph's (NEC),10,8-2,195,76,271,0.720,04/03/2022,2022.0
2,Lehigh (Patriot),9,6-3,142,75,217,0.654,04/03/2022,2022.0
3,Maryland (Big Ten),9,9-0,183,104,287,0.638,04/03/2022,2022.0
4,Boston U. (Patriot),9,8-1,153,90,243,0.630,04/03/2022,2022.0
5,Ohio St. (Big Ten),10,7-3,175,106,281,0.623,04/03/2022,2022.0
6,Vermont (America East),11,5-6,162,100,262,0.618,04/03/2022,2022.0
7,Villanova (Big East),9,6-3,154,104,258,0.597,04/03/2022,2022.0
8,Georgetown (Big East),9,8-1,142,98,240,0.592,04/03/2022,2022.0
9,Michigan (Big Ten),11,7-4,189,131,320,0.591,04/03/2022,2022.0
10,Syracuse (ACC),9,4-5,161,113,274,0.588,04/03/2022,2022.0
11,Marquette (Big East),9,3-6,132,95,227,0.581,04/03/2022,2022.0
12,Quinnipiac (MAAC),8,1-7,122,92,214,0.570,04/03/2022,2022.0
13,Denver (Big East),10,5-5,166,126,292,0.568,04/03/2022,2022.0
14,Colgate (Patriot),9,2-7,124,95,219,0.566,04/03/2022,2022.0
15,Duke (ACC),13,9-4,211,163,374,0.564,04/03/2022,2022.0
16,North Carolina (ACC),10,7-3,159,128,287,0.554,04/03/2022,2022.0
17,LIU (NEC),10,5-5,126,102,228,0.553,04/03/2022,2022.0
18,Stony Brook (America East),9,5-4,138,115,253,0.545,04/03/2022,2022.0
19,Massachusetts (CAA),9,6-3,126,106,232,0.543,04/03/2022,2022.0
20,UMBC (America East),7,2-5,89,75,164,0.543,04/03/2022,2022.0
21,Bryant (NEC),9,5-4,106,91,197,0.538,04/03/2022,2022.0
22,Virginia (ACC),9,7-2,149,129,278,0.536,04/03/2022,2022.0
23,Fairfield (CAA),10,6-4,161,140,301,0.535,04/03/2022,2022.0
24,Loyola Maryland (Patriot),9,4-5,129,116,245,0.527,04/03/2022,2022.0
25,St. Bonaventure (MAAC),9,7-2,112,101,213,0.526,04/03/2022,2022.0
26,Yale (Ivy League),7,5-2,102,92,194,0.526,04/03/2022,2022.0
27,Robert Morris (ASUN),9,5-4,136,124,260,0.523,04/03/2022,2022.0
28,Dartmouth (Ivy League),8,4-4,94,86,180,0.522,04/03/2022,2022.0
29,Binghamton (America East),9,4-5,131,120,251,0.522,04/03/2022,2022.0
30,Rutgers (Big Ten),11,10-1,168,161,329,0.511,04/03/2022,2022.0
31,UMass Lowell (America East),9,1-8,130,125,255,0.510,04/03/2022,2022.0
32,Utah (ASUN),8,5-3,110,106,216,0.509,04/03/2022,2022.0
33,Richmond (SoCon),9,6-3,128,124,252,0.508,04/03/2022,2022.0
34,Army West Point (Patriot),10,8-2,145,141,286,0.507,04/03/2022,2022.0
35,Brown (Ivy League),9,5-4,127,127,254,0.500,04/03/2022,2022.0
35,Hobart (NEC),7,2-5,107,107,214,0.500,04/03/2022,2022.0
37,Bucknell (Patriot),10,7-3,138,140,278,0.496,04/03/2022,2022.0
38,Monmouth (MAAC),8,4-4,89,93,182,0.489,04/03/2022,2022.0
39,Princeton (Ivy League),8,6-2,120,126,246,0.488,04/03/2022,2022.0
40,Navy (Patriot),10,6-4,117,127,244,0.480,04/03/2022,2022.0
41,Johns Hopkins (Big Ten),11,5-6,137,151,288,0.476,04/03/2022,2022.0
42,Mercer (SoCon),11,3-8,137,153,290,0.472,04/03/2022,2022.0
43,Canisius (MAAC),10,2-8,135,151,286,0.472,04/03/2022,2022.0
44,Jacksonville (SoCon),11,9-2,145,163,308,0.471,04/03/2022,2022.0
45,Penn (Ivy League),7,4-3,87,98,185,0.470,04/03/2022,2022.0
46,NJIT (America East),8,0-8,83,94,177,0.469,04/03/2022,2022.0
47,UAlbany (America East),8,3-5,104,119,223,0.466,04/03/2022,2022.0
48,Air Force (ASUN),10,5-5,120,139,259,0.463,04/03/2022,2022.0
49,Mount St. Mary's (NEC),11,4-7,124,148,272,0.456,04/03/2022,2022.0
50,Hofstra (CAA),11,4-7,119,145,264,0.451,04/03/2022,2022.0
51,Cleveland St. (ASUN),9,3-6,105,129,234,0.449,04/03/2022,2022.0
52,Providence (Big East),10,5-5,126,156,282,0.447,04/03/2022,2022.0
53,High Point (SoCon),10,5-5,129,160,289,0.446,04/03/2022,2022.0
54,Holy Cross (Patriot),9,0-9,112,139,251,0.446,04/03/2022,2022.0
55,Penn St. (Big Ten),10,2-8,128,159,287,0.446,04/03/2022,2022.0
56,Siena (MAAC),10,3-7,106,133,239,0.444,04/03/2022,2022.0
57,Cornell (Ivy League),9,8-1,105,138,243,0.432,04/03/2022,2022.0
58,Hampton (SoCon),6,0-6,69,92,161,0.429,04/03/2022,2022.0
59,Sacred Heart (NEC),9,3-6,113,151,264,0.428,04/03/2022,2022.0
60,Harvard (Ivy League),8,7-1,89,122,211,0.422,04/03/2022,2022.0
61,Lafayette (Patriot),11,3-8,137,189,326,0.420,04/03/2022,2022.0
62,Delaware (CAA),10,6-4,120,166,286,0.420,04/03/2022,2022.0
63,VMI (SoCon),10,3-7,106,147,253,0.419,04/03/2022,2022.0
64,Detroit Mercy (ASUN),7,1-6,79,110,189,0.418,04/03/2022,2022.0
65,Towson (CAA),10,4-6,110,157,267,0.412,04/03/2022,2022.0
66,Notre Dame (ACC),7,3-4,77,110,187,0.412,04/03/2022,2022.0
67,Bellarmine (ASUN),12,3-9,117,173,290,0.403,04/03/2022,2022.0
68,St. John's (NY) (Big East),10,2-8,116,174,290,0.400,04/03/2022,2022.0
69,Marist (MAAC),9,3-6,91,139,230,0.396,04/03/2022,2022.0
70,Wagner (NEC),8,3-5,66,108,174,0.379,04/03/2022,2022.0
71,Drexel (CAA),9,4-5,86,167,253,0.340,04/03/2022,2022.0
72,Manhattan (MAAC),9,4-5,64,138,202,0.317,04/03/2022,2022.0
-,Merrimack (NEC),8,4-4,92,94,186,0.495,04/03/2022,2022.0
1,Saint Joseph's (NEC),9,7-2,176,64,240,0.733,03/29/2022,2022.0
2,Lehigh (Patriot),8,5-3,127,66,193,0.658,03/29/2022,2022.0
3,Maryland (Big Ten),8,8-0,164,87,251,0.653,03/29/2022,2022.0
4,Ohio St. (Big Ten),9,6-3,161,90,251,0.641,03/29/2022,2022.0
5,Vermont (America East),10,4-6,154,90,244,0.631,03/29/2022,2022.0
6,Boston U. (Patriot),8,7-1,131,82,213,0.615,03/29/2022,2022.0
7,Michigan (Big Ten),10,7-3,172,112,284,0.606,03/29/2022,2022.0
8,Georgetown (Big East),8,7-1,125,86,211,0.592,03/29/2022,2022.0
9,Quinnipiac (MAAC),7,1-6,109,75,184,0.592,03/29/2022,2022.0
10,Villanova (Big East),8,5-3,132,92,224,0.589,03/29/2022,2022.0
11,Denver (Big East),9,5-4,154,109,263,0.586,03/29/2022,2022.0
12,Syracuse (ACC),8,4-4,141,102,243,0.580,03/29/2022,2022.0
13,Marquette (Big East),8,2-6,114,83,197,0.579,03/29/2022,2022.0
14,Colgate (Patriot),8,2-6,116,86,202,0.574,03/29/2022,2022.0
15,Duke (ACC),12,8-4,198,151,349,0.567,03/29/2022,2022.0
16,LIU (NEC),9,5-4,120,92,212,0.566,03/29/2022,2022.0
17,North Carolina (ACC),9,7-2,147,115,262,0.561,03/29/2022,2022.0
18,Stony Brook (America East),9,5-4,138,115,253,0.545,03/29/2022,2022.0
19,UMBC (America East),6,2-4,79,67,146,0.541,03/29/2022,2022.0
20,Fairfield (CAA),9,5-4,148,128,276,0.536,03/29/2022,2022.0
21,Bryant (NEC),8,4-4,96,85,181,0.530,03/29/2022,2022.0
22,Loyola Maryland (Patriot),8,3-5,115,102,217,0.530,03/29/2022,2022.0
23,Virginia (ACC),8,7-1,129,116,245,0.527,03/29/2022,2022.0
24,St. Bonaventure (MAAC),9,7-2,112,101,213,0.526,03/29/2022,2022.0
25,Utah (ASUN),7,4-3,103,93,196,0.526,03/29/2022,2022.0
26,Bucknell (Patriot),9,7-2,134,121,255,0.525,03/29/2022,2022.0
27,Richmond (SoCon),8,5-3,115,104,219,0.525,03/29/2022,2022.0
28,Binghamton (America East),9,4-5,131,120,251,0.522,03/29/2022,2022.0
29,Yale (Ivy League),6,4-2,88,81,169,0.521,03/29/2022,2022.0
30,Rutgers (Big Ten),10,9-1,159,147,306,0.520,03/29/2022,2022.0
31,Hobart (NEC),6,2-4,95,88,183,0.519,03/29/2022,2022.0
32,Dartmouth (Ivy League),7,4-3,83,79,162,0.512,03/29/2022,2022.0
33,Massachusetts (CAA),8,5-3,106,101,207,0.512,03/29/2022,2022.0
34,Navy (Patriot),9,6-3,109,105,214,0.509,03/29/2022,2022.0
35,Robert Morris (ASUN),8,4-4,122,118,240,0.508,03/29/2022,2022.0
36,UMass Lowell (America East),8,1-7,112,114,226,0.496,03/29/2022,2022.0
37,Princeton (Ivy League),7,5-2,107,109,216,0.495,03/29/2022,2022.0
38,Brown (Ivy League),8,5-3,110,114,224,0.491,03/29/2022,2022.0
39,Mercer (SoCon),10,3-7,127,136,263,0.483,03/29/2022,2022.0
40,Monmouth (MAAC),7,4-3,81,87,168,0.482,03/29/2022,2022.0
41,Mount St. Mary's (NEC),10,4-6,118,128,246,0.480,03/29/2022,2022.0
42,UAlbany (America East),7,2-5,93,101,194,0.479,03/29/2022,2022.0
43,Army West Point (Patriot),9,7-2,126,137,263,0.479,03/29/2022,2022.0
44,Penn (Ivy League),6,4-2,76,84,160,0.475,03/29/2022,2022.0
45,Jacksonville (SoCon),10,8-2,132,146,278,0.475,03/29/2022,2022.0
46,NJIT (America East),8,0-8,83,94,177,0.469,03/29/2022,2022.0
47,Johns Hopkins (Big Ten),10,5-5,123,142,265,0.464,03/29/2022,2022.0
48,Cleveland St. (ASUN),8,3-5,94,111,205,0.459,03/29/2022,2022.0
49,Providence (Big East),9,5-4,114,138,252,0.452,03/29/2022,2022.0
50,Canisius (MAAC),9,2-7,116,141,257,0.451,03/29/2022,2022.0
51,Air Force (ASUN),9,5-4,107,132,239,0.448,03/29/2022,2022.0
51,Hofstra (CAA),10,4-6,107,132,239,0.448,03/29/2022,2022.0
53,Siena (MAAC),9,2-7,100,125,225,0.444,03/29/2022,2022.0
54,Holy Cross (Patriot),8,0-8,98,125,223,0.439,03/29/2022,2022.0
55,Delaware (CAA),9,6-3,114,147,261,0.437,03/29/2022,2022.0
56,Penn St. (Big Ten),9,2-7,112,145,257,0.436,03/29/2022,2022.0
57,Cornell (Ivy League),8,7-1,98,127,225,0.436,03/29/2022,2022.0
58,High Point (SoCon),9,5-4,112,147,259,0.432,03/29/2022,2022.0
59,Detroit Mercy (ASUN),6,1-5,73,96,169,0.432,03/29/2022,2022.0
60,Hampton (SoCon),6,0-6,69,92,161,0.429,03/29/2022,2022.0
61,Lafayette (Patriot),10,3-7,128,174,302,0.424,03/29/2022,2022.0
62,Notre Dame (ACC),6,2-4,66,90,156,0.423,03/29/2022,2022.0
63,Sacred Heart (NEC),8,3-5,99,139,238,0.416,03/29/2022,2022.0
64,Harvard (Ivy League),7,6-1,80,114,194,0.412,03/29/2022,2022.0
65,St. John's (NY) (Big East),9,2-7,105,151,256,0.410,03/29/2022,2022.0
66,VMI (SoCon),9,2-7,89,137,226,0.394,03/29/2022,2022.0
67,Bellarmine (ASUN),11,2-9,99,162,261,0.379,03/29/2022,2022.0
68,Towson (CAA),9,3-6,89,149,238,0.374,03/29/2022,2022.0
69,Marist (MAAC),8,2-6,74,126,200,0.370,03/29/2022,2022.0
70,Wagner (NEC),7,2-5,54,94,148,0.365,03/29/2022,2022.0
71,Drexel (CAA),8,4-4,78,146,224,0.348,03/29/2022,2022.0
72,Manhattan (MAAC),8,3-5,54,119,173,0.312,03/29/2022,2022.0
-,Merrimack (NEC),7,3-4,72,88,160,0.450,03/29/2022,2022.0
1,Saint Joseph's (NEC),9,7-2,176,64,240,0.733,03/27/2022,2022.0
2,Lehigh (Patriot),7,4-3,111,56,167,0.665,03/27/2022,2022.0
3,Maryland (Big Ten),8,8-0,164,87,251,0.653,03/27/2022,2022.0
4,Ohio St. (Big Ten),9,6-3,161,90,251,0.641,03/27/2022,2022.0
5,Vermont (America East),10,4-6,154,90,244,0.631,03/27/2022,2022.0
6,Boston U. (Patriot),8,7-1,131,82,213,0.615,03/27/2022,2022.0
7,Michigan (Big Ten),10,7-3,172,112,284,0.606,03/27/2022,2022.0
8,Georgetown (Big East),8,7-1,125,86,211,0.592,03/27/2022,2022.0
9,Quinnipiac (MAAC),7,1-6,109,75,184,0.592,03/27/2022,2022.0
10,Colgate (Patriot),7,2-5,103,71,174,0.592,03/27/2022,2022.0
11,Villanova (Big East),8,5-3,132,92,224,0.589,03/27/2022,2022.0
12,Denver (Big East),9,5-4,154,109,263,0.586,03/27/2022,2022.0
13,Syracuse (ACC),8,4-4,141,102,243,0.580,03/27/2022,2022.0
14,Marquette (Big East),8,2-6,114,83,197,0.579,03/27/2022,2022.0
15,Duke (ACC),12,8-4,198,151,349,0.567,03/27/2022,2022.0
16,LIU (NEC),9,5-4,120,92,212,0.566,03/27/2022,2022.0
17,North Carolina (ACC),9,7-2,147,115,262,0.561,03/27/2022,2022.0
18,Stony Brook (America East),9,5-4,138,115,253,0.545,03/27/2022,2022.0
19,UMBC (America East),6,2-4,79,67,146,0.541,03/27/2022,2022.0
20,Binghamton (America East),8,4-4,121,104,225,0.538,03/27/2022,2022.0
21,Fairfield (CAA),9,5-4,148,128,276,0.536,03/27/2022,2022.0
22,Bryant (NEC),8,4-4,96,85,181,0.530,03/27/2022,2022.0
23,Loyola Maryland (Patriot),8,3-5,115,102,217,0.530,03/27/2022,2022.0
24,Utah (ASUN),7,4-3,103,93,196,0.526,03/27/2022,2022.0
25,St. Bonaventure (MAAC),9,7-2,111,102,213,0.521,03/27/2022,2022.0
26,Yale (Ivy League),6,4-2,88,81,169,0.521,03/27/2022,2022.0
27,Rutgers (Big Ten),10,9-1,159,147,306,0.520,03/27/2022,2022.0
28,Hobart (NEC),6,2-4,95,88,183,0.519,03/27/2022,2022.0
29,Virginia (ACC),8,7-1,127,118,245,0.518,03/27/2022,2022.0
30,Bucknell (Patriot),9,7-2,132,123,255,0.518,03/27/2022,2022.0
31,Massachusetts (CAA),8,5-3,107,100,207,0.517,03/27/2022,2022.0
32,Dartmouth (Ivy League),7,4-3,83,79,162,0.512,03/27/2022,2022.0
33,Navy (Patriot),9,6-3,109,105,214,0.509,03/27/2022,2022.0
34,Robert Morris (ASUN),8,4-4,122,118,240,0.508,03/27/2022,2022.0
35,UMass Lowell (America East),8,1-7,112,114,226,0.496,03/27/2022,2022.0
36,Princeton (Ivy League),7,5-2,107,109,216,0.495,03/27/2022,2022.0
37,Richmond (SoCon),8,5-3,94,96,190,0.495,03/27/2022,2022.0
38,Brown (Ivy League),8,5-3,109,115,224,0.487,03/27/2022,2022.0
39,Mercer (SoCon),10,3-7,127,136,263,0.483,03/27/2022,2022.0
40,Monmouth (MAAC),7,4-3,81,87,168,0.482,03/27/2022,2022.0
41,Mount St. Mary's (NEC),10,4-6,118,128,246,0.480,03/27/2022,2022.0
42,UAlbany (America East),7,2-5,93,101,194,0.479,03/27/2022,2022.0
43,Army West Point (Patriot),9,7-2,126,137,263,0.479,03/27/2022,2022.0
44,Penn (Ivy League),6,4-2,76,84,160,0.475,03/27/2022,2022.0
45,Jacksonville (SoCon),10,8-2,132,146,278,0.475,03/27/2022,2022.0
46,NJIT (America East),8,0-8,83,94,177,0.469,03/27/2022,2022.0
47,Johns Hopkins (Big Ten),10,5-5,123,142,265,0.464,03/27/2022,2022.0
48,Hampton (SoCon),6,0-6,61,71,132,0.462,03/27/2022,2022.0
49,Providence (Big East),9,5-4,114,138,252,0.452,03/27/2022,2022.0
50,Canisius (MAAC),9,2-7,116,141,257,0.451,03/27/2022,2022.0
51,Air Force (ASUN),9,5-4,107,132,239,0.448,03/27/2022,2022.0
51,Hofstra (CAA),10,4-6,107,132,239,0.448,03/27/2022,2022.0
53,Siena (MAAC),9,2-7,100,125,225,0.444,03/27/2022,2022.0
54,Holy Cross (Patriot),8,0-8,98,125,223,0.439,03/27/2022,2022.0
55,Delaware (CAA),9,6-3,114,147,261,0.437,03/27/2022,2022.0
56,Notre Dame (ACC),6,2-4,68,88,156,0.436,03/27/2022,2022.0
57,Penn St. (Big Ten),9,2-7,112,145,257,0.436,03/27/2022,2022.0
58,High Point (SoCon),9,5-4,112,147,259,0.432,03/27/2022,2022.0
59,Detroit Mercy (ASUN),6,1-5,73,96,169,0.432,03/27/2022,2022.0
60,Cornell (Ivy League),7,6-1,85,112,197,0.431,03/27/2022,2022.0
61,Cleveland St. (ASUN),8,3-5,72,98,170,0.424,03/27/2022,2022.0
62,Lafayette (Patriot),9,2-7,115,159,274,0.420,03/27/2022,2022.0
63,Harvard (Ivy League),7,6-1,80,114,194,0.412,03/27/2022,2022.0
64,St. John's (NY) (Big East),9,2-7,105,151,256,0.410,03/27/2022,2022.0
65,Sacred Heart (NEC),7,3-4,84,126,210,0.400,03/27/2022,2022.0
66,VMI (SoCon),9,2-7,76,115,191,0.398,03/27/2022,2022.0
67,Bellarmine (ASUN),11,2-9,99,162,261,0.379,03/27/2022,2022.0
68,Towson (CAA),9,3-6,89,149,238,0.374,03/27/2022,2022.0
69,Marist (MAAC),8,2-6,74,126,200,0.370,03/27/2022,2022.0
70,Wagner (NEC),7,2-5,54,94,148,0.365,03/27/2022,2022.0
71,Drexel (CAA),8,4-4,78,146,224,0.348,03/27/2022,2022.0
72,Manhattan (MAAC),8,3-5,55,118,173,0.318,03/27/2022,2022.0
-,Merrimack (NEC),7,3-4,72,88,160,0.450,03/27/2022,2022.0
1,Saint Joseph's (NEC),8,6-2,155,64,219,0.708,03/22/2022,2022.0
2,Lehigh (Patriot),6,4-2,94,44,138,0.681,03/22/2022,2022.0
3,Ohio St. (Big Ten),8,6-2,149,74,223,0.668,03/22/2022,2022.0
4,Maryland (Big Ten),7,7-0,143,79,222,0.644,03/22/2022,2022.0
5,Georgetown (Big East),7,6-1,113,69,182,0.621,03/22/2022,2022.0
6,Vermont (America East),9,3-6,132,87,219,0.603,03/22/2022,2022.0
7,Colgate (Patriot),6,2-4,90,60,150,0.600,03/22/2022,2022.0
8,Michigan (Big Ten),9,7-2,152,102,254,0.598,03/22/2022,2022.0
9,Marquette (Big East),7,2-5,99,69,168,0.589,03/22/2022,2022.0
10,Quinnipiac (MAAC),6,1-5,97,68,165,0.588,03/22/2022,2022.0
11,Villanova (Big East),7,4-3,111,78,189,0.587,03/22/2022,2022.0
12,Syracuse (ACC),7,3-4,125,90,215,0.581,03/22/2022,2022.0
13,Duke (ACC),11,8-3,186,135,321,0.579,03/22/2022,2022.0
14,Stony Brook (America East),8,5-3,131,96,227,0.577,03/22/2022,2022.0
15,Binghamton (America East),7,3-4,115,86,201,0.572,03/22/2022,2022.0
16,Denver (Big East),8,4-4,135,103,238,0.567,03/22/2022,2022.0
17,LIU (NEC),8,4-4,104,81,185,0.562,03/22/2022,2022.0
18,Boston U. (Patriot),7,6-1,99,79,178,0.556,03/22/2022,2022.0
19,Yale (Ivy League),5,3-2,78,63,141,0.553,03/22/2022,2022.0
20,Virginia (ACC),7,6-1,119,102,221,0.538,03/22/2022,2022.0
21,Fairfield (CAA),9,5-4,148,128,276,0.536,03/22/2022,2022.0
22,North Carolina (ACC),8,6-2,126,109,235,0.536,03/22/2022,2022.0
23,Bryant (NEC),7,3-4,82,71,153,0.536,03/22/2022,2022.0
24,Bucknell (Patriot),8,6-2,121,110,231,0.524,03/22/2022,2022.0
25,Dartmouth (Ivy League),6,4-2,68,62,130,0.523,03/22/2022,2022.0
26,Hobart (NEC),5,2-3,81,74,155,0.523,03/22/2022,2022.0
27,Loyola Maryland (Patriot),7,3-4,97,90,187,0.519,03/22/2022,2022.0
28,Massachusetts (CAA),7,4-3,96,90,186,0.516,03/22/2022,2022.0
29,Rutgers (Big Ten),9,8-1,143,135,278,0.514,03/22/2022,2022.0
30,Mercer (SoCon),9,3-6,117,112,229,0.511,03/22/2022,2022.0
31,Navy (Patriot),8,5-3,94,94,188,0.500,03/22/2022,2022.0
31,St. Bonaventure (MAAC),8,6-2,93,93,186,0.500,03/22/2022,2022.0
31,UMBC (America East),5,2-3,61,61,122,0.500,03/22/2022,2022.0
34,Robert Morris (ASUN),7,3-4,103,104,207,0.498,03/22/2022,2022.0
35,Monmouth (MAAC),6,3-3,74,75,149,0.497,03/22/2022,2022.0
36,Richmond (SoCon),7,4-3,94,96,190,0.495,03/22/2022,2022.0
37,Mount St. Mary's (NEC),9,3-6,106,109,215,0.493,03/22/2022,2022.0
38,Army West Point (Patriot),8,6-2,114,119,233,0.489,03/22/2022,2022.0
39,Brown (Ivy League),7,5-2,99,104,203,0.488,03/22/2022,2022.0
40,Utah (ASUN),6,3-3,79,83,162,0.488,03/22/2022,2022.0
41,Canisius (MAAC),8,2-6,113,119,232,0.487,03/22/2022,2022.0
42,UMass Lowell (America East),7,0-7,100,107,207,0.483,03/22/2022,2022.0
43,NJIT (America East),7,0-7,76,82,158,0.481,03/22/2022,2022.0
44,Johns Hopkins (Big Ten),9,4-5,113,122,235,0.481,03/22/2022,2022.0
45,Princeton (Ivy League),6,5-1,89,99,188,0.473,03/22/2022,2022.0
46,Lafayette (Patriot),8,2-6,112,127,239,0.469,03/22/2022,2022.0
47,Hampton (SoCon),5,0-5,61,71,132,0.462,03/22/2022,2022.0
48,Hofstra (CAA),9,4-5,99,117,216,0.458,03/22/2022,2022.0
49,Penn St. (Big Ten),8,2-6,104,124,228,0.456,03/22/2022,2022.0
50,Cornell (Ivy League),6,6-0,76,91,167,0.455,03/22/2022,2022.0
51,Jacksonville (SoCon),9,7-2,111,135,246,0.451,03/22/2022,2022.0
52,Air Force (ASUN),8,4-4,93,117,210,0.443,03/22/2022,2022.0
53,Delaware (CAA),8,6-2,100,126,226,0.442,03/22/2022,2022.0
54,Holy Cross (Patriot),7,0-7,87,110,197,0.442,03/22/2022,2022.0
55,UAlbany (America East),6,1-5,74,94,168,0.440,03/22/2022,2022.0
56,Providence (Big East),8,4-4,99,130,229,0.432,03/22/2022,2022.0
57,Siena (MAAC),8,2-6,86,114,200,0.430,03/22/2022,2022.0
58,Wagner (NEC),6,2-4,54,73,127,0.425,03/22/2022,2022.0
59,Cleveland St. (ASUN),7,2-5,72,98,170,0.424,03/22/2022,2022.0
60,Penn (Ivy League),5,3-2,55,75,130,0.423,03/22/2022,2022.0
61,High Point (SoCon),8,4-4,97,133,230,0.422,03/22/2022,2022.0
62,Detroit Mercy (ASUN),5,1-4,59,81,140,0.421,03/22/2022,2022.0
63,St. John's (NY) (Big East),8,2-6,94,130,224,0.420,03/22/2022,2022.0
64,VMI (SoCon),8,2-6,76,115,191,0.398,03/22/2022,2022.0
65,Bellarmine (ASUN),10,2-8,93,141,234,0.397,03/22/2022,2022.0
66,Notre Dame (ACC),5,2-3,52,80,132,0.394,03/22/2022,2022.0
67,Towson (CAA),8,3-5,83,130,213,0.390,03/22/2022,2022.0
68,Harvard (Ivy League),6,5-1,63,99,162,0.389,03/22/2022,2022.0
69,Sacred Heart (NEC),6,3-3,65,114,179,0.363,03/22/2022,2022.0
70,Marist (MAAC),7,1-6,63,112,175,0.360,03/22/2022,2022.0
71,Drexel (CAA),7,4-3,64,127,191,0.335,03/22/2022,2022.0
72,Manhattan (MAAC),7,3-4,46,100,146,0.315,03/22/2022,2022.0
-,Merrimack (NEC),6,3-3,61,72,133,0.459,03/22/2022,2022.0
1,Saint Joseph's (NEC),8,6-2,155,64,219,0.708,03/20/2022,2022.0
2,Lehigh (Patriot),6,4-2,94,44,138,0.681,03/20/2022,2022.0
3,Ohio St. (Big Ten),7,5-2,136,67,203,0.670,03/20/2022,2022.0
4,Maryland (Big Ten),7,7-0,143,79,222,0.644,03/20/2022,2022.0
5,Vermont (America East),9,3-6,121,73,194,0.624,03/20/2022,2022.0
6,Georgetown (Big East),7,6-1,113,69,182,0.621,03/20/2022,2022.0
7,Colgate (Patriot),6,2-4,90,60,150,0.600,03/20/2022,2022.0
8,Michigan (Big Ten),9,7-2,152,102,254,0.598,03/20/2022,2022.0
9,Marquette (Big East),7,2-5,100,68,168,0.595,03/20/2022,2022.0
10,Quinnipiac (MAAC),6,1-5,97,68,165,0.588,03/20/2022,2022.0
11,Villanova (Big East),7,4-3,111,78,189,0.587,03/20/2022,2022.0
12,Boston U. (Patriot),6,6-0,89,64,153,0.582,03/20/2022,2022.0
13,Syracuse (ACC),7,3-4,125,90,215,0.581,03/20/2022,2022.0
14,Duke (ACC),11,8-3,186,135,321,0.579,03/20/2022,2022.0
15,Stony Brook (America East),8,5-3,131,96,227,0.577,03/20/2022,2022.0
16,Binghamton (America East),7,3-4,115,86,201,0.572,03/20/2022,2022.0
17,Denver (Big East),8,4-4,135,103,238,0.567,03/20/2022,2022.0
18,LIU (NEC),8,4-4,104,81,185,0.562,03/20/2022,2022.0
19,Dartmouth (Ivy League),5,4-1,61,49,110,0.555,03/20/2022,2022.0
20,Yale (Ivy League),5,3-2,78,63,141,0.553,03/20/2022,2022.0
21,Virginia (ACC),7,6-1,119,102,221,0.538,03/20/2022,2022.0
22,North Carolina (ACC),8,6-2,126,109,235,0.536,03/20/2022,2022.0
23,Bryant (NEC),7,3-4,82,71,153,0.536,03/20/2022,2022.0
24,Fairfield (CAA),8,5-3,130,114,244,0.533,03/20/2022,2022.0
25,Bucknell (Patriot),8,6-2,121,110,231,0.524,03/20/2022,2022.0
26,Hobart (NEC),5,2-3,81,74,155,0.523,03/20/2022,2022.0
27,Loyola Maryland (Patriot),7,3-4,97,90,187,0.519,03/20/2022,2022.0
28,Rutgers (Big Ten),9,8-1,143,135,278,0.514,03/20/2022,2022.0
29,Mercer (SoCon),9,3-6,117,112,229,0.511,03/20/2022,2022.0
30,Massachusetts (CAA),7,4-3,82,79,161,0.509,03/20/2022,2022.0
31,Navy (Patriot),8,5-3,94,94,188,0.500,03/20/2022,2022.0
31,St. Bonaventure (MAAC),8,6-2,93,93,186,0.500,03/20/2022,2022.0
31,UMBC (America East),5,2-3,61,61,122,0.500,03/20/2022,2022.0
34,Monmouth (MAAC),6,3-3,74,75,149,0.497,03/20/2022,2022.0
35,Richmond (SoCon),7,4-3,94,96,190,0.495,03/20/2022,2022.0
36,Mount St. Mary's (NEC),9,3-6,106,109,215,0.493,03/20/2022,2022.0
37,Robert Morris (ASUN),7,3-4,102,105,207,0.493,03/20/2022,2022.0
38,Army West Point (Patriot),8,6-2,114,119,233,0.489,03/20/2022,2022.0
39,Brown (Ivy League),7,5-2,99,104,203,0.488,03/20/2022,2022.0
40,Utah (ASUN),6,3-3,79,83,162,0.488,03/20/2022,2022.0
41,Canisius (MAAC),8,2-6,113,119,232,0.487,03/20/2022,2022.0
42,UMass Lowell (America East),7,0-7,100,107,207,0.483,03/20/2022,2022.0
43,NJIT (America East),7,0-7,76,82,158,0.481,03/20/2022,2022.0
44,Johns Hopkins (Big Ten),9,4-5,113,122,235,0.481,03/20/2022,2022.0
45,Princeton (Ivy League),6,5-1,89,99,188,0.473,03/20/2022,2022.0
46,Lafayette (Patriot),8,2-6,112,127,239,0.469,03/20/2022,2022.0
47,Hofstra (CAA),9,4-5,99,117,216,0.458,03/20/2022,2022.0
48,Penn St. (Big Ten),8,2-6,104,124,228,0.456,03/20/2022,2022.0
49,Cornell (Ivy League),6,6-0,76,91,167,0.455,03/20/2022,2022.0
50,Jacksonville (SoCon),9,7-2,111,135,246,0.451,03/20/2022,2022.0
51,Hampton (SoCon),5,0-5,46,57,103,0.447,03/20/2022,2022.0
52,Air Force (ASUN),8,4-4,93,117,210,0.443,03/20/2022,2022.0
53,Delaware (CAA),8,6-2,100,126,226,0.442,03/20/2022,2022.0
54,Holy Cross (Patriot),7,0-7,87,110,197,0.442,03/20/2022,2022.0
55,UAlbany (America East),6,1-5,74,94,168,0.440,03/20/2022,2022.0
56,Providence (Big East),8,4-4,99,130,229,0.432,03/20/2022,2022.0
57,Siena (MAAC),8,2-6,86,114,200,0.430,03/20/2022,2022.0
58,Wagner (NEC),6,2-4,54,73,127,0.425,03/20/2022,2022.0
59,Penn (Ivy League),5,3-2,55,75,130,0.423,03/20/2022,2022.0
60,High Point (SoCon),8,4-4,97,133,230,0.422,03/20/2022,2022.0
61,Detroit Mercy (ASUN),5,1-4,59,81,140,0.421,03/20/2022,2022.0
62,St. John's (NY) (Big East),7,1-6,80,112,192,0.417,03/20/2022,2022.0
63,Cleveland St. (ASUN),7,2-5,58,83,141,0.411,03/20/2022,2022.0
64,VMI (SoCon),8,2-6,76,115,191,0.398,03/20/2022,2022.0
65,Bellarmine (ASUN),10,2-8,93,141,234,0.397,03/20/2022,2022.0
66,Notre Dame (ACC),5,2-3,52,80,132,0.394,03/20/2022,2022.0
67,Towson (CAA),8,3-5,83,130,213,0.390,03/20/2022,2022.0
68,Sacred Heart (NEC),6,3-3,65,114,179,0.363,03/20/2022,2022.0
69,Marist (MAAC),7,1-6,63,112,175,0.360,03/20/2022,2022.0
70,Harvard (Ivy League),5,4-1,48,89,137,0.350,03/20/2022,2022.0
71,Drexel (CAA),7,4-3,64,127,191,0.335,03/20/2022,2022.0
72,Manhattan (MAAC),7,3-4,46,100,146,0.315,03/20/2022,2022.0
-,Merrimack (NEC),6,3-3,61,72,133,0.459,03/20/2022,2022.0
1,Saint Joseph's (NEC),7,5-2,138,52,190,0.726,03/16/2022,2022.0
2,Ohio St. (Big Ten),6,5-1,123,53,176,0.699,03/16/2022,2022.0
3,Lehigh (Patriot),5,3-2,77,36,113,0.681,03/16/2022,2022.0
4,Maryland (Big Ten),6,6-0,118,65,183,0.645,03/16/2022,2022.0
5,Georgetown (Big East),6,5-1,98,59,157,0.624,03/16/2022,2022.0
6,Vermont (America East),7,2-5,107,66,173,0.618,03/16/2022,2022.0
7,Syracuse (ACC),6,2-4,113,76,189,0.598,03/16/2022,2022.0
8,Villanova (Big East),6,3-3,94,64,158,0.595,03/16/2022,2022.0
9,Michigan (Big Ten),8,7-1,136,95,231,0.589,03/16/2022,2022.0
10,Quinnipiac (MAAC),5,1-4,85,61,146,0.582,03/16/2022,2022.0
11,Stony Brook (America East),7,5-2,117,84,201,0.582,03/16/2022,2022.0
12,Marquette (Big East),6,2-4,86,62,148,0.581,03/16/2022,2022.0
13,Virginia (ACC),6,6-0,105,77,182,0.577,03/16/2022,2022.0
14,Denver (Big East),7,3-4,121,90,211,0.573,03/16/2022,2022.0
15,Boston U. (Patriot),5,5-0,70,53,123,0.569,03/16/2022,2022.0
16,Duke (ACC),10,7-3,168,129,297,0.566,03/16/2022,2022.0
17,Dartmouth (Ivy League),4,3-1,45,35,80,0.563,03/16/2022,2022.0
18,Colgate (Patriot),5,1-4,70,55,125,0.560,03/16/2022,2022.0
19,LIU (NEC),7,3-4,91,72,163,0.558,03/16/2022,2022.0
20,Binghamton (America East),6,2-4,93,76,169,0.550,03/16/2022,2022.0
21,Fairfield (CAA),7,4-3,116,98,214,0.542,03/16/2022,2022.0
22,Bucknell (Patriot),7,6-1,110,95,205,0.537,03/16/2022,2022.0
23,Bryant (NEC),6,2-4,69,60,129,0.535,03/16/2022,2022.0
24,North Carolina (ACC),7,5-2,108,97,205,0.527,03/16/2022,2022.0
25,Rutgers (Big Ten),8,7-1,127,116,243,0.523,03/16/2022,2022.0
26,Mercer (SoCon),8,3-5,106,98,204,0.520,03/16/2022,2022.0
27,UMBC (America East),4,2-2,49,46,95,0.516,03/16/2022,2022.0
28,Robert Morris (ASUN),6,2-4,96,91,187,0.513,03/16/2022,2022.0
29,Army West Point (Patriot),7,6-1,106,102,208,0.510,03/16/2022,2022.0
30,Loyola Maryland (Patriot),6,2-4,82,79,161,0.509,03/16/2022,2022.0
30,Massachusetts (CAA),6,3-3,82,79,161,0.509,03/16/2022,2022.0
32,Navy (Patriot),7,4-3,83,80,163,0.509,03/16/2022,2022.0
33,St. Bonaventure (MAAC),7,5-2,86,83,169,0.509,03/16/2022,2022.0
34,Mount St. Mary's (NEC),8,3-5,94,92,186,0.505,03/16/2022,2022.0
35,Yale (Ivy League),4,3-1,57,56,113,0.504,03/16/2022,2022.0
36,NJIT (America East),6,0-6,69,68,137,0.504,03/16/2022,2022.0
36,Utah (ASUN),5,3-2,69,68,137,0.504,03/16/2022,2022.0
38,Lafayette (Patriot),7,2-5,107,107,214,0.500,03/16/2022,2022.0
39,Monmouth (MAAC),6,3-3,74,75,149,0.497,03/16/2022,2022.0
40,Cornell (Ivy League),5,5-0,69,70,139,0.496,03/16/2022,2022.0
41,Hobart (NEC),4,2-2,65,69,134,0.485,03/16/2022,2022.0
42,Richmond (SoCon),6,3-3,79,84,163,0.485,03/16/2022,2022.0
43,Johns Hopkins (Big Ten),7,4-3,89,96,185,0.481,03/16/2022,2022.0
44,Princeton (Ivy League),5,4-1,70,78,148,0.473,03/16/2022,2022.0
45,UAlbany (America East),5,1-4,64,72,136,0.471,03/16/2022,2022.0
46,UMass Lowell (America East),6,0-6,81,94,175,0.463,03/16/2022,2022.0
47,Siena (MAAC),7,2-5,83,97,180,0.461,03/16/2022,2022.0
48,Jacksonville (SoCon),8,6-2,98,116,214,0.458,03/16/2022,2022.0
49,Penn St. (Big Ten),8,2-6,104,124,228,0.456,03/16/2022,2022.0
50,Holy Cross (Patriot),6,0-6,76,91,167,0.455,03/16/2022,2022.0
51,Canisius (MAAC),7,1-6,96,116,212,0.453,03/16/2022,2022.0
52,Hampton (SoCon),4,0-4,46,57,103,0.447,03/16/2022,2022.0
53,Hofstra (CAA),8,4-4,80,101,181,0.442,03/16/2022,2022.0
54,Brown (Ivy League),6,5-1,77,100,177,0.435,03/16/2022,2022.0
55,Wagner (NEC),5,2-3,45,60,105,0.429,03/16/2022,2022.0
56,Air Force (ASUN),7,3-4,79,106,185,0.427,03/16/2022,2022.0
57,High Point (SoCon),7,4-3,85,115,200,0.425,03/16/2022,2022.0
58,Delaware (CAA),7,5-2,85,116,201,0.423,03/16/2022,2022.0
59,Detroit Mercy (ASUN),5,1-4,59,81,140,0.421,03/16/2022,2022.0
60,Providence (Big East),7,4-3,83,116,199,0.417,03/16/2022,2022.0
61,Notre Dame (ACC),4,1-3,45,64,109,0.413,03/16/2022,2022.0
62,Cleveland St. (ASUN),6,1-5,58,83,141,0.411,03/16/2022,2022.0
63,VMI (SoCon),7,2-5,67,96,163,0.411,03/16/2022,2022.0
64,Towson (CAA),7,3-4,77,112,189,0.407,03/16/2022,2022.0
64,St. John's (NY) (Big East),6,1-5,66,96,162,0.407,03/16/2022,2022.0
66,Harvard (Ivy League),4,3-1,44,67,111,0.396,03/16/2022,2022.0
67,Sacred Heart (NEC),5,2-3,60,98,158,0.380,03/16/2022,2022.0
68,Penn (Ivy League),4,3-1,34,56,90,0.378,03/16/2022,2022.0
69,Bellarmine (ASUN),9,1-8,74,132,206,0.359,03/16/2022,2022.0
70,Marist (MAAC),6,1-5,53,105,158,0.335,03/16/2022,2022.0
71,Drexel (CAA),6,4-2,50,110,160,0.313,03/16/2022,2022.0
72,Manhattan (MAAC),6,2-4,39,88,127,0.307,03/16/2022,2022.0
-,Merrimack (NEC),5,3-2,50,59,109,0.459,03/16/2022,2022.0
1,Saint Joseph's (NEC),7,5-2,138,52,190,0.726,03/14/2022,2022.0
2,Ohio St. (Big Ten),6,5-1,123,53,176,0.699,03/14/2022,2022.0
3,Lehigh (Patriot),5,3-2,77,36,113,0.681,03/14/2022,2022.0
4,Maryland (Big Ten),6,6-0,118,65,183,0.645,03/14/2022,2022.0
5,Georgetown (Big East),6,5-1,98,59,157,0.624,03/14/2022,2022.0
6,Vermont (America East),7,2-5,107,66,173,0.618,03/14/2022,2022.0
7,Stony Brook (America East),6,4-2,103,68,171,0.602,03/14/2022,2022.0
8,Syracuse (ACC),6,2-4,113,76,189,0.598,03/14/2022,2022.0
9,Villanova (Big East),6,3-3,94,64,158,0.595,03/14/2022,2022.0
10,Michigan (Big Ten),8,7-1,136,95,231,0.589,03/14/2022,2022.0
11,Quinnipiac (MAAC),5,1-4,85,61,146,0.582,03/14/2022,2022.0
12,Marquette (Big East),6,2-4,86,62,148,0.581,03/14/2022,2022.0
13,Virginia (ACC),6,6-0,105,77,182,0.577,03/14/2022,2022.0
14,Denver (Big East),7,3-4,121,90,211,0.573,03/14/2022,2022.0
15,Boston U. (Patriot),5,5-0,70,53,123,0.569,03/14/2022,2022.0
16,Duke (ACC),10,7-3,168,129,297,0.566,03/14/2022,2022.0
17,Dartmouth (Ivy League),4,3-1,45,35,80,0.563,03/14/2022,2022.0
18,Colgate (Patriot),5,1-4,70,55,125,0.560,03/14/2022,2022.0
19,Bucknell (Patriot),6,5-1,98,81,179,0.547,03/14/2022,2022.0
20,Fairfield (CAA),7,4-3,116,98,214,0.542,03/14/2022,2022.0
21,Bryant (NEC),6,2-4,69,60,129,0.535,03/14/2022,2022.0
22,North Carolina (ACC),7,5-2,108,97,205,0.527,03/14/2022,2022.0
23,Mercer (SoCon),8,3-5,106,98,204,0.520,03/14/2022,2022.0
24,Rutgers (Big Ten),7,6-1,108,100,208,0.519,03/14/2022,2022.0
25,UMBC (America East),4,2-2,49,46,95,0.516,03/14/2022,2022.0
26,Robert Morris (ASUN),6,2-4,96,91,187,0.513,03/14/2022,2022.0
27,Army West Point (Patriot),7,6-1,106,102,208,0.510,03/14/2022,2022.0
28,Loyola Maryland (Patriot),6,2-4,82,79,161,0.509,03/14/2022,2022.0
28,Massachusetts (CAA),6,3-3,82,79,161,0.509,03/14/2022,2022.0
30,Navy (Patriot),7,4-3,83,80,163,0.509,03/14/2022,2022.0
31,St. Bonaventure (MAAC),7,5-2,86,83,169,0.509,03/14/2022,2022.0
32,Lafayette (Patriot),6,2-4,91,88,179,0.508,03/14/2022,2022.0
33,Mount St. Mary's (NEC),8,3-5,94,92,186,0.505,03/14/2022,2022.0
34,Yale (Ivy League),4,3-1,57,56,113,0.504,03/14/2022,2022.0
35,NJIT (America East),6,0-6,69,68,137,0.504,03/14/2022,2022.0
35,Utah (ASUN),5,3-2,69,68,137,0.504,03/14/2022,2022.0
37,Cornell (Ivy League),5,5-0,69,70,139,0.496,03/14/2022,2022.0
38,Hobart (NEC),4,2-2,65,69,134,0.485,03/14/2022,2022.0
39,Richmond (SoCon),6,3-3,79,84,163,0.485,03/14/2022,2022.0
40,Johns Hopkins (Big Ten),7,4-3,89,96,185,0.481,03/14/2022,2022.0
41,Princeton (Ivy League),5,4-1,70,78,148,0.473,03/14/2022,2022.0
42,Monmouth (MAAC),5,2-3,60,70,130,0.462,03/14/2022,2022.0
43,Siena (MAAC),7,2-5,83,97,180,0.461,03/14/2022,2022.0
44,Jacksonville (SoCon),8,6-2,98,116,214,0.458,03/14/2022,2022.0
45,Holy Cross (Patriot),6,0-6,76,91,167,0.455,03/14/2022,2022.0
46,Canisius (MAAC),7,1-6,96,116,212,0.453,03/14/2022,2022.0
47,VMI (SoCon),6,2-4,65,79,144,0.451,03/14/2022,2022.0
48,UMass Lowell (America East),5,0-5,65,80,145,0.448,03/14/2022,2022.0
49,Hampton (SoCon),4,0-4,46,57,103,0.447,03/14/2022,2022.0
50,Penn St. (Big Ten),7,2-5,90,112,202,0.446,03/14/2022,2022.0
51,Hofstra (CAA),8,4-4,80,101,181,0.442,03/14/2022,2022.0
52,Brown (Ivy League),6,5-1,77,100,177,0.435,03/14/2022,2022.0
53,Wagner (NEC),5,2-3,45,60,105,0.429,03/14/2022,2022.0
54,Air Force (ASUN),7,3-4,79,106,185,0.427,03/14/2022,2022.0
55,High Point (SoCon),7,4-3,85,115,200,0.425,03/14/2022,2022.0
56,Delaware (CAA),7,5-2,84,117,201,0.418,03/14/2022,2022.0
57,Providence (Big East),7,4-3,83,116,199,0.417,03/14/2022,2022.0
58,Notre Dame (ACC),4,1-3,45,64,109,0.413,03/14/2022,2022.0
59,Cleveland St. (ASUN),6,1-5,58,83,141,0.411,03/14/2022,2022.0
60,Towson (CAA),7,3-4,77,112,189,0.407,03/14/2022,2022.0
60,St. John's (NY) (Big East),6,1-5,66,96,162,0.407,03/14/2022,2022.0
62,Detroit Mercy (ASUN),5,1-4,56,84,140,0.400,03/14/2022,2022.0
63,Harvard (Ivy League),4,3-1,44,67,111,0.396,03/14/2022,2022.0
64,Sacred Heart (NEC),5,2-3,60,98,158,0.380,03/14/2022,2022.0
65,Penn (Ivy League),4,3-1,34,56,90,0.378,03/14/2022,2022.0
66,Bellarmine (ASUN),9,1-8,74,132,206,0.359,03/14/2022,2022.0
67,Marist (MAAC),6,1-5,54,104,158,0.342,03/14/2022,2022.0
68,Drexel (CAA),6,4-2,50,110,160,0.313,03/14/2022,2022.0
69,Manhattan (MAAC),6,2-4,39,88,127,0.307,03/14/2022,2022.0
-,Merrimack (NEC),5,3-2,50,59,109,0.459,03/14/2022,2022.0
1,Saint Joseph's (NEC),7,5-2,138,52,190,0.726,03/13/2022,2022.0
2,Ohio St. (Big Ten),6,5-1,123,53,176,0.699,03/13/2022,2022.0
3,Lehigh (Patriot),5,3-2,77,36,113,0.681,03/13/2022,2022.0
4,Maryland (Big Ten),6,6-0,118,65,183,0.645,03/13/2022,2022.0
5,Georgetown (Big East),6,5-1,98,59,157,0.624,03/13/2022,2022.0
6,Vermont (America East),7,2-5,107,66,173,0.618,03/13/2022,2022.0
7,Stony Brook (America East),6,4-2,103,68,171,0.602,03/13/2022,2022.0
8,Syracuse (ACC),6,2-4,113,76,189,0.598,03/13/2022,2022.0
9,Villanova (Big East),6,3-3,94,64,158,0.595,03/13/2022,2022.0
10,Michigan (Big Ten),8,7-1,136,95,231,0.589,03/13/2022,2022.0
11,Quinnipiac (MAAC),5,1-4,85,61,146,0.582,03/13/2022,2022.0
12,Marquette (Big East),6,2-4,86,62,148,0.581,03/13/2022,2022.0
13,Virginia (ACC),6,6-0,105,77,182,0.577,03/13/2022,2022.0
14,Denver (Big East),7,3-4,121,90,211,0.573,03/13/2022,2022.0
15,Boston U. (Patriot),5,5-0,70,53,123,0.569,03/13/2022,2022.0
16,Duke (ACC),10,7-3,168,129,297,0.566,03/13/2022,2022.0
17,Fairfield (CAA),6,3-3,103,80,183,0.563,03/13/2022,2022.0
18,Dartmouth (Ivy League),4,3-1,45,35,80,0.563,03/13/2022,2022.0
19,Colgate (Patriot),5,1-4,70,55,125,0.560,03/13/2022,2022.0
20,LIU (NEC),7,3-4,91,72,163,0.558,03/13/2022,2022.0
21,Bucknell (Patriot),6,5-1,98,81,179,0.547,03/13/2022,2022.0
22,Binghamton (America East),5,2-3,75,63,138,0.543,03/13/2022,2022.0
23,Bryant (NEC),6,2-4,69,60,129,0.535,03/13/2022,2022.0
24,Mercer (SoCon),8,3-5,109,97,206,0.529,03/13/2022,2022.0
25,North Carolina (ACC),7,5-2,108,97,205,0.527,03/13/2022,2022.0
26,Rutgers (Big Ten),7,6-1,108,100,208,0.519,03/13/2022,2022.0
27,UMBC (America East),4,2-2,49,46,95,0.516,03/13/2022,2022.0
28,Robert Morris (ASUN),6,2-4,96,91,187,0.513,03/13/2022,2022.0
29,Army West Point (Patriot),7,6-1,106,102,208,0.510,03/13/2022,2022.0
30,Loyola Maryland (Patriot),6,2-4,82,79,161,0.509,03/13/2022,2022.0
30,Massachusetts (CAA),6,3-3,82,79,161,0.509,03/13/2022,2022.0
32,Navy (Patriot),7,4-3,83,80,163,0.509,03/13/2022,2022.0
33,St. Bonaventure (MAAC),7,5-2,86,83,169,0.509,03/13/2022,2022.0
34,Lafayette (Patriot),6,2-4,91,88,179,0.508,03/13/2022,2022.0
35,Mount St. Mary's (NEC),8,3-5,94,92,186,0.505,03/13/2022,2022.0
36,Yale (Ivy League),4,3-1,57,56,113,0.504,03/13/2022,2022.0
37,NJIT (America East),6,0-6,69,68,137,0.504,03/13/2022,2022.0
37,Utah (ASUN),5,3-2,69,68,137,0.504,03/13/2022,2022.0
39,Cornell (Ivy League),5,5-0,69,70,139,0.496,03/13/2022,2022.0
40,Hobart (NEC),4,2-2,65,69,134,0.485,03/13/2022,2022.0
41,Richmond (SoCon),6,3-3,79,84,163,0.485,03/13/2022,2022.0
42,Johns Hopkins (Big Ten),7,4-3,89,96,185,0.481,03/13/2022,2022.0
43,Princeton (Ivy League),5,4-1,70,78,148,0.473,03/13/2022,2022.0
44,UAlbany (America East),5,1-4,64,72,136,0.471,03/13/2022,2022.0
45,Monmouth (MAAC),5,2-3,60,70,130,0.462,03/13/2022,2022.0
46,Siena (MAAC),7,2-5,83,97,180,0.461,03/13/2022,2022.0
47,Holy Cross (Patriot),6,0-6,76,91,167,0.455,03/13/2022,2022.0
48,Canisius (MAAC),7,1-6,96,116,212,0.453,03/13/2022,2022.0
49,VMI (SoCon),6,2-4,65,79,144,0.451,03/13/2022,2022.0
50,Jacksonville (SoCon),8,6-2,97,119,216,0.449,03/13/2022,2022.0
51,UMass Lowell (America East),5,0-5,65,80,145,0.448,03/13/2022,2022.0
52,Hampton (SoCon),4,0-4,46,57,103,0.447,03/13/2022,2022.0
53,Penn St. (Big Ten),7,2-5,90,112,202,0.446,03/13/2022,2022.0
54,Hofstra (CAA),8,4-4,80,101,181,0.442,03/13/2022,2022.0
55,Brown (Ivy League),6,5-1,77,100,177,0.435,03/13/2022,2022.0
56,Wagner (NEC),5,2-3,45,60,105,0.429,03/13/2022,2022.0
57,Air Force (ASUN),7,3-4,79,106,185,0.427,03/13/2022,2022.0
58,High Point (SoCon),7,4-3,85,115,200,0.425,03/13/2022,2022.0
59,Delaware (CAA),7,5-2,84,117,201,0.418,03/13/2022,2022.0
60,Providence (Big East),7,4-3,83,116,199,0.417,03/13/2022,2022.0
61,Notre Dame (ACC),4,1-3,45,64,109,0.413,03/13/2022,2022.0
62,Cleveland St. (ASUN),6,1-5,58,83,141,0.411,03/13/2022,2022.0
63,Towson (CAA),7,3-4,77,112,189,0.407,03/13/2022,2022.0
63,St. John's (NY) (Big East),6,1-5,66,96,162,0.407,03/13/2022,2022.0
65,Detroit Mercy (ASUN),5,1-4,56,84,140,0.400,03/13/2022,2022.0
66,Harvard (Ivy League),4,3-1,44,67,111,0.396,03/13/2022,2022.0
67,Sacred Heart (NEC),5,2-3,60,98,158,0.380,03/13/2022,2022.0
68,Penn (Ivy League),4,3-1,34,56,90,0.378,03/13/2022,2022.0
69,Bellarmine (ASUN),9,1-8,74,132,206,0.359,03/13/2022,2022.0
70,Marist (MAAC),6,1-5,54,104,158,0.342,03/13/2022,2022.0
71,Drexel (CAA),6,4-2,50,110,160,0.313,03/13/2022,2022.0
72,Manhattan (MAAC),6,2-4,39,88,127,0.307,03/13/2022,2022.0
-,Merrimack (NEC),5,3-2,50,59,109,0.459,03/13/2022,2022.0
1,Ohio St. (Big Ten),5,4-1,107,41,148,0.723,03/10/2022,2022.0
2,Saint Joseph's (NEC),6,4-2,124,48,172,0.721,03/10/2022,2022.0
3,Lehigh (Patriot),4,2-2,57,29,86,0.663,03/10/2022,2022.0
4,Maryland (Big Ten),5,5-0,95,54,149,0.638,03/10/2022,2022.0
5,Georgetown (Big East),5,4-1,79,49,128,0.617,03/10/2022,2022.0
6,Vermont (America East),6,2-4,91,58,149,0.611,03/10/2022,2022.0
7,Syracuse (ACC),5,2-3,99,69,168,0.589,03/10/2022,2022.0
8,Michigan (Big Ten),7,7-0,121,85,206,0.587,03/10/2022,2022.0
9,Bucknell (Patriot),5,5-0,91,65,156,0.583,03/10/2022,2022.0
10,Quinnipiac (MAAC),5,1-4,85,61,146,0.582,03/10/2022,2022.0
11,Stony Brook (America East),5,4-1,87,63,150,0.580,03/10/2022,2022.0
11,Colgate (Patriot),4,1-3,58,42,100,0.580,03/10/2022,2022.0
13,Duke (ACC),9,7-2,158,115,273,0.579,03/10/2022,2022.0
14,Villanova (Big East),5,3-2,81,59,140,0.579,03/10/2022,2022.0
15,Virginia (ACC),6,6-0,105,77,182,0.577,03/10/2022,2022.0
16,UMBC (America East),3,1-2,39,29,68,0.574,03/10/2022,2022.0
17,Fairfield (CAA),6,3-3,103,80,183,0.563,03/10/2022,2022.0
18,Dartmouth (Ivy League),4,3-1,45,35,80,0.563,03/10/2022,2022.0
19,Denver (Big East),6,3-3,101,79,180,0.561,03/10/2022,2022.0
20,Yale (Ivy League),3,2-1,46,36,82,0.561,03/10/2022,2022.0
21,Lafayette (Patriot),5,2-3,81,65,146,0.555,03/10/2022,2022.0
22,Marquette (Big East),5,2-3,67,56,123,0.545,03/10/2022,2022.0
23,Binghamton (America East),5,2-3,75,63,138,0.543,03/10/2022,2022.0
24,Mercer (SoCon),7,3-4,101,85,186,0.543,03/10/2022,2022.0
25,LIU (NEC),6,3-3,76,64,140,0.543,03/10/2022,2022.0
26,Rutgers (Big Ten),6,6-0,96,81,177,0.542,03/10/2022,2022.0
27,Boston U. (Patriot),4,4-0,54,46,100,0.540,03/10/2022,2022.0
28,Massachusetts (CAA),5,2-3,74,64,138,0.536,03/10/2022,2022.0
29,North Carolina (ACC),7,5-2,108,97,205,0.527,03/10/2022,2022.0
30,UAlbany (America East),4,1-3,53,49,102,0.520,03/10/2022,2022.0
31,St. Bonaventure (MAAC),5,3-2,64,60,124,0.516,03/10/2022,2022.0
32,Richmond (SoCon),5,3-2,69,65,134,0.515,03/10/2022,2022.0
33,Cornell (Ivy League),4,4-0,54,51,105,0.514,03/10/2022,2022.0
34,Bryant (NEC),5,2-3,51,49,100,0.510,03/10/2022,2022.0
35,Navy (Patriot),6,3-3,70,68,138,0.507,03/10/2022,2022.0
36,Mount St. Mary's (NEC),8,3-5,94,92,186,0.505,03/10/2022,2022.0
37,Johns Hopkins (Big Ten),6,3-3,82,82,164,0.500,03/10/2022,2022.0
38,Loyola Maryland (Patriot),5,1-4,68,69,137,0.496,03/10/2022,2022.0
39,Holy Cross (Patriot),5,0-5,69,71,140,0.493,03/10/2022,2022.0
40,Robert Morris (ASUN),5,2-3,78,82,160,0.488,03/10/2022,2022.0
41,Hobart (NEC),4,2-2,65,69,134,0.485,03/10/2022,2022.0
42,Monmouth (MAAC),4,1-3,51,55,106,0.481,03/10/2022,2022.0
43,NJIT (America East),5,0-5,54,59,113,0.478,03/10/2022,2022.0
43,VMI (SoCon),5,2-3,54,59,113,0.478,03/10/2022,2022.0
45,Army West Point (Patriot),6,5-1,83,92,175,0.474,03/10/2022,2022.0
46,Utah (ASUN),4,3-1,52,58,110,0.473,03/10/2022,2022.0
47,Brown (Ivy League),5,4-1,72,84,156,0.462,03/10/2022,2022.0
48,Canisius (MAAC),7,1-6,96,116,212,0.453,03/10/2022,2022.0
49,Siena (MAAC),6,1-5,69,85,154,0.448,03/10/2022,2022.0
50,Hampton (SoCon),4,0-4,46,57,103,0.447,03/10/2022,2022.0
51,High Point (SoCon),6,3-3,76,97,173,0.439,03/10/2022,2022.0
52,Air Force (ASUN),6,2-4,68,88,156,0.436,03/10/2022,2022.0
52,Princeton (Ivy League),4,3-1,51,66,117,0.436,03/10/2022,2022.0
54,Providence (Big East),6,3-3,75,100,175,0.429,03/10/2022,2022.0
55,Towson (CAA),6,3-3,73,98,171,0.427,03/10/2022,2022.0
56,Penn St. (Big Ten),6,2-4,71,97,168,0.423,03/10/2022,2022.0
57,Jacksonville (SoCon),7,5-2,81,113,194,0.418,03/10/2022,2022.0
58,Hofstra (CAA),7,3-4,68,97,165,0.412,03/10/2022,2022.0
59,Notre Dame (ACC),3,1-2,33,48,81,0.407,03/10/2022,2022.0
60,Penn (Ivy League),3,2-1,29,43,72,0.403,03/10/2022,2022.0
61,UMass Lowell (America East),4,0-4,47,71,118,0.398,03/10/2022,2022.0
62,St. John's (NY) (Big East),5,1-4,54,82,136,0.397,03/10/2022,2022.0
63,Harvard (Ivy League),3,2-1,34,52,86,0.395,03/10/2022,2022.0
64,Sacred Heart (NEC),4,1-3,51,80,131,0.389,03/10/2022,2022.0
65,Wagner (NEC),4,1-3,33,52,85,0.388,03/10/2022,2022.0
66,Delaware (CAA),6,4-2,66,105,171,0.386,03/10/2022,2022.0
67,Bellarmine (ASUN),8,1-7,68,116,184,0.370,03/10/2022,2022.0
68,Cleveland St. (ASUN),4,1-3,35,61,96,0.365,03/10/2022,2022.0
69,Detroit Mercy (ASUN),4,0-4,36,73,109,0.330,03/10/2022,2022.0
70,Marist (MAAC),5,1-4,42,86,128,0.328,03/10/2022,2022.0
71,Drexel (CAA),5,3-2,44,91,135,0.326,03/10/2022,2022.0
72,Manhattan (MAAC),5,2-3,35,76,111,0.315,03/10/2022,2022.0
-,Merrimack (NEC),5,3-2,50,59,109,0.459,03/10/2022,2022.0
1,Ohio St. (Big Ten),5,4-1,107,41,148,0.723,03/09/2022,2022.0
2,Saint Joseph's (NEC),6,4-2,124,48,172,0.721,03/09/2022,2022.0
3,Lehigh (Patriot),4,2-2,57,29,86,0.663,03/09/2022,2022.0
4,Maryland (Big Ten),5,5-0,95,54,149,0.638,03/09/2022,2022.0
5,Georgetown (Big East),5,4-1,79,49,128,0.617,03/09/2022,2022.0
6,Vermont (America East),6,2-4,91,58,149,0.611,03/09/2022,2022.0
7,Virginia (ACC),5,5-0,91,61,152,0.599,03/09/2022,2022.0
8,Syracuse (ACC),5,2-3,99,69,168,0.589,03/09/2022,2022.0
9,Michigan (Big Ten),7,7-0,121,85,206,0.587,03/09/2022,2022.0
10,Bucknell (Patriot),5,5-0,91,65,156,0.583,03/09/2022,2022.0
11,Quinnipiac (MAAC),5,1-4,85,61,146,0.582,03/09/2022,2022.0
12,Mercer (SoCon),6,2-4,93,67,160,0.581,03/09/2022,2022.0
13,Stony Brook (America East),5,4-1,87,63,150,0.580,03/09/2022,2022.0
13,Colgate (Patriot),4,1-3,58,42,100,0.580,03/09/2022,2022.0
15,Duke (ACC),9,7-2,158,115,273,0.579,03/09/2022,2022.0
16,Villanova (Big East),5,3-2,81,59,140,0.579,03/09/2022,2022.0
17,UMBC (America East),3,1-2,39,29,68,0.574,03/09/2022,2022.0
18,Fairfield (CAA),6,3-3,103,80,183,0.563,03/09/2022,2022.0
19,Dartmouth (Ivy League),4,3-1,45,35,80,0.563,03/09/2022,2022.0
20,Denver (Big East),6,3-3,101,79,180,0.561,03/09/2022,2022.0
21,Yale (Ivy League),3,2-1,46,36,82,0.561,03/09/2022,2022.0
22,Lafayette (Patriot),5,2-3,81,65,146,0.555,03/09/2022,2022.0
23,Marquette (Big East),5,2-3,67,56,123,0.545,03/09/2022,2022.0
24,Binghamton (America East),5,2-3,75,63,138,0.543,03/09/2022,2022.0
25,LIU (NEC),6,3-3,76,64,140,0.543,03/09/2022,2022.0
26,Rutgers (Big Ten),6,6-0,96,81,177,0.542,03/09/2022,2022.0
27,Boston U. (Patriot),4,4-0,54,46,100,0.540,03/09/2022,2022.0
28,Massachusetts (CAA),5,2-3,74,64,138,0.536,03/09/2022,2022.0
29,North Carolina (ACC),6,5-1,92,83,175,0.526,03/09/2022,2022.0
30,UAlbany (America East),4,1-3,53,49,102,0.520,03/09/2022,2022.0
31,St. Bonaventure (MAAC),5,3-2,64,60,124,0.516,03/09/2022,2022.0
32,Richmond (SoCon),5,3-2,69,65,134,0.515,03/09/2022,2022.0
33,Cornell (Ivy League),4,4-0,54,51,105,0.514,03/09/2022,2022.0
34,Bryant (NEC),5,2-3,51,49,100,0.510,03/09/2022,2022.0
35,Navy (Patriot),6,3-3,70,68,138,0.507,03/09/2022,2022.0
36,Johns Hopkins (Big Ten),6,3-3,82,82,164,0.500,03/09/2022,2022.0
37,Loyola Maryland (Patriot),5,1-4,68,69,137,0.496,03/09/2022,2022.0
38,Holy Cross (Patriot),5,0-5,69,71,140,0.493,03/09/2022,2022.0
39,Robert Morris (ASUN),5,2-3,78,82,160,0.488,03/09/2022,2022.0
40,Hobart (NEC),4,2-2,65,69,134,0.485,03/09/2022,2022.0
41,Monmouth (MAAC),4,1-3,51,55,106,0.481,03/09/2022,2022.0
42,NJIT (America East),5,0-5,54,59,113,0.478,03/09/2022,2022.0
42,VMI (SoCon),5,2-3,54,59,113,0.478,03/09/2022,2022.0
44,Mount St. Mary's (NEC),7,3-4,76,84,160,0.475,03/09/2022,2022.0
45,Army West Point (Patriot),6,5-1,83,92,175,0.474,03/09/2022,2022.0
46,Utah (ASUN),4,3-1,52,58,110,0.473,03/09/2022,2022.0
47,Brown (Ivy League),5,4-1,72,84,156,0.462,03/09/2022,2022.0
48,Canisius (MAAC),7,1-6,96,116,212,0.453,03/09/2022,2022.0
49,Siena (MAAC),6,1-5,69,85,154,0.448,03/09/2022,2022.0
50,Hampton (SoCon),4,0-4,46,57,103,0.447,03/09/2022,2022.0
51,High Point (SoCon),6,3-3,76,97,173,0.439,03/09/2022,2022.0
52,Air Force (ASUN),6,2-4,68,88,156,0.436,03/09/2022,2022.0
52,Princeton (Ivy League),4,3-1,51,66,117,0.436,03/09/2022,2022.0
54,Providence (Big East),6,3-3,75,100,175,0.429,03/09/2022,2022.0
55,Towson (CAA),6,3-3,73,98,171,0.427,03/09/2022,2022.0
56,Penn St. (Big Ten),6,2-4,71,97,168,0.423,03/09/2022,2022.0
57,Jacksonville (SoCon),7,5-2,81,113,194,0.418,03/09/2022,2022.0
58,Hofstra (CAA),7,3-4,68,97,165,0.412,03/09/2022,2022.0
59,Notre Dame (ACC),3,1-2,33,48,81,0.407,03/09/2022,2022.0
60,Penn (Ivy League),3,2-1,29,43,72,0.403,03/09/2022,2022.0
61,UMass Lowell (America East),4,0-4,47,71,118,0.398,03/09/2022,2022.0
62,St. John's (NY) (Big East),5,1-4,54,82,136,0.397,03/09/2022,2022.0
63,Harvard (Ivy League),3,2-1,34,52,86,0.395,03/09/2022,2022.0
64,Sacred Heart (NEC),4,1-3,51,80,131,0.389,03/09/2022,2022.0
65,Wagner (NEC),4,1-3,33,52,85,0.388,03/09/2022,2022.0
66,Delaware (CAA),6,4-2,66,105,171,0.386,03/09/2022,2022.0
67,Bellarmine (ASUN),8,1-7,68,116,184,0.370,03/09/2022,2022.0
68,Cleveland St. (ASUN),4,1-3,35,61,96,0.365,03/09/2022,2022.0
69,Detroit Mercy (ASUN),4,0-4,36,73,109,0.330,03/09/2022,2022.0
70,Marist (MAAC),5,1-4,42,86,128,0.328,03/09/2022,2022.0
71,Drexel (CAA),5,3-2,44,91,135,0.326,03/09/2022,2022.0
72,Manhattan (MAAC),5,2-3,35,76,111,0.315,03/09/2022,2022.0
-,Merrimack (NEC),5,3-2,50,59,109,0.459,03/09/2022,2022.0
1,Ohio St. (Big Ten),5,4-1,107,41,148,0.723,03/08/2022,2022.0
2,Saint Joseph's (NEC),6,4-2,124,48,172,0.721,03/08/2022,2022.0
3,Lehigh (Patriot),4,2-2,57,29,86,0.663,03/08/2022,2022.0
4,Maryland (Big Ten),5,5-0,95,54,149,0.638,03/08/2022,2022.0
5,Georgetown (Big East),5,4-1,79,49,128,0.617,03/08/2022,2022.0
6,Vermont (America East),6,2-4,91,58,149,0.611,03/08/2022,2022.0
7,Virginia (ACC),5,5-0,91,61,152,0.599,03/08/2022,2022.0
8,Syracuse (ACC),5,2-3,99,69,168,0.589,03/08/2022,2022.0
9,Michigan (Big Ten),7,7-0,121,85,206,0.587,03/08/2022,2022.0
10,Bucknell (Patriot),5,5-0,91,65,156,0.583,03/08/2022,2022.0
11,Quinnipiac (MAAC),5,1-4,85,61,146,0.582,03/08/2022,2022.0
12,Mercer (SoCon),6,2-4,93,67,160,0.581,03/08/2022,2022.0
13,Stony Brook (America East),5,4-1,87,63,150,0.580,03/08/2022,2022.0
13,Colgate (Patriot),4,1-3,58,42,100,0.580,03/08/2022,2022.0
15,Duke (ACC),9,7-2,158,115,273,0.579,03/08/2022,2022.0
16,Villanova (Big East),5,3-2,81,59,140,0.579,03/08/2022,2022.0
17,UMBC (America East),3,1-2,39,29,68,0.574,03/08/2022,2022.0
18,Fairfield (CAA),6,3-3,103,80,183,0.563,03/08/2022,2022.0
19,Dartmouth (Ivy League),4,3-1,45,35,80,0.563,03/08/2022,2022.0
20,Denver (Big East),6,3-3,101,79,180,0.561,03/08/2022,2022.0
21,Yale (Ivy League),3,2-1,46,36,82,0.561,03/08/2022,2022.0
22,Lafayette (Patriot),5,2-3,81,65,146,0.555,03/08/2022,2022.0
23,Marquette (Big East),5,2-3,67,56,123,0.545,03/08/2022,2022.0
24,Binghamton (America East),5,2-3,75,63,138,0.543,03/08/2022,2022.0
25,LIU (NEC),6,3-3,76,64,140,0.543,03/08/2022,2022.0
26,Rutgers (Big Ten),6,6-0,96,81,177,0.542,03/08/2022,2022.0
27,Boston U. (Patriot),4,4-0,54,46,100,0.540,03/08/2022,2022.0
28,Massachusetts (CAA),5,2-3,74,64,138,0.536,03/08/2022,2022.0
29,North Carolina (ACC),6,5-1,92,83,175,0.526,03/08/2022,2022.0
30,UAlbany (America East),4,1-3,53,49,102,0.520,03/08/2022,2022.0
31,St. Bonaventure (MAAC),5,3-2,64,60,124,0.516,03/08/2022,2022.0
32,Richmond (SoCon),5,3-2,69,65,134,0.515,03/08/2022,2022.0
33,Cornell (Ivy League),4,4-0,54,51,105,0.514,03/08/2022,2022.0
34,Bryant (NEC),5,2-3,51,49,100,0.510,03/08/2022,2022.0
35,Navy (Patriot),6,3-3,70,68,138,0.507,03/08/2022,2022.0
36,Johns Hopkins (Big Ten),6,3-3,82,82,164,0.500,03/08/2022,2022.0
37,Loyola Maryland (Patriot),5,1-4,68,69,137,0.496,03/08/2022,2022.0
38,Robert Morris (ASUN),4,1-3,63,64,127,0.496,03/08/2022,2022.0
39,Holy Cross (Patriot),5,0-5,69,71,140,0.493,03/08/2022,2022.0
40,Hobart (NEC),4,2-2,65,69,134,0.485,03/08/2022,2022.0
41,Monmouth (MAAC),4,1-3,51,55,106,0.481,03/08/2022,2022.0
42,NJIT (America East),5,0-5,54,59,113,0.478,03/08/2022,2022.0
42,VMI (SoCon),5,2-3,54,59,113,0.478,03/08/2022,2022.0
44,Mount St. Mary's (NEC),7,3-4,76,84,160,0.475,03/08/2022,2022.0
45,Army West Point (Patriot),6,5-1,83,92,175,0.474,03/08/2022,2022.0
46,Utah (ASUN),4,3-1,52,58,110,0.473,03/08/2022,2022.0
47,Brown (Ivy League),5,4-1,72,84,156,0.462,03/08/2022,2022.0
48,Siena (MAAC),6,1-5,69,85,154,0.448,03/08/2022,2022.0
49,Hampton (SoCon),4,0-4,46,57,103,0.447,03/08/2022,2022.0
50,High Point (SoCon),6,3-3,76,97,173,0.439,03/08/2022,2022.0
51,Air Force (ASUN),6,2-4,68,88,156,0.436,03/08/2022,2022.0
51,Princeton (Ivy League),4,3-1,51,66,117,0.436,03/08/2022,2022.0
53,Canisius (MAAC),6,1-5,78,101,179,0.436,03/08/2022,2022.0
54,Providence (Big East),6,3-3,75,100,175,0.429,03/08/2022,2022.0
55,Towson (CAA),6,3-3,73,98,171,0.427,03/08/2022,2022.0
56,Penn St. (Big Ten),6,2-4,71,97,168,0.423,03/08/2022,2022.0
57,Jacksonville (SoCon),7,5-2,81,113,194,0.418,03/08/2022,2022.0
58,Hofstra (CAA),7,3-4,68,97,165,0.412,03/08/2022,2022.0
59,Notre Dame (ACC),3,1-2,33,48,81,0.407,03/08/2022,2022.0
60,Penn (Ivy League),3,2-1,29,43,72,0.403,03/08/2022,2022.0
61,UMass Lowell (America East),4,0-4,47,71,118,0.398,03/08/2022,2022.0
62,St. John's (NY) (Big East),5,1-4,54,82,136,0.397,03/08/2022,2022.0
63,Harvard (Ivy League),3,2-1,34,52,86,0.395,03/08/2022,2022.0
64,Sacred Heart (NEC),4,1-3,51,80,131,0.389,03/08/2022,2022.0
65,Wagner (NEC),4,1-3,33,52,85,0.388,03/08/2022,2022.0
66,Delaware (CAA),6,4-2,66,105,171,0.386,03/08/2022,2022.0
67,Bellarmine (ASUN),8,1-7,68,116,184,0.370,03/08/2022,2022.0
68,Cleveland St. (ASUN),4,1-3,35,61,96,0.365,03/08/2022,2022.0
69,Detroit Mercy (ASUN),4,0-4,36,73,109,0.330,03/08/2022,2022.0
70,Marist (MAAC),5,1-4,42,86,128,0.328,03/08/2022,2022.0
71,Drexel (CAA),5,3-2,44,91,135,0.326,03/08/2022,2022.0
72,Manhattan (MAAC),5,2-3,35,76,111,0.315,03/08/2022,2022.0
-,Merrimack (NEC),5,3-2,50,59,109,0.459,03/08/2022,2022.0
1,Ohio St. (Big Ten),5,4-1,107,41,148,0.723,03/06/2022,2022.0
2,Saint Joseph's (NEC),5,4-1,97,39,136,0.713,03/06/2022,2022.0
3,Lehigh (Patriot),4,2-2,57,29,86,0.663,03/06/2022,2022.0
4,Maryland (Big Ten),5,5-0,95,54,149,0.638,03/06/2022,2022.0
5,Georgetown (Big East),5,4-1,79,49,128,0.617,03/06/2022,2022.0
6,Quinnipiac (MAAC),4,1-3,73,46,119,0.613,03/06/2022,2022.0
7,Vermont (America East),5,2-3,80,51,131,0.611,03/06/2022,2022.0
8,Virginia (ACC),5,5-0,91,61,152,0.599,03/06/2022,2022.0
9,Dartmouth (Ivy League),3,2-1,37,25,62,0.597,03/06/2022,2022.0
10,UAlbany (America East),3,1-2,46,32,78,0.590,03/06/2022,2022.0
11,Syracuse (ACC),5,2-3,99,69,168,0.589,03/06/2022,2022.0
12,Michigan (Big Ten),7,7-0,121,85,206,0.587,03/06/2022,2022.0
13,Bucknell (Patriot),5,5-0,91,65,156,0.583,03/06/2022,2022.0
14,Mercer (SoCon),6,2-4,93,67,160,0.581,03/06/2022,2022.0
15,Stony Brook (America East),5,4-1,87,63,150,0.580,03/06/2022,2022.0
15,Colgate (Patriot),4,1-3,58,42,100,0.580,03/06/2022,2022.0
17,Duke (ACC),9,7-2,158,115,273,0.579,03/06/2022,2022.0
18,Villanova (Big East),5,3-2,81,59,140,0.579,03/06/2022,2022.0
19,UMBC (America East),3,1-2,39,29,68,0.574,03/06/2022,2022.0
20,Fairfield (CAA),5,2-3,88,68,156,0.564,03/06/2022,2022.0
21,Denver (Big East),6,3-3,101,79,180,0.561,03/06/2022,2022.0
22,Yale (Ivy League),3,2-1,46,36,82,0.561,03/06/2022,2022.0
23,Lafayette (Patriot),5,2-3,81,65,146,0.555,03/06/2022,2022.0
24,Marquette (Big East),5,2-3,67,56,123,0.545,03/06/2022,2022.0
25,LIU (NEC),6,3-3,76,64,140,0.543,03/06/2022,2022.0
26,Rutgers (Big Ten),6,6-0,96,81,177,0.542,03/06/2022,2022.0
27,Boston U. (Patriot),4,4-0,54,46,100,0.540,03/06/2022,2022.0
28,North Carolina (ACC),6,5-1,92,83,175,0.526,03/06/2022,2022.0
29,Bryant (NEC),5,2-3,52,48,100,0.520,03/06/2022,2022.0
30,St. Bonaventure (MAAC),5,3-2,64,60,124,0.516,03/06/2022,2022.0
31,Richmond (SoCon),5,3-2,69,65,134,0.515,03/06/2022,2022.0
32,Cornell (Ivy League),4,4-0,54,51,105,0.514,03/06/2022,2022.0
33,Navy (Patriot),6,3-3,70,68,138,0.507,03/06/2022,2022.0
34,Johns Hopkins (Big Ten),6,3-3,82,82,164,0.500,03/06/2022,2022.0
34,Massachusetts (CAA),4,1-3,57,57,114,0.500,03/06/2022,2022.0
36,Loyola Maryland (Patriot),5,1-4,68,69,137,0.496,03/06/2022,2022.0
37,Robert Morris (ASUN),4,1-3,63,64,127,0.496,03/06/2022,2022.0
38,Holy Cross (Patriot),5,0-5,69,71,140,0.493,03/06/2022,2022.0
39,Hobart (NEC),4,2-2,65,69,134,0.485,03/06/2022,2022.0
40,Binghamton (America East),4,1-3,56,60,116,0.483,03/06/2022,2022.0
41,Monmouth (MAAC),4,1-3,51,55,106,0.481,03/06/2022,2022.0
42,NJIT (America East),5,0-5,54,59,113,0.478,03/06/2022,2022.0
42,VMI (SoCon),5,2-3,54,59,113,0.478,03/06/2022,2022.0
44,Mount St. Mary's (NEC),7,3-4,76,84,160,0.475,03/06/2022,2022.0
45,Army West Point (Patriot),6,5-1,83,92,175,0.474,03/06/2022,2022.0
46,Utah (ASUN),4,3-1,52,58,110,0.473,03/06/2022,2022.0
47,Brown (Ivy League),5,4-1,72,84,156,0.462,03/06/2022,2022.0
48,Hofstra (CAA),6,3-3,65,78,143,0.455,03/06/2022,2022.0
49,Siena (MAAC),6,1-5,69,85,154,0.448,03/06/2022,2022.0
50,Hampton (SoCon),4,0-4,46,57,103,0.447,03/06/2022,2022.0
51,High Point (SoCon),6,3-3,76,97,173,0.439,03/06/2022,2022.0
52,Air Force (ASUN),6,2-4,68,88,156,0.436,03/06/2022,2022.0
52,Princeton (Ivy League),4,3-1,51,66,117,0.436,03/06/2022,2022.0
54,Canisius (MAAC),6,1-5,78,101,179,0.436,03/06/2022,2022.0
55,Towson (CAA),6,3-3,73,98,171,0.427,03/06/2022,2022.0
56,Sacred Heart (NEC),3,1-2,42,57,99,0.424,03/06/2022,2022.0
57,Penn St. (Big Ten),6,2-4,71,97,168,0.423,03/06/2022,2022.0
58,Jacksonville (SoCon),7,5-2,81,113,194,0.418,03/06/2022,2022.0
59,Notre Dame (ACC),3,1-2,33,48,81,0.407,03/06/2022,2022.0
60,Penn (Ivy League),3,2-1,29,43,72,0.403,03/06/2022,2022.0
61,UMass Lowell (America East),4,0-4,47,71,118,0.398,03/06/2022,2022.0
62,St. John's (NY) (Big East),5,1-4,54,82,136,0.397,03/06/2022,2022.0
63,Harvard (Ivy League),3,2-1,34,52,86,0.395,03/06/2022,2022.0
64,Wagner (NEC),4,1-3,33,52,85,0.388,03/06/2022,2022.0
65,Delaware (CAA),6,4-2,66,105,171,0.386,03/06/2022,2022.0
66,Bellarmine (ASUN),8,1-7,68,116,184,0.370,03/06/2022,2022.0
67,Cleveland St. (ASUN),4,1-3,35,61,96,0.365,03/06/2022,2022.0
68,Providence (Big East),5,2-3,52,91,143,0.364,03/06/2022,2022.0
69,Drexel (CAA),4,2-2,35,64,99,0.354,03/06/2022,2022.0
70,Detroit Mercy (ASUN),4,0-4,36,73,109,0.330,03/06/2022,2022.0
71,Marist (MAAC),5,1-4,42,86,128,0.328,03/06/2022,2022.0
72,Manhattan (MAAC),5,2-3,35,76,111,0.315,03/06/2022,2022.0
-,Merrimack (NEC),5,3-2,50,59,109,0.459,03/06/2022,2022.0
1,Ohio St. (Big Ten),4,4-0,94,25,119,0.790,03/02/2022,2022.0
2,Saint Joseph's (NEC),4,3-1,81,28,109,0.743,03/02/2022,2022.0
3,Mercer (SoCon),5,2-3,84,50,134,0.627,03/02/2022,2022.0
4,Vermont (America East),4,1-3,66,40,106,0.623,03/02/2022,2022.0
5,Maryland (Big Ten),4,4-0,77,48,125,0.616,03/02/2022,2022.0
6,Virginia (ACC),4,4-0,75,47,122,0.615,03/02/2022,2022.0
7,Quinnipiac (MAAC),4,1-3,73,46,119,0.613,03/02/2022,2022.0
8,Michigan (Big Ten),6,6-0,108,69,177,0.610,03/02/2022,2022.0
9,Lehigh (Patriot),3,1-2,39,25,64,0.609,03/02/2022,2022.0
10,Colgate (Patriot),3,1-2,44,29,73,0.603,03/02/2022,2022.0
11,Rutgers (Big Ten),5,5-0,84,56,140,0.600,03/02/2022,2022.0
12,Georgetown (Big East),4,4-0,63,43,106,0.594,03/02/2022,2022.0
13,UAlbany (America East),3,1-2,46,32,78,0.590,03/02/2022,2022.0
14,Duke (ACC),8,6-2,146,103,249,0.586,03/02/2022,2022.0
15,UMBC (America East),2,1-1,25,18,43,0.581,03/02/2022,2022.0
16,Yale (Ivy League),2,1-1,31,23,54,0.574,03/02/2022,2022.0
17,Bucknell (Patriot),4,4-0,71,53,124,0.573,03/02/2022,2022.0
18,Syracuse (ACC),4,1-3,74,56,130,0.569,03/02/2022,2022.0
19,Lafayette (Patriot),4,2-2,66,50,116,0.569,03/02/2022,2022.0
19,Navy (Patriot),5,3-2,66,50,116,0.569,03/02/2022,2022.0
21,Boston U. (Patriot),3,3-0,41,32,73,0.562,03/02/2022,2022.0
22,Denver (Big East),5,3-2,81,64,145,0.559,03/02/2022,2022.0
23,Fairfield (CAA),4,2-2,69,56,125,0.552,03/02/2022,2022.0
24,North Carolina (ACC),5,4-1,77,63,140,0.550,03/02/2022,2022.0
25,Villanova (Big East),4,2-2,67,55,122,0.549,03/02/2022,2022.0
26,Stony Brook (America East),4,4-0,62,51,113,0.549,03/02/2022,2022.0
27,Bryant (NEC),4,2-2,41,34,75,0.547,03/02/2022,2022.0
28,Hobart (NEC),3,2-1,52,44,96,0.542,03/02/2022,2022.0
29,Marquette (Big East),4,1-3,54,47,101,0.535,03/02/2022,2022.0
30,Hampton (SoCon),3,0-3,41,37,78,0.526,03/02/2022,2022.0
31,Binghamton (America East),3,1-2,44,40,84,0.524,03/02/2022,2022.0
32,LIU (NEC),5,3-2,62,57,119,0.521,03/02/2022,2022.0
33,Richmond (SoCon),4,3-1,57,53,110,0.518,03/02/2022,2022.0
34,Massachusetts (CAA),3,1-2,44,42,86,0.512,03/02/2022,2022.0
35,Johns Hopkins (Big Ten),5,3-2,68,66,134,0.507,03/02/2022,2022.0
36,Monmouth (MAAC),3,1-2,40,39,79,0.506,03/02/2022,2022.0
37,Cornell (Ivy League),3,3-0,38,38,76,0.500,03/02/2022,2022.0
37,Dartmouth (Ivy League),2,1-1,19,19,38,0.500,03/02/2022,2022.0
39,Loyola Maryland (Patriot),4,0-4,53,54,107,0.495,03/02/2022,2022.0
40,Mount St. Mary's (NEC),6,3-3,70,72,142,0.493,03/02/2022,2022.0
41,Army West Point (Patriot),5,4-1,73,76,149,0.490,03/02/2022,2022.0
42,Hofstra (CAA),5,3-2,61,64,125,0.488,03/02/2022,2022.0
43,Siena (MAAC),5,1-4,63,67,130,0.485,03/02/2022,2022.0
44,Princeton (Ivy League),3,2-1,45,50,95,0.474,03/02/2022,2022.0
44,Notre Dame (ACC),2,1-1,27,30,57,0.474,03/02/2022,2022.0
46,Holy Cross (Patriot),4,0-4,53,61,114,0.465,03/02/2022,2022.0
47,Robert Morris (ASUN),3,0-3,46,55,101,0.455,03/02/2022,2022.0
48,NJIT (America East),4,0-4,44,53,97,0.454,03/02/2022,2022.0
49,St. Bonaventure (MAAC),4,2-2,44,55,99,0.444,03/02/2022,2022.0
50,Brown (Ivy League),4,3-1,54,68,122,0.443,03/02/2022,2022.0
51,VMI (SoCon),4,1-3,42,53,95,0.442,03/02/2022,2022.0
52,Towson (CAA),5,2-3,62,84,146,0.425,03/02/2022,2022.0
53,Jacksonville (SoCon),6,5-1,70,95,165,0.424,03/02/2022,2022.0
53,Sacred Heart (NEC),3,1-2,42,57,99,0.424,03/02/2022,2022.0
55,Canisius (MAAC),5,1-4,65,89,154,0.422,03/02/2022,2022.0
56,Utah (ASUN),3,2-1,34,47,81,0.420,03/02/2022,2022.0
57,Air Force (ASUN),5,1-4,53,75,128,0.414,03/02/2022,2022.0
58,Penn St. (Big Ten),5,2-3,59,88,147,0.401,03/02/2022,2022.0
59,High Point (SoCon),5,2-3,60,90,150,0.400,03/02/2022,2022.0
59,Harvard (Ivy League),2,1-1,22,33,55,0.400,03/02/2022,2022.0
61,Penn (Ivy League),2,1-1,20,31,51,0.392,03/02/2022,2022.0
62,Wagner (NEC),3,0-3,27,42,69,0.391,03/02/2022,2022.0
63,Bellarmine (ASUN),7,1-6,61,100,161,0.379,03/02/2022,2022.0
64,Drexel (CAA),3,1-2,28,50,78,0.359,03/02/2022,2022.0
65,Delaware (CAA),5,4-1,50,92,142,0.352,03/02/2022,2022.0
66,Manhattan (MAAC),4,2-2,32,59,91,0.352,03/02/2022,2022.0
67,UMass Lowell (America East),3,0-3,31,59,90,0.344,03/02/2022,2022.0
68,Providence (Big East),4,2-2,36,73,109,0.330,03/02/2022,2022.0
69,Cleveland St. (ASUN),3,0-3,23,48,71,0.324,03/02/2022,2022.0
70,St. John's (NY) (Big East),4,0-4,37,79,116,0.319,03/02/2022,2022.0
71,Detroit Mercy (ASUN),3,0-3,27,60,87,0.310,03/02/2022,2022.0
72,Marist (MAAC),4,1-3,29,71,100,0.290,03/02/2022,2022.0
-,Merrimack (NEC),4,2-2,38,43,81,0.469,03/02/2022,2022.0
1,Ohio St. (Big Ten),4,4-0,94,25,119,0.790,02/28/2022,2022.0
2,Saint Joseph's (NEC),4,3-1,81,28,109,0.743,02/28/2022,2022.0
3,Mercer (SoCon),5,2-3,84,50,134,0.627,02/28/2022,2022.0
4,Michigan (Big Ten),5,5-0,94,57,151,0.623,02/28/2022,2022.0
5,Vermont (America East),4,1-3,66,41,107,0.617,02/28/2022,2022.0
6,Maryland (Big Ten),4,4-0,77,48,125,0.616,02/28/2022,2022.0
7,Virginia (ACC),4,4-0,75,47,122,0.615,02/28/2022,2022.0
8,Quinnipiac (MAAC),4,1-3,73,46,119,0.613,02/28/2022,2022.0
9,Lehigh (Patriot),3,1-2,39,25,64,0.609,02/28/2022,2022.0
10,Colgate (Patriot),3,1-2,44,29,73,0.603,02/28/2022,2022.0
11,Rutgers (Big Ten),5,5-0,84,56,140,0.600,02/28/2022,2022.0
12,UAlbany (America East),2,0-2,34,23,57,0.596,02/28/2022,2022.0
13,Georgetown (Big East),3,3-0,47,32,79,0.595,02/28/2022,2022.0
14,Hobart (NEC),2,2-0,39,27,66,0.591,02/28/2022,2022.0
15,UMBC (America East),2,1-1,25,18,43,0.581,02/28/2022,2022.0
16,Duke (ACC),7,5-2,123,91,214,0.575,02/28/2022,2022.0
17,Yale (Ivy League),2,1-1,31,23,54,0.574,02/28/2022,2022.0
18,Bucknell (Patriot),4,4-0,71,53,124,0.573,02/28/2022,2022.0
19,Lafayette (Patriot),4,2-2,66,50,116,0.569,02/28/2022,2022.0
19,Navy (Patriot),5,3-2,66,50,116,0.569,02/28/2022,2022.0
21,Boston U. (Patriot),3,3-0,41,32,73,0.562,02/28/2022,2022.0
22,Marquette (Big East),3,1-2,42,33,75,0.560,02/28/2022,2022.0
23,Denver (Big East),5,3-2,81,64,145,0.559,02/28/2022,2022.0
24,Villanova (Big East),3,2-1,50,40,90,0.556,02/28/2022,2022.0
25,North Carolina (ACC),5,4-1,77,63,140,0.550,02/28/2022,2022.0
26,Stony Brook (America East),4,4-0,62,51,113,0.549,02/28/2022,2022.0
27,Bryant (NEC),3,1-2,41,34,75,0.547,02/28/2022,2022.0
28,Syracuse (ACC),3,1-2,52,45,97,0.536,02/28/2022,2022.0
29,Richmond (SoCon),3,2-1,46,40,86,0.535,02/28/2022,2022.0
30,Army West Point (Patriot),4,3-1,62,54,116,0.534,02/28/2022,2022.0
31,Hampton (SoCon),3,0-3,41,37,78,0.526,02/28/2022,2022.0
32,Binghamton (America East),3,1-2,44,40,84,0.524,02/28/2022,2022.0
33,LIU (NEC),5,3-2,62,57,119,0.521,02/28/2022,2022.0
34,Mount St. Mary's (NEC),5,3-2,59,56,115,0.513,02/28/2022,2022.0
35,Fairfield (CAA),3,1-2,44,42,86,0.512,02/28/2022,2022.0
35,Massachusetts (CAA),3,1-2,44,42,86,0.512,02/28/2022,2022.0
37,Johns Hopkins (Big Ten),5,3-2,68,66,134,0.507,02/28/2022,2022.0
38,Dartmouth (Ivy League),2,1-1,19,19,38,0.500,02/28/2022,2022.0
39,Siena (MAAC),4,1-3,54,55,109,0.495,02/28/2022,2022.0
40,Hofstra (CAA),5,3-2,61,64,125,0.488,02/28/2022,2022.0
41,Princeton (Ivy League),3,2-1,45,50,95,0.474,02/28/2022,2022.0
41,Notre Dame (ACC),2,1-1,27,30,57,0.474,02/28/2022,2022.0
43,Sacred Heart (NEC),2,1-1,28,32,60,0.467,02/28/2022,2022.0
44,Holy Cross (Patriot),4,0-4,53,61,114,0.465,02/28/2022,2022.0
45,Monmouth (MAAC),2,0-2,27,32,59,0.458,02/28/2022,2022.0
46,Cornell (Ivy League),2,2-0,21,25,46,0.457,02/28/2022,2022.0
47,Robert Morris (ASUN),3,0-3,46,55,101,0.455,02/28/2022,2022.0
48,NJIT (America East),4,0-4,44,53,97,0.454,02/28/2022,2022.0
49,Loyola Maryland (Patriot),3,0-3,38,46,84,0.452,02/28/2022,2022.0
50,VMI (SoCon),4,1-3,42,53,95,0.442,02/28/2022,2022.0
51,Brown (Ivy League),3,2-1,40,51,91,0.440,02/28/2022,2022.0
52,Towson (CAA),4,1-3,54,69,123,0.439,02/28/2022,2022.0
53,Jacksonville (SoCon),6,5-1,70,95,165,0.424,02/28/2022,2022.0
54,Canisius (MAAC),5,1-4,65,89,154,0.422,02/28/2022,2022.0
55,Utah (ASUN),3,2-1,34,47,81,0.420,02/28/2022,2022.0
56,High Point (SoCon),4,2-2,48,67,115,0.417,02/28/2022,2022.0
57,Air Force (ASUN),5,1-4,53,75,128,0.414,02/28/2022,2022.0
58,St. Bonaventure (MAAC),3,2-1,31,44,75,0.413,02/28/2022,2022.0
59,Wagner (NEC),2,0-2,20,29,49,0.408,02/28/2022,2022.0
60,Penn St. (Big Ten),5,2-3,59,88,147,0.401,02/28/2022,2022.0
61,Harvard (Ivy League),2,1-1,22,33,55,0.400,02/28/2022,2022.0
62,Penn (Ivy League),2,1-1,20,31,51,0.392,02/28/2022,2022.0
63,Bellarmine (ASUN),6,1-5,61,100,161,0.379,02/28/2022,2022.0
64,Drexel (CAA),3,1-2,28,50,78,0.359,02/28/2022,2022.0
65,Delaware (CAA),5,4-1,50,92,142,0.352,02/28/2022,2022.0
66,Manhattan (MAAC),4,2-2,32,59,91,0.352,02/28/2022,2022.0
67,UMass Lowell (America East),3,0-3,31,59,90,0.344,02/28/2022,2022.0
68,Providence (Big East),4,2-2,36,73,109,0.330,02/28/2022,2022.0
69,Cleveland St. (ASUN),3,0-3,23,48,71,0.324,02/28/2022,2022.0
70,St. John's (NY) (Big East),4,0-4,37,79,116,0.319,02/28/2022,2022.0
71,Detroit Mercy (ASUN),3,0-3,27,60,87,0.310,02/28/2022,2022.0
72,Marist (MAAC),4,1-3,29,71,100,0.290,02/28/2022,2022.0
-,Merrimack (NEC),4,2-2,38,43,81,0.469,02/28/2022,2022.0
1,Ohio St. (Big Ten),3,3-0,72,16,88,0.818,02/23/2022,2022.0
2,Saint Joseph's (NEC),3,2-1,58,24,82,0.707,02/23/2022,2022.0
3,Vermont (America East),3,1-2,52,28,80,0.650,02/23/2022,2022.0
4,Notre Dame (ACC),1,1-0,18,10,28,0.643,02/23/2022,2022.0
5,Rutgers (Big Ten),4,4-0,71,40,111,0.640,02/23/2022,2022.0
6,Sacred Heart (NEC),1,0-1,21,12,33,0.636,02/23/2022,2022.0
7,Syracuse (ACC),2,1-1,41,24,65,0.631,02/23/2022,2022.0
8,Lehigh (Patriot),2,1-1,29,17,46,0.630,02/23/2022,2022.0
9,Mercer (SoCon),5,2-3,84,50,134,0.627,02/23/2022,2022.0
10,Michigan (Big Ten),4,4-0,82,49,131,0.626,02/23/2022,2022.0
11,UMBC (America East),1,1-0,14,9,23,0.609,02/23/2022,2022.0
12,Colgate (Patriot),3,1-2,44,29,73,0.603,02/23/2022,2022.0
13,Virginia (ACC),3,3-0,54,36,90,0.600,02/23/2022,2022.0
14,Maryland (Big Ten),3,3-0,57,39,96,0.594,02/23/2022,2022.0
15,Bryant (NEC),2,1-1,32,22,54,0.593,02/23/2022,2022.0
16,Lafayette (Patriot),3,2-1,52,36,88,0.591,02/23/2022,2022.0
16,Hobart (NEC),2,2-0,39,27,66,0.591,02/23/2022,2022.0
18,Fairfield (CAA),2,1-1,34,24,58,0.586,02/23/2022,2022.0
19,Richmond (SoCon),2,1-1,29,21,50,0.580,02/23/2022,2022.0
20,Quinnipiac (MAAC),3,1-2,53,39,92,0.576,02/23/2022,2022.0
21,Boston U. (Patriot),2,2-0,27,20,47,0.574,02/23/2022,2022.0
22,Duke (ACC),6,5-1,106,79,185,0.573,02/23/2022,2022.0
23,Navy (Patriot),4,3-1,48,38,86,0.558,02/23/2022,2022.0
24,Denver (Big East),3,2-1,49,39,88,0.557,02/23/2022,2022.0
25,Johns Hopkins (Big Ten),4,3-1,58,47,105,0.552,02/23/2022,2022.0
26,Bucknell (Patriot),3,3-0,54,44,98,0.551,02/23/2022,2022.0
26,Hampton (SoCon),2,0-2,27,22,49,0.551,02/23/2022,2022.0
28,Princeton (Ivy League),2,2-0,36,30,66,0.545,02/23/2022,2022.0
29,Harvard (Ivy League),1,1-0,13,11,24,0.542,02/23/2022,2022.0
30,Georgetown (Big East),2,2-0,27,23,50,0.540,02/23/2022,2022.0
30,Marquette (Big East),2,1-1,27,23,50,0.540,02/23/2022,2022.0
32,Binghamton (America East),2,0-2,30,26,56,0.536,02/23/2022,2022.0
32,UAlbany (America East),1,0-1,15,13,28,0.536,02/23/2022,2022.0
34,Massachusetts (CAA),2,1-1,32,28,60,0.533,02/23/2022,2022.0
35,Mount St. Mary's (NEC),4,2-2,50,45,95,0.526,02/23/2022,2022.0
36,North Carolina (ACC),4,3-1,58,53,111,0.523,02/23/2022,2022.0
37,Villanova (Big East),2,1-1,32,30,62,0.516,02/23/2022,2022.0
38,Stony Brook (America East),2,2-0,33,31,64,0.516,02/23/2022,2022.0
39,Army West Point (Patriot),3,2-1,46,45,91,0.505,02/23/2022,2022.0
40,Yale (Ivy League),1,1-0,17,17,34,0.500,02/23/2022,2022.0
41,LIU (NEC),3,2-1,35,37,72,0.486,02/23/2022,2022.0
41,NJIT (America East),3,0-3,35,37,72,0.486,02/23/2022,2022.0
43,Hofstra (CAA),3,2-1,36,39,75,0.480,02/23/2022,2022.0
44,Holy Cross (Patriot),3,0-3,43,49,92,0.467,02/23/2022,2022.0
45,Cornell (Ivy League),1,1-0,13,15,28,0.464,02/23/2022,2022.0
46,Robert Morris (ASUN),3,0-3,46,55,101,0.455,02/23/2022,2022.0
47,Canisius (MAAC),3,1-2,46,57,103,0.447,02/23/2022,2022.0
48,Monmouth (MAAC),1,0-1,14,18,32,0.438,02/23/2022,2022.0
49,VMI (SoCon),3,1-2,32,42,74,0.432,02/23/2022,2022.0
50,Utah (ASUN),2,1-1,24,32,56,0.429,02/23/2022,2022.0
51,Siena (MAAC),3,0-3,35,47,82,0.427,02/23/2022,2022.0
52,High Point (SoCon),3,1-2,36,49,85,0.424,02/23/2022,2022.0
53,Brown (Ivy League),2,1-1,27,37,64,0.422,02/23/2022,2022.0
54,Penn St. (Big Ten),4,1-3,53,74,127,0.417,02/23/2022,2022.0
55,Dartmouth (Ivy League),1,0-1,7,10,17,0.412,02/23/2022,2022.0
56,Towson (CAA),3,1-2,35,52,87,0.402,02/23/2022,2022.0
57,Loyola Maryland (Patriot),2,0-2,22,33,55,0.400,02/23/2022,2022.0
58,Jacksonville (SoCon),4,3-1,45,70,115,0.391,02/23/2022,2022.0
59,Providence (Big East),3,2-1,32,50,82,0.390,02/23/2022,2022.0
60,Wagner (NEC),1,0-1,11,18,29,0.379,02/23/2022,2022.0
61,St. Bonaventure (MAAC),2,1-1,20,34,54,0.370,02/23/2022,2022.0
62,Drexel (CAA),2,0-2,18,31,49,0.367,02/23/2022,2022.0
63,UMass Lowell (America East),2,0-2,23,40,63,0.365,02/23/2022,2022.0
64,Penn (Ivy League),1,0-1,8,14,22,0.364,02/23/2022,2022.0
65,Bellarmine (ASUN),5,0-5,46,86,132,0.348,02/23/2022,2022.0
66,Air Force (ASUN),3,0-3,28,56,84,0.333,02/23/2022,2022.0
67,Delaware (CAA),4,3-1,36,79,115,0.313,02/23/2022,2022.0
68,Detroit Mercy (ASUN),3,0-3,27,60,87,0.310,02/23/2022,2022.0
69,St. John's (NY) (Big East),2,0-2,19,45,64,0.297,02/23/2022,2022.0
70,Manhattan (MAAC),3,1-2,21,50,71,0.296,02/23/2022,2022.0
71,Cleveland St. (ASUN),2,0-2,15,36,51,0.294,02/23/2022,2022.0
72,Marist (MAAC),3,1-2,20,54,74,0.270,02/23/2022,2022.0
-,Merrimack (NEC),3,1-2,26,33,59,0.441,02/23/2022,2022.0
1,Ohio St. (Big Ten),3,3-0,72,16,88,0.818,02/21/2022,2022.0
2,Saint Joseph's (NEC),3,2-1,58,24,82,0.707,02/21/2022,2022.0
3,Vermont (America East),3,1-2,52,28,80,0.650,02/21/2022,2022.0
4,Michigan (Big Ten),3,3-0,61,33,94,0.649,02/21/2022,2022.0
5,Notre Dame (ACC),1,1-0,18,10,28,0.643,02/21/2022,2022.0
6,Rutgers (Big Ten),4,4-0,71,40,111,0.640,02/21/2022,2022.0
7,Sacred Heart (NEC),1,0-1,21,12,33,0.636,02/21/2022,2022.0
7,Binghamton (America East),1,0-1,14,8,22,0.636,02/21/2022,2022.0
9,Syracuse (ACC),2,1-1,41,24,65,0.631,02/21/2022,2022.0
10,Lehigh (Patriot),2,1-1,29,17,46,0.630,02/21/2022,2022.0
11,Mercer (SoCon),5,2-3,84,50,134,0.627,02/21/2022,2022.0
12,UMBC (America East),1,1-0,14,9,23,0.609,02/21/2022,2022.0
13,Colgate (Patriot),3,1-2,44,29,73,0.603,02/21/2022,2022.0
14,Virginia (ACC),3,3-0,54,36,90,0.600,02/21/2022,2022.0
15,Maryland (Big Ten),3,3-0,57,39,96,0.594,02/21/2022,2022.0
16,Bryant (NEC),2,1-1,32,22,54,0.593,02/21/2022,2022.0
17,Hobart (NEC),2,2-0,39,27,66,0.591,02/21/2022,2022.0
18,Fairfield (CAA),2,1-1,34,24,58,0.586,02/21/2022,2022.0
19,Richmond (SoCon),2,1-1,29,21,50,0.580,02/21/2022,2022.0
20,Quinnipiac (MAAC),3,1-2,53,39,92,0.576,02/21/2022,2022.0
21,Boston U. (Patriot),2,2-0,27,20,47,0.574,02/21/2022,2022.0
22,Lafayette (Patriot),2,1-1,35,27,62,0.565,02/21/2022,2022.0
23,Princeton (Ivy League),1,1-0,18,14,32,0.563,02/21/2022,2022.0
24,Navy (Patriot),4,3-1,48,38,86,0.558,02/21/2022,2022.0
25,Denver (Big East),3,2-1,49,39,88,0.557,02/21/2022,2022.0
26,Brown (Ivy League),1,1-0,20,16,36,0.556,02/21/2022,2022.0
27,Johns Hopkins (Big Ten),4,3-1,58,47,105,0.552,02/21/2022,2022.0
28,Bucknell (Patriot),3,3-0,54,44,98,0.551,02/21/2022,2022.0
28,Hampton (SoCon),2,0-2,27,22,49,0.551,02/21/2022,2022.0
30,Harvard (Ivy League),1,1-0,13,11,24,0.542,02/21/2022,2022.0
31,Georgetown (Big East),2,2-0,27,23,50,0.540,02/21/2022,2022.0
31,Marquette (Big East),2,1-1,27,23,50,0.540,02/21/2022,2022.0
33,UAlbany (America East),1,0-1,15,13,28,0.536,02/21/2022,2022.0
34,Massachusetts (CAA),2,1-1,32,28,60,0.533,02/21/2022,2022.0
35,Mount St. Mary's (NEC),4,2-2,50,45,95,0.526,02/21/2022,2022.0
36,Duke (ACC),5,4-1,77,71,148,0.520,02/21/2022,2022.0
37,Villanova (Big East),2,1-1,32,30,62,0.516,02/21/2022,2022.0
38,Stony Brook (America East),2,2-0,33,31,64,0.516,02/21/2022,2022.0
39,Yale (Ivy League),1,1-0,17,17,34,0.500,02/21/2022,2022.0
40,LIU (NEC),3,2-1,35,37,72,0.486,02/21/2022,2022.0
40,NJIT (America East),3,0-3,35,37,72,0.486,02/21/2022,2022.0
42,Hofstra (CAA),3,2-1,36,39,75,0.480,02/21/2022,2022.0
43,Army West Point (Patriot),2,1-1,27,30,57,0.474,02/21/2022,2022.0
44,Holy Cross (Patriot),3,0-3,43,49,92,0.467,02/21/2022,2022.0
45,Cornell (Ivy League),1,1-0,13,15,28,0.464,02/21/2022,2022.0
46,Robert Morris (ASUN),3,0-3,46,55,101,0.455,02/21/2022,2022.0
47,Canisius (MAAC),2,1-1,30,36,66,0.455,02/21/2022,2022.0
48,North Carolina (ACC),3,2-1,37,46,83,0.446,02/21/2022,2022.0
49,Monmouth (MAAC),1,0-1,14,18,32,0.438,02/21/2022,2022.0
50,VMI (SoCon),3,1-2,32,42,74,0.432,02/21/2022,2022.0
51,Utah (ASUN),2,1-1,24,32,56,0.429,02/21/2022,2022.0
52,High Point (SoCon),3,1-2,36,49,85,0.424,02/21/2022,2022.0
53,Penn St. (Big Ten),4,1-3,53,74,127,0.417,02/21/2022,2022.0
54,Siena (MAAC),2,0-2,20,28,48,0.417,02/21/2022,2022.0
55,Dartmouth (Ivy League),1,0-1,7,10,17,0.412,02/21/2022,2022.0
56,Towson (CAA),3,1-2,35,52,87,0.402,02/21/2022,2022.0
57,Loyola Maryland (Patriot),2,0-2,22,33,55,0.400,02/21/2022,2022.0
58,Jacksonville (SoCon),4,3-1,45,70,115,0.391,02/21/2022,2022.0
58,Drexel (CAA),1,0-1,9,14,23,0.391,02/21/2022,2022.0
60,Providence (Big East),3,2-1,32,50,82,0.390,02/21/2022,2022.0
61,Wagner (NEC),1,0-1,11,18,29,0.379,02/21/2022,2022.0
62,UMass Lowell (America East),2,0-2,23,40,63,0.365,02/21/2022,2022.0
63,Penn (Ivy League),1,0-1,8,14,22,0.364,02/21/2022,2022.0
64,Delaware (CAA),3,3-0,28,50,78,0.359,02/21/2022,2022.0
65,Air Force (ASUN),3,0-3,28,56,84,0.333,02/21/2022,2022.0
66,Detroit Mercy (ASUN),3,0-3,27,60,87,0.310,02/21/2022,2022.0
67,Bellarmine (ASUN),4,0-4,32,72,104,0.308,02/21/2022,2022.0
68,St. John's (NY) (Big East),2,0-2,19,45,64,0.297,02/21/2022,2022.0
69,Manhattan (MAAC),3,1-2,21,50,71,0.296,02/21/2022,2022.0
70,Cleveland St. (ASUN),2,0-2,15,36,51,0.294,02/21/2022,2022.0
71,Marist (MAAC),3,1-2,20,54,74,0.270,02/21/2022,2022.0
72,St. Bonaventure (MAAC),1,0-1,6,20,26,0.231,02/21/2022,2022.0
-,Merrimack (NEC),3,1-2,26,33,59,0.441,02/21/2022,2022.0
1,Ohio St. (Big Ten),3,3-0,72,16,88,0.818,02/20/2022,2022.0
2,Saint Joseph's (NEC),3,2-1,58,24,82,0.707,02/20/2022,2022.0
3,Vermont (America East),3,1-2,52,28,80,0.650,02/20/2022,2022.0
4,Michigan (Big Ten),3,3-0,61,33,94,0.649,02/20/2022,2022.0
5,Notre Dame (ACC),1,1-0,18,10,28,0.643,02/20/2022,2022.0
6,Rutgers (Big Ten),4,4-0,71,40,111,0.640,02/20/2022,2022.0
7,Sacred Heart (NEC),1,0-1,21,12,33,0.636,02/20/2022,2022.0
7,Binghamton (America East),1,0-1,14,8,22,0.636,02/20/2022,2022.0
9,Syracuse (ACC),2,1-1,41,24,65,0.631,02/20/2022,2022.0
10,Lehigh (Patriot),2,1-1,29,17,46,0.630,02/20/2022,2022.0
11,Mercer (SoCon),5,2-3,84,50,134,0.627,02/20/2022,2022.0
12,UMBC (America East),1,1-0,14,9,23,0.609,02/20/2022,2022.0
13,Colgate (Patriot),3,1-2,44,29,73,0.603,02/20/2022,2022.0
14,Virginia (ACC),3,3-0,54,36,90,0.600,02/20/2022,2022.0
15,Maryland (Big Ten),3,3-0,57,39,96,0.594,02/20/2022,2022.0
16,Bryant (NEC),2,1-1,32,22,54,0.593,02/20/2022,2022.0
17,Hobart (NEC),2,2-0,39,27,66,0.591,02/20/2022,2022.0
18,Fairfield (CAA),2,1-1,34,24,58,0.586,02/20/2022,2022.0
19,Richmond (SoCon),2,1-1,29,21,50,0.580,02/20/2022,2022.0
20,Quinnipiac (MAAC),3,1-2,53,39,92,0.576,02/20/2022,2022.0
21,Boston U. (Patriot),2,2-0,27,20,47,0.574,02/20/2022,2022.0
22,Lafayette (Patriot),2,1-1,35,27,62,0.565,02/20/2022,2022.0
23,Princeton (Ivy League),1,1-0,18,14,32,0.563,02/20/2022,2022.0
24,Navy (Patriot),4,3-1,48,38,86,0.558,02/20/2022,2022.0
25,Denver (Big East),3,2-1,49,39,88,0.557,02/20/2022,2022.0
26,Brown (Ivy League),1,1-0,20,16,36,0.556,02/20/2022,2022.0
27,Johns Hopkins (Big Ten),4,3-1,58,47,105,0.552,02/20/2022,2022.0
28,Bucknell (Patriot),3,3-0,54,44,98,0.551,02/20/2022,2022.0
29,Harvard (Ivy League),1,1-0,13,11,24,0.542,02/20/2022,2022.0
30,Georgetown (Big East),2,2-0,27,23,50,0.540,02/20/2022,2022.0
30,Marquette (Big East),2,1-1,27,23,50,0.540,02/20/2022,2022.0
32,UAlbany (America East),1,0-1,15,13,28,0.536,02/20/2022,2022.0
33,Massachusetts (CAA),2,1-1,32,28,60,0.533,02/20/2022,2022.0
34,Mount St. Mary's (NEC),4,2-2,50,45,95,0.526,02/20/2022,2022.0
35,Duke (ACC),5,4-1,77,71,148,0.520,02/20/2022,2022.0
36,Villanova (Big East),2,1-1,32,30,62,0.516,02/20/2022,2022.0
37,Stony Brook (America East),2,2-0,33,31,64,0.516,02/20/2022,2022.0
38,Yale (Ivy League),1,1-0,17,17,34,0.500,02/20/2022,2022.0
39,LIU (NEC),3,2-1,35,37,72,0.486,02/20/2022,2022.0
39,NJIT (America East),3,0-3,35,37,72,0.486,02/20/2022,2022.0
41,Hofstra (CAA),3,2-1,36,39,75,0.480,02/20/2022,2022.0
41,VMI (SoCon),2,0-2,24,26,50,0.480,02/20/2022,2022.0
43,Army West Point (Patriot),2,1-1,27,30,57,0.474,02/20/2022,2022.0
44,Holy Cross (Patriot),3,0-3,43,49,92,0.467,02/20/2022,2022.0
45,Cornell (Ivy League),1,1-0,13,15,28,0.464,02/20/2022,2022.0
46,Robert Morris (ASUN),3,0-3,46,55,101,0.455,02/20/2022,2022.0
47,Canisius (MAAC),2,1-1,30,36,66,0.455,02/20/2022,2022.0
48,North Carolina (ACC),3,2-1,37,46,83,0.446,02/20/2022,2022.0
49,Hampton (SoCon),1,0-1,11,14,25,0.440,02/20/2022,2022.0
50,Monmouth (MAAC),1,0-1,14,18,32,0.438,02/20/2022,2022.0
51,Utah (ASUN),2,1-1,24,32,56,0.429,02/20/2022,2022.0
52,High Point (SoCon),3,1-2,36,49,85,0.424,02/20/2022,2022.0
53,Penn St. (Big Ten),4,1-3,53,74,127,0.417,02/20/2022,2022.0
54,Siena (MAAC),2,0-2,20,28,48,0.417,02/20/2022,2022.0
55,Dartmouth (Ivy League),1,0-1,7,10,17,0.412,02/20/2022,2022.0
56,Towson (CAA),3,1-2,35,52,87,0.402,02/20/2022,2022.0
57,Loyola Maryland (Patriot),2,0-2,22,33,55,0.400,02/20/2022,2022.0
58,Jacksonville (SoCon),4,3-1,45,70,115,0.391,02/20/2022,2022.0
58,Drexel (CAA),1,0-1,9,14,23,0.391,02/20/2022,2022.0
60,Providence (Big East),3,2-1,32,50,82,0.390,02/20/2022,2022.0
61,Wagner (NEC),1,0-1,11,18,29,0.379,02/20/2022,2022.0
62,UMass Lowell (America East),2,0-2,23,40,63,0.365,02/20/2022,2022.0
63,Penn (Ivy League),1,0-1,8,14,22,0.364,02/20/2022,2022.0
64,Delaware (CAA),3,3-0,28,50,78,0.359,02/20/2022,2022.0
65,Air Force (ASUN),3,0-3,28,56,84,0.333,02/20/2022,2022.0
66,Detroit Mercy (ASUN),3,0-3,27,60,87,0.310,02/20/2022,2022.0
67,Bellarmine (ASUN),4,0-4,32,72,104,0.308,02/20/2022,2022.0
68,St. John's (NY) (Big East),2,0-2,19,45,64,0.297,02/20/2022,2022.0
69,Manhattan (MAAC),3,1-2,21,50,71,0.296,02/20/2022,2022.0
70,Cleveland St. (ASUN),2,0-2,15,36,51,0.294,02/20/2022,2022.0
71,Marist (MAAC),3,1-2,20,54,74,0.270,02/20/2022,2022.0
72,St. Bonaventure (MAAC),1,0-1,6,20,26,0.231,02/20/2022,2022.0
-,Merrimack (NEC),3,1-2,26,33,59,0.441,02/20/2022,2022.0
1,Ohio St. (Big Ten),2,2-0,50,7,57,0.877,02/17/2022,2022.0
2,Lehigh (Patriot),1,1-0,15,3,18,0.833,02/17/2022,2022.0
3,Saint Joseph's (NEC),2,1-1,38,14,52,0.731,02/17/2022,2022.0
4,Syracuse (ACC),1,1-0,26,11,37,0.703,02/17/2022,2022.0
5,Michigan (Big Ten),2,2-0,46,21,67,0.687,02/17/2022,2022.0
6,Mercer (SoCon),4,1-3,74,37,111,0.667,02/17/2022,2022.0
6,Rutgers (Big Ten),3,3-0,56,28,84,0.667,02/17/2022,2022.0
6,Bryant (NEC),1,1-0,20,10,30,0.667,02/17/2022,2022.0
9,Boston U. (Patriot),1,1-0,15,8,23,0.652,02/17/2022,2022.0
10,Maryland (Big Ten),2,2-0,44,24,68,0.647,02/17/2022,2022.0
11,Sacred Heart (NEC),1,0-1,21,12,33,0.636,02/17/2022,2022.0
12,Virginia (ACC),2,2-0,37,23,60,0.617,02/17/2022,2022.0
13,Denver (Big East),2,2-0,35,22,57,0.614,02/17/2022,2022.0
14,Marquette (Big East),1,1-0,13,9,22,0.591,02/17/2022,2022.0
15,Lafayette (Patriot),2,1-1,35,27,62,0.565,02/17/2022,2022.0
16,Fairfield (CAA),1,0-1,16,13,29,0.552,02/17/2022,2022.0
17,North Carolina (ACC),2,2-0,28,24,52,0.538,02/17/2022,2022.0
18,Colgate (Patriot),2,0-2,26,24,50,0.520,02/17/2022,2022.0
19,Mount St. Mary's (NEC),3,1-2,36,34,70,0.514,02/17/2022,2022.0
20,Duke (ACC),4,3-1,60,57,117,0.513,02/17/2022,2022.0
21,Army West Point (Patriot),1,1-0,15,15,30,0.500,02/17/2022,2022.0
21,Massachusetts (CAA),1,0-1,15,15,30,0.500,02/17/2022,2022.0
23,Navy (Patriot),2,1-1,22,23,45,0.489,02/17/2022,2022.0
24,Holy Cross (Patriot),2,0-2,31,34,65,0.477,02/17/2022,2022.0
25,Robert Morris (ASUN),2,0-2,31,35,66,0.470,02/17/2022,2022.0
26,Georgetown (Big East),1,1-0,13,15,28,0.464,02/17/2022,2022.0
27,Stony Brook (America East),1,1-0,13,16,29,0.448,02/17/2022,2022.0
28,Penn St. (Big Ten),3,1-2,43,54,97,0.443,02/17/2022,2022.0
29,Utah (ASUN),2,1-1,24,32,56,0.429,02/17/2022,2022.0
30,High Point (SoCon),3,1-2,36,49,85,0.424,02/17/2022,2022.0
31,Towson (CAA),2,1-1,22,35,57,0.386,02/17/2022,2022.0
32,Air Force (ASUN),2,0-2,23,38,61,0.377,02/17/2022,2022.0
33,Richmond (SoCon),1,0-1,9,16,25,0.360,02/17/2022,2022.0
34,Delaware (CAA),3,3-0,28,50,78,0.359,02/17/2022,2022.0
35,Manhattan (MAAC),2,1-1,19,34,53,0.358,02/17/2022,2022.0
36,Jacksonville (SoCon),3,2-1,31,56,87,0.356,02/17/2022,2022.0
37,Canisius (MAAC),1,0-1,13,25,38,0.342,02/17/2022,2022.0
38,Providence (Big East),2,1-1,18,40,58,0.310,02/17/2022,2022.0
39,Marist (MAAC),2,1-1,15,34,49,0.306,02/17/2022,2022.0
40,UMass Lowell (America East),1,0-1,10,23,33,0.303,02/17/2022,2022.0
41,Loyola Maryland (Patriot),1,0-1,9,22,31,0.290,02/17/2022,2022.0
42,Detroit Mercy (ASUN),2,0-2,17,42,59,0.288,02/17/2022,2022.0
43,St. John's (NY) (Big East),1,0-1,9,23,32,0.281,02/17/2022,2022.0
44,Bellarmine (ASUN),3,0-3,21,55,76,0.276,02/17/2022,2022.0
45,St. Bonaventure (MAAC),1,0-1,6,20,26,0.231,02/17/2022,2022.0
46,Cleveland St. (ASUN),1,0-1,2,26,28,0.071,02/17/2022,2022.0
-,Merrimack (NEC),2,0-2,16,26,42,0.381,02/17/2022,2022.0
1,Ohio St. (Big Ten),2,2-0,50,7,57,0.877,02/15/2022,2022.0
2,Lehigh (Patriot),1,1-0,15,3,18,0.833,02/15/2022,2022.0
3,Saint Joseph's (NEC),2,1-1,38,14,52,0.731,02/15/2022,2022.0
4,Syracuse (ACC),1,1-0,26,11,37,0.703,02/15/2022,2022.0
5,Quinnipiac (MAAC),1,1-0,23,10,33,0.697,02/15/2022,2022.0
6,Michigan (Big Ten),2,2-0,46,21,67,0.687,02/15/2022,2022.0
7,Rutgers (Big Ten),3,3-0,56,28,84,0.667,02/15/2022,2022.0
7,Bryant (NEC),1,1-0,20,10,30,0.667,02/15/2022,2022.0
9,Hobart (NEC),1,1-0,25,13,38,0.658,02/15/2022,2022.0
10,Boston U. (Patriot),1,1-0,15,8,23,0.652,02/15/2022,2022.0
11,Mercer (SoCon),4,1-3,71,38,109,0.651,02/15/2022,2022.0
12,Maryland (Big Ten),2,2-0,44,24,68,0.647,02/15/2022,2022.0
13,Sacred Heart (NEC),1,0-1,21,12,33,0.636,02/15/2022,2022.0
13,Binghamton (America East),1,0-1,14,8,22,0.636,02/15/2022,2022.0
15,Vermont (America East),2,0-2,31,19,50,0.620,02/15/2022,2022.0
16,Virginia (ACC),2,2-0,37,23,60,0.617,02/15/2022,2022.0
17,Denver (Big East),2,2-0,35,22,57,0.614,02/15/2022,2022.0
18,Marquette (Big East),1,1-0,13,9,22,0.591,02/15/2022,2022.0
19,Johns Hopkins (Big Ten),3,2-1,47,34,81,0.580,02/15/2022,2022.0
20,Lafayette (Patriot),2,1-1,35,27,62,0.565,02/15/2022,2022.0
21,Fairfield (CAA),1,0-1,16,13,29,0.552,02/15/2022,2022.0
22,North Carolina (ACC),2,2-0,28,24,52,0.538,02/15/2022,2022.0
23,Villanova (Big East),1,1-0,15,13,28,0.536,02/15/2022,2022.0
24,LIU (NEC),2,1-1,26,23,49,0.531,02/15/2022,2022.0
25,Colgate (Patriot),2,0-2,26,24,50,0.520,02/15/2022,2022.0
26,Mount St. Mary's (NEC),3,1-2,36,34,70,0.514,02/15/2022,2022.0
27,Duke (ACC),4,3-1,60,57,117,0.513,02/15/2022,2022.0
28,Penn St. (Big Ten),2,1-1,34,33,67,0.507,02/15/2022,2022.0
29,NJIT (America East),2,0-2,24,24,48,0.500,02/15/2022,2022.0
29,Army West Point (Patriot),1,1-0,15,15,30,0.500,02/15/2022,2022.0
29,Massachusetts (CAA),1,0-1,15,15,30,0.500,02/15/2022,2022.0
32,Navy (Patriot),2,1-1,22,23,45,0.489,02/15/2022,2022.0
33,Bucknell (Patriot),2,2-0,32,34,66,0.485,02/15/2022,2022.0
34,Holy Cross (Patriot),2,0-2,31,34,65,0.477,02/15/2022,2022.0
35,Robert Morris (ASUN),2,0-2,31,35,66,0.470,02/15/2022,2022.0
36,Georgetown (Big East),1,1-0,13,15,28,0.464,02/15/2022,2022.0
37,Stony Brook (America East),1,1-0,13,16,29,0.448,02/15/2022,2022.0
38,Hofstra (CAA),2,2-0,23,29,52,0.442,02/15/2022,2022.0
39,Utah (ASUN),2,1-1,24,32,56,0.429,02/15/2022,2022.0
40,High Point (SoCon),3,1-2,36,49,85,0.424,02/15/2022,2022.0
41,Siena (MAAC),1,0-1,10,14,24,0.417,02/15/2022,2022.0
42,Towson (CAA),2,1-1,22,35,57,0.386,02/15/2022,2022.0
43,Manhattan (MAAC),1,0-1,10,16,26,0.385,02/15/2022,2022.0
44,Air Force (ASUN),2,0-2,23,38,61,0.377,02/15/2022,2022.0
45,Jacksonville (SoCon),3,2-1,32,53,85,0.376,02/15/2022,2022.0
46,Richmond (SoCon),1,0-1,9,16,25,0.360,02/15/2022,2022.0
47,Delaware (CAA),3,3-0,28,50,78,0.359,02/15/2022,2022.0
48,Canisius (MAAC),1,0-1,13,25,38,0.342,02/15/2022,2022.0
49,Providence (Big East),2,1-1,18,40,58,0.310,02/15/2022,2022.0
50,Marist (MAAC),2,1-1,15,34,49,0.306,02/15/2022,2022.0
51,UMass Lowell (America East),1,0-1,10,23,33,0.303,02/15/2022,2022.0
52,Loyola Maryland (Patriot),1,0-1,9,22,31,0.290,02/15/2022,2022.0
53,Detroit Mercy (ASUN),2,0-2,17,42,59,0.288,02/15/2022,2022.0
54,St. John's (NY) (Big East),1,0-1,9,23,32,0.281,02/15/2022,2022.0
55,Bellarmine (ASUN),3,0-3,21,55,76,0.276,02/15/2022,2022.0
56,VMI (SoCon),1,0-1,6,17,23,0.261,02/15/2022,2022.0
57,St. Bonaventure (MAAC),1,0-1,6,20,26,0.231,02/15/2022,2022.0
58,Cleveland St. (ASUN),1,0-1,2,26,28,0.071,02/15/2022,2022.0
-,Merrimack (NEC),2,0-2,16,26,42,0.381,02/15/2022,2022.0
1,Ohio St. (Big Ten),2,2-0,50,7,57,0.877,02/13/2022,2022.0
2,Lehigh (Patriot),1,1-0,15,3,18,0.833,02/13/2022,2022.0
3,Saint Joseph's (NEC),1,1-0,20,6,26,0.769,02/13/2022,2022.0
4,Syracuse (ACC),1,1-0,26,11,37,0.703,02/13/2022,2022.0
5,Quinnipiac (MAAC),1,1-0,23,10,33,0.697,02/13/2022,2022.0
6,Michigan (Big Ten),2,2-0,46,21,67,0.687,02/13/2022,2022.0
7,Rutgers (Big Ten),3,3-0,56,28,84,0.667,02/13/2022,2022.0
7,Bryant (NEC),1,1-0,20,10,30,0.667,02/13/2022,2022.0
9,Hobart (NEC),1,1-0,25,13,38,0.658,02/13/2022,2022.0
10,Boston U. (Patriot),1,1-0,15,8,23,0.652,02/13/2022,2022.0
11,Maryland (Big Ten),2,2-0,44,24,68,0.647,02/13/2022,2022.0
12,Sacred Heart (NEC),1,0-1,21,12,33,0.636,02/13/2022,2022.0
12,Binghamton (America East),1,0-1,14,8,22,0.636,02/13/2022,2022.0
14,Vermont (America East),2,0-2,31,19,50,0.620,02/13/2022,2022.0
15,Virginia (ACC),2,2-0,37,23,60,0.617,02/13/2022,2022.0
16,Denver (Big East),2,2-0,35,22,57,0.614,02/13/2022,2022.0
17,Mercer (SoCon),3,1-2,45,30,75,0.600,02/13/2022,2022.0
18,Marquette (Big East),1,1-0,13,9,22,0.591,02/13/2022,2022.0
19,Johns Hopkins (Big Ten),3,2-1,47,34,81,0.580,02/13/2022,2022.0
20,Lafayette (Patriot),2,1-1,35,27,62,0.565,02/13/2022,2022.0
21,Fairfield (CAA),1,0-1,16,13,29,0.552,02/13/2022,2022.0
22,North Carolina (ACC),2,2-0,28,24,52,0.538,02/13/2022,2022.0
23,Villanova (Big East),1,1-0,15,13,28,0.536,02/13/2022,2022.0
24,LIU (NEC),2,1-1,26,23,49,0.531,02/13/2022,2022.0
25,Colgate (Patriot),2,0-2,26,24,50,0.520,02/13/2022,2022.0
26,Duke (ACC),4,3-1,60,57,117,0.513,02/13/2022,2022.0
27,Penn St. (Big Ten),2,1-1,34,33,67,0.507,02/13/2022,2022.0
28,NJIT (America East),2,0-2,24,24,48,0.500,02/13/2022,2022.0
28,Army West Point (Patriot),1,1-0,15,15,30,0.500,02/13/2022,2022.0
28,Massachusetts (CAA),1,0-1,15,15,30,0.500,02/13/2022,2022.0
31,Navy (Patriot),2,1-1,22,23,45,0.489,02/13/2022,2022.0
32,Bucknell (Patriot),2,2-0,32,34,66,0.485,02/13/2022,2022.0
33,Holy Cross (Patriot),2,0-2,31,34,65,0.477,02/13/2022,2022.0
34,Jacksonville (SoCon),2,1-1,24,27,51,0.471,02/13/2022,2022.0
35,Robert Morris (ASUN),2,0-2,31,35,66,0.470,02/13/2022,2022.0
36,Mount St. Mary's (NEC),2,1-1,21,24,45,0.467,02/13/2022,2022.0
37,Georgetown (Big East),1,1-0,13,15,28,0.464,02/13/2022,2022.0
38,Stony Brook (America East),1,1-0,13,16,29,0.448,02/13/2022,2022.0
39,Hofstra (CAA),2,2-0,23,29,52,0.442,02/13/2022,2022.0
40,Utah (ASUN),2,1-1,24,32,56,0.429,02/13/2022,2022.0
41,High Point (SoCon),3,1-2,36,49,85,0.424,02/13/2022,2022.0
42,Siena (MAAC),1,0-1,10,14,24,0.417,02/13/2022,2022.0
43,Delaware (CAA),2,2-0,20,32,52,0.385,02/13/2022,2022.0
43,Manhattan (MAAC),1,0-1,10,16,26,0.385,02/13/2022,2022.0
45,Air Force (ASUN),2,0-2,23,38,61,0.377,02/13/2022,2022.0
46,Towson (CAA),1,0-1,12,20,32,0.375,02/13/2022,2022.0
47,Richmond (SoCon),1,0-1,9,16,25,0.360,02/13/2022,2022.0
48,Canisius (MAAC),1,0-1,13,25,38,0.342,02/13/2022,2022.0
49,Providence (Big East),2,1-1,18,40,58,0.310,02/13/2022,2022.0
50,Marist (MAAC),2,1-1,15,34,49,0.306,02/13/2022,2022.0
51,UMass Lowell (America East),1,0-1,10,23,33,0.303,02/13/2022,2022.0
52,Loyola Maryland (Patriot),1,0-1,9,22,31,0.290,02/13/2022,2022.0
53,Detroit Mercy (ASUN),2,0-2,17,42,59,0.288,02/13/2022,2022.0
54,St. John's (NY) (Big East),1,0-1,9,23,32,0.281,02/13/2022,2022.0
55,Bellarmine (ASUN),3,0-3,21,55,76,0.276,02/13/2022,2022.0
56,VMI (SoCon),1,0-1,6,17,23,0.261,02/13/2022,2022.0
57,St. Bonaventure (MAAC),1,0-1,6,20,26,0.231,02/13/2022,2022.0
58,Cleveland St. (ASUN),1,0-1,2,26,28,0.071,02/13/2022,2022.0
-,Merrimack (NEC),2,0-2,16,26,42,0.381,02/13/2022,2022.0
1,Ohio St. (Big Ten),1,1-0,24,5,29,0.828,02/06/2022,2022.0
2,Michigan (Big Ten),1,1-0,28,9,37,0.757,02/06/2022,2022.0
3,Holy Cross (Patriot),1,0-1,20,8,28,0.714,02/06/2022,2022.0
4,NJIT (America East),1,0-1,21,9,30,0.700,02/06/2022,2022.0
5,Vermont (America East),1,0-1,17,8,25,0.680,02/06/2022,2022.0
6,Mercer (SoCon),2,1-1,32,21,53,0.604,02/06/2022,2022.0
7,Virginia (ACC),1,1-0,21,14,35,0.600,02/06/2022,2022.0
8,Maryland (Big Ten),1,1-0,22,15,37,0.595,02/06/2022,2022.0
9,Denver (Big East),1,1-0,18,13,31,0.581,02/06/2022,2022.0
10,Hofstra (CAA),1,1-0,11,8,19,0.579,02/06/2022,2022.0
11,Johns Hopkins (Big Ten),1,1-0,12,9,21,0.571,02/06/2022,2022.0
12,Navy (Patriot),1,0-1,13,10,23,0.565,02/06/2022,2022.0
13,Penn St. (Big Ten),1,1-0,21,18,39,0.538,02/06/2022,2022.0
14,Rutgers (Big Ten),1,1-0,13,12,25,0.520,02/06/2022,2022.0
15,Bucknell (Patriot),1,1-0,18,18,36,0.500,02/06/2022,2022.0
16,LIU (NEC),1,0-1,12,13,25,0.480,02/06/2022,2022.0
17,Duke (ACC),2,2-0,29,32,61,0.475,02/06/2022,2022.0
18,Lafayette (Patriot),1,0-1,18,21,39,0.462,02/06/2022,2022.0
19,Mount St. Mary's (NEC),1,1-0,10,13,23,0.435,02/06/2022,2022.0
20,Jacksonville (SoCon),1,0-1,9,12,21,0.429,02/06/2022,2022.0
21,Utah (ASUN),1,0-1,13,18,31,0.419,02/06/2022,2022.0
22,Robert Morris (ASUN),1,0-1,15,21,36,0.417,02/06/2022,2022.0
23,High Point (SoCon),1,0-1,15,22,37,0.405,02/06/2022,2022.0
24,Air Force (ASUN),1,0-1,14,21,35,0.400,02/06/2022,2022.0
25,Delaware (CAA),1,1-0,9,21,30,0.300,02/06/2022,2022.0
26,Providence (Big East),1,1-0,8,20,28,0.286,02/06/2022,2022.0
27,Bellarmine (ASUN),2,0-2,12,42,54,0.222,02/06/2022,2022.0
28,Detroit Mercy (ASUN),1,0-1,5,24,29,0.172,02/06/2022,2022.0
-,Merrimack (NEC),1,0-1,8,11,19,0.421,02/06/2022,2022.0
1,Lehigh (Patriot),15,10-5,270,156,426,0.634,05/29/2023-Final Statistics,2023.0
2,Saint Joseph's (Atlantic 10),15,10-5,268,164,432,0.620,05/29/2023-Final Statistics,2023.0
3,Mount St. Mary's (MAAC),16,8-8,259,163,422,0.614,05/29/2023-Final Statistics,2023.0
4,Army West Point (Patriot),17,13-4,263,168,431,0.610,05/29/2023-Final Statistics,2023.0
5,Vermont (America East),14,9-5,213,137,350,0.609,05/29/2023-Final Statistics,2023.0
6,Denver (Big East),15,10-5,226,148,374,0.604,05/29/2023-Final Statistics,2023.0
7,Duke (ACC),19,16-3,330,218,548,0.602,05/29/2023-Final Statistics,2023.0
8,Michigan (Big Ten),17,10-7,299,200,499,0.599,05/29/2023-Final Statistics,2023.0
9,Maryland (Big Ten),16,10-6,254,172,426,0.596,05/29/2023-Final Statistics,2023.0
10,Mercer (ASUN),16,6-10,256,176,432,0.593,05/29/2023-Final Statistics,2023.0
11,Brown (Ivy League),14,6-8,240,168,408,0.588,05/29/2023-Final Statistics,2023.0
12,Navy (Patriot),16,8-8,222,163,385,0.577,05/29/2023-Final Statistics,2023.0
13,Hofstra (CAA),14,5-9,194,145,339,0.572,05/29/2023-Final Statistics,2023.0
14,Bryant (America East),17,12-5,290,222,512,0.566,05/29/2023-Final Statistics,2023.0
15,Binghamton (America East),14,9-5,225,179,404,0.557,05/29/2023-Final Statistics,2023.0
16,Massachusetts (Atlantic 10),14,8-6,173,138,311,0.556,05/29/2023-Final Statistics,2023.0
17,Monmouth (CAA),14,5-9,193,154,347,0.556,05/29/2023-Final Statistics,2023.0
18,Drexel (CAA),14,8-6,211,169,380,0.555,05/29/2023-Final Statistics,2023.0
19,Dartmouth (Ivy League),12,6-6,195,158,353,0.552,05/29/2023-Final Statistics,2023.0
20,Georgetown (Big East),17,13-4,277,226,503,0.551,05/29/2023-Final Statistics,2023.0
21,Towson (CAA),15,6-9,213,177,390,0.546,05/29/2023-Final Statistics,2023.0
22,High Point (Atlantic 10),17,9-8,278,232,510,0.545,05/29/2023-Final Statistics,2023.0
23,Utah (ASUN),17,12-5,295,248,543,0.543,05/29/2023-Final Statistics,2023.0
24,Virginia (ACC),17,13-4,300,254,554,0.542,05/29/2023-Final Statistics,2023.0
25,Quinnipiac (MAAC),14,7-7,229,197,426,0.538,05/29/2023-Final Statistics,2023.0
26,Jacksonville (ASUN),16,12-4,238,206,444,0.536,05/29/2023-Final Statistics,2023.0
27,Villanova (Big East),15,10-5,218,189,407,0.536,05/29/2023-Final Statistics,2023.0
28,Robert Morris (ASUN),16,8-8,228,199,427,0.534,05/29/2023-Final Statistics,2023.0
29,Rutgers (Big Ten),14,8-6,193,173,366,0.527,05/29/2023-Final Statistics,2023.0
30,Manhattan (MAAC),15,10-5,164,148,312,0.526,05/29/2023-Final Statistics,2023.0
31,Yale (Ivy League),15,9-6,251,227,478,0.525,05/29/2023-Final Statistics,2023.0
32,Marquette (Big East),14,6-8,212,198,410,0.517,05/29/2023-Final Statistics,2023.0
33,Colgate (Patriot),11,2-9,148,143,291,0.509,05/29/2023-Final Statistics,2023.0
34,Hobart (Atlantic 10),13,5-8,203,199,402,0.505,05/29/2023-Final Statistics,2023.0
35,North Carolina (ACC),14,7-7,205,205,410,0.500,05/29/2023-Final Statistics,2023.0
36,NJIT (America East),13,3-10,172,173,345,0.499,05/29/2023-Final Statistics,2023.0
37,Boston U. (Patriot),14,10-4,194,196,390,0.497,05/29/2023-Final Statistics,2023.0
38,Johns Hopkins (Big Ten),18,12-6,244,248,492,0.496,05/29/2023-Final Statistics,2023.0
39,Cornell (Ivy League),15,11-4,220,225,445,0.494,05/29/2023-Final Statistics,2023.0
40,VMI (MAAC),15,6-9,198,204,402,0.493,05/29/2023-Final Statistics,2023.0
41,Richmond (Atlantic 10),16,11-5,213,227,440,0.484,05/29/2023-Final Statistics,2023.0
42,Bellarmine (ASUN),17,11-6,230,246,476,0.483,05/29/2023-Final Statistics,2023.0
43,Marist (MAAC),18,10-8,256,275,531,0.482,05/29/2023-Final Statistics,2023.0
44,Delaware (CAA),18,13-5,238,257,495,0.481,05/29/2023-Final Statistics,2023.0
45,Canisius (MAAC),15,2-13,195,215,410,0.476,05/29/2023-Final Statistics,2023.0
46,Stony Brook (CAA),16,9-7,211,237,448,0.471,05/29/2023-Final Statistics,2023.0
47,UAlbany (America East),16,6-10,193,218,411,0.470,05/29/2023-Final Statistics,2023.0
48,St. Bonaventure (Atlantic 10),14,1-13,174,197,371,0.469,05/29/2023-Final Statistics,2023.0
49,Notre Dame (ACC),16,14-2,217,246,463,0.469,05/29/2023-Final Statistics,2023.0
50,Cleveland St. (ASUN),13,6-7,169,192,361,0.468,05/29/2023-Final Statistics,2023.0
51,Princeton (Ivy League),15,8-7,199,228,427,0.466,05/29/2023-Final Statistics,2023.0
52,Fairfield (CAA),14,5-9,182,214,396,0.460,05/29/2023-Final Statistics,2023.0
53,UMBC (America East),13,8-5,147,173,320,0.459,05/29/2023-Final Statistics,2023.0
54,LIU (MAAC),14,5-9,167,199,366,0.456,05/29/2023-Final Statistics,2023.0
55,Hampton (CAA),14,2-12,164,196,360,0.456,05/29/2023-Final Statistics,2023.0
56,Penn St. (Big Ten),16,11-5,206,247,453,0.455,05/29/2023-Final Statistics,2023.0
57,Ohio St. (Big Ten),14,5-9,177,213,390,0.454,05/29/2023-Final Statistics,2023.0
58,Penn (Ivy League),13,7-6,157,190,347,0.452,05/29/2023-Final Statistics,2023.0
59,Sacred Heart (MAAC),15,5-10,173,210,383,0.452,05/29/2023-Final Statistics,2023.0
60,Lafayette (Patriot),16,6-10,193,243,436,0.443,05/29/2023-Final Statistics,2023.0
61,Harvard (Ivy League),12,5-7,155,197,352,0.440,05/29/2023-Final Statistics,2023.0
62,Siena (MAAC),16,9-7,180,229,409,0.440,05/29/2023-Final Statistics,2023.0
63,Holy Cross (Patriot),14,1-13,165,227,392,0.421,05/29/2023-Final Statistics,2023.0
64,Syracuse (ACC),15,8-7,187,259,446,0.419,05/29/2023-Final Statistics,2023.0
65,Loyola Maryland (Patriot),17,9-8,176,263,439,0.401,05/29/2023-Final Statistics,2023.0
66,Wagner (MAAC),14,3-11,125,187,312,0.401,05/29/2023-Final Statistics,2023.0
67,Providence (Big East),15,6-9,172,258,430,0.400,05/29/2023-Final Statistics,2023.0
68,Bucknell (Patriot),13,3-10,140,211,351,0.399,05/29/2023-Final Statistics,2023.0
69,Air Force (ASUN),17,11-6,166,262,428,0.388,05/29/2023-Final Statistics,2023.0
70,Detroit Mercy (ASUN),13,2-11,130,230,360,0.361,05/29/2023-Final Statistics,2023.0
71,UMass Lowell (America East),13,0-13,120,226,346,0.347,05/29/2023-Final Statistics,2023.0
72,St. John's (NY) (Big East),14,0-14,103,286,389,0.265,05/29/2023-Final Statistics,2023.0
-,Hartford (DI Independent),6,6-0,99,36,135,0.733,05/29/2023-Final Statistics,2023.0
-,Lindenwood (ASUN),12,2-10,142,187,329,0.432,05/29/2023-Final Statistics,2023.0
-,Merrimack (America East),14,7-7,145,210,355,0.408,05/29/2023-Final Statistics,2023.0
-,Queens (NC) (ASUN),14,2-12,147,237,384,0.383,05/29/2023-Final Statistics,2023.0
1,Princeton (Ivy League),1,0-1,19,10,29,0.655,05/10/2023 - 05/29/2023-2023 NCAA DI MLA Championship,2023.0
2,Notre Dame (ACC),4,4-0,60,47,107,0.561,05/10/2023 - 05/29/2023-2023 NCAA DI MLA Championship,2023.0
3,Yale (Ivy League),1,0-1,22,18,40,0.550,05/10/2023 - 05/29/2023-2023 NCAA DI MLA Championship,2023.0
4,Bryant (America East),1,0-1,18,15,33,0.545,05/10/2023 - 05/29/2023-2023 NCAA DI MLA Championship,2023.0
5,Duke (ACC),4,3-1,61,51,112,0.545,05/10/2023 - 05/29/2023-2023 NCAA DI MLA Championship,2023.0
6,Johns Hopkins (Big Ten),2,1-1,31,26,57,0.544,05/10/2023 - 05/29/2023-2023 NCAA DI MLA Championship,2023.0
7,Army West Point (Patriot),2,1-1,31,27,58,0.534,05/10/2023 - 05/29/2023-2023 NCAA DI MLA Championship,2023.0
8,Virginia (ACC),3,2-1,47,43,90,0.522,05/10/2023 - 05/29/2023-2023 NCAA DI MLA Championship,2023.0
9,Michigan (Big Ten),2,1-1,31,29,60,0.517,05/10/2023 - 05/29/2023-2023 NCAA DI MLA Championship,2023.0
10,Maryland (Big Ten),1,0-1,18,17,35,0.514,05/10/2023 - 05/29/2023-2023 NCAA DI MLA Championship,2023.0
11,Delaware (CAA),2,1-1,33,32,65,0.508,05/10/2023 - 05/29/2023-2023 NCAA DI MLA Championship,2023.0
12,Georgetown (Big East),2,1-1,35,39,74,0.473,05/10/2023 - 05/29/2023-2023 NCAA DI MLA Championship,2023.0
13,Cornell (Ivy League),1,0-1,15,18,33,0.455,05/10/2023 - 05/29/2023-2023 NCAA DI MLA Championship,2023.0
14,Marist (MAAC),1,0-1,17,22,39,0.436,05/10/2023 - 05/29/2023-2023 NCAA DI MLA Championship,2023.0
15,Penn St. (Big Ten),3,2-1,32,55,87,0.368,05/10/2023 - 05/29/2023-2023 NCAA DI MLA Championship,2023.0
16,Richmond (Atlantic 10),1,0-1,10,18,28,0.357,05/10/2023 - 05/29/2023-2023 NCAA DI MLA Championship,2023.0
17,Utah (ASUN),1,0-1,9,22,31,0.290,05/10/2023 - 05/29/2023-2023 NCAA DI MLA Championship,2023.0
1,Lehigh (Patriot),15,10-5,270,156,426,0.634,05/27/2023,2023.0
2,Saint Joseph's (Atlantic 10),15,10-5,268,164,432,0.620,05/27/2023,2023.0
3,Mount St. Mary's (MAAC),16,8-8,259,163,422,0.614,05/27/2023,2023.0
4,Duke (ACC),18,16-2,320,204,524,0.611,05/27/2023,2023.0
5,Army West Point (Patriot),17,13-4,263,168,431,0.610,05/27/2023,2023.0
6,Vermont (America East),14,9-5,213,137,350,0.609,05/27/2023,2023.0
7,Denver (Big East),15,10-5,226,148,374,0.604,05/27/2023,2023.0
8,Michigan (Big Ten),17,10-7,299,200,499,0.599,05/27/2023,2023.0
9,Maryland (Big Ten),16,10-6,254,172,426,0.596,05/27/2023,2023.0
10,Mercer (ASUN),16,6-10,256,176,432,0.593,05/27/2023,2023.0
11,Brown (Ivy League),14,6-8,240,168,408,0.588,05/27/2023,2023.0
12,Navy (Patriot),16,8-8,222,163,385,0.577,05/27/2023,2023.0
13,Hofstra (CAA),14,5-9,194,145,339,0.572,05/27/2023,2023.0
14,Bryant (America East),17,12-5,290,222,512,0.566,05/27/2023,2023.0
15,Binghamton (America East),14,9-5,225,179,404,0.557,05/27/2023,2023.0
16,Massachusetts (Atlantic 10),14,8-6,173,138,311,0.556,05/27/2023,2023.0
17,Monmouth (CAA),14,5-9,193,154,347,0.556,05/27/2023,2023.0
18,Drexel (CAA),14,8-6,211,169,380,0.555,05/27/2023,2023.0
19,Dartmouth (Ivy League),12,6-6,195,158,353,0.552,05/27/2023,2023.0
20,Georgetown (Big East),17,13-4,277,226,503,0.551,05/27/2023,2023.0
21,Towson (CAA),15,6-9,213,177,390,0.546,05/27/2023,2023.0
22,High Point (Atlantic 10),17,9-8,278,232,510,0.545,05/27/2023,2023.0
23,Utah (ASUN),17,12-5,295,248,543,0.543,05/27/2023,2023.0
24,Virginia (ACC),17,13-4,300,254,554,0.542,05/27/2023,2023.0
25,Quinnipiac (MAAC),14,7-7,229,197,426,0.538,05/27/2023,2023.0
26,Jacksonville (ASUN),16,12-4,238,206,444,0.536,05/27/2023,2023.0
27,Villanova (Big East),15,10-5,218,189,407,0.536,05/27/2023,2023.0
28,Robert Morris (ASUN),16,8-8,228,199,427,0.534,05/27/2023,2023.0
29,Rutgers (Big Ten),14,8-6,193,173,366,0.527,05/27/2023,2023.0
30,Manhattan (MAAC),15,10-5,164,148,312,0.526,05/27/2023,2023.0
31,Yale (Ivy League),15,9-6,251,227,478,0.525,05/27/2023,2023.0
32,Marquette (Big East),14,6-8,212,198,410,0.517,05/27/2023,2023.0
33,Colgate (Patriot),11,2-9,148,143,291,0.509,05/27/2023,2023.0
34,Hobart (Atlantic 10),13,5-8,203,199,402,0.505,05/27/2023,2023.0
35,North Carolina (ACC),14,7-7,205,205,410,0.500,05/27/2023,2023.0
36,NJIT (America East),13,3-10,172,173,345,0.499,05/27/2023,2023.0
37,Boston U. (Patriot),14,10-4,194,196,390,0.497,05/27/2023,2023.0
38,Johns Hopkins (Big Ten),18,12-6,244,248,492,0.496,05/27/2023,2023.0
39,Cornell (Ivy League),15,11-4,220,225,445,0.494,05/27/2023,2023.0
40,VMI (MAAC),15,6-9,198,204,402,0.493,05/27/2023,2023.0
41,Richmond (Atlantic 10),16,11-5,213,227,440,0.484,05/27/2023,2023.0
42,Bellarmine (ASUN),17,11-6,230,246,476,0.483,05/27/2023,2023.0
43,Marist (MAAC),18,10-8,256,275,531,0.482,05/27/2023,2023.0
44,Delaware (CAA),18,13-5,238,257,495,0.481,05/27/2023,2023.0
45,Canisius (MAAC),15,2-13,195,215,410,0.476,05/27/2023,2023.0
46,Stony Brook (CAA),16,9-7,211,237,448,0.471,05/27/2023,2023.0
47,UAlbany (America East),16,6-10,193,218,411,0.470,05/27/2023,2023.0
48,St. Bonaventure (Atlantic 10),14,1-13,174,197,371,0.469,05/27/2023,2023.0
49,Cleveland St. (ASUN),13,6-7,169,192,361,0.468,05/27/2023,2023.0
50,Princeton (Ivy League),15,8-7,199,228,427,0.466,05/27/2023,2023.0
51,Notre Dame (ACC),15,13-2,203,236,439,0.462,05/27/2023,2023.0
52,Fairfield (CAA),14,5-9,182,214,396,0.460,05/27/2023,2023.0
53,UMBC (America East),13,8-5,147,173,320,0.459,05/27/2023,2023.0
54,LIU (MAAC),14,5-9,167,199,366,0.456,05/27/2023,2023.0
55,Hampton (CAA),14,2-12,164,196,360,0.456,05/27/2023,2023.0
56,Penn St. (Big Ten),16,11-5,206,247,453,0.455,05/27/2023,2023.0
57,Ohio St. (Big Ten),14,5-9,177,213,390,0.454,05/27/2023,2023.0
58,Penn (Ivy League),13,7-6,157,190,347,0.452,05/27/2023,2023.0
59,Sacred Heart (MAAC),15,5-10,173,210,383,0.452,05/27/2023,2023.0
60,Lafayette (Patriot),16,6-10,193,243,436,0.443,05/27/2023,2023.0
61,Harvard (Ivy League),12,5-7,155,197,352,0.440,05/27/2023,2023.0
62,Siena (MAAC),16,9-7,180,229,409,0.440,05/27/2023,2023.0
63,Holy Cross (Patriot),14,1-13,165,227,392,0.421,05/27/2023,2023.0
64,Syracuse (ACC),15,8-7,187,259,446,0.419,05/27/2023,2023.0
65,Loyola Maryland (Patriot),17,9-8,176,263,439,0.401,05/27/2023,2023.0
66,Wagner (MAAC),14,3-11,125,187,312,0.401,05/27/2023,2023.0
67,Providence (Big East),15,6-9,172,258,430,0.400,05/27/2023,2023.0
68,Bucknell (Patriot),13,3-10,140,211,351,0.399,05/27/2023,2023.0
69,Air Force (ASUN),17,11-6,166,262,428,0.388,05/27/2023,2023.0
70,Detroit Mercy (ASUN),13,2-11,130,230,360,0.361,05/27/2023,2023.0
71,UMass Lowell (America East),13,0-13,120,226,346,0.347,05/27/2023,2023.0
72,St. John's (NY) (Big East),14,0-14,103,286,389,0.265,05/27/2023,2023.0
-,Hartford (DI Independent),6,6-0,99,36,135,0.733,05/27/2023,2023.0
-,Lindenwood (ASUN),12,2-10,142,187,329,0.432,05/27/2023,2023.0
-,Merrimack (America East),14,7-7,145,210,355,0.408,05/27/2023,2023.0
-,Queens (NC) (ASUN),14,2-12,147,237,384,0.383,05/27/2023,2023.0
1,Lehigh (Patriot),15,10-5,270,156,426,0.634,05/21/2023,2023.0
2,Saint Joseph's (Atlantic 10),15,10-5,268,164,432,0.620,05/21/2023,2023.0
3,Mount St. Mary's (MAAC),16,8-8,259,163,422,0.614,05/21/2023,2023.0
4,Army West Point (Patriot),17,13-4,263,168,431,0.610,05/21/2023,2023.0
5,Duke (ACC),17,15-2,298,191,489,0.609,05/21/2023,2023.0
6,Vermont (America East),14,9-5,213,137,350,0.609,05/21/2023,2023.0
7,Denver (Big East),15,10-5,226,148,374,0.604,05/21/2023,2023.0
8,Michigan (Big Ten),17,10-7,299,200,499,0.599,05/21/2023,2023.0
9,Maryland (Big Ten),16,10-6,254,172,426,0.596,05/21/2023,2023.0
10,Mercer (ASUN),16,6-10,256,176,432,0.593,05/21/2023,2023.0
11,Brown (Ivy League),14,6-8,240,168,408,0.588,05/21/2023,2023.0
12,Navy (Patriot),16,8-8,222,163,385,0.577,05/21/2023,2023.0
13,Hofstra (CAA),14,5-9,194,145,339,0.572,05/21/2023,2023.0
14,Bryant (America East),17,12-5,290,222,512,0.566,05/21/2023,2023.0
15,Binghamton (America East),14,9-5,225,179,404,0.557,05/21/2023,2023.0
16,Massachusetts (Atlantic 10),14,8-6,173,138,311,0.556,05/21/2023,2023.0
17,Monmouth (CAA),14,5-9,193,154,347,0.556,05/21/2023,2023.0
18,Drexel (CAA),14,8-6,211,169,380,0.555,05/21/2023,2023.0
19,Dartmouth (Ivy League),12,6-6,195,158,353,0.552,05/21/2023,2023.0
20,Georgetown (Big East),17,13-4,277,226,503,0.551,05/21/2023,2023.0
21,Virginia (ACC),16,13-3,288,238,526,0.548,05/21/2023,2023.0
22,Towson (CAA),15,6-9,213,177,390,0.546,05/21/2023,2023.0
23,High Point (Atlantic 10),17,9-8,278,232,510,0.545,05/21/2023,2023.0
24,Utah (ASUN),17,12-5,295,248,543,0.543,05/21/2023,2023.0
25,Quinnipiac (MAAC),14,7-7,229,197,426,0.538,05/21/2023,2023.0
26,Jacksonville (ASUN),16,12-4,238,206,444,0.536,05/21/2023,2023.0
27,Villanova (Big East),15,10-5,218,189,407,0.536,05/21/2023,2023.0
28,Robert Morris (ASUN),16,8-8,228,199,427,0.534,05/21/2023,2023.0
29,Rutgers (Big Ten),14,8-6,193,173,366,0.527,05/21/2023,2023.0
30,Manhattan (MAAC),15,10-5,164,148,312,0.526,05/21/2023,2023.0
31,Yale (Ivy League),15,9-6,251,227,478,0.525,05/21/2023,2023.0
32,Marquette (Big East),14,6-8,212,198,410,0.517,05/21/2023,2023.0
33,Colgate (Patriot),11,2-9,148,143,291,0.509,05/21/2023,2023.0
34,Hobart (Atlantic 10),13,5-8,203,199,402,0.505,05/21/2023,2023.0
35,North Carolina (ACC),14,7-7,205,205,410,0.500,05/21/2023,2023.0
36,NJIT (America East),13,3-10,172,173,345,0.499,05/21/2023,2023.0
37,Boston U. (Patriot),14,10-4,194,196,390,0.497,05/21/2023,2023.0
38,Johns Hopkins (Big Ten),18,12-6,244,248,492,0.496,05/21/2023,2023.0
39,Cornell (Ivy League),15,11-4,220,225,445,0.494,05/21/2023,2023.0
40,VMI (MAAC),15,6-9,198,204,402,0.493,05/21/2023,2023.0
41,Richmond (Atlantic 10),16,11-5,213,227,440,0.484,05/21/2023,2023.0
42,Bellarmine (ASUN),17,11-6,230,246,476,0.483,05/21/2023,2023.0
43,Marist (MAAC),18,10-8,256,275,531,0.482,05/21/2023,2023.0
44,Delaware (CAA),18,13-5,238,257,495,0.481,05/21/2023,2023.0
45,Canisius (MAAC),15,2-13,195,215,410,0.476,05/21/2023,2023.0
46,Stony Brook (CAA),16,9-7,211,237,448,0.471,05/21/2023,2023.0
47,UAlbany (America East),16,6-10,193,218,411,0.470,05/21/2023,2023.0
48,St. Bonaventure (Atlantic 10),14,1-13,174,197,371,0.469,05/21/2023,2023.0
49,Cleveland St. (ASUN),13,6-7,169,192,361,0.468,05/21/2023,2023.0
50,Princeton (Ivy League),15,8-7,199,228,427,0.466,05/21/2023,2023.0
51,Penn St. (Big Ten),15,11-4,193,225,418,0.462,05/21/2023,2023.0
52,Fairfield (CAA),14,5-9,182,214,396,0.460,05/21/2023,2023.0
53,UMBC (America East),13,8-5,147,173,320,0.459,05/21/2023,2023.0
54,LIU (MAAC),14,5-9,167,199,366,0.456,05/21/2023,2023.0
55,Hampton (CAA),14,2-12,164,196,360,0.456,05/21/2023,2023.0
56,Notre Dame (ACC),14,12-2,187,224,411,0.455,05/21/2023,2023.0
57,Ohio St. (Big Ten),14,5-9,177,213,390,0.454,05/21/2023,2023.0
58,Penn (Ivy League),13,7-6,157,190,347,0.452,05/21/2023,2023.0
59,Sacred Heart (MAAC),15,5-10,173,210,383,0.452,05/21/2023,2023.0
60,Lafayette (Patriot),16,6-10,193,243,436,0.443,05/21/2023,2023.0
61,Harvard (Ivy League),12,5-7,155,197,352,0.440,05/21/2023,2023.0
62,Siena (MAAC),16,9-7,180,229,409,0.440,05/21/2023,2023.0
63,Holy Cross (Patriot),14,1-13,165,227,392,0.421,05/21/2023,2023.0
64,Syracuse (ACC),15,8-7,187,259,446,0.419,05/21/2023,2023.0
65,Loyola Maryland (Patriot),17,9-8,176,263,439,0.401,05/21/2023,2023.0
66,Wagner (MAAC),14,3-11,125,187,312,0.401,05/21/2023,2023.0
67,Providence (Big East),15,6-9,172,258,430,0.400,05/21/2023,2023.0
68,Bucknell (Patriot),13,3-10,140,211,351,0.399,05/21/2023,2023.0
69,Air Force (ASUN),17,11-6,166,262,428,0.388,05/21/2023,2023.0
70,Detroit Mercy (ASUN),13,2-11,130,230,360,0.361,05/21/2023,2023.0
71,UMass Lowell (America East),13,0-13,120,226,346,0.347,05/21/2023,2023.0
72,St. John's (NY) (Big East),14,0-14,103,286,389,0.265,05/21/2023,2023.0
-,Hartford (DI Independent),6,6-0,99,36,135,0.733,05/21/2023,2023.0
-,Lindenwood (ASUN),12,2-10,142,187,329,0.432,05/21/2023,2023.0
-,Merrimack (America East),14,7-7,145,210,355,0.408,05/21/2023,2023.0
-,Queens (NC) (ASUN),14,2-12,147,237,384,0.383,05/21/2023,2023.0
1,Lehigh (Patriot),15,10-5,270,156,426,0.634,05/20/2023,2023.0
2,Saint Joseph's (Atlantic 10),15,10-5,268,164,432,0.620,05/20/2023,2023.0
3,Mount St. Mary's (MAAC),16,8-8,259,163,422,0.614,05/20/2023,2023.0
4,Army West Point (Patriot),16,13-3,249,159,408,0.610,05/20/2023,2023.0
5,Duke (ACC),17,15-2,298,191,489,0.609,05/20/2023,2023.0
6,Vermont (America East),14,9-5,213,137,350,0.609,05/20/2023,2023.0
7,Denver (Big East),15,10-5,226,148,374,0.604,05/20/2023,2023.0
8,Michigan (Big Ten),17,10-7,299,200,499,0.599,05/20/2023,2023.0
9,Maryland (Big Ten),16,10-6,254,172,426,0.596,05/20/2023,2023.0
10,Mercer (ASUN),16,6-10,256,176,432,0.593,05/20/2023,2023.0
11,Brown (Ivy League),14,6-8,240,168,408,0.588,05/20/2023,2023.0
12,Navy (Patriot),16,8-8,222,163,385,0.577,05/20/2023,2023.0
13,Hofstra (CAA),14,5-9,194,145,339,0.572,05/20/2023,2023.0
14,Bryant (America East),17,12-5,290,222,512,0.566,05/20/2023,2023.0
15,Binghamton (America East),14,9-5,225,179,404,0.557,05/20/2023,2023.0
16,Massachusetts (Atlantic 10),14,8-6,173,138,311,0.556,05/20/2023,2023.0
17,Monmouth (CAA),14,5-9,193,154,347,0.556,05/20/2023,2023.0
18,Drexel (CAA),14,8-6,211,169,380,0.555,05/20/2023,2023.0
19,Dartmouth (Ivy League),12,6-6,195,158,353,0.552,05/20/2023,2023.0
20,Georgetown (Big East),17,13-4,277,226,503,0.551,05/20/2023,2023.0
21,Virginia (ACC),16,13-3,288,238,526,0.548,05/20/2023,2023.0
22,Towson (CAA),15,6-9,213,177,390,0.546,05/20/2023,2023.0
23,High Point (Atlantic 10),17,9-8,278,232,510,0.545,05/20/2023,2023.0
24,Utah (ASUN),17,12-5,295,248,543,0.543,05/20/2023,2023.0
25,Quinnipiac (MAAC),14,7-7,229,197,426,0.538,05/20/2023,2023.0
26,Jacksonville (ASUN),16,12-4,238,206,444,0.536,05/20/2023,2023.0
27,Villanova (Big East),15,10-5,218,189,407,0.536,05/20/2023,2023.0
28,Robert Morris (ASUN),16,8-8,228,199,427,0.534,05/20/2023,2023.0
29,Rutgers (Big Ten),14,8-6,193,173,366,0.527,05/20/2023,2023.0
30,Manhattan (MAAC),15,10-5,164,148,312,0.526,05/20/2023,2023.0
31,Yale (Ivy League),15,9-6,251,227,478,0.525,05/20/2023,2023.0
32,Marquette (Big East),14,6-8,212,198,410,0.517,05/20/2023,2023.0
33,Colgate (Patriot),11,2-9,148,143,291,0.509,05/20/2023,2023.0
34,Hobart (Atlantic 10),13,5-8,203,199,402,0.505,05/20/2023,2023.0
35,North Carolina (ACC),14,7-7,205,205,410,0.500,05/20/2023,2023.0
36,NJIT (America East),13,3-10,172,173,345,0.499,05/20/2023,2023.0
37,Boston U. (Patriot),14,10-4,194,196,390,0.497,05/20/2023,2023.0
38,Cornell (Ivy League),15,11-4,220,225,445,0.494,05/20/2023,2023.0
39,VMI (MAAC),15,6-9,198,204,402,0.493,05/20/2023,2023.0
40,Johns Hopkins (Big Ten),17,12-5,228,240,468,0.487,05/20/2023,2023.0
41,Richmond (Atlantic 10),16,11-5,213,227,440,0.484,05/20/2023,2023.0
42,Bellarmine (ASUN),17,11-6,230,246,476,0.483,05/20/2023,2023.0
43,Marist (MAAC),18,10-8,256,275,531,0.482,05/20/2023,2023.0
44,Delaware (CAA),18,13-5,238,257,495,0.481,05/20/2023,2023.0
45,Canisius (MAAC),15,2-13,195,215,410,0.476,05/20/2023,2023.0
46,Stony Brook (CAA),16,9-7,211,237,448,0.471,05/20/2023,2023.0
47,UAlbany (America East),16,6-10,193,218,411,0.470,05/20/2023,2023.0
48,St. Bonaventure (Atlantic 10),14,1-13,174,197,371,0.469,05/20/2023,2023.0
49,Cleveland St. (ASUN),13,6-7,169,192,361,0.468,05/20/2023,2023.0
50,Princeton (Ivy League),15,8-7,199,228,427,0.466,05/20/2023,2023.0
51,Penn St. (Big Ten),14,10-4,184,211,395,0.466,05/20/2023,2023.0
52,Notre Dame (ACC),13,11-2,179,208,387,0.463,05/20/2023,2023.0
53,Fairfield (CAA),14,5-9,182,214,396,0.460,05/20/2023,2023.0
54,UMBC (America East),13,8-5,147,173,320,0.459,05/20/2023,2023.0
55,LIU (MAAC),14,5-9,167,199,366,0.456,05/20/2023,2023.0
56,Hampton (CAA),14,2-12,164,196,360,0.456,05/20/2023,2023.0
57,Ohio St. (Big Ten),14,5-9,177,213,390,0.454,05/20/2023,2023.0
58,Penn (Ivy League),13,7-6,157,190,347,0.452,05/20/2023,2023.0
59,Sacred Heart (MAAC),15,5-10,173,210,383,0.452,05/20/2023,2023.0
60,Lafayette (Patriot),16,6-10,193,243,436,0.443,05/20/2023,2023.0
61,Harvard (Ivy League),12,5-7,155,197,352,0.440,05/20/2023,2023.0
62,Siena (MAAC),16,9-7,180,229,409,0.440,05/20/2023,2023.0
63,Holy Cross (Patriot),14,1-13,165,227,392,0.421,05/20/2023,2023.0
64,Syracuse (ACC),15,8-7,187,259,446,0.419,05/20/2023,2023.0
65,Loyola Maryland (Patriot),17,9-8,176,263,439,0.401,05/20/2023,2023.0
66,Wagner (MAAC),14,3-11,125,187,312,0.401,05/20/2023,2023.0
67,Providence (Big East),15,6-9,172,258,430,0.400,05/20/2023,2023.0
68,Bucknell (Patriot),13,3-10,140,211,351,0.399,05/20/2023,2023.0
69,Air Force (ASUN),17,11-6,166,262,428,0.388,05/20/2023,2023.0
70,Detroit Mercy (ASUN),13,2-11,130,230,360,0.361,05/20/2023,2023.0
71,UMass Lowell (America East),13,0-13,120,226,346,0.347,05/20/2023,2023.0
72,St. John's (NY) (Big East),14,0-14,103,286,389,0.265,05/20/2023,2023.0
-,Hartford (DI Independent),6,6-0,99,36,135,0.733,05/20/2023,2023.0
-,Lindenwood (ASUN),12,2-10,142,187,329,0.432,05/20/2023,2023.0
-,Merrimack (America East),14,7-7,145,210,355,0.408,05/20/2023,2023.0
-,Queens (NC) (ASUN),14,2-12,147,237,384,0.383,05/20/2023,2023.0
1,Lehigh (Patriot),15,10-5,270,156,426,0.634,05/14/2023,2023.0
2,Saint Joseph's (Atlantic 10),15,10-5,268,164,432,0.620,05/14/2023,2023.0
3,Duke (ACC),16,14-2,284,178,462,0.615,05/14/2023,2023.0
4,Mount St. Mary's (MAAC),16,8-8,259,163,422,0.614,05/14/2023,2023.0
5,Army West Point (Patriot),16,13-3,249,159,408,0.610,05/14/2023,2023.0
6,Vermont (America East),14,9-5,213,137,350,0.609,05/14/2023,2023.0
7,Michigan (Big Ten),16,10-6,286,186,472,0.606,05/14/2023,2023.0
8,Denver (Big East),15,10-5,226,148,374,0.604,05/14/2023,2023.0
9,Maryland (Big Ten),16,10-6,254,172,426,0.596,05/14/2023,2023.0
10,Mercer (ASUN),16,6-10,256,176,432,0.593,05/14/2023,2023.0
11,Brown (Ivy League),14,6-8,240,168,408,0.588,05/14/2023,2023.0
12,Navy (Patriot),16,8-8,222,163,385,0.577,05/14/2023,2023.0
13,Hofstra (CAA),14,5-9,194,145,339,0.572,05/14/2023,2023.0
14,Bryant (America East),17,12-5,290,222,512,0.566,05/14/2023,2023.0
15,Binghamton (America East),14,9-5,225,179,404,0.557,05/14/2023,2023.0
16,Massachusetts (Atlantic 10),14,8-6,173,138,311,0.556,05/14/2023,2023.0
17,Monmouth (CAA),14,5-9,193,154,347,0.556,05/14/2023,2023.0
18,Drexel (CAA),14,8-6,211,169,380,0.555,05/14/2023,2023.0
19,Georgetown (Big East),16,13-3,260,209,469,0.554,05/14/2023,2023.0
20,Dartmouth (Ivy League),12,6-6,195,158,353,0.552,05/14/2023,2023.0
21,Virginia (ACC),15,12-3,271,221,492,0.551,05/14/2023,2023.0
22,Towson (CAA),15,6-9,213,177,390,0.546,05/14/2023,2023.0
23,High Point (Atlantic 10),17,9-8,278,232,510,0.545,05/14/2023,2023.0
24,Utah (ASUN),17,12-5,295,248,543,0.543,05/14/2023,2023.0
25,Quinnipiac (MAAC),14,7-7,229,197,426,0.538,05/14/2023,2023.0
26,Jacksonville (ASUN),16,12-4,238,206,444,0.536,05/14/2023,2023.0
27,Villanova (Big East),15,10-5,218,189,407,0.536,05/14/2023,2023.0
28,Robert Morris (ASUN),16,8-8,228,199,427,0.534,05/14/2023,2023.0
29,Rutgers (Big Ten),14,8-6,193,173,366,0.527,05/14/2023,2023.0
30,Manhattan (MAAC),15,10-5,164,148,312,0.526,05/14/2023,2023.0
31,Yale (Ivy League),15,9-6,251,227,478,0.525,05/14/2023,2023.0
32,Marquette (Big East),14,6-8,212,198,410,0.517,05/14/2023,2023.0
33,Colgate (Patriot),11,2-9,148,143,291,0.509,05/14/2023,2023.0
34,Hobart (Atlantic 10),13,5-8,203,199,402,0.505,05/14/2023,2023.0
35,North Carolina (ACC),14,7-7,205,205,410,0.500,05/14/2023,2023.0
36,NJIT (America East),13,3-10,172,173,345,0.499,05/14/2023,2023.0
37,Boston U. (Patriot),14,10-4,194,196,390,0.497,05/14/2023,2023.0
38,Cornell (Ivy League),15,11-4,220,225,445,0.494,05/14/2023,2023.0
39,VMI (MAAC),15,6-9,198,204,402,0.493,05/14/2023,2023.0
40,Johns Hopkins (Big Ten),17,12-5,228,240,468,0.487,05/14/2023,2023.0
41,Richmond (Atlantic 10),16,11-5,213,227,440,0.484,05/14/2023,2023.0
42,Bellarmine (ASUN),17,11-6,230,246,476,0.483,05/14/2023,2023.0
43,Marist (MAAC),18,10-8,256,275,531,0.482,05/14/2023,2023.0
44,Delaware (CAA),18,13-5,238,257,495,0.481,05/14/2023,2023.0
45,Canisius (MAAC),15,2-13,195,215,410,0.476,05/14/2023,2023.0
46,Stony Brook (CAA),16,9-7,211,237,448,0.471,05/14/2023,2023.0
47,UAlbany (America East),16,6-10,193,218,411,0.470,05/14/2023,2023.0
48,St. Bonaventure (Atlantic 10),14,1-13,174,197,371,0.469,05/14/2023,2023.0
49,Cleveland St. (ASUN),13,6-7,169,192,361,0.468,05/14/2023,2023.0
50,Princeton (Ivy League),15,8-7,199,228,427,0.466,05/14/2023,2023.0
51,Penn St. (Big Ten),14,10-4,184,211,395,0.466,05/14/2023,2023.0
52,Notre Dame (ACC),13,11-2,179,208,387,0.463,05/14/2023,2023.0
53,Fairfield (CAA),14,5-9,182,214,396,0.460,05/14/2023,2023.0
54,UMBC (America East),13,8-5,147,173,320,0.459,05/14/2023,2023.0
55,LIU (MAAC),14,5-9,167,199,366,0.456,05/14/2023,2023.0
56,Hampton (CAA),14,2-12,164,196,360,0.456,05/14/2023,2023.0
57,Ohio St. (Big Ten),14,5-9,177,213,390,0.454,05/14/2023,2023.0
58,Penn (Ivy League),13,7-6,157,190,347,0.452,05/14/2023,2023.0
59,Sacred Heart (MAAC),15,5-10,173,210,383,0.452,05/14/2023,2023.0
60,Lafayette (Patriot),16,6-10,193,243,436,0.443,05/14/2023,2023.0
61,Harvard (Ivy League),12,5-7,155,197,352,0.440,05/14/2023,2023.0
62,Siena (MAAC),16,9-7,180,229,409,0.440,05/14/2023,2023.0
63,Holy Cross (Patriot),14,1-13,165,227,392,0.421,05/14/2023,2023.0
64,Syracuse (ACC),15,8-7,187,259,446,0.419,05/14/2023,2023.0
65,Loyola Maryland (Patriot),17,9-8,176,263,439,0.401,05/14/2023,2023.0
66,Wagner (MAAC),14,3-11,125,187,312,0.401,05/14/2023,2023.0
67,Providence (Big East),15,6-9,172,258,430,0.400,05/14/2023,2023.0
68,Bucknell (Patriot),13,3-10,140,211,351,0.399,05/14/2023,2023.0
69,Air Force (ASUN),17,11-6,166,262,428,0.388,05/14/2023,2023.0
70,Detroit Mercy (ASUN),13,2-11,130,230,360,0.361,05/14/2023,2023.0
71,UMass Lowell (America East),13,0-13,120,226,346,0.347,05/14/2023,2023.0
72,St. John's (NY) (Big East),14,0-14,103,286,389,0.265,05/14/2023,2023.0
-,Hartford (DI Independent),6,6-0,99,36,135,0.733,05/14/2023,2023.0
-,Lindenwood (ASUN),12,2-10,142,187,329,0.432,05/14/2023,2023.0
-,Merrimack (America East),14,7-7,145,210,355,0.408,05/14/2023,2023.0
-,Queens (NC) (ASUN),14,2-12,147,237,384,0.383,05/14/2023,2023.0
1,Lehigh (Patriot),15,10-5,270,156,426,0.634,05/13/2023,2023.0
2,Saint Joseph's (Atlantic 10),15,10-5,268,164,432,0.620,05/13/2023,2023.0
3,Duke (ACC),15,13-2,269,167,436,0.617,05/13/2023,2023.0
4,Mount St. Mary's (MAAC),16,8-8,259,163,422,0.614,05/13/2023,2023.0
5,Michigan (Big Ten),15,9-6,268,171,439,0.610,05/13/2023,2023.0
6,Army West Point (Patriot),16,13-3,249,159,408,0.610,05/13/2023,2023.0
7,Vermont (America East),14,9-5,213,137,350,0.609,05/13/2023,2023.0
8,Denver (Big East),15,10-5,226,148,374,0.604,05/13/2023,2023.0
9,Maryland (Big Ten),16,10-6,254,172,426,0.596,05/13/2023,2023.0
10,Mercer (ASUN),16,6-10,256,176,432,0.593,05/13/2023,2023.0
11,Brown (Ivy League),14,6-8,240,168,408,0.588,05/13/2023,2023.0
12,Navy (Patriot),16,8-8,222,163,385,0.577,05/13/2023,2023.0
13,Hofstra (CAA),14,5-9,194,145,339,0.572,05/13/2023,2023.0
14,Bryant (America East),16,12-4,272,207,479,0.568,05/13/2023,2023.0
15,Binghamton (America East),14,9-5,225,179,404,0.557,05/13/2023,2023.0
16,Massachusetts (Atlantic 10),14,8-6,173,138,311,0.556,05/13/2023,2023.0
17,Monmouth (CAA),14,5-9,193,154,347,0.556,05/13/2023,2023.0
18,Drexel (CAA),14,8-6,211,169,380,0.555,05/13/2023,2023.0
19,Georgetown (Big East),16,13-3,260,209,469,0.554,05/13/2023,2023.0
20,Dartmouth (Ivy League),12,6-6,195,158,353,0.552,05/13/2023,2023.0
21,Virginia (ACC),15,12-3,271,221,492,0.551,05/13/2023,2023.0
22,Towson (CAA),15,6-9,213,177,390,0.546,05/13/2023,2023.0
23,High Point (Atlantic 10),17,9-8,278,232,510,0.545,05/13/2023,2023.0
24,Utah (ASUN),17,12-5,295,248,543,0.543,05/13/2023,2023.0
25,Quinnipiac (MAAC),14,7-7,229,197,426,0.538,05/13/2023,2023.0
26,Jacksonville (ASUN),16,12-4,238,206,444,0.536,05/13/2023,2023.0
27,Villanova (Big East),15,10-5,218,189,407,0.536,05/13/2023,2023.0
28,Robert Morris (ASUN),16,8-8,228,199,427,0.534,05/13/2023,2023.0
29,Rutgers (Big Ten),14,8-6,193,173,366,0.527,05/13/2023,2023.0
30,Manhattan (MAAC),15,10-5,164,148,312,0.526,05/13/2023,2023.0
31,Yale (Ivy League),15,9-6,251,227,478,0.525,05/13/2023,2023.0
32,Marquette (Big East),14,6-8,212,198,410,0.517,05/13/2023,2023.0
33,Colgate (Patriot),11,2-9,148,143,291,0.509,05/13/2023,2023.0
34,Hobart (Atlantic 10),13,5-8,203,199,402,0.505,05/13/2023,2023.0
35,North Carolina (ACC),14,7-7,205,205,410,0.500,05/13/2023,2023.0
36,NJIT (America East),13,3-10,172,173,345,0.499,05/13/2023,2023.0
37,Cornell (Ivy League),14,11-3,205,207,412,0.498,05/13/2023,2023.0
38,Boston U. (Patriot),14,10-4,194,196,390,0.497,05/13/2023,2023.0
39,VMI (MAAC),15,6-9,198,204,402,0.493,05/13/2023,2023.0
40,Johns Hopkins (Big Ten),16,11-5,213,222,435,0.490,05/13/2023,2023.0
41,Richmond (Atlantic 10),16,11-5,213,227,440,0.484,05/13/2023,2023.0
42,Delaware (CAA),17,13-4,227,242,469,0.484,05/13/2023,2023.0
43,Bellarmine (ASUN),17,11-6,230,246,476,0.483,05/13/2023,2023.0
44,Marist (MAAC),18,10-8,256,275,531,0.482,05/13/2023,2023.0
45,Canisius (MAAC),15,2-13,195,215,410,0.476,05/13/2023,2023.0
46,Penn St. (Big Ten),13,9-4,174,192,366,0.475,05/13/2023,2023.0
47,Stony Brook (CAA),16,9-7,211,237,448,0.471,05/13/2023,2023.0
48,UAlbany (America East),16,6-10,193,218,411,0.470,05/13/2023,2023.0
49,St. Bonaventure (Atlantic 10),14,1-13,174,197,371,0.469,05/13/2023,2023.0
50,Cleveland St. (ASUN),13,6-7,169,192,361,0.468,05/13/2023,2023.0
51,Notre Dame (ACC),13,11-2,179,208,387,0.463,05/13/2023,2023.0
52,Fairfield (CAA),14,5-9,182,214,396,0.460,05/13/2023,2023.0
53,UMBC (America East),13,8-5,147,173,320,0.459,05/13/2023,2023.0
54,LIU (MAAC),14,5-9,167,199,366,0.456,05/13/2023,2023.0
55,Hampton (CAA),14,2-12,164,196,360,0.456,05/13/2023,2023.0
56,Ohio St. (Big Ten),14,5-9,177,213,390,0.454,05/13/2023,2023.0
57,Penn (Ivy League),13,7-6,157,190,347,0.452,05/13/2023,2023.0
58,Princeton (Ivy League),14,8-6,180,218,398,0.452,05/13/2023,2023.0
59,Sacred Heart (MAAC),15,5-10,173,210,383,0.452,05/13/2023,2023.0
60,Lafayette (Patriot),16,6-10,193,243,436,0.443,05/13/2023,2023.0
61,Harvard (Ivy League),12,5-7,155,197,352,0.440,05/13/2023,2023.0
62,Siena (MAAC),16,9-7,180,229,409,0.440,05/13/2023,2023.0
63,Holy Cross (Patriot),14,1-13,165,227,392,0.421,05/13/2023,2023.0
64,Syracuse (ACC),15,8-7,187,259,446,0.419,05/13/2023,2023.0
65,Loyola Maryland (Patriot),17,9-8,176,263,439,0.401,05/13/2023,2023.0
66,Wagner (MAAC),14,3-11,125,187,312,0.401,05/13/2023,2023.0
67,Providence (Big East),15,6-9,172,258,430,0.400,05/13/2023,2023.0
68,Bucknell (Patriot),13,3-10,140,211,351,0.399,05/13/2023,2023.0
69,Air Force (ASUN),17,11-6,166,262,428,0.388,05/13/2023,2023.0
70,Detroit Mercy (ASUN),13,2-11,130,230,360,0.361,05/13/2023,2023.0
71,UMass Lowell (America East),13,0-13,120,226,346,0.347,05/13/2023,2023.0
72,St. John's (NY) (Big East),14,0-14,103,286,389,0.265,05/13/2023,2023.0
-,Hartford (DI Independent),6,6-0,99,36,135,0.733,05/13/2023,2023.0
-,Lindenwood (ASUN),12,2-10,142,187,329,0.432,05/13/2023,2023.0
-,Merrimack (America East),14,7-7,145,210,355,0.408,05/13/2023,2023.0
-,Queens (NC) (ASUN),14,2-12,147,237,384,0.383,05/13/2023,2023.0
1,Lehigh (Patriot),15,10-5,270,156,426,0.634,05/10/2023,2023.0
2,Army West Point (Patriot),15,12-3,232,141,373,0.622,05/10/2023,2023.0
3,Saint Joseph's (Atlantic 10),15,10-5,268,164,432,0.620,05/10/2023,2023.0
4,Duke (ACC),15,13-2,269,167,436,0.617,05/10/2023,2023.0
5,Mount St. Mary's (MAAC),16,8-8,259,163,422,0.614,05/10/2023,2023.0
6,Michigan (Big Ten),15,9-6,268,171,439,0.610,05/10/2023,2023.0
7,Vermont (America East),14,9-5,213,137,350,0.609,05/10/2023,2023.0
8,Denver (Big East),15,10-5,226,148,374,0.604,05/10/2023,2023.0
9,Maryland (Big Ten),15,10-5,236,155,391,0.604,05/10/2023,2023.0
10,Mercer (ASUN),16,6-10,256,176,432,0.593,05/10/2023,2023.0
11,Brown (Ivy League),14,6-8,240,168,408,0.588,05/10/2023,2023.0
12,Navy (Patriot),16,8-8,222,163,385,0.577,05/10/2023,2023.0
13,Hofstra (CAA),14,5-9,194,145,339,0.572,05/10/2023,2023.0
14,Bryant (America East),16,12-4,272,207,479,0.568,05/10/2023,2023.0
15,Georgetown (Big East),15,12-3,242,187,429,0.564,05/10/2023,2023.0
16,Utah (ASUN),16,12-4,286,226,512,0.559,05/10/2023,2023.0
17,Binghamton (America East),14,9-5,225,179,404,0.557,05/10/2023,2023.0
18,Massachusetts (Atlantic 10),14,8-6,173,138,311,0.556,05/10/2023,2023.0
19,Monmouth (CAA),14,5-9,193,154,347,0.556,05/10/2023,2023.0
20,Drexel (CAA),14,8-6,211,169,380,0.555,05/10/2023,2023.0
21,Dartmouth (Ivy League),12,6-6,195,158,353,0.552,05/10/2023,2023.0
22,Towson (CAA),15,6-9,213,177,390,0.546,05/10/2023,2023.0
23,Virginia (ACC),14,11-3,253,211,464,0.545,05/10/2023,2023.0
24,High Point (Atlantic 10),17,9-8,278,232,510,0.545,05/10/2023,2023.0
25,Quinnipiac (MAAC),14,7-7,229,197,426,0.538,05/10/2023,2023.0
26,Jacksonville (ASUN),16,12-4,238,206,444,0.536,05/10/2023,2023.0
27,Villanova (Big East),15,10-5,218,189,407,0.536,05/10/2023,2023.0
28,Robert Morris (ASUN),16,8-8,228,199,427,0.534,05/10/2023,2023.0
29,Rutgers (Big Ten),14,8-6,193,173,366,0.527,05/10/2023,2023.0
30,Manhattan (MAAC),15,10-5,164,148,312,0.526,05/10/2023,2023.0
31,Yale (Ivy League),14,9-5,229,209,438,0.523,05/10/2023,2023.0
32,Marquette (Big East),14,6-8,212,198,410,0.517,05/10/2023,2023.0
33,Colgate (Patriot),11,2-9,148,143,291,0.509,05/10/2023,2023.0
34,Hobart (Atlantic 10),13,5-8,203,199,402,0.505,05/10/2023,2023.0
35,North Carolina (ACC),14,7-7,205,205,410,0.500,05/10/2023,2023.0
36,NJIT (America East),13,3-10,172,173,345,0.499,05/10/2023,2023.0
37,Cornell (Ivy League),14,11-3,205,207,412,0.498,05/10/2023,2023.0
38,Boston U. (Patriot),14,10-4,194,196,390,0.497,05/10/2023,2023.0
39,Richmond (Atlantic 10),15,11-4,203,209,412,0.493,05/10/2023,2023.0
40,VMI (MAAC),15,6-9,198,204,402,0.493,05/10/2023,2023.0
41,Johns Hopkins (Big Ten),16,11-5,213,222,435,0.490,05/10/2023,2023.0
42,Delaware (CAA),17,13-4,227,242,469,0.484,05/10/2023,2023.0
43,Bellarmine (ASUN),17,11-6,230,246,476,0.483,05/10/2023,2023.0
44,Marist (MAAC),18,10-8,256,275,531,0.482,05/10/2023,2023.0
45,Canisius (MAAC),15,2-13,195,215,410,0.476,05/10/2023,2023.0
46,Penn St. (Big Ten),13,9-4,174,192,366,0.475,05/10/2023,2023.0
47,Stony Brook (CAA),16,9-7,211,237,448,0.471,05/10/2023,2023.0
48,UAlbany (America East),16,6-10,193,218,411,0.470,05/10/2023,2023.0
49,St. Bonaventure (Atlantic 10),14,1-13,174,197,371,0.469,05/10/2023,2023.0
50,Cleveland St. (ASUN),13,6-7,169,192,361,0.468,05/10/2023,2023.0
51,Fairfield (CAA),14,5-9,182,214,396,0.460,05/10/2023,2023.0
52,UMBC (America East),13,8-5,147,173,320,0.459,05/10/2023,2023.0
53,LIU (MAAC),14,5-9,167,199,366,0.456,05/10/2023,2023.0
54,Hampton (CAA),14,2-12,164,196,360,0.456,05/10/2023,2023.0
55,Ohio St. (Big Ten),14,5-9,177,213,390,0.454,05/10/2023,2023.0
56,Penn (Ivy League),13,7-6,157,190,347,0.452,05/10/2023,2023.0
57,Princeton (Ivy League),14,8-6,180,218,398,0.452,05/10/2023,2023.0
58,Sacred Heart (MAAC),15,5-10,173,210,383,0.452,05/10/2023,2023.0
59,Lafayette (Patriot),16,6-10,193,243,436,0.443,05/10/2023,2023.0
60,Notre Dame (ACC),12,10-2,157,199,356,0.441,05/10/2023,2023.0
61,Harvard (Ivy League),12,5-7,155,197,352,0.440,05/10/2023,2023.0
62,Siena (MAAC),16,9-7,180,229,409,0.440,05/10/2023,2023.0
63,Holy Cross (Patriot),14,1-13,165,227,392,0.421,05/10/2023,2023.0
64,Syracuse (ACC),15,8-7,187,259,446,0.419,05/10/2023,2023.0
65,Loyola Maryland (Patriot),17,9-8,176,263,439,0.401,05/10/2023,2023.0
66,Wagner (MAAC),14,3-11,125,187,312,0.401,05/10/2023,2023.0
67,Providence (Big East),15,6-9,172,258,430,0.400,05/10/2023,2023.0
68,Bucknell (Patriot),13,3-10,140,211,351,0.399,05/10/2023,2023.0
69,Air Force (ASUN),17,11-6,166,262,428,0.388,05/10/2023,2023.0
70,Detroit Mercy (ASUN),13,2-11,130,230,360,0.361,05/10/2023,2023.0
71,UMass Lowell (America East),13,0-13,120,226,346,0.347,05/10/2023,2023.0
72,St. John's (NY) (Big East),14,0-14,103,286,389,0.265,05/10/2023,2023.0
-,Hartford (DI Independent),6,6-0,99,36,135,0.733,05/10/2023,2023.0
-,Lindenwood (ASUN),12,2-10,142,187,329,0.432,05/10/2023,2023.0
-,Merrimack (America East),14,7-7,145,210,355,0.408,05/10/2023,2023.0
-,Queens (NC) (ASUN),14,2-12,147,237,384,0.383,05/10/2023,2023.0
1,Lehigh (Patriot),15,10-5,270,156,426,0.634,05/07/2023,2023.0
2,Army West Point (Patriot),15,12-3,232,141,373,0.622,05/07/2023,2023.0
3,Saint Joseph's (Atlantic 10),15,10-5,268,164,432,0.620,05/07/2023,2023.0
4,Duke (ACC),15,13-2,269,167,436,0.617,05/07/2023,2023.0
5,Mount St. Mary's (MAAC),16,8-8,259,163,422,0.614,05/07/2023,2023.0
6,Michigan (Big Ten),15,9-6,268,171,439,0.610,05/07/2023,2023.0
7,Vermont (America East),14,9-5,213,137,350,0.609,05/07/2023,2023.0
8,Denver (Big East),15,10-5,226,148,374,0.604,05/07/2023,2023.0
9,Maryland (Big Ten),15,10-5,236,155,391,0.604,05/07/2023,2023.0
10,Mercer (ASUN),16,6-10,256,176,432,0.593,05/07/2023,2023.0
11,Brown (Ivy League),14,6-8,240,168,408,0.588,05/07/2023,2023.0
12,Navy (Patriot),16,8-8,222,163,385,0.577,05/07/2023,2023.0
13,Hofstra (CAA),14,5-9,194,145,339,0.572,05/07/2023,2023.0
14,Bryant (America East),16,12-4,272,207,479,0.568,05/07/2023,2023.0
15,Georgetown (Big East),15,12-3,242,187,429,0.564,05/07/2023,2023.0
16,Utah (ASUN),16,12-4,286,226,512,0.559,05/07/2023,2023.0
17,Binghamton (America East),14,9-5,225,179,404,0.557,05/07/2023,2023.0
18,Massachusetts (Atlantic 10),14,8-6,173,138,311,0.556,05/07/2023,2023.0
19,Monmouth (CAA),14,5-9,193,154,347,0.556,05/07/2023,2023.0
20,Drexel (CAA),14,8-6,211,169,380,0.555,05/07/2023,2023.0
21,Dartmouth (Ivy League),12,6-6,195,158,353,0.552,05/07/2023,2023.0
22,Towson (CAA),15,6-9,213,177,390,0.546,05/07/2023,2023.0
23,Virginia (ACC),14,11-3,253,211,464,0.545,05/07/2023,2023.0
24,High Point (Atlantic 10),17,9-8,278,232,510,0.545,05/07/2023,2023.0
25,Quinnipiac (MAAC),14,7-7,229,197,426,0.538,05/07/2023,2023.0
26,Jacksonville (ASUN),16,12-4,238,206,444,0.536,05/07/2023,2023.0
27,Villanova (Big East),15,10-5,218,189,407,0.536,05/07/2023,2023.0
28,Robert Morris (ASUN),16,8-8,228,199,427,0.534,05/07/2023,2023.0
29,Rutgers (Big Ten),14,8-6,193,173,366,0.527,05/07/2023,2023.0
30,Manhattan (MAAC),15,10-5,164,148,312,0.526,05/07/2023,2023.0
31,Yale (Ivy League),14,9-5,229,209,438,0.523,05/07/2023,2023.0
32,Marquette (Big East),14,6-8,212,198,410,0.517,05/07/2023,2023.0
33,Colgate (Patriot),11,2-9,148,143,291,0.509,05/07/2023,2023.0
34,Hobart (Atlantic 10),13,5-8,203,199,402,0.505,05/07/2023,2023.0
35,North Carolina (ACC),14,7-7,205,205,410,0.500,05/07/2023,2023.0
36,NJIT (America East),13,3-10,172,173,345,0.499,05/07/2023,2023.0
37,Cornell (Ivy League),14,11-3,205,207,412,0.498,05/07/2023,2023.0
38,Boston U. (Patriot),14,10-4,194,196,390,0.497,05/07/2023,2023.0
39,Richmond (Atlantic 10),15,11-4,203,209,412,0.493,05/07/2023,2023.0
40,VMI (MAAC),15,6-9,198,204,402,0.493,05/07/2023,2023.0
41,Johns Hopkins (Big Ten),16,11-5,213,222,435,0.490,05/07/2023,2023.0
42,Marist (MAAC),17,10-7,239,253,492,0.486,05/07/2023,2023.0
43,Bellarmine (ASUN),17,11-6,230,246,476,0.483,05/07/2023,2023.0
44,Delaware (CAA),16,12-4,205,225,430,0.477,05/07/2023,2023.0
45,Canisius (MAAC),15,2-13,195,215,410,0.476,05/07/2023,2023.0
46,Penn St. (Big Ten),13,9-4,174,192,366,0.475,05/07/2023,2023.0
47,Stony Brook (CAA),16,9-7,211,237,448,0.471,05/07/2023,2023.0
48,UAlbany (America East),16,6-10,193,218,411,0.470,05/07/2023,2023.0
49,St. Bonaventure (Atlantic 10),14,1-13,174,197,371,0.469,05/07/2023,2023.0
50,Cleveland St. (ASUN),13,6-7,169,192,361,0.468,05/07/2023,2023.0
51,Fairfield (CAA),14,5-9,182,214,396,0.460,05/07/2023,2023.0
52,UMBC (America East),13,8-5,147,173,320,0.459,05/07/2023,2023.0
53,LIU (MAAC),14,5-9,167,199,366,0.456,05/07/2023,2023.0
54,Hampton (CAA),14,2-12,164,196,360,0.456,05/07/2023,2023.0
55,Ohio St. (Big Ten),14,5-9,177,213,390,0.454,05/07/2023,2023.0
56,Penn (Ivy League),13,7-6,157,190,347,0.452,05/07/2023,2023.0
57,Princeton (Ivy League),14,8-6,180,218,398,0.452,05/07/2023,2023.0
58,Sacred Heart (MAAC),15,5-10,173,210,383,0.452,05/07/2023,2023.0
59,Lafayette (Patriot),16,6-10,193,243,436,0.443,05/07/2023,2023.0
60,Notre Dame (ACC),12,10-2,157,199,356,0.441,05/07/2023,2023.0
61,Harvard (Ivy League),12,5-7,155,197,352,0.440,05/07/2023,2023.0
62,Siena (MAAC),16,9-7,180,229,409,0.440,05/07/2023,2023.0
63,Holy Cross (Patriot),14,1-13,165,227,392,0.421,05/07/2023,2023.0
64,Syracuse (ACC),15,8-7,187,259,446,0.419,05/07/2023,2023.0
65,Loyola Maryland (Patriot),17,9-8,176,263,439,0.401,05/07/2023,2023.0
66,Wagner (MAAC),14,3-11,125,187,312,0.401,05/07/2023,2023.0
67,Providence (Big East),15,6-9,172,258,430,0.400,05/07/2023,2023.0
68,Bucknell (Patriot),13,3-10,140,211,351,0.399,05/07/2023,2023.0
69,Air Force (ASUN),17,11-6,166,262,428,0.388,05/07/2023,2023.0
70,Detroit Mercy (ASUN),13,2-11,130,230,360,0.361,05/07/2023,2023.0
71,UMass Lowell (America East),13,0-13,120,226,346,0.347,05/07/2023,2023.0
72,St. John's (NY) (Big East),14,0-14,103,286,389,0.265,05/07/2023,2023.0
-,Hartford (DI Independent),6,6-0,99,36,135,0.733,05/07/2023,2023.0
-,Lindenwood (ASUN),12,2-10,142,187,329,0.432,05/07/2023,2023.0
-,Merrimack (America East),14,7-7,145,210,355,0.408,05/07/2023,2023.0
-,Queens (NC) (ASUN),14,2-12,147,237,384,0.383,05/07/2023,2023.0
1,Lehigh (Patriot),15,10-5,270,156,426,0.634,05/06/2023,2023.0
2,Saint Joseph's (Atlantic 10),15,10-5,268,164,432,0.620,05/06/2023,2023.0
3,Duke (ACC),14,12-2,256,160,416,0.615,05/06/2023,2023.0
4,Mount St. Mary's (MAAC),16,8-8,259,163,422,0.614,05/06/2023,2023.0
5,Michigan (Big Ten),15,9-6,268,171,439,0.610,05/06/2023,2023.0
6,Army West Point (Patriot),14,11-3,214,137,351,0.610,05/06/2023,2023.0
7,Vermont (America East),14,9-5,213,137,350,0.609,05/06/2023,2023.0
8,Denver (Big East),15,10-5,226,148,374,0.604,05/06/2023,2023.0
9,Maryland (Big Ten),15,10-5,236,155,391,0.604,05/06/2023,2023.0
10,Mercer (ASUN),16,6-10,256,176,432,0.593,05/06/2023,2023.0
11,Brown (Ivy League),14,6-8,240,168,408,0.588,05/06/2023,2023.0
12,Navy (Patriot),16,8-8,222,163,385,0.577,05/06/2023,2023.0
13,Hofstra (CAA),14,5-9,194,145,339,0.572,05/06/2023,2023.0
14,Bryant (America East),16,12-4,272,207,479,0.568,05/06/2023,2023.0
15,Georgetown (Big East),15,12-3,242,187,429,0.564,05/06/2023,2023.0
16,Binghamton (America East),14,9-5,225,179,404,0.557,05/06/2023,2023.0
17,Massachusetts (Atlantic 10),14,8-6,173,138,311,0.556,05/06/2023,2023.0
18,Monmouth (CAA),14,5-9,193,154,347,0.556,05/06/2023,2023.0
19,Drexel (CAA),14,8-6,211,169,380,0.555,05/06/2023,2023.0
20,Dartmouth (Ivy League),12,6-6,195,158,353,0.552,05/06/2023,2023.0
21,Towson (CAA),15,6-9,213,177,390,0.546,05/06/2023,2023.0
22,Virginia (ACC),14,11-3,253,211,464,0.545,05/06/2023,2023.0
23,High Point (Atlantic 10),17,9-8,278,232,510,0.545,05/06/2023,2023.0
24,Utah (ASUN),15,11-4,265,224,489,0.542,05/06/2023,2023.0
25,Quinnipiac (MAAC),14,7-7,229,197,426,0.538,05/06/2023,2023.0
26,Jacksonville (ASUN),16,12-4,238,206,444,0.536,05/06/2023,2023.0
27,Villanova (Big East),15,10-5,218,189,407,0.536,05/06/2023,2023.0
28,Robert Morris (ASUN),16,8-8,228,199,427,0.534,05/06/2023,2023.0
29,Rutgers (Big Ten),14,8-6,193,173,366,0.527,05/06/2023,2023.0
30,Yale (Ivy League),13,9-4,214,193,407,0.526,05/06/2023,2023.0
31,Manhattan (MAAC),15,10-5,164,148,312,0.526,05/06/2023,2023.0
32,Marquette (Big East),14,6-8,212,198,410,0.517,05/06/2023,2023.0
33,Colgate (Patriot),11,2-9,148,143,291,0.509,05/06/2023,2023.0
34,Hobart (Atlantic 10),13,5-8,203,199,402,0.505,05/06/2023,2023.0
35,North Carolina (ACC),14,7-7,205,205,410,0.500,05/06/2023,2023.0
36,NJIT (America East),13,3-10,172,173,345,0.499,05/06/2023,2023.0
37,Cornell (Ivy League),14,11-3,205,207,412,0.498,05/06/2023,2023.0
38,Boston U. (Patriot),14,10-4,194,196,390,0.497,05/06/2023,2023.0
39,Richmond (Atlantic 10),15,11-4,203,209,412,0.493,05/06/2023,2023.0
40,VMI (MAAC),15,6-9,198,204,402,0.493,05/06/2023,2023.0
41,Johns Hopkins (Big Ten),16,11-5,213,222,435,0.490,05/06/2023,2023.0
42,Marist (MAAC),17,10-7,239,253,492,0.486,05/06/2023,2023.0
43,Bellarmine (ASUN),17,11-6,230,246,476,0.483,05/06/2023,2023.0
44,Delaware (CAA),16,12-4,205,225,430,0.477,05/06/2023,2023.0
45,Canisius (MAAC),15,2-13,195,215,410,0.476,05/06/2023,2023.0
46,Penn St. (Big Ten),13,9-4,174,192,366,0.475,05/06/2023,2023.0
47,Stony Brook (CAA),16,9-7,211,237,448,0.471,05/06/2023,2023.0
48,UAlbany (America East),16,6-10,193,218,411,0.470,05/06/2023,2023.0
49,St. Bonaventure (Atlantic 10),14,1-13,174,197,371,0.469,05/06/2023,2023.0
50,Cleveland St. (ASUN),13,6-7,169,192,361,0.468,05/06/2023,2023.0
51,Fairfield (CAA),14,5-9,182,214,396,0.460,05/06/2023,2023.0
52,UMBC (America East),13,8-5,147,173,320,0.459,05/06/2023,2023.0
53,LIU (MAAC),14,5-9,167,199,366,0.456,05/06/2023,2023.0
54,Hampton (CAA),14,2-12,164,196,360,0.456,05/06/2023,2023.0
55,Ohio St. (Big Ten),14,5-9,177,213,390,0.454,05/06/2023,2023.0
56,Penn (Ivy League),13,7-6,157,190,347,0.452,05/06/2023,2023.0
57,Sacred Heart (MAAC),15,5-10,173,210,383,0.452,05/06/2023,2023.0
58,Princeton (Ivy League),13,7-6,164,203,367,0.447,05/06/2023,2023.0
59,Lafayette (Patriot),16,6-10,193,243,436,0.443,05/06/2023,2023.0
60,Notre Dame (ACC),12,10-2,157,199,356,0.441,05/06/2023,2023.0
61,Harvard (Ivy League),12,5-7,155,197,352,0.440,05/06/2023,2023.0
62,Siena (MAAC),16,9-7,180,229,409,0.440,05/06/2023,2023.0
63,Holy Cross (Patriot),14,1-13,165,227,392,0.421,05/06/2023,2023.0
64,Syracuse (ACC),15,8-7,187,259,446,0.419,05/06/2023,2023.0
65,Loyola Maryland (Patriot),16,9-7,172,245,417,0.412,05/06/2023,2023.0
66,Air Force (ASUN),16,11-5,164,241,405,0.405,05/06/2023,2023.0
67,Wagner (MAAC),14,3-11,125,187,312,0.401,05/06/2023,2023.0
68,Providence (Big East),15,6-9,172,258,430,0.400,05/06/2023,2023.0
69,Bucknell (Patriot),13,3-10,140,211,351,0.399,05/06/2023,2023.0
70,Detroit Mercy (ASUN),13,2-11,130,230,360,0.361,05/06/2023,2023.0
71,UMass Lowell (America East),13,0-13,120,226,346,0.347,05/06/2023,2023.0
72,St. John's (NY) (Big East),14,0-14,103,286,389,0.265,05/06/2023,2023.0
-,Hartford (DI Independent),6,6-0,99,36,135,0.733,05/06/2023,2023.0
-,Lindenwood (ASUN),12,2-10,142,187,329,0.432,05/06/2023,2023.0
-,Merrimack (America East),13,7-6,138,197,335,0.412,05/06/2023,2023.0
-,Queens (NC) (ASUN),14,2-12,147,237,384,0.383,05/06/2023,2023.0
1,Lehigh (Patriot),15,10-5,270,156,426,0.634,05/05/2023,2023.0
2,Saint Joseph's (Atlantic 10),15,10-5,268,164,432,0.620,05/05/2023,2023.0
3,Duke (ACC),14,12-2,256,160,416,0.615,05/05/2023,2023.0
4,Michigan (Big Ten),14,8-6,257,161,418,0.615,05/05/2023,2023.0
5,Mount St. Mary's (MAAC),16,8-8,259,163,422,0.614,05/05/2023,2023.0
6,Maryland (Big Ten),14,10-4,226,144,370,0.611,05/05/2023,2023.0
7,Army West Point (Patriot),14,11-3,214,137,351,0.610,05/05/2023,2023.0
8,Vermont (America East),14,9-5,213,137,350,0.609,05/05/2023,2023.0
9,Denver (Big East),14,10-4,212,141,353,0.601,05/05/2023,2023.0
10,Mercer (ASUN),16,6-10,256,176,432,0.593,05/05/2023,2023.0
11,Brown (Ivy League),14,6-8,240,168,408,0.588,05/05/2023,2023.0
12,Navy (Patriot),16,8-8,222,163,385,0.577,05/05/2023,2023.0
13,Georgetown (Big East),14,11-3,235,173,408,0.576,05/05/2023,2023.0
14,Hofstra (CAA),14,5-9,194,145,339,0.572,05/05/2023,2023.0
15,Bryant (America East),15,11-4,257,194,451,0.570,05/05/2023,2023.0
16,Binghamton (America East),14,9-5,225,179,404,0.557,05/05/2023,2023.0
17,Massachusetts (Atlantic 10),14,8-6,173,138,311,0.556,05/05/2023,2023.0
18,Monmouth (CAA),14,5-9,193,154,347,0.556,05/05/2023,2023.0
19,Drexel (CAA),14,8-6,211,169,380,0.555,05/05/2023,2023.0
20,Dartmouth (Ivy League),12,6-6,195,158,353,0.552,05/05/2023,2023.0
21,Towson (CAA),15,6-9,213,177,390,0.546,05/05/2023,2023.0
22,Virginia (ACC),14,11-3,253,211,464,0.545,05/05/2023,2023.0
23,Utah (ASUN),15,11-4,265,224,489,0.542,05/05/2023,2023.0
24,High Point (Atlantic 10),16,9-7,261,224,485,0.538,05/05/2023,2023.0
25,Quinnipiac (MAAC),14,7-7,229,197,426,0.538,05/05/2023,2023.0
26,Jacksonville (ASUN),16,12-4,238,206,444,0.536,05/05/2023,2023.0
27,Villanova (Big East),15,10-5,218,189,407,0.536,05/05/2023,2023.0
28,Robert Morris (ASUN),16,8-8,228,199,427,0.534,05/05/2023,2023.0
29,Rutgers (Big Ten),14,8-6,193,173,366,0.527,05/05/2023,2023.0
30,Yale (Ivy League),13,9-4,214,193,407,0.526,05/05/2023,2023.0
31,Manhattan (MAAC),15,10-5,164,148,312,0.526,05/05/2023,2023.0
32,Marquette (Big East),14,6-8,212,198,410,0.517,05/05/2023,2023.0
33,Colgate (Patriot),11,2-9,148,143,291,0.509,05/05/2023,2023.0
34,Hobart (Atlantic 10),13,5-8,203,199,402,0.505,05/05/2023,2023.0
35,Richmond (Atlantic 10),14,10-4,195,192,387,0.504,05/05/2023,2023.0
36,NJIT (America East),13,3-10,172,173,345,0.499,05/05/2023,2023.0
37,Cornell (Ivy League),14,11-3,205,207,412,0.498,05/05/2023,2023.0
38,Boston U. (Patriot),14,10-4,194,196,390,0.497,05/05/2023,2023.0
39,North Carolina (ACC),13,7-6,188,191,379,0.496,05/05/2023,2023.0
40,VMI (MAAC),15,6-9,198,204,402,0.493,05/05/2023,2023.0
41,Delaware (CAA),15,11-4,198,206,404,0.490,05/05/2023,2023.0
42,Johns Hopkins (Big Ten),16,11-5,213,222,435,0.490,05/05/2023,2023.0
43,Marist (MAAC),16,9-7,229,242,471,0.486,05/05/2023,2023.0
44,Bellarmine (ASUN),17,11-6,230,246,476,0.483,05/05/2023,2023.0
45,Canisius (MAAC),15,2-13,195,215,410,0.476,05/05/2023,2023.0
46,Penn St. (Big Ten),13,9-4,174,192,366,0.475,05/05/2023,2023.0
47,UAlbany (America East),15,6-9,180,203,383,0.470,05/05/2023,2023.0
48,St. Bonaventure (Atlantic 10),14,1-13,174,197,371,0.469,05/05/2023,2023.0
49,Cleveland St. (ASUN),13,6-7,169,192,361,0.468,05/05/2023,2023.0
50,Fairfield (CAA),14,5-9,182,214,396,0.460,05/05/2023,2023.0
51,UMBC (America East),13,8-5,147,173,320,0.459,05/05/2023,2023.0
52,LIU (MAAC),14,5-9,167,199,366,0.456,05/05/2023,2023.0
53,Hampton (CAA),14,2-12,164,196,360,0.456,05/05/2023,2023.0
54,Stony Brook (CAA),15,9-6,192,230,422,0.455,05/05/2023,2023.0
55,Ohio St. (Big Ten),14,5-9,177,213,390,0.454,05/05/2023,2023.0
56,Penn (Ivy League),13,7-6,157,190,347,0.452,05/05/2023,2023.0
57,Sacred Heart (MAAC),15,5-10,173,210,383,0.452,05/05/2023,2023.0
58,Princeton (Ivy League),13,7-6,164,203,367,0.447,05/05/2023,2023.0
59,Lafayette (Patriot),16,6-10,193,243,436,0.443,05/05/2023,2023.0
60,Harvard (Ivy League),12,5-7,155,197,352,0.440,05/05/2023,2023.0
61,Notre Dame (ACC),11,9-2,143,182,325,0.440,05/05/2023,2023.0
62,Siena (MAAC),15,9-6,169,219,388,0.436,05/05/2023,2023.0
63,Holy Cross (Patriot),14,1-13,165,227,392,0.421,05/05/2023,2023.0
64,Syracuse (ACC),15,8-7,187,259,446,0.419,05/05/2023,2023.0
65,Loyola Maryland (Patriot),16,9-7,172,245,417,0.412,05/05/2023,2023.0
66,Air Force (ASUN),16,11-5,164,241,405,0.405,05/05/2023,2023.0
67,Wagner (MAAC),14,3-11,125,187,312,0.401,05/05/2023,2023.0
68,Providence (Big East),15,6-9,172,258,430,0.400,05/05/2023,2023.0
69,Bucknell (Patriot),13,3-10,140,211,351,0.399,05/05/2023,2023.0
70,Detroit Mercy (ASUN),13,2-11,130,230,360,0.361,05/05/2023,2023.0
71,UMass Lowell (America East),13,0-13,120,226,346,0.347,05/05/2023,2023.0
72,St. John's (NY) (Big East),14,0-14,103,286,389,0.265,05/05/2023,2023.0
-,Hartford (DI Independent),6,6-0,99,36,135,0.733,05/05/2023,2023.0
-,Lindenwood (ASUN),12,2-10,142,187,329,0.432,05/05/2023,2023.0
-,Merrimack (America East),13,7-6,138,197,335,0.412,05/05/2023,2023.0
-,Queens (NC) (ASUN),14,2-12,147,237,384,0.383,05/05/2023,2023.0
1,Lehigh (Patriot),14,10-4,254,137,391,0.650,05/04/2023,2023.0
2,Saint Joseph's (Atlantic 10),15,10-5,268,164,432,0.620,05/04/2023,2023.0
3,Army West Point (Patriot),13,10-3,195,121,316,0.617,05/04/2023,2023.0
4,Duke (ACC),14,12-2,256,160,416,0.615,05/04/2023,2023.0
5,Michigan (Big Ten),14,8-6,257,161,418,0.615,05/04/2023,2023.0
6,Mount St. Mary's (MAAC),16,8-8,259,163,422,0.614,05/04/2023,2023.0
7,Maryland (Big Ten),14,10-4,226,144,370,0.611,05/04/2023,2023.0
8,Vermont (America East),14,9-5,213,137,350,0.609,05/04/2023,2023.0
9,Denver (Big East),14,10-4,212,141,353,0.601,05/04/2023,2023.0
10,Mercer (ASUN),16,6-10,256,176,432,0.593,05/04/2023,2023.0
11,Brown (Ivy League),14,6-8,240,168,408,0.588,05/04/2023,2023.0
12,Navy (Patriot),16,8-8,222,163,385,0.577,05/04/2023,2023.0
13,Georgetown (Big East),14,11-3,235,173,408,0.576,05/04/2023,2023.0
14,Hofstra (CAA),14,5-9,194,145,339,0.572,05/04/2023,2023.0
15,Bryant (America East),15,11-4,257,194,451,0.570,05/04/2023,2023.0
16,Binghamton (America East),14,9-5,225,179,404,0.557,05/04/2023,2023.0
17,Massachusetts (Atlantic 10),14,8-6,173,138,311,0.556,05/04/2023,2023.0
18,Monmouth (CAA),14,5-9,193,154,347,0.556,05/04/2023,2023.0
19,Drexel (CAA),14,8-6,211,169,380,0.555,05/04/2023,2023.0
20,Dartmouth (Ivy League),12,6-6,195,158,353,0.552,05/04/2023,2023.0
21,Towson (CAA),15,6-9,213,177,390,0.546,05/04/2023,2023.0
22,Virginia (ACC),14,11-3,253,211,464,0.545,05/04/2023,2023.0
23,High Point (Atlantic 10),16,9-7,261,224,485,0.538,05/04/2023,2023.0
24,Quinnipiac (MAAC),14,7-7,229,197,426,0.538,05/04/2023,2023.0
25,Jacksonville (ASUN),16,12-4,238,206,444,0.536,05/04/2023,2023.0
26,Villanova (Big East),15,10-5,218,189,407,0.536,05/04/2023,2023.0
27,Utah (ASUN),14,10-4,241,213,454,0.531,05/04/2023,2023.0
28,Robert Morris (ASUN),15,8-7,216,191,407,0.531,05/04/2023,2023.0
29,Rutgers (Big Ten),14,8-6,193,173,366,0.527,05/04/2023,2023.0
30,Manhattan (MAAC),15,10-5,164,148,312,0.526,05/04/2023,2023.0
31,Cornell (Ivy League),13,11-2,192,179,371,0.518,05/04/2023,2023.0
32,Marquette (Big East),14,6-8,212,198,410,0.517,05/04/2023,2023.0
33,Colgate (Patriot),11,2-9,148,143,291,0.509,05/04/2023,2023.0
34,Yale (Ivy League),12,8-4,186,180,366,0.508,05/04/2023,2023.0
35,Hobart (Atlantic 10),13,5-8,203,199,402,0.505,05/04/2023,2023.0
36,Richmond (Atlantic 10),14,10-4,195,192,387,0.504,05/04/2023,2023.0
37,NJIT (America East),13,3-10,172,173,345,0.499,05/04/2023,2023.0
38,Bellarmine (ASUN),16,11-5,219,222,441,0.497,05/04/2023,2023.0
39,North Carolina (ACC),13,7-6,188,191,379,0.496,05/04/2023,2023.0
40,Boston U. (Patriot),13,10-3,181,185,366,0.495,05/04/2023,2023.0
41,VMI (MAAC),15,6-9,198,204,402,0.493,05/04/2023,2023.0
42,Delaware (CAA),15,11-4,198,206,404,0.490,05/04/2023,2023.0
43,Johns Hopkins (Big Ten),16,11-5,213,222,435,0.490,05/04/2023,2023.0
44,Marist (MAAC),16,9-7,229,242,471,0.486,05/04/2023,2023.0
45,Canisius (MAAC),15,2-13,195,215,410,0.476,05/04/2023,2023.0
46,Penn St. (Big Ten),13,9-4,174,192,366,0.475,05/04/2023,2023.0
47,UAlbany (America East),15,6-9,180,203,383,0.470,05/04/2023,2023.0
48,St. Bonaventure (Atlantic 10),14,1-13,174,197,371,0.469,05/04/2023,2023.0
49,Cleveland St. (ASUN),13,6-7,169,192,361,0.468,05/04/2023,2023.0
50,Fairfield (CAA),14,5-9,182,214,396,0.460,05/04/2023,2023.0
51,UMBC (America East),13,8-5,147,173,320,0.459,05/04/2023,2023.0
52,LIU (MAAC),14,5-9,167,199,366,0.456,05/04/2023,2023.0
53,Hampton (CAA),14,2-12,164,196,360,0.456,05/04/2023,2023.0
54,Stony Brook (CAA),15,9-6,192,230,422,0.455,05/04/2023,2023.0
55,Ohio St. (Big Ten),14,5-9,177,213,390,0.454,05/04/2023,2023.0
56,Sacred Heart (MAAC),15,5-10,173,210,383,0.452,05/04/2023,2023.0
57,Penn (Ivy League),12,7-5,146,180,326,0.448,05/04/2023,2023.0
58,Princeton (Ivy League),12,6-6,154,192,346,0.445,05/04/2023,2023.0
59,Lafayette (Patriot),16,6-10,193,243,436,0.443,05/04/2023,2023.0
60,Harvard (Ivy League),12,5-7,155,197,352,0.440,05/04/2023,2023.0
61,Notre Dame (ACC),11,9-2,143,182,325,0.440,05/04/2023,2023.0
62,Siena (MAAC),15,9-6,169,219,388,0.436,05/04/2023,2023.0
63,Holy Cross (Patriot),14,1-13,165,227,392,0.421,05/04/2023,2023.0
64,Syracuse (ACC),15,8-7,187,259,446,0.419,05/04/2023,2023.0
65,Loyola Maryland (Patriot),15,8-7,161,232,393,0.410,05/04/2023,2023.0
66,Air Force (ASUN),15,10-5,156,229,385,0.405,05/04/2023,2023.0
67,Wagner (MAAC),14,3-11,125,187,312,0.401,05/04/2023,2023.0
68,Providence (Big East),15,6-9,172,258,430,0.400,05/04/2023,2023.0
69,Bucknell (Patriot),13,3-10,140,211,351,0.399,05/04/2023,2023.0
70,Detroit Mercy (ASUN),13,2-11,130,230,360,0.361,05/04/2023,2023.0
71,UMass Lowell (America East),13,0-13,120,226,346,0.347,05/04/2023,2023.0
72,St. John's (NY) (Big East),14,0-14,103,286,389,0.265,05/04/2023,2023.0
-,Hartford (DI Independent),6,6-0,99,36,135,0.733,05/04/2023,2023.0
-,Lindenwood (ASUN),12,2-10,142,187,329,0.432,05/04/2023,2023.0
-,Merrimack (America East),13,7-6,138,197,335,0.412,05/04/2023,2023.0
-,Queens (NC) (ASUN),14,2-12,147,237,384,0.383,05/04/2023,2023.0
1,Lehigh (Patriot),14,10-4,254,137,391,0.650,05/02/2023,2023.0
2,Saint Joseph's (Atlantic 10),14,10-4,249,150,399,0.624,05/02/2023,2023.0
3,Maryland (Big Ten),13,9-4,213,131,344,0.619,05/02/2023,2023.0
4,Army West Point (Patriot),13,10-3,195,121,316,0.617,05/02/2023,2023.0
5,Duke (ACC),14,12-2,256,160,416,0.615,05/02/2023,2023.0
6,Michigan (Big Ten),13,7-6,234,149,383,0.611,05/02/2023,2023.0
7,Denver (Big East),13,9-4,197,127,324,0.608,05/02/2023,2023.0
8,Mount St. Mary's (MAAC),15,8-7,237,155,392,0.605,05/02/2023,2023.0
9,Vermont (America East),13,9-4,200,132,332,0.602,05/02/2023,2023.0
10,Mercer (ASUN),16,6-10,256,176,432,0.593,05/02/2023,2023.0
11,Brown (Ivy League),14,6-8,240,168,408,0.588,05/02/2023,2023.0
12,Navy (Patriot),16,8-8,222,163,385,0.577,05/02/2023,2023.0
13,Bryant (America East),14,10-4,243,181,424,0.573,05/02/2023,2023.0
14,Hofstra (CAA),14,5-9,194,145,339,0.572,05/02/2023,2023.0
15,Georgetown (Big East),13,10-3,214,165,379,0.565,05/02/2023,2023.0
16,Binghamton (America East),13,9-4,212,165,377,0.562,05/02/2023,2023.0
17,Massachusetts (Atlantic 10),13,8-5,158,126,284,0.556,05/02/2023,2023.0
18,Monmouth (CAA),14,5-9,193,154,347,0.556,05/02/2023,2023.0
19,Dartmouth (Ivy League),12,6-6,195,158,353,0.552,05/02/2023,2023.0
20,Towson (CAA),14,6-8,202,165,367,0.550,05/02/2023,2023.0
21,High Point (Atlantic 10),15,8-7,247,205,452,0.546,05/02/2023,2023.0
22,Virginia (ACC),14,11-3,253,211,464,0.545,05/02/2023,2023.0
23,Drexel (CAA),13,8-5,193,161,354,0.545,05/02/2023,2023.0
24,Villanova (Big East),14,10-4,204,174,378,0.540,05/02/2023,2023.0
25,Quinnipiac (MAAC),14,7-7,229,197,426,0.538,05/02/2023,2023.0
26,Jacksonville (ASUN),16,12-4,238,206,444,0.536,05/02/2023,2023.0
27,Utah (ASUN),14,10-4,241,213,454,0.531,05/02/2023,2023.0
28,Robert Morris (ASUN),15,8-7,216,191,407,0.531,05/02/2023,2023.0
29,Rutgers (Big Ten),14,8-6,193,173,366,0.527,05/02/2023,2023.0
30,Cornell (Ivy League),13,11-2,192,179,371,0.518,05/02/2023,2023.0
31,Marquette (Big East),14,6-8,212,198,410,0.517,05/02/2023,2023.0
32,Manhattan (MAAC),14,10-4,148,141,289,0.512,05/02/2023,2023.0
33,Colgate (Patriot),11,2-9,148,143,291,0.509,05/02/2023,2023.0
34,Richmond (Atlantic 10),13,9-4,183,177,360,0.508,05/02/2023,2023.0
35,Yale (Ivy League),12,8-4,186,180,366,0.508,05/02/2023,2023.0
36,Hobart (Atlantic 10),13,5-8,203,199,402,0.505,05/02/2023,2023.0
37,Marist (MAAC),15,8-7,221,220,441,0.501,05/02/2023,2023.0
38,NJIT (America East),13,3-10,172,173,345,0.499,05/02/2023,2023.0
39,Bellarmine (ASUN),16,11-5,219,222,441,0.497,05/02/2023,2023.0
40,North Carolina (ACC),13,7-6,188,191,379,0.496,05/02/2023,2023.0
41,Boston U. (Patriot),13,10-3,181,185,366,0.495,05/02/2023,2023.0
42,VMI (MAAC),15,6-9,198,204,402,0.493,05/02/2023,2023.0
43,Penn St. (Big Ten),12,9-3,162,169,331,0.489,05/02/2023,2023.0
44,Johns Hopkins (Big Ten),15,11-4,200,209,409,0.489,05/02/2023,2023.0
45,Delaware (CAA),14,10-4,186,195,381,0.488,05/02/2023,2023.0
46,UAlbany (America East),14,5-9,175,190,365,0.479,05/02/2023,2023.0
47,Canisius (MAAC),15,2-13,195,215,410,0.476,05/02/2023,2023.0
48,St. Bonaventure (Atlantic 10),14,1-13,174,197,371,0.469,05/02/2023,2023.0
49,Cleveland St. (ASUN),13,6-7,169,192,361,0.468,05/02/2023,2023.0
50,Stony Brook (CAA),14,8-6,184,212,396,0.465,05/02/2023,2023.0
51,Fairfield (CAA),14,5-9,182,214,396,0.460,05/02/2023,2023.0
52,UMBC (America East),13,8-5,147,173,320,0.459,05/02/2023,2023.0
53,LIU (MAAC),14,5-9,167,199,366,0.456,05/02/2023,2023.0
54,Hampton (CAA),14,2-12,164,196,360,0.456,05/02/2023,2023.0
55,Ohio St. (Big Ten),14,5-9,177,213,390,0.454,05/02/2023,2023.0
56,Sacred Heart (MAAC),15,5-10,173,210,383,0.452,05/02/2023,2023.0
57,Penn (Ivy League),12,7-5,146,180,326,0.448,05/02/2023,2023.0
58,Princeton (Ivy League),12,6-6,154,192,346,0.445,05/02/2023,2023.0
59,Siena (MAAC),14,8-6,162,203,365,0.444,05/02/2023,2023.0
60,Lafayette (Patriot),16,6-10,193,243,436,0.443,05/02/2023,2023.0
61,Harvard (Ivy League),12,5-7,155,197,352,0.440,05/02/2023,2023.0
62,Notre Dame (ACC),11,9-2,143,182,325,0.440,05/02/2023,2023.0
63,Holy Cross (Patriot),14,1-13,165,227,392,0.421,05/02/2023,2023.0
64,Syracuse (ACC),15,8-7,187,259,446,0.419,05/02/2023,2023.0
65,Loyola Maryland (Patriot),15,8-7,161,232,393,0.410,05/02/2023,2023.0
66,Providence (Big East),14,6-8,164,237,401,0.409,05/02/2023,2023.0
67,Air Force (ASUN),15,10-5,156,229,385,0.405,05/02/2023,2023.0
68,Wagner (MAAC),14,3-11,125,187,312,0.401,05/02/2023,2023.0
69,Bucknell (Patriot),13,3-10,140,211,351,0.399,05/02/2023,2023.0
70,Detroit Mercy (ASUN),13,2-11,130,230,360,0.361,05/02/2023,2023.0
71,UMass Lowell (America East),13,0-13,120,226,346,0.347,05/02/2023,2023.0
72,St. John's (NY) (Big East),14,0-14,103,286,389,0.265,05/02/2023,2023.0
-,Hartford (DI Independent),6,6-0,99,36,135,0.733,05/02/2023,2023.0
-,Lindenwood (ASUN),12,2-10,142,187,329,0.432,05/02/2023,2023.0
-,Merrimack (America East),13,7-6,138,197,335,0.412,05/02/2023,2023.0
-,Queens (NC) (ASUN),14,2-12,147,237,384,0.383,05/02/2023,2023.0
1,Lehigh (Patriot),13,9-4,238,130,368,0.647,04/30/2023,2023.0
2,Saint Joseph's (Atlantic 10),14,10-4,249,150,399,0.624,04/30/2023,2023.0
3,Maryland (Big Ten),13,9-4,213,131,344,0.619,04/30/2023,2023.0
4,Army West Point (Patriot),13,10-3,195,121,316,0.617,04/30/2023,2023.0
5,Duke (ACC),14,12-2,256,160,416,0.615,04/30/2023,2023.0
6,Michigan (Big Ten),13,7-6,234,149,383,0.611,04/30/2023,2023.0
7,Denver (Big East),13,9-4,197,127,324,0.608,04/30/2023,2023.0
8,Mount St. Mary's (MAAC),15,8-7,237,155,392,0.605,04/30/2023,2023.0
9,Vermont (America East),13,9-4,200,132,332,0.602,04/30/2023,2023.0
10,Mercer (ASUN),15,6-9,241,162,403,0.598,04/30/2023,2023.0
11,Brown (Ivy League),14,6-8,240,168,408,0.588,04/30/2023,2023.0
12,Bryant (America East),14,10-4,243,181,424,0.573,04/30/2023,2023.0
13,Hofstra (CAA),14,5-9,194,145,339,0.572,04/30/2023,2023.0
14,Navy (Patriot),15,8-7,205,158,363,0.565,04/30/2023,2023.0
15,Georgetown (Big East),13,10-3,214,165,379,0.565,04/30/2023,2023.0
16,Binghamton (America East),13,9-4,212,165,377,0.562,04/30/2023,2023.0
17,Massachusetts (Atlantic 10),13,8-5,158,126,284,0.556,04/30/2023,2023.0
18,Monmouth (CAA),14,5-9,193,154,347,0.556,04/30/2023,2023.0
19,Dartmouth (Ivy League),12,6-6,195,158,353,0.552,04/30/2023,2023.0
20,Towson (CAA),14,6-8,202,165,367,0.550,04/30/2023,2023.0
21,High Point (Atlantic 10),15,8-7,247,205,452,0.546,04/30/2023,2023.0
22,Virginia (ACC),14,11-3,254,211,465,0.546,04/30/2023,2023.0
23,Drexel (CAA),13,8-5,193,161,354,0.545,04/30/2023,2023.0
24,Jacksonville (ASUN),15,12-3,229,194,423,0.541,04/30/2023,2023.0
25,Villanova (Big East),14,10-4,204,174,378,0.540,04/30/2023,2023.0
26,Quinnipiac (MAAC),14,7-7,229,197,426,0.538,04/30/2023,2023.0
27,Utah (ASUN),14,10-4,241,213,454,0.531,04/30/2023,2023.0
28,Robert Morris (ASUN),14,7-7,204,182,386,0.528,04/30/2023,2023.0
29,Rutgers (Big Ten),14,8-6,193,173,366,0.527,04/30/2023,2023.0
30,Cornell (Ivy League),13,11-2,192,179,371,0.518,04/30/2023,2023.0
31,Marquette (Big East),14,6-8,212,198,410,0.517,04/30/2023,2023.0
32,Manhattan (MAAC),14,10-4,148,141,289,0.512,04/30/2023,2023.0
33,Colgate (Patriot),11,2-9,148,143,291,0.509,04/30/2023,2023.0
34,Richmond (Atlantic 10),13,9-4,183,177,360,0.508,04/30/2023,2023.0
35,Yale (Ivy League),12,8-4,186,180,366,0.508,04/30/2023,2023.0
36,Hobart (Atlantic 10),13,5-8,203,199,402,0.505,04/30/2023,2023.0
37,Marist (MAAC),15,8-7,221,220,441,0.501,04/30/2023,2023.0
38,NJIT (America East),13,3-10,172,173,345,0.499,04/30/2023,2023.0
39,Bellarmine (ASUN),15,10-5,205,207,412,0.498,04/30/2023,2023.0
40,North Carolina (ACC),13,7-6,188,191,379,0.496,04/30/2023,2023.0
41,Boston U. (Patriot),13,10-3,181,185,366,0.495,04/30/2023,2023.0
42,VMI (MAAC),15,6-9,198,204,402,0.493,04/30/2023,2023.0
43,Penn St. (Big Ten),12,9-3,162,169,331,0.489,04/30/2023,2023.0
44,Johns Hopkins (Big Ten),15,11-4,200,209,409,0.489,04/30/2023,2023.0
45,Delaware (CAA),14,10-4,186,195,381,0.488,04/30/2023,2023.0
46,UAlbany (America East),14,5-9,175,190,365,0.479,04/30/2023,2023.0
47,Canisius (MAAC),15,2-13,195,215,410,0.476,04/30/2023,2023.0
48,St. Bonaventure (Atlantic 10),14,1-13,174,197,371,0.469,04/30/2023,2023.0
49,Cleveland St. (ASUN),13,6-7,169,192,361,0.468,04/30/2023,2023.0
50,Stony Brook (CAA),14,8-6,184,212,396,0.465,04/30/2023,2023.0
51,Fairfield (CAA),14,5-9,182,214,396,0.460,04/30/2023,2023.0
52,UMBC (America East),13,8-5,147,173,320,0.459,04/30/2023,2023.0
53,LIU (MAAC),14,5-9,167,199,366,0.456,04/30/2023,2023.0
54,Hampton (CAA),14,2-12,164,196,360,0.456,04/30/2023,2023.0
55,Ohio St. (Big Ten),14,5-9,177,213,390,0.454,04/30/2023,2023.0
56,Sacred Heart (MAAC),15,5-10,173,210,383,0.452,04/30/2023,2023.0
57,Lafayette (Patriot),15,6-9,186,227,413,0.450,04/30/2023,2023.0
58,Penn (Ivy League),12,7-5,146,180,326,0.448,04/30/2023,2023.0
59,Princeton (Ivy League),12,6-6,154,192,346,0.445,04/30/2023,2023.0
60,Siena (MAAC),14,8-6,162,203,365,0.444,04/30/2023,2023.0
61,Harvard (Ivy League),12,5-7,155,197,352,0.440,04/30/2023,2023.0
62,Notre Dame (ACC),11,9-2,143,183,326,0.439,04/30/2023,2023.0
63,Holy Cross (Patriot),14,1-13,165,227,392,0.421,04/30/2023,2023.0
64,Loyola Maryland (Patriot),14,7-7,156,215,371,0.420,04/30/2023,2023.0
65,Syracuse (ACC),15,8-7,187,259,446,0.419,04/30/2023,2023.0
66,Providence (Big East),14,6-8,164,237,401,0.409,04/30/2023,2023.0
67,Air Force (ASUN),15,10-5,156,229,385,0.405,04/30/2023,2023.0
68,Wagner (MAAC),14,3-11,125,187,312,0.401,04/30/2023,2023.0
69,Bucknell (Patriot),13,3-10,140,211,351,0.399,04/30/2023,2023.0
70,Detroit Mercy (ASUN),13,2-11,130,230,360,0.361,04/30/2023,2023.0
71,UMass Lowell (America East),13,0-13,120,226,346,0.347,04/30/2023,2023.0
72,St. John's (NY) (Big East),14,0-14,103,286,389,0.265,04/30/2023,2023.0
-,Hartford (DI Independent),6,6-0,99,36,135,0.733,04/30/2023,2023.0
-,Lindenwood (ASUN),12,2-10,142,187,329,0.432,04/30/2023,2023.0
-,Merrimack (America East),13,7-6,138,197,335,0.412,04/30/2023,2023.0
-,Queens (NC) (ASUN),14,2-12,147,237,384,0.383,04/30/2023,2023.0
1,Lehigh (Patriot),12,8-4,218,123,341,0.639,04/26/2023,2023.0
2,Saint Joseph's (Atlantic 10),13,9-4,231,136,367,0.629,04/26/2023,2023.0
3,Michigan (Big Ten),12,6-6,219,136,355,0.617,04/26/2023,2023.0
4,Army West Point (Patriot),12,10-2,178,111,289,0.616,04/26/2023,2023.0
5,Duke (ACC),13,11-2,234,147,381,0.614,04/26/2023,2023.0
6,Maryland (Big Ten),12,8-4,193,124,317,0.609,04/26/2023,2023.0
7,Mount St. Mary's (MAAC),15,8-7,237,155,392,0.605,04/26/2023,2023.0
8,Denver (Big East),12,8-4,175,116,291,0.601,04/26/2023,2023.0
9,Vermont (America East),12,8-4,184,126,310,0.594,04/26/2023,2023.0
10,Mercer (ASUN),14,5-9,222,158,380,0.584,04/26/2023,2023.0
11,Dartmouth (Ivy League),11,6-5,188,137,325,0.578,04/26/2023,2023.0
12,Brown (Ivy League),13,5-8,219,161,380,0.576,04/26/2023,2023.0
13,Bryant (America East),13,10-3,229,170,399,0.574,04/26/2023,2023.0
14,Georgetown (Big East),12,9-3,201,154,355,0.566,04/26/2023,2023.0
15,Monmouth (CAA),13,5-8,180,140,320,0.563,04/26/2023,2023.0
16,Binghamton (America East),12,8-4,192,151,343,0.560,04/26/2023,2023.0
17,Quinnipiac (MAAC),13,7-6,209,165,374,0.559,04/26/2023,2023.0
18,Hofstra (CAA),13,5-8,175,139,314,0.557,04/26/2023,2023.0
19,High Point (Atlantic 10),14,8-6,233,187,420,0.555,04/26/2023,2023.0
20,Massachusetts (Atlantic 10),12,7-5,144,116,260,0.554,04/26/2023,2023.0
21,Navy (Patriot),14,7-7,186,152,338,0.550,04/26/2023,2023.0
22,Rutgers (Big Ten),13,8-5,186,153,339,0.549,04/26/2023,2023.0
23,Drexel (CAA),12,7-5,179,148,327,0.547,04/26/2023,2023.0
24,Villanova (Big East),13,10-3,193,161,354,0.545,04/26/2023,2023.0
25,Jacksonville (ASUN),14,11-3,215,180,395,0.544,04/26/2023,2023.0
26,Virginia (ACC),13,10-3,239,201,440,0.543,04/26/2023,2023.0
27,Towson (CAA),13,5-8,184,155,339,0.543,04/26/2023,2023.0
28,Marquette (Big East),13,6-7,201,176,377,0.533,04/26/2023,2023.0
29,Robert Morris (ASUN),13,7-6,192,172,364,0.527,04/26/2023,2023.0
30,Utah (ASUN),13,9-4,224,204,428,0.523,04/26/2023,2023.0
31,Manhattan (MAAC),14,10-4,148,141,289,0.512,04/26/2023,2023.0
32,Hobart (Atlantic 10),12,5-7,193,185,378,0.511,04/26/2023,2023.0
33,Boston U. (Patriot),12,9-3,171,168,339,0.504,04/26/2023,2023.0
34,Cornell (Ivy League),12,10-2,170,170,340,0.500,04/26/2023,2023.0
35,Delaware (CAA),13,10-3,176,177,353,0.499,04/26/2023,2023.0
36,Bellarmine (ASUN),14,10-4,191,193,384,0.497,04/26/2023,2023.0
37,Richmond (Atlantic 10),12,8-4,159,161,320,0.497,04/26/2023,2023.0
38,Colgate (Patriot),10,1-9,127,129,256,0.496,04/26/2023,2023.0
39,North Carolina (ACC),13,7-6,188,191,379,0.496,04/26/2023,2023.0
40,Yale (Ivy League),11,7-4,167,170,337,0.496,04/26/2023,2023.0
41,VMI (MAAC),15,6-9,198,204,402,0.493,04/26/2023,2023.0
42,Penn St. (Big Ten),12,9-3,162,169,331,0.489,04/26/2023,2023.0
43,Johns Hopkins (Big Ten),15,11-4,200,209,409,0.489,04/26/2023,2023.0
44,UAlbany (America East),13,5-8,161,170,331,0.486,04/26/2023,2023.0
45,NJIT (America East),12,2-10,156,165,321,0.486,04/26/2023,2023.0
46,Marist (MAAC),14,7-7,189,200,389,0.486,04/26/2023,2023.0
47,Stony Brook (CAA),13,7-6,178,193,371,0.480,04/26/2023,2023.0
48,St. Bonaventure (Atlantic 10),13,1-12,158,173,331,0.477,04/26/2023,2023.0
49,Canisius (MAAC),15,2-13,195,215,410,0.476,04/26/2023,2023.0
50,UMBC (America East),12,8-4,141,157,298,0.473,04/26/2023,2023.0
51,Cleveland St. (ASUN),12,5-7,154,177,331,0.465,04/26/2023,2023.0
52,Sacred Heart (MAAC),14,5-9,165,192,357,0.462,04/26/2023,2023.0
53,Princeton (Ivy League),11,6-5,145,170,315,0.460,04/26/2023,2023.0
54,Fairfield (CAA),13,4-9,167,198,365,0.458,04/26/2023,2023.0
55,LIU (MAAC),14,5-9,167,199,366,0.456,04/26/2023,2023.0
56,Ohio St. (Big Ten),13,5-8,164,198,362,0.453,04/26/2023,2023.0
57,Lafayette (Patriot),15,6-9,186,227,413,0.450,04/26/2023,2023.0
58,Hampton (CAA),13,2-11,148,181,329,0.450,04/26/2023,2023.0
59,Harvard (Ivy League),11,5-6,145,178,323,0.449,04/26/2023,2023.0
60,Penn (Ivy League),12,7-5,146,180,326,0.448,04/26/2023,2023.0
61,Notre Dame (ACC),10,9-1,133,168,301,0.442,04/26/2023,2023.0
62,Loyola Maryland (Patriot),13,7-6,149,195,344,0.433,04/26/2023,2023.0
63,Siena (MAAC),13,7-6,144,195,339,0.425,04/26/2023,2023.0
64,Syracuse (ACC),14,8-6,174,237,411,0.423,04/26/2023,2023.0
65,Holy Cross (Patriot),13,1-12,151,206,357,0.423,04/26/2023,2023.0
66,Bucknell (Patriot),12,3-9,134,192,326,0.411,04/26/2023,2023.0
67,Air Force (ASUN),14,9-5,146,217,363,0.402,04/26/2023,2023.0
68,Wagner (MAAC),14,3-11,125,187,312,0.401,04/26/2023,2023.0
69,Providence (Big East),13,5-8,143,231,374,0.382,04/26/2023,2023.0
70,Detroit Mercy (ASUN),12,2-10,115,215,330,0.348,04/26/2023,2023.0
71,UMass Lowell (America East),12,0-12,112,210,322,0.348,04/26/2023,2023.0
72,St. John's (NY) (Big East),13,0-13,97,265,362,0.268,04/26/2023,2023.0
-,Hartford (DI Independent),6,6-0,99,36,135,0.733,04/26/2023,2023.0
-,Lindenwood (ASUN),11,2-9,138,168,306,0.451,04/26/2023,2023.0
-,Merrimack (America East),12,6-6,127,183,310,0.410,04/26/2023,2023.0
-,Queens (NC) (ASUN),13,2-11,138,220,358,0.385,04/26/2023,2023.0
1,Lehigh (Patriot),12,8-4,218,123,341,0.639,04/25/2023,2023.0
2,Saint Joseph's (Atlantic 10),13,9-4,231,136,367,0.629,04/25/2023,2023.0
3,Michigan (Big Ten),12,6-6,219,136,355,0.617,04/25/2023,2023.0
4,Army West Point (Patriot),12,10-2,178,111,289,0.616,04/25/2023,2023.0
5,Duke (ACC),13,11-2,234,147,381,0.614,04/25/2023,2023.0
6,Maryland (Big Ten),12,8-4,193,124,317,0.609,04/25/2023,2023.0
7,Mount St. Mary's (MAAC),15,8-7,237,155,392,0.605,04/25/2023,2023.0
8,Denver (Big East),12,8-4,175,116,291,0.601,04/25/2023,2023.0
9,Vermont (America East),12,8-4,184,126,310,0.594,04/25/2023,2023.0
10,Mercer (ASUN),14,5-9,222,158,380,0.584,04/25/2023,2023.0
11,Dartmouth (Ivy League),11,6-5,188,137,325,0.578,04/25/2023,2023.0
12,Brown (Ivy League),13,5-8,219,161,380,0.576,04/25/2023,2023.0
13,Bryant (America East),13,10-3,229,170,399,0.574,04/25/2023,2023.0
14,Georgetown (Big East),12,9-3,201,154,355,0.566,04/25/2023,2023.0
15,Monmouth (CAA),13,5-8,180,140,320,0.563,04/25/2023,2023.0
16,Binghamton (America East),12,8-4,192,151,343,0.560,04/25/2023,2023.0
17,Quinnipiac (MAAC),13,7-6,209,165,374,0.559,04/25/2023,2023.0
18,Hofstra (CAA),13,5-8,175,139,314,0.557,04/25/2023,2023.0
19,High Point (Atlantic 10),14,8-6,233,187,420,0.555,04/25/2023,2023.0
20,Massachusetts (Atlantic 10),12,7-5,144,116,260,0.554,04/25/2023,2023.0
21,Navy (Patriot),14,7-7,186,152,338,0.550,04/25/2023,2023.0
22,Rutgers (Big Ten),13,8-5,186,153,339,0.549,04/25/2023,2023.0
23,Drexel (CAA),12,7-5,179,148,327,0.547,04/25/2023,2023.0
24,Villanova (Big East),13,10-3,193,161,354,0.545,04/25/2023,2023.0
25,Jacksonville (ASUN),14,11-3,215,180,395,0.544,04/25/2023,2023.0
26,Virginia (ACC),13,10-3,239,201,440,0.543,04/25/2023,2023.0
27,Towson (CAA),13,5-8,184,155,339,0.543,04/25/2023,2023.0
28,Marquette (Big East),13,6-7,201,176,377,0.533,04/25/2023,2023.0
29,Robert Morris (ASUN),13,7-6,192,172,364,0.527,04/25/2023,2023.0
30,Utah (ASUN),13,9-4,224,204,428,0.523,04/25/2023,2023.0
31,Manhattan (MAAC),14,10-4,148,141,289,0.512,04/25/2023,2023.0
32,Hobart (Atlantic 10),12,5-7,193,185,378,0.511,04/25/2023,2023.0
33,Boston U. (Patriot),12,9-3,171,168,339,0.504,04/25/2023,2023.0
34,UAlbany (America East),12,5-7,152,150,302,0.503,04/25/2023,2023.0
35,Cornell (Ivy League),12,10-2,170,170,340,0.500,04/25/2023,2023.0
36,Delaware (CAA),13,10-3,176,177,353,0.499,04/25/2023,2023.0
37,Bellarmine (ASUN),14,10-4,191,193,384,0.497,04/25/2023,2023.0
38,Richmond (Atlantic 10),12,8-4,159,161,320,0.497,04/25/2023,2023.0
39,Colgate (Patriot),10,1-9,127,129,256,0.496,04/25/2023,2023.0
40,North Carolina (ACC),13,7-6,188,191,379,0.496,04/25/2023,2023.0
41,Yale (Ivy League),11,7-4,167,170,337,0.496,04/25/2023,2023.0
42,VMI (MAAC),15,6-9,198,204,402,0.493,04/25/2023,2023.0
43,Penn St. (Big Ten),12,9-3,162,169,331,0.489,04/25/2023,2023.0
44,Johns Hopkins (Big Ten),15,11-4,200,209,409,0.489,04/25/2023,2023.0
45,NJIT (America East),12,2-10,156,165,321,0.486,04/25/2023,2023.0
46,Marist (MAAC),14,7-7,189,200,389,0.486,04/25/2023,2023.0
47,Stony Brook (CAA),13,7-6,178,193,371,0.480,04/25/2023,2023.0
48,St. Bonaventure (Atlantic 10),13,1-12,158,173,331,0.477,04/25/2023,2023.0
49,Canisius (MAAC),15,2-13,195,215,410,0.476,04/25/2023,2023.0
50,UMBC (America East),12,8-4,141,157,298,0.473,04/25/2023,2023.0
51,Cleveland St. (ASUN),12,5-7,154,177,331,0.465,04/25/2023,2023.0
52,Sacred Heart (MAAC),14,5-9,165,192,357,0.462,04/25/2023,2023.0
53,Princeton (Ivy League),11,6-5,145,170,315,0.460,04/25/2023,2023.0
54,Fairfield (CAA),13,4-9,167,198,365,0.458,04/25/2023,2023.0
55,LIU (MAAC),14,5-9,167,199,366,0.456,04/25/2023,2023.0
56,Ohio St. (Big Ten),13,5-8,164,198,362,0.453,04/25/2023,2023.0
57,Lafayette (Patriot),15,6-9,186,227,413,0.450,04/25/2023,2023.0
58,Hampton (CAA),13,2-11,148,181,329,0.450,04/25/2023,2023.0
59,Harvard (Ivy League),11,5-6,145,178,323,0.449,04/25/2023,2023.0
60,Notre Dame (ACC),10,9-1,133,168,301,0.442,04/25/2023,2023.0
61,Loyola Maryland (Patriot),13,7-6,149,195,344,0.433,04/25/2023,2023.0
62,Siena (MAAC),13,7-6,144,195,339,0.425,04/25/2023,2023.0
63,Penn (Ivy League),11,6-5,126,171,297,0.424,04/25/2023,2023.0
64,Syracuse (ACC),14,8-6,174,237,411,0.423,04/25/2023,2023.0
65,Holy Cross (Patriot),13,1-12,151,206,357,0.423,04/25/2023,2023.0
66,Bucknell (Patriot),12,3-9,134,192,326,0.411,04/25/2023,2023.0
67,Air Force (ASUN),14,9-5,146,217,363,0.402,04/25/2023,2023.0
68,Wagner (MAAC),14,3-11,125,187,312,0.401,04/25/2023,2023.0
69,Providence (Big East),13,5-8,143,231,374,0.382,04/25/2023,2023.0
70,Detroit Mercy (ASUN),12,2-10,115,215,330,0.348,04/25/2023,2023.0
71,UMass Lowell (America East),12,0-12,112,210,322,0.348,04/25/2023,2023.0
72,St. John's (NY) (Big East),13,0-13,97,265,362,0.268,04/25/2023,2023.0
-,Hartford (DI Independent),6,6-0,99,36,135,0.733,04/25/2023,2023.0
-,Lindenwood (ASUN),11,2-9,138,168,306,0.451,04/25/2023,2023.0
-,Merrimack (America East),12,6-6,127,183,310,0.410,04/25/2023,2023.0
-,Queens (NC) (ASUN),13,2-11,138,220,358,0.385,04/25/2023,2023.0
1,Lehigh (Patriot),12,8-4,218,123,341,0.639,04/24/2023,2023.0
2,Saint Joseph's (Atlantic 10),13,9-4,231,136,367,0.629,04/24/2023,2023.0
3,Michigan (Big Ten),12,6-6,219,136,355,0.617,04/24/2023,2023.0
4,Army West Point (Patriot),12,10-2,178,111,289,0.616,04/24/2023,2023.0
5,Duke (ACC),13,11-2,234,147,381,0.614,04/24/2023,2023.0
6,Maryland (Big Ten),12,8-4,193,124,317,0.609,04/24/2023,2023.0
7,Mount St. Mary's (MAAC),15,8-7,237,155,392,0.605,04/24/2023,2023.0
8,Denver (Big East),12,8-4,175,116,291,0.601,04/24/2023,2023.0
9,Vermont (America East),12,8-4,184,126,310,0.594,04/24/2023,2023.0
10,Brown (Ivy League),12,5-7,203,144,347,0.585,04/24/2023,2023.0
11,Mercer (ASUN),14,5-9,222,158,380,0.584,04/24/2023,2023.0
12,Bryant (America East),12,9-3,212,154,366,0.579,04/24/2023,2023.0
13,Dartmouth (Ivy League),11,6-5,188,137,325,0.578,04/24/2023,2023.0
14,Georgetown (Big East),12,9-3,201,154,355,0.566,04/24/2023,2023.0
15,Monmouth (CAA),13,5-8,180,140,320,0.563,04/24/2023,2023.0
16,Binghamton (America East),12,8-4,192,151,343,0.560,04/24/2023,2023.0
17,Quinnipiac (MAAC),13,7-6,209,165,374,0.559,04/24/2023,2023.0
18,Hofstra (CAA),13,5-8,175,139,314,0.557,04/24/2023,2023.0
19,High Point (Atlantic 10),14,8-6,233,187,420,0.555,04/24/2023,2023.0
20,Massachusetts (Atlantic 10),12,7-5,144,116,260,0.554,04/24/2023,2023.0
21,Navy (Patriot),14,7-7,186,152,338,0.550,04/24/2023,2023.0
22,Rutgers (Big Ten),13,8-5,186,153,339,0.549,04/24/2023,2023.0
23,Drexel (CAA),12,7-5,179,148,327,0.547,04/24/2023,2023.0
24,Villanova (Big East),13,10-3,193,161,354,0.545,04/24/2023,2023.0
25,Jacksonville (ASUN),14,11-3,215,180,395,0.544,04/24/2023,2023.0
26,Virginia (ACC),12,9-3,221,186,407,0.543,04/24/2023,2023.0
27,Towson (CAA),13,5-8,184,155,339,0.543,04/24/2023,2023.0
28,Marquette (Big East),13,6-7,201,176,377,0.533,04/24/2023,2023.0
29,Robert Morris (ASUN),13,7-6,192,172,364,0.527,04/24/2023,2023.0
30,Utah (ASUN),13,9-4,224,204,428,0.523,04/24/2023,2023.0
31,Manhattan (MAAC),14,10-4,148,141,289,0.512,04/24/2023,2023.0
32,Hobart (Atlantic 10),12,5-7,193,185,378,0.511,04/24/2023,2023.0
33,Boston U. (Patriot),12,9-3,171,168,339,0.504,04/24/2023,2023.0
34,UAlbany (America East),12,5-7,152,150,302,0.503,04/24/2023,2023.0
35,Cornell (Ivy League),12,10-2,170,170,340,0.500,04/24/2023,2023.0
36,Delaware (CAA),13,10-3,176,177,353,0.499,04/24/2023,2023.0
37,Bellarmine (ASUN),14,10-4,191,193,384,0.497,04/24/2023,2023.0
38,Richmond (Atlantic 10),12,8-4,159,161,320,0.497,04/24/2023,2023.0
39,Colgate (Patriot),10,1-9,127,129,256,0.496,04/24/2023,2023.0
40,North Carolina (ACC),13,7-6,188,191,379,0.496,04/24/2023,2023.0
41,Yale (Ivy League),11,7-4,167,170,337,0.496,04/24/2023,2023.0
42,VMI (MAAC),15,6-9,198,204,402,0.493,04/24/2023,2023.0
43,Penn St. (Big Ten),12,9-3,162,169,331,0.489,04/24/2023,2023.0
44,Johns Hopkins (Big Ten),15,11-4,200,209,409,0.489,04/24/2023,2023.0
45,NJIT (America East),12,2-10,156,165,321,0.486,04/24/2023,2023.0
46,Marist (MAAC),14,7-7,189,200,389,0.486,04/24/2023,2023.0
47,Stony Brook (CAA),13,7-6,178,193,371,0.480,04/24/2023,2023.0
48,St. Bonaventure (Atlantic 10),13,1-12,158,173,331,0.477,04/24/2023,2023.0
49,Canisius (MAAC),15,2-13,195,215,410,0.476,04/24/2023,2023.0
50,UMBC (America East),12,8-4,141,157,298,0.473,04/24/2023,2023.0
51,Cleveland St. (ASUN),12,5-7,154,177,331,0.465,04/24/2023,2023.0
52,Sacred Heart (MAAC),14,5-9,165,192,357,0.462,04/24/2023,2023.0
53,Princeton (Ivy League),11,6-5,145,170,315,0.460,04/24/2023,2023.0
54,Fairfield (CAA),13,4-9,167,198,365,0.458,04/24/2023,2023.0
55,LIU (MAAC),14,5-9,167,199,366,0.456,04/24/2023,2023.0
56,Ohio St. (Big Ten),13,5-8,164,198,362,0.453,04/24/2023,2023.0
57,Lafayette (Patriot),14,6-8,171,209,380,0.450,04/24/2023,2023.0
58,Hampton (CAA),13,2-11,148,181,329,0.450,04/24/2023,2023.0
59,Harvard (Ivy League),11,5-6,145,178,323,0.449,04/24/2023,2023.0
60,Notre Dame (ACC),10,9-1,133,168,301,0.442,04/24/2023,2023.0
61,Loyola Maryland (Patriot),13,7-6,149,195,344,0.433,04/24/2023,2023.0
62,Siena (MAAC),13,7-6,144,195,339,0.425,04/24/2023,2023.0
63,Penn (Ivy League),11,6-5,126,171,297,0.424,04/24/2023,2023.0
64,Syracuse (ACC),14,8-6,174,237,411,0.423,04/24/2023,2023.0
65,Holy Cross (Patriot),13,1-12,151,206,357,0.423,04/24/2023,2023.0
66,Bucknell (Patriot),12,3-9,134,192,326,0.411,04/24/2023,2023.0
67,Air Force (ASUN),14,9-5,146,217,363,0.402,04/24/2023,2023.0
68,Wagner (MAAC),14,3-11,125,187,312,0.401,04/24/2023,2023.0
69,Providence (Big East),13,5-8,143,231,374,0.382,04/24/2023,2023.0
70,Detroit Mercy (ASUN),12,2-10,115,215,330,0.348,04/24/2023,2023.0
71,UMass Lowell (America East),12,0-12,112,210,322,0.348,04/24/2023,2023.0
72,St. John's (NY) (Big East),13,0-13,97,265,362,0.268,04/24/2023,2023.0
-,Hartford (DI Independent),6,6-0,99,36,135,0.733,04/24/2023,2023.0
-,Lindenwood (ASUN),11,2-9,138,168,306,0.451,04/24/2023,2023.0
-,Merrimack (America East),12,6-6,127,183,310,0.410,04/24/2023,2023.0
-,Queens (NC) (ASUN),13,2-11,138,220,358,0.385,04/24/2023,2023.0
1,Lehigh (Patriot),12,8-4,218,123,341,0.639,04/23/2023,2023.0
2,Saint Joseph's (Atlantic 10),13,9-4,231,136,367,0.629,04/23/2023,2023.0
3,Michigan (Big Ten),12,6-6,219,136,355,0.617,04/23/2023,2023.0
4,Army West Point (Patriot),12,10-2,178,111,289,0.616,04/23/2023,2023.0
5,Duke (ACC),13,11-2,234,147,381,0.614,04/23/2023,2023.0
6,Maryland (Big Ten),12,8-4,193,124,317,0.609,04/23/2023,2023.0
7,Mount St. Mary's (MAAC),15,8-7,237,155,392,0.605,04/23/2023,2023.0
8,Denver (Big East),12,8-4,175,116,291,0.601,04/23/2023,2023.0
9,Vermont (America East),12,8-4,184,126,310,0.594,04/23/2023,2023.0
10,Brown (Ivy League),12,5-7,203,144,347,0.585,04/23/2023,2023.0
11,Mercer (ASUN),14,5-9,222,158,380,0.584,04/23/2023,2023.0
12,Bryant (America East),12,9-3,212,154,366,0.579,04/23/2023,2023.0
13,Dartmouth (Ivy League),11,6-5,188,137,325,0.578,04/23/2023,2023.0
14,Monmouth (CAA),13,5-8,180,140,320,0.563,04/23/2023,2023.0
15,Binghamton (America East),12,8-4,192,151,343,0.560,04/23/2023,2023.0
16,Quinnipiac (MAAC),13,7-6,209,165,374,0.559,04/23/2023,2023.0
17,Hofstra (CAA),13,5-8,175,139,314,0.557,04/23/2023,2023.0
18,High Point (Atlantic 10),14,8-6,233,187,420,0.555,04/23/2023,2023.0
19,Massachusetts (Atlantic 10),12,7-5,144,116,260,0.554,04/23/2023,2023.0
20,Navy (Patriot),14,7-7,186,152,338,0.550,04/23/2023,2023.0
21,Rutgers (Big Ten),13,8-5,186,153,339,0.549,04/23/2023,2023.0
22,Georgetown (Big East),12,9-3,176,145,321,0.548,04/23/2023,2023.0
23,Villanova (Big East),13,10-3,194,160,354,0.548,04/23/2023,2023.0
24,Drexel (CAA),12,7-5,179,148,327,0.547,04/23/2023,2023.0
25,Jacksonville (ASUN),14,11-3,215,180,395,0.544,04/23/2023,2023.0
26,Virginia (ACC),12,9-3,221,186,407,0.543,04/23/2023,2023.0
27,Towson (CAA),13,5-8,184,155,339,0.543,04/23/2023,2023.0
28,Marquette (Big East),13,6-7,200,177,377,0.531,04/23/2023,2023.0
29,Robert Morris (ASUN),13,7-6,192,172,364,0.527,04/23/2023,2023.0
30,Utah (ASUN),13,9-4,204,189,393,0.519,04/23/2023,2023.0
31,Manhattan (MAAC),14,10-4,148,141,289,0.512,04/23/2023,2023.0
32,Hobart (Atlantic 10),12,5-7,193,185,378,0.511,04/23/2023,2023.0
33,Boston U. (Patriot),12,9-3,171,168,339,0.504,04/23/2023,2023.0
34,UAlbany (America East),12,5-7,152,150,302,0.503,04/23/2023,2023.0
35,Cornell (Ivy League),12,10-2,170,170,340,0.500,04/23/2023,2023.0
36,Delaware (CAA),13,10-3,176,177,353,0.499,04/23/2023,2023.0
37,Bellarmine (ASUN),14,10-4,191,193,384,0.497,04/23/2023,2023.0
38,Richmond (Atlantic 10),12,8-4,159,161,320,0.497,04/23/2023,2023.0
39,Colgate (Patriot),10,1-9,127,129,256,0.496,04/23/2023,2023.0
40,North Carolina (ACC),13,7-6,188,191,379,0.496,04/23/2023,2023.0
41,Yale (Ivy League),11,7-4,167,170,337,0.496,04/23/2023,2023.0
42,VMI (MAAC),15,6-9,198,204,402,0.493,04/23/2023,2023.0
43,Penn St. (Big Ten),12,9-3,162,169,331,0.489,04/23/2023,2023.0
44,Johns Hopkins (Big Ten),15,11-4,200,209,409,0.489,04/23/2023,2023.0
45,NJIT (America East),12,2-10,156,165,321,0.486,04/23/2023,2023.0
46,Marist (MAAC),14,7-7,189,200,389,0.486,04/23/2023,2023.0
47,Stony Brook (CAA),13,7-6,178,193,371,0.480,04/23/2023,2023.0
48,St. Bonaventure (Atlantic 10),13,1-12,158,173,331,0.477,04/23/2023,2023.0
49,Canisius (MAAC),15,2-13,195,215,410,0.476,04/23/2023,2023.0
50,UMBC (America East),12,8-4,141,157,298,0.473,04/23/2023,2023.0
51,Cleveland St. (ASUN),12,5-7,139,157,296,0.470,04/23/2023,2023.0
52,Sacred Heart (MAAC),14,5-9,165,192,357,0.462,04/23/2023,2023.0
53,Princeton (Ivy League),11,6-5,145,170,315,0.460,04/23/2023,2023.0
54,Fairfield (CAA),13,4-9,167,198,365,0.458,04/23/2023,2023.0
55,LIU (MAAC),14,5-9,167,199,366,0.456,04/23/2023,2023.0
56,Ohio St. (Big Ten),13,5-8,164,198,362,0.453,04/23/2023,2023.0
57,Lafayette (Patriot),14,6-8,171,209,380,0.450,04/23/2023,2023.0
58,Hampton (CAA),13,2-11,148,181,329,0.450,04/23/2023,2023.0
59,Harvard (Ivy League),11,5-6,145,178,323,0.449,04/23/2023,2023.0
60,Notre Dame (ACC),10,9-1,133,168,301,0.442,04/23/2023,2023.0
61,Loyola Maryland (Patriot),13,7-6,149,195,344,0.433,04/23/2023,2023.0
62,Siena (MAAC),13,7-6,144,195,339,0.425,04/23/2023,2023.0
63,Penn (Ivy League),11,6-5,126,171,297,0.424,04/23/2023,2023.0
64,Syracuse (ACC),14,8-6,174,237,411,0.423,04/23/2023,2023.0
65,Holy Cross (Patriot),13,1-12,151,206,357,0.423,04/23/2023,2023.0
66,Bucknell (Patriot),12,3-9,134,192,326,0.411,04/23/2023,2023.0
67,Air Force (ASUN),14,9-5,146,217,363,0.402,04/23/2023,2023.0
68,Wagner (MAAC),14,3-11,125,187,312,0.401,04/23/2023,2023.0
69,Providence (Big East),13,5-8,143,231,374,0.382,04/23/2023,2023.0
70,Detroit Mercy (ASUN),12,2-10,115,215,330,0.348,04/23/2023,2023.0
71,UMass Lowell (America East),12,0-12,112,210,322,0.348,04/23/2023,2023.0
72,St. John's (NY) (Big East),13,0-13,88,240,328,0.268,04/23/2023,2023.0
-,Hartford (DI Independent),6,6-0,99,36,135,0.733,04/23/2023,2023.0
-,Lindenwood (ASUN),11,2-9,138,168,306,0.451,04/23/2023,2023.0
-,Merrimack (America East),12,6-6,127,183,310,0.410,04/23/2023,2023.0
-,Queens (NC) (ASUN),13,2-11,138,220,358,0.385,04/23/2023,2023.0
1,Lehigh (Patriot),11,8-3,201,112,313,0.642,04/18/2023,2023.0
2,Saint Joseph's (Atlantic 10),12,8-4,220,124,344,0.640,04/18/2023,2023.0
3,Maryland (Big Ten),11,8-3,180,110,290,0.621,04/18/2023,2023.0
4,Army West Point (Patriot),11,9-2,166,102,268,0.619,04/18/2023,2023.0
5,Duke (ACC),13,11-2,234,147,381,0.614,04/18/2023,2023.0
6,Denver (Big East),11,7-4,161,107,268,0.601,04/18/2023,2023.0
7,Michigan (Big Ten),11,5-6,190,128,318,0.597,04/18/2023,2023.0
8,Mount St. Mary's (MAAC),14,8-6,214,150,364,0.588,04/18/2023,2023.0
9,Bryant (America East),11,8-3,198,140,338,0.586,04/18/2023,2023.0
10,Brown (Ivy League),11,5-6,185,133,318,0.582,04/18/2023,2023.0
11,Mercer (ASUN),13,4-9,204,150,354,0.576,04/18/2023,2023.0
12,Dartmouth (Ivy League),10,6-4,170,128,298,0.570,04/18/2023,2023.0
13,Vermont (America East),11,7-4,161,122,283,0.569,04/18/2023,2023.0
14,Binghamton (America East),11,8-3,178,137,315,0.565,04/18/2023,2023.0
15,Monmouth (CAA),12,5-7,163,127,290,0.562,04/18/2023,2023.0
16,Navy (Patriot),13,7-6,177,140,317,0.558,04/18/2023,2023.0
17,Massachusetts (Atlantic 10),11,7-4,132,105,237,0.557,04/18/2023,2023.0
18,Hofstra (CAA),12,4-8,162,129,291,0.557,04/18/2023,2023.0
19,Quinnipiac (MAAC),12,6-6,188,151,339,0.555,04/18/2023,2023.0
20,High Point (Atlantic 10),13,7-6,217,175,392,0.554,04/18/2023,2023.0
21,Towson (CAA),12,4-8,171,138,309,0.553,04/18/2023,2023.0
22,Drexel (CAA),11,7-4,162,131,293,0.553,04/18/2023,2023.0
23,Georgetown (Big East),11,8-3,176,145,321,0.548,04/18/2023,2023.0
24,Marquette (Big East),12,6-6,187,155,342,0.547,04/18/2023,2023.0
25,Virginia (ACC),11,8-3,202,171,373,0.542,04/18/2023,2023.0
26,Rutgers (Big Ten),12,8-4,171,145,316,0.541,04/18/2023,2023.0
27,Villanova (Big East),12,9-3,172,147,319,0.539,04/18/2023,2023.0
28,Jacksonville (ASUN),13,11-2,195,172,367,0.531,04/18/2023,2023.0
29,Utah (ASUN),12,8-4,204,189,393,0.519,04/18/2023,2023.0
30,Boston U. (Patriot),11,8-3,160,151,311,0.514,04/18/2023,2023.0
31,Cornell (Ivy League),11,9-2,159,152,311,0.511,04/18/2023,2023.0
32,Richmond (Atlantic 10),11,7-4,142,139,281,0.505,04/18/2023,2023.0
33,Hobart (Atlantic 10),11,5-6,170,167,337,0.504,04/18/2023,2023.0
34,Penn St. (Big Ten),11,8-3,154,154,308,0.500,04/18/2023,2023.0
35,Delaware (CAA),12,9-3,159,160,319,0.498,04/18/2023,2023.0
36,Manhattan (MAAC),13,9-4,138,140,278,0.496,04/18/2023,2023.0
37,VMI (MAAC),14,6-8,186,189,375,0.496,04/18/2023,2023.0
38,Robert Morris (ASUN),12,6-6,163,167,330,0.494,04/18/2023,2023.0
39,Yale (Ivy League),10,6-4,154,160,314,0.490,04/18/2023,2023.0
40,UAlbany (America East),10,4-6,123,129,252,0.488,04/18/2023,2023.0
41,Johns Hopkins (Big Ten),14,10-4,186,196,382,0.487,04/18/2023,2023.0
42,Colgate (Patriot),9,1-8,110,116,226,0.487,04/18/2023,2023.0
43,Stony Brook (CAA),12,6-6,163,173,336,0.485,04/18/2023,2023.0
44,Bellarmine (ASUN),13,9-4,175,186,361,0.485,04/18/2023,2023.0
45,St. Bonaventure (Atlantic 10),12,1-11,146,157,303,0.482,04/18/2023,2023.0
46,North Carolina (ACC),12,7-5,168,181,349,0.481,04/18/2023,2023.0
47,NJIT (America East),11,2-9,142,153,295,0.481,04/18/2023,2023.0
48,Marist (MAAC),13,6-7,174,188,362,0.481,04/18/2023,2023.0
49,Canisius (MAAC),14,2-12,184,199,383,0.480,04/18/2023,2023.0
50,Ohio St. (Big Ten),12,5-7,156,169,325,0.480,04/18/2023,2023.0
51,UMBC (America East),11,7-4,129,143,272,0.474,04/18/2023,2023.0
52,Cleveland St. (ASUN),11,5-6,139,157,296,0.470,04/18/2023,2023.0
53,LIU (MAAC),13,5-8,153,178,331,0.462,04/18/2023,2023.0
54,Princeton (Ivy League),10,5-5,130,155,285,0.456,04/18/2023,2023.0
55,Notre Dame (ACC),9,8-1,123,148,271,0.454,04/18/2023,2023.0
56,Sacred Heart (MAAC),13,4-9,149,181,330,0.452,04/18/2023,2023.0
57,Hampton (CAA),12,2-10,138,168,306,0.451,04/18/2023,2023.0
58,Siena (MAAC),12,6-6,139,172,311,0.447,04/18/2023,2023.0
59,Fairfield (CAA),12,4-8,147,183,330,0.445,04/18/2023,2023.0
60,Harvard (Ivy League),10,5-5,130,163,293,0.444,04/18/2023,2023.0
61,Penn (Ivy League),10,5-5,117,153,270,0.433,04/18/2023,2023.0
62,Loyola Maryland (Patriot),12,6-6,136,178,314,0.433,04/18/2023,2023.0
63,Lafayette (Patriot),13,5-8,151,198,349,0.433,04/18/2023,2023.0
64,Holy Cross (Patriot),13,1-12,151,206,357,0.423,04/18/2023,2023.0
65,Syracuse (ACC),13,8-5,159,218,377,0.422,04/18/2023,2023.0
66,Bucknell (Patriot),11,3-8,123,172,295,0.417,04/18/2023,2023.0
67,Wagner (MAAC),13,3-10,124,177,301,0.412,04/18/2023,2023.0
68,Air Force (ASUN),13,8-5,138,197,335,0.412,04/18/2023,2023.0
69,Providence (Big East),12,5-7,133,216,349,0.381,04/18/2023,2023.0
70,UMass Lowell (America East),11,0-11,108,187,295,0.366,04/18/2023,2023.0
71,Detroit Mercy (ASUN),11,2-9,109,198,307,0.355,04/18/2023,2023.0
72,St. John's (NY) (Big East),12,0-12,88,240,328,0.268,04/18/2023,2023.0
-,Hartford (DI Independent),5,5-0,86,28,114,0.754,04/18/2023,2023.0
-,Lindenwood (ASUN),10,2-8,132,140,272,0.485,04/18/2023,2023.0
-,Merrimack (America East),11,6-5,119,164,283,0.420,04/18/2023,2023.0
-,Queens (NC) (ASUN),12,2-10,130,202,332,0.392,04/18/2023,2023.0
1,Lehigh (Patriot),11,8-3,201,112,313,0.642,04/16/2023,2023.0
2,Saint Joseph's (Atlantic 10),12,8-4,220,124,344,0.640,04/16/2023,2023.0
3,Maryland (Big Ten),11,8-3,180,110,290,0.621,04/16/2023,2023.0
4,Army West Point (Patriot),11,9-2,166,102,268,0.619,04/16/2023,2023.0
5,Duke (ACC),13,11-2,234,147,381,0.614,04/16/2023,2023.0
6,Denver (Big East),11,7-4,161,107,268,0.601,04/16/2023,2023.0
7,Michigan (Big Ten),11,5-6,190,128,318,0.597,04/16/2023,2023.0
8,Mount St. Mary's (MAAC),14,8-6,214,150,364,0.588,04/16/2023,2023.0
9,Bryant (America East),11,8-3,198,140,338,0.586,04/16/2023,2023.0
10,Brown (Ivy League),11,5-6,185,133,318,0.582,04/16/2023,2023.0
11,Mercer (ASUN),13,4-9,204,150,354,0.576,04/16/2023,2023.0
12,Dartmouth (Ivy League),10,6-4,170,128,298,0.570,04/16/2023,2023.0
13,Vermont (America East),11,7-4,160,123,283,0.565,04/16/2023,2023.0
14,Binghamton (America East),11,8-3,178,137,315,0.565,04/16/2023,2023.0
15,Monmouth (CAA),12,5-7,163,128,291,0.560,04/16/2023,2023.0
16,Navy (Patriot),13,7-6,177,140,317,0.558,04/16/2023,2023.0
17,Massachusetts (Atlantic 10),11,7-4,132,105,237,0.557,04/16/2023,2023.0
18,Hofstra (CAA),12,4-8,162,129,291,0.557,04/16/2023,2023.0
19,Quinnipiac (MAAC),12,6-6,188,151,339,0.555,04/16/2023,2023.0
20,High Point (Atlantic 10),13,7-6,217,175,392,0.554,04/16/2023,2023.0
21,Towson (CAA),12,4-8,171,138,309,0.553,04/16/2023,2023.0
22,Drexel (CAA),11,7-4,162,131,293,0.553,04/16/2023,2023.0
23,Marquette (Big East),12,6-6,187,155,342,0.547,04/16/2023,2023.0
24,Virginia (ACC),11,8-3,202,171,373,0.542,04/16/2023,2023.0
25,Rutgers (Big Ten),12,8-4,171,145,316,0.541,04/16/2023,2023.0
26,Georgetown (Big East),10,7-3,155,132,287,0.540,04/16/2023,2023.0
27,Villanova (Big East),12,9-3,172,147,319,0.539,04/16/2023,2023.0
28,Jacksonville (ASUN),13,11-2,195,172,367,0.531,04/16/2023,2023.0
29,Utah (ASUN),12,8-4,204,189,393,0.519,04/16/2023,2023.0
30,Boston U. (Patriot),11,8-3,160,151,311,0.514,04/16/2023,2023.0
31,Cornell (Ivy League),11,9-2,159,152,311,0.511,04/16/2023,2023.0
32,Richmond (Atlantic 10),11,7-4,142,139,281,0.505,04/16/2023,2023.0
33,Hobart (Atlantic 10),11,5-6,170,167,337,0.504,04/16/2023,2023.0
34,Penn St. (Big Ten),11,8-3,154,154,308,0.500,04/16/2023,2023.0
35,Delaware (CAA),12,9-3,159,160,319,0.498,04/16/2023,2023.0
36,Manhattan (MAAC),13,9-4,138,140,278,0.496,04/16/2023,2023.0
37,VMI (MAAC),14,6-8,186,189,375,0.496,04/16/2023,2023.0
38,Robert Morris (ASUN),12,6-6,162,168,330,0.491,04/16/2023,2023.0
39,Yale (Ivy League),10,6-4,154,160,314,0.490,04/16/2023,2023.0
40,UAlbany (America East),10,4-6,123,129,252,0.488,04/16/2023,2023.0
41,Johns Hopkins (Big Ten),14,10-4,186,196,382,0.487,04/16/2023,2023.0
42,Colgate (Patriot),9,1-8,110,116,226,0.487,04/16/2023,2023.0
43,Stony Brook (CAA),12,6-6,163,173,336,0.485,04/16/2023,2023.0
44,Bellarmine (ASUN),13,9-4,175,186,361,0.485,04/16/2023,2023.0
45,St. Bonaventure (Atlantic 10),12,1-11,146,157,303,0.482,04/16/2023,2023.0
46,North Carolina (ACC),12,7-5,168,181,349,0.481,04/16/2023,2023.0
47,NJIT (America East),11,2-9,142,153,295,0.481,04/16/2023,2023.0
48,Marist (MAAC),13,6-7,174,188,362,0.481,04/16/2023,2023.0
49,Canisius (MAAC),14,2-12,184,199,383,0.480,04/16/2023,2023.0
50,Ohio St. (Big Ten),12,5-7,156,169,325,0.480,04/16/2023,2023.0
51,UMBC (America East),11,7-4,129,143,272,0.474,04/16/2023,2023.0
52,Cleveland St. (ASUN),11,5-6,139,157,296,0.470,04/16/2023,2023.0
53,LIU (MAAC),13,5-8,153,178,331,0.462,04/16/2023,2023.0
54,Princeton (Ivy League),10,5-5,130,155,285,0.456,04/16/2023,2023.0
55,Notre Dame (ACC),9,8-1,123,148,271,0.454,04/16/2023,2023.0
56,Sacred Heart (MAAC),13,4-9,149,181,330,0.452,04/16/2023,2023.0
57,Hampton (CAA),12,2-10,138,168,306,0.451,04/16/2023,2023.0
58,Fairfield (CAA),12,4-8,148,183,331,0.447,04/16/2023,2023.0
59,Harvard (Ivy League),10,5-5,131,162,293,0.447,04/16/2023,2023.0
60,Siena (MAAC),12,6-6,139,172,311,0.447,04/16/2023,2023.0
61,Loyola Maryland (Patriot),11,6-5,123,157,280,0.439,04/16/2023,2023.0
62,Penn (Ivy League),10,5-5,117,153,270,0.433,04/16/2023,2023.0
63,Lafayette (Patriot),13,5-8,151,198,349,0.433,04/16/2023,2023.0
64,Syracuse (ACC),13,8-5,159,218,377,0.422,04/16/2023,2023.0
65,Bucknell (Patriot),11,3-8,123,172,295,0.417,04/16/2023,2023.0
66,Wagner (MAAC),13,3-10,124,177,301,0.412,04/16/2023,2023.0
67,Air Force (ASUN),13,8-5,138,197,335,0.412,04/16/2023,2023.0
68,Holy Cross (Patriot),12,0-12,135,199,334,0.404,04/16/2023,2023.0
69,Providence (Big East),12,5-7,133,216,349,0.381,04/16/2023,2023.0
70,UMass Lowell (America East),10,0-10,101,171,272,0.371,04/16/2023,2023.0
71,Detroit Mercy (ASUN),11,2-9,109,198,307,0.355,04/16/2023,2023.0
72,St. John's (NY) (Big East),12,0-12,88,240,328,0.268,04/16/2023,2023.0
-,Hartford (DI Independent),5,5-0,86,28,114,0.754,04/16/2023,2023.0
-,Lindenwood (ASUN),10,2-8,132,140,272,0.485,04/16/2023,2023.0
-,Merrimack (America East),11,6-5,119,164,283,0.420,04/16/2023,2023.0
-,Queens (NC) (ASUN),12,2-10,131,201,332,0.395,04/16/2023,2023.0
1,Lehigh (Patriot),10,7-3,184,102,286,0.643,04/13/2023,2023.0
2,Saint Joseph's (Atlantic 10),11,7-4,204,116,320,0.638,04/13/2023,2023.0
3,Army West Point (Patriot),10,9-1,153,91,244,0.627,04/13/2023,2023.0
4,Maryland (Big Ten),10,7-3,166,103,269,0.617,04/13/2023,2023.0
5,Duke (ACC),12,10-2,213,136,349,0.610,04/13/2023,2023.0
6,Michigan (Big Ten),10,5-5,176,118,294,0.599,04/13/2023,2023.0
7,Vermont (America East),10,6-4,151,104,255,0.592,04/13/2023,2023.0
8,Mount St. Mary's (MAAC),13,7-6,196,140,336,0.583,04/13/2023,2023.0
9,Mercer (ASUN),12,4-8,184,133,317,0.580,04/13/2023,2023.0
10,Denver (Big East),10,6-4,140,102,242,0.579,04/13/2023,2023.0
11,Bryant (America East),10,8-2,179,131,310,0.577,04/13/2023,2023.0
12,Binghamton (America East),10,7-3,163,120,283,0.576,04/13/2023,2023.0
13,Dartmouth (Ivy League),9,6-3,156,115,271,0.576,04/13/2023,2023.0
14,Hofstra (CAA),11,3-8,156,116,272,0.574,04/13/2023,2023.0
15,Brown (Ivy League),10,5-5,163,125,288,0.566,04/13/2023,2023.0
16,Virginia (ACC),10,8-2,191,150,341,0.560,04/13/2023,2023.0
17,Towson (CAA),11,3-8,159,125,284,0.560,04/13/2023,2023.0
18,Rutgers (Big Ten),11,8-3,164,131,295,0.556,04/13/2023,2023.0
19,Marquette (Big East),11,6-5,171,138,309,0.553,04/13/2023,2023.0
20,High Point (Atlantic 10),12,7-5,203,164,367,0.553,04/13/2023,2023.0
21,Quinnipiac (MAAC),11,5-6,169,139,308,0.549,04/13/2023,2023.0
22,Massachusetts (Atlantic 10),10,6-4,119,98,217,0.548,04/13/2023,2023.0
23,Monmouth (CAA),11,5-6,141,117,258,0.547,04/13/2023,2023.0
24,Navy (Patriot),12,6-6,163,136,299,0.545,04/13/2023,2023.0
25,Drexel (CAA),10,7-3,149,125,274,0.544,04/13/2023,2023.0
26,Georgetown (Big East),9,6-3,138,116,254,0.543,04/13/2023,2023.0
27,Villanova (Big East),11,8-3,154,133,287,0.537,04/13/2023,2023.0
28,Utah (ASUN),11,7-4,187,169,356,0.525,04/13/2023,2023.0
29,Hobart (Atlantic 10),10,5-5,162,151,313,0.518,04/13/2023,2023.0
30,Jacksonville (ASUN),12,10-2,178,166,344,0.517,04/13/2023,2023.0
31,Cornell (Ivy League),10,8-2,148,139,287,0.516,04/13/2023,2023.0
32,Yale (Ivy League),9,5-4,146,138,284,0.514,04/13/2023,2023.0
33,Boston U. (Patriot),10,7-3,145,138,283,0.512,04/13/2023,2023.0
34,Richmond (Atlantic 10),10,6-4,131,125,256,0.512,04/13/2023,2023.0
35,Penn St. (Big Ten),10,7-3,144,140,284,0.507,04/13/2023,2023.0
36,Delaware (CAA),11,8-3,149,145,294,0.507,04/13/2023,2023.0
37,VMI (MAAC),13,6-7,174,170,344,0.506,04/13/2023,2023.0
38,Colgate (Patriot),8,1-7,100,99,199,0.503,04/13/2023,2023.0
39,Ohio St. (Big Ten),11,5-6,148,148,296,0.500,04/13/2023,2023.0
40,St. Bonaventure (Atlantic 10),11,1-10,139,144,283,0.491,04/13/2023,2023.0
41,Cleveland St. (ASUN),10,5-5,133,139,272,0.489,04/13/2023,2023.0
42,Manhattan (MAAC),12,9-3,126,132,258,0.488,04/13/2023,2023.0
43,Robert Morris (ASUN),11,5-6,147,155,302,0.487,04/13/2023,2023.0
44,Canisius (MAAC),13,2-11,176,188,364,0.484,04/13/2023,2023.0
45,NJIT (America East),10,2-8,131,140,271,0.483,04/13/2023,2023.0
46,UAlbany (America East),9,3-6,110,118,228,0.482,04/13/2023,2023.0
47,Marist (MAAC),12,5-7,158,174,332,0.476,04/13/2023,2023.0
48,Stony Brook (CAA),11,6-5,148,163,311,0.476,04/13/2023,2023.0
49,Johns Hopkins (Big Ten),13,9-4,165,188,353,0.467,04/13/2023,2023.0
50,UMBC (America East),10,7-3,112,128,240,0.467,04/13/2023,2023.0
51,Bellarmine (ASUN),12,8-4,157,180,337,0.466,04/13/2023,2023.0
52,LIU (MAAC),12,5-7,139,162,301,0.462,04/13/2023,2023.0
53,North Carolina (ACC),11,7-4,146,171,317,0.461,04/13/2023,2023.0
54,Sacred Heart (MAAC),12,4-8,139,163,302,0.460,04/13/2023,2023.0
55,Fairfield (CAA),11,3-8,137,161,298,0.460,04/13/2023,2023.0
56,Notre Dame (ACC),9,8-1,123,148,271,0.454,04/13/2023,2023.0
57,Princeton (Ivy League),9,4-5,117,141,258,0.453,04/13/2023,2023.0
58,Siena (MAAC),11,5-6,131,160,291,0.450,04/13/2023,2023.0
59,Hampton (CAA),11,2-9,125,156,281,0.445,04/13/2023,2023.0
60,Lafayette (Patriot),12,5-7,147,184,331,0.444,04/13/2023,2023.0
61,Harvard (Ivy League),9,5-4,118,148,266,0.444,04/13/2023,2023.0
62,Loyola Maryland (Patriot),10,6-4,110,142,252,0.437,04/13/2023,2023.0
63,Syracuse (ACC),12,7-5,149,196,345,0.432,04/13/2023,2023.0
64,Penn (Ivy League),9,4-5,103,140,243,0.424,04/13/2023,2023.0
65,Holy Cross (Patriot),11,0-11,122,179,301,0.405,04/13/2023,2023.0
66,Air Force (ASUN),12,7-5,122,180,302,0.404,04/13/2023,2023.0
67,Wagner (MAAC),12,2-10,113,169,282,0.401,04/13/2023,2023.0
68,Bucknell (Patriot),10,2-8,103,159,262,0.393,04/13/2023,2023.0
69,UMass Lowell (America East),9,0-9,93,154,247,0.377,04/13/2023,2023.0
70,Providence (Big East),11,5-6,119,198,317,0.375,04/13/2023,2023.0
71,Detroit Mercy (ASUN),10,2-8,92,182,274,0.336,04/13/2023,2023.0
72,St. John's (NY) (Big East),11,0-11,83,219,302,0.275,04/13/2023,2023.0
-,Hartford (DI Independent),5,5-0,86,28,114,0.754,04/13/2023,2023.0
-,Lindenwood (ASUN),9,2-7,126,123,249,0.506,04/13/2023,2023.0
-,Merrimack (America East),10,5-5,102,156,258,0.395,04/13/2023,2023.0
-,Queens (NC) (ASUN),11,2-9,118,186,304,0.388,04/13/2023,2023.0
1,Lehigh (Patriot),10,7-3,184,102,286,0.643,04/12/2023,2023.0
2,Saint Joseph's (Atlantic 10),11,7-4,204,116,320,0.638,04/12/2023,2023.0
3,Army West Point (Patriot),10,9-1,153,91,244,0.627,04/12/2023,2023.0
4,Maryland (Big Ten),10,7-3,166,103,269,0.617,04/12/2023,2023.0
5,Duke (ACC),12,10-2,213,136,349,0.610,04/12/2023,2023.0
6,Denver (Big East),9,5-4,130,86,216,0.602,04/12/2023,2023.0
7,Michigan (Big Ten),10,5-5,176,118,294,0.599,04/12/2023,2023.0
8,Vermont (America East),10,6-4,151,104,255,0.592,04/12/2023,2023.0
9,Mercer (ASUN),12,4-8,184,133,317,0.580,04/12/2023,2023.0
10,Mount St. Mary's (MAAC),13,7-6,195,141,336,0.580,04/12/2023,2023.0
11,Bryant (America East),10,8-2,179,131,310,0.577,04/12/2023,2023.0
12,Binghamton (America East),10,7-3,163,120,283,0.576,04/12/2023,2023.0
13,Dartmouth (Ivy League),9,6-3,156,115,271,0.576,04/12/2023,2023.0
14,Hofstra (CAA),11,3-8,156,116,272,0.574,04/12/2023,2023.0
15,Brown (Ivy League),10,5-5,163,125,288,0.566,04/12/2023,2023.0
16,Virginia (ACC),10,8-2,191,150,341,0.560,04/12/2023,2023.0
17,Rutgers (Big Ten),11,8-3,164,131,295,0.556,04/12/2023,2023.0
18,Towson (CAA),10,3-7,143,115,258,0.554,04/12/2023,2023.0
19,Marquette (Big East),11,6-5,171,138,309,0.553,04/12/2023,2023.0
20,High Point (Atlantic 10),12,7-5,203,164,367,0.553,04/12/2023,2023.0
21,Quinnipiac (MAAC),11,5-6,169,139,308,0.549,04/12/2023,2023.0
22,Massachusetts (Atlantic 10),10,6-4,119,98,217,0.548,04/12/2023,2023.0
23,Monmouth (CAA),11,5-6,141,117,258,0.547,04/12/2023,2023.0
24,Navy (Patriot),12,6-6,163,136,299,0.545,04/12/2023,2023.0
25,Drexel (CAA),10,7-3,149,125,274,0.544,04/12/2023,2023.0
26,Georgetown (Big East),9,6-3,138,116,254,0.543,04/12/2023,2023.0
27,Villanova (Big East),11,8-3,154,133,287,0.537,04/12/2023,2023.0
28,Utah (ASUN),11,7-4,187,169,356,0.525,04/12/2023,2023.0
29,Hobart (Atlantic 10),10,5-5,162,151,313,0.518,04/12/2023,2023.0
30,Jacksonville (ASUN),12,10-2,178,166,344,0.517,04/12/2023,2023.0
31,Cornell (Ivy League),10,8-2,148,139,287,0.516,04/12/2023,2023.0
32,Yale (Ivy League),9,5-4,146,138,284,0.514,04/12/2023,2023.0
33,Boston U. (Patriot),10,7-3,145,138,283,0.512,04/12/2023,2023.0
34,Richmond (Atlantic 10),10,6-4,131,125,256,0.512,04/12/2023,2023.0
35,Penn St. (Big Ten),10,7-3,144,140,284,0.507,04/12/2023,2023.0
36,Delaware (CAA),11,8-3,149,145,294,0.507,04/12/2023,2023.0
37,VMI (MAAC),13,6-7,174,170,344,0.506,04/12/2023,2023.0
38,Colgate (Patriot),8,1-7,100,99,199,0.503,04/12/2023,2023.0
39,Ohio St. (Big Ten),11,5-6,148,148,296,0.500,04/12/2023,2023.0
40,St. Bonaventure (Atlantic 10),11,1-10,139,144,283,0.491,04/12/2023,2023.0
41,Cleveland St. (ASUN),10,5-5,133,139,272,0.489,04/12/2023,2023.0
42,Manhattan (MAAC),12,9-3,126,132,258,0.488,04/12/2023,2023.0
43,Robert Morris (ASUN),11,5-6,147,155,302,0.487,04/12/2023,2023.0
44,Canisius (MAAC),13,2-11,177,187,364,0.486,04/12/2023,2023.0
45,NJIT (America East),10,2-8,131,140,271,0.483,04/12/2023,2023.0
46,UAlbany (America East),9,3-6,110,118,228,0.482,04/12/2023,2023.0
47,Marist (MAAC),12,5-7,158,174,332,0.476,04/12/2023,2023.0
48,Stony Brook (CAA),11,6-5,148,163,311,0.476,04/12/2023,2023.0
49,Johns Hopkins (Big Ten),13,9-4,165,188,353,0.467,04/12/2023,2023.0
50,UMBC (America East),10,7-3,112,128,240,0.467,04/12/2023,2023.0
51,Bellarmine (ASUN),12,8-4,157,180,337,0.466,04/12/2023,2023.0
52,LIU (MAAC),12,5-7,139,162,301,0.462,04/12/2023,2023.0
53,North Carolina (ACC),11,7-4,146,171,317,0.461,04/12/2023,2023.0
54,Sacred Heart (MAAC),12,4-8,139,163,302,0.460,04/12/2023,2023.0
55,Fairfield (CAA),11,3-8,137,161,298,0.460,04/12/2023,2023.0
56,Notre Dame (ACC),9,8-1,123,148,271,0.454,04/12/2023,2023.0
57,Princeton (Ivy League),9,4-5,117,141,258,0.453,04/12/2023,2023.0
58,Siena (MAAC),11,5-6,131,160,291,0.450,04/12/2023,2023.0
59,Hampton (CAA),11,2-9,125,156,281,0.445,04/12/2023,2023.0
60,Lafayette (Patriot),12,5-7,147,184,331,0.444,04/12/2023,2023.0
61,Harvard (Ivy League),9,5-4,118,148,266,0.444,04/12/2023,2023.0
62,Loyola Maryland (Patriot),10,6-4,110,142,252,0.437,04/12/2023,2023.0
63,Syracuse (ACC),12,7-5,149,196,345,0.432,04/12/2023,2023.0
64,Penn (Ivy League),9,4-5,103,140,243,0.424,04/12/2023,2023.0
65,Holy Cross (Patriot),11,0-11,122,179,301,0.405,04/12/2023,2023.0
66,Air Force (ASUN),12,7-5,122,180,302,0.404,04/12/2023,2023.0
67,Wagner (MAAC),12,2-10,113,169,282,0.401,04/12/2023,2023.0
68,Bucknell (Patriot),10,2-8,103,159,262,0.393,04/12/2023,2023.0
69,UMass Lowell (America East),9,0-9,93,154,247,0.377,04/12/2023,2023.0
70,Providence (Big East),11,5-6,119,198,317,0.375,04/12/2023,2023.0
71,Detroit Mercy (ASUN),10,2-8,92,182,274,0.336,04/12/2023,2023.0
72,St. John's (NY) (Big East),11,0-11,83,219,302,0.275,04/12/2023,2023.0
-,Hartford (DI Independent),5,5-0,86,28,114,0.754,04/12/2023,2023.0
-,Lindenwood (ASUN),9,2-7,126,123,249,0.506,04/12/2023,2023.0
-,Merrimack (America East),10,5-5,102,156,258,0.395,04/12/2023,2023.0
-,Queens (NC) (ASUN),11,2-9,118,186,304,0.388,04/12/2023,2023.0
1,Lehigh (Patriot),10,7-3,184,102,286,0.643,04/11/2023,2023.0
2,Saint Joseph's (Atlantic 10),11,7-4,204,116,320,0.638,04/11/2023,2023.0
3,Army West Point (Patriot),10,9-1,153,91,244,0.627,04/11/2023,2023.0
4,Maryland (Big Ten),10,7-3,166,103,269,0.617,04/11/2023,2023.0
5,Duke (ACC),12,10-2,213,136,349,0.610,04/11/2023,2023.0
6,Denver (Big East),9,5-4,130,86,216,0.602,04/11/2023,2023.0
7,Michigan (Big Ten),10,5-5,176,118,294,0.599,04/11/2023,2023.0
8,Vermont (America East),10,6-4,151,104,255,0.592,04/11/2023,2023.0
9,Mercer (ASUN),12,4-8,184,133,317,0.580,04/11/2023,2023.0
10,Mount St. Mary's (MAAC),12,6-6,176,128,304,0.579,04/11/2023,2023.0
11,Bryant (America East),10,8-2,179,131,310,0.577,04/11/2023,2023.0
12,Binghamton (America East),10,7-3,163,120,283,0.576,04/11/2023,2023.0
13,Dartmouth (Ivy League),9,6-3,156,115,271,0.576,04/11/2023,2023.0
14,Hofstra (CAA),11,3-8,156,116,272,0.574,04/11/2023,2023.0
15,Brown (Ivy League),10,5-5,163,125,288,0.566,04/11/2023,2023.0
16,Virginia (ACC),10,8-2,191,150,341,0.560,04/11/2023,2023.0
17,Rutgers (Big Ten),11,8-3,164,131,295,0.556,04/11/2023,2023.0
18,Towson (CAA),10,3-7,143,115,258,0.554,04/11/2023,2023.0
19,Marquette (Big East),11,6-5,171,138,309,0.553,04/11/2023,2023.0
20,High Point (Atlantic 10),12,7-5,203,164,367,0.553,04/11/2023,2023.0
21,Massachusetts (Atlantic 10),10,6-4,119,98,217,0.548,04/11/2023,2023.0
22,Monmouth (CAA),11,5-6,141,117,258,0.547,04/11/2023,2023.0
23,Navy (Patriot),12,6-6,163,136,299,0.545,04/11/2023,2023.0
24,Drexel (CAA),10,7-3,149,125,274,0.544,04/11/2023,2023.0
25,Georgetown (Big East),9,6-3,138,116,254,0.543,04/11/2023,2023.0
26,Quinnipiac (MAAC),10,5-5,151,129,280,0.539,04/11/2023,2023.0
27,Villanova (Big East),11,8-3,154,133,287,0.537,04/11/2023,2023.0
28,Utah (ASUN),10,6-4,170,152,322,0.528,04/11/2023,2023.0
29,Hobart (Atlantic 10),10,5-5,162,151,313,0.518,04/11/2023,2023.0
30,Cornell (Ivy League),10,8-2,148,139,287,0.516,04/11/2023,2023.0
31,Yale (Ivy League),9,5-4,146,138,284,0.514,04/11/2023,2023.0
32,Boston U. (Patriot),10,7-3,145,138,283,0.512,04/11/2023,2023.0
33,Richmond (Atlantic 10),10,6-4,131,125,256,0.512,04/11/2023,2023.0
34,Jacksonville (ASUN),11,9-2,161,156,317,0.508,04/11/2023,2023.0
35,Penn St. (Big Ten),10,7-3,144,140,284,0.507,04/11/2023,2023.0
36,Delaware (CAA),11,8-3,149,145,294,0.507,04/11/2023,2023.0
37,Colgate (Patriot),8,1-7,100,99,199,0.503,04/11/2023,2023.0
38,Ohio St. (Big Ten),11,5-6,148,148,296,0.500,04/11/2023,2023.0
39,Manhattan (MAAC),11,8-3,114,116,230,0.496,04/11/2023,2023.0
40,Canisius (MAAC),12,2-10,164,168,332,0.494,04/11/2023,2023.0
41,Cleveland St. (ASUN),9,4-5,120,123,243,0.494,04/11/2023,2023.0
42,St. Bonaventure (Atlantic 10),11,1-10,139,144,283,0.491,04/11/2023,2023.0
43,VMI (MAAC),12,5-7,155,163,318,0.487,04/11/2023,2023.0
44,NJIT (America East),10,2-8,131,140,271,0.483,04/11/2023,2023.0
45,UAlbany (America East),9,3-6,110,118,228,0.482,04/11/2023,2023.0
46,Bellarmine (ASUN),11,8-3,144,156,300,0.480,04/11/2023,2023.0
47,Stony Brook (CAA),11,6-5,148,163,311,0.476,04/11/2023,2023.0
48,Marist (MAAC),11,4-7,143,160,303,0.472,04/11/2023,2023.0
49,Sacred Heart (MAAC),11,3-8,129,145,274,0.471,04/11/2023,2023.0
50,Johns Hopkins (Big Ten),13,9-4,165,188,353,0.467,04/11/2023,2023.0
51,UMBC (America East),10,7-3,112,128,240,0.467,04/11/2023,2023.0
52,Robert Morris (ASUN),10,4-6,123,142,265,0.464,04/11/2023,2023.0
53,North Carolina (ACC),11,7-4,146,171,317,0.461,04/11/2023,2023.0
54,Fairfield (CAA),11,3-8,137,161,298,0.460,04/11/2023,2023.0
55,Notre Dame (ACC),9,8-1,123,148,271,0.454,04/11/2023,2023.0
56,Princeton (Ivy League),9,4-5,117,141,258,0.453,04/11/2023,2023.0
57,LIU (MAAC),11,5-6,123,150,273,0.451,04/11/2023,2023.0
58,Siena (MAAC),10,5-5,117,145,262,0.447,04/11/2023,2023.0
59,Hampton (CAA),11,2-9,125,156,281,0.445,04/11/2023,2023.0
60,Lafayette (Patriot),12,5-7,147,184,331,0.444,04/11/2023,2023.0
61,Harvard (Ivy League),9,5-4,118,148,266,0.444,04/11/2023,2023.0
62,Loyola Maryland (Patriot),10,6-4,110,142,252,0.437,04/11/2023,2023.0
63,Syracuse (ACC),12,7-5,149,196,345,0.432,04/11/2023,2023.0
64,Penn (Ivy League),9,4-5,103,140,243,0.424,04/11/2023,2023.0
65,Wagner (MAAC),11,2-9,106,150,256,0.414,04/11/2023,2023.0
66,Holy Cross (Patriot),11,0-11,122,179,301,0.405,04/11/2023,2023.0
67,Air Force (ASUN),12,7-5,122,180,302,0.404,04/11/2023,2023.0
68,Bucknell (Patriot),10,2-8,103,159,262,0.393,04/11/2023,2023.0
69,UMass Lowell (America East),9,0-9,93,154,247,0.377,04/11/2023,2023.0
70,Providence (Big East),11,5-6,119,198,317,0.375,04/11/2023,2023.0
71,Detroit Mercy (ASUN),9,2-7,82,165,247,0.332,04/11/2023,2023.0
72,St. John's (NY) (Big East),11,0-11,83,219,302,0.275,04/11/2023,2023.0
-,Hartford (DI Independent),5,5-0,86,28,114,0.754,04/11/2023,2023.0
-,Lindenwood (ASUN),8,2-6,109,106,215,0.507,04/11/2023,2023.0
-,Merrimack (America East),10,5-5,102,156,258,0.395,04/11/2023,2023.0
-,Queens (NC) (ASUN),10,2-8,102,173,275,0.371,04/11/2023,2023.0
1,Lehigh (Patriot),10,7-3,184,102,286,0.643,04/09/2023,2023.0
2,Saint Joseph's (Atlantic 10),11,7-4,204,116,320,0.638,04/09/2023,2023.0
3,Army West Point (Patriot),10,9-1,153,91,244,0.627,04/09/2023,2023.0
4,Maryland (Big Ten),10,7-3,166,103,269,0.617,04/09/2023,2023.0
5,Duke (ACC),12,10-2,213,136,349,0.610,04/09/2023,2023.0
6,Denver (Big East),9,5-4,130,86,216,0.602,04/09/2023,2023.0
7,Vermont (America East),10,6-4,152,103,255,0.596,04/09/2023,2023.0
8,Michigan (Big Ten),10,5-5,175,119,294,0.595,04/09/2023,2023.0
9,Mercer (ASUN),12,4-8,184,133,317,0.580,04/09/2023,2023.0
10,Mount St. Mary's (MAAC),12,6-6,176,128,304,0.579,04/09/2023,2023.0
11,Bryant (America East),10,8-2,179,131,310,0.577,04/09/2023,2023.0
12,Binghamton (America East),10,7-3,163,120,283,0.576,04/09/2023,2023.0
13,Dartmouth (Ivy League),9,6-3,156,115,271,0.576,04/09/2023,2023.0
14,Hofstra (CAA),11,3-8,156,116,272,0.574,04/09/2023,2023.0
15,Brown (Ivy League),10,5-5,163,125,288,0.566,04/09/2023,2023.0
16,Virginia (ACC),10,8-2,191,150,341,0.560,04/09/2023,2023.0
17,Rutgers (Big Ten),11,8-3,165,130,295,0.559,04/09/2023,2023.0
18,Marquette (Big East),10,6-4,152,121,273,0.557,04/09/2023,2023.0
19,Towson (CAA),10,3-7,143,115,258,0.554,04/09/2023,2023.0
20,High Point (Atlantic 10),12,7-5,203,164,367,0.553,04/09/2023,2023.0
21,Massachusetts (Atlantic 10),10,6-4,119,98,217,0.548,04/09/2023,2023.0
22,Monmouth (CAA),11,5-6,141,117,258,0.547,04/09/2023,2023.0
23,Navy (Patriot),12,6-6,163,136,299,0.545,04/09/2023,2023.0
24,Drexel (CAA),10,7-3,149,125,274,0.544,04/09/2023,2023.0
25,Georgetown (Big East),9,6-3,138,116,254,0.543,04/09/2023,2023.0
26,Quinnipiac (MAAC),10,5-5,151,129,280,0.539,04/09/2023,2023.0
27,Villanova (Big East),11,8-3,154,133,287,0.537,04/09/2023,2023.0
28,Utah (ASUN),10,6-4,170,152,322,0.528,04/09/2023,2023.0
29,Cornell (Ivy League),9,7-2,131,120,251,0.522,04/09/2023,2023.0
30,Hobart (Atlantic 10),10,5-5,162,151,313,0.518,04/09/2023,2023.0
31,Yale (Ivy League),9,5-4,146,138,284,0.514,04/09/2023,2023.0
32,Boston U. (Patriot),10,7-3,145,138,283,0.512,04/09/2023,2023.0
33,Richmond (Atlantic 10),10,6-4,131,125,256,0.512,04/09/2023,2023.0
34,Jacksonville (ASUN),11,9-2,161,156,317,0.508,04/09/2023,2023.0
35,Penn St. (Big Ten),10,7-3,144,140,284,0.507,04/09/2023,2023.0
36,Delaware (CAA),11,8-3,149,145,294,0.507,04/09/2023,2023.0
37,Colgate (Patriot),8,1-7,100,99,199,0.503,04/09/2023,2023.0
38,Ohio St. (Big Ten),11,5-6,148,148,296,0.500,04/09/2023,2023.0
39,Manhattan (MAAC),11,8-3,114,116,230,0.496,04/09/2023,2023.0
40,Canisius (MAAC),12,2-10,164,168,332,0.494,04/09/2023,2023.0
41,Cleveland St. (ASUN),9,4-5,120,123,243,0.494,04/09/2023,2023.0
42,St. Bonaventure (Atlantic 10),11,1-10,139,144,283,0.491,04/09/2023,2023.0
43,VMI (MAAC),12,5-7,155,163,318,0.487,04/09/2023,2023.0
44,NJIT (America East),10,2-8,131,140,271,0.483,04/09/2023,2023.0
45,UAlbany (America East),9,3-6,110,118,228,0.482,04/09/2023,2023.0
46,Bellarmine (ASUN),11,8-3,144,156,300,0.480,04/09/2023,2023.0
47,Stony Brook (CAA),11,6-5,148,163,311,0.476,04/09/2023,2023.0
48,Marist (MAAC),11,4-7,143,160,303,0.472,04/09/2023,2023.0
49,Sacred Heart (MAAC),11,3-8,129,145,274,0.471,04/09/2023,2023.0
50,Johns Hopkins (Big Ten),13,9-4,165,188,353,0.467,04/09/2023,2023.0
51,UMBC (America East),10,7-3,112,128,240,0.467,04/09/2023,2023.0
52,Robert Morris (ASUN),10,4-6,123,142,265,0.464,04/09/2023,2023.0
53,North Carolina (ACC),11,7-4,146,171,317,0.461,04/09/2023,2023.0
54,Fairfield (CAA),11,3-8,137,161,298,0.460,04/09/2023,2023.0
55,Notre Dame (ACC),9,8-1,123,148,271,0.454,04/09/2023,2023.0
56,Princeton (Ivy League),9,4-5,117,141,258,0.453,04/09/2023,2023.0
57,LIU (MAAC),11,5-6,123,150,273,0.451,04/09/2023,2023.0
58,Siena (MAAC),10,5-5,117,145,262,0.447,04/09/2023,2023.0
59,Hampton (CAA),11,2-9,125,156,281,0.445,04/09/2023,2023.0
60,Lafayette (Patriot),12,5-7,147,184,331,0.444,04/09/2023,2023.0
61,Harvard (Ivy League),9,5-4,117,149,266,0.440,04/09/2023,2023.0
62,Loyola Maryland (Patriot),10,6-4,110,142,252,0.437,04/09/2023,2023.0
63,Syracuse (ACC),12,7-5,149,196,345,0.432,04/09/2023,2023.0
64,Penn (Ivy League),9,4-5,103,140,243,0.424,04/09/2023,2023.0
65,Wagner (MAAC),11,2-9,106,150,256,0.414,04/09/2023,2023.0
66,Holy Cross (Patriot),11,0-11,122,179,301,0.405,04/09/2023,2023.0
67,Air Force (ASUN),12,7-5,122,180,302,0.404,04/09/2023,2023.0
68,Bucknell (Patriot),10,2-8,103,159,262,0.393,04/09/2023,2023.0
69,UMass Lowell (America East),9,0-9,93,154,247,0.377,04/09/2023,2023.0
70,Providence (Big East),11,5-6,119,198,317,0.375,04/09/2023,2023.0
71,Detroit Mercy (ASUN),9,2-7,82,165,247,0.332,04/09/2023,2023.0
72,St. John's (NY) (Big East),11,0-11,83,219,302,0.275,04/09/2023,2023.0
-,Hartford (DI Independent),5,5-0,86,28,114,0.754,04/09/2023,2023.0
-,Lindenwood (ASUN),8,2-6,109,106,215,0.507,04/09/2023,2023.0
-,Merrimack (America East),10,5-5,102,156,258,0.395,04/09/2023,2023.0
-,Queens (NC) (ASUN),10,2-8,102,173,275,0.371,04/09/2023,2023.0
1,Saint Joseph's (Atlantic 10),10,6-4,186,104,290,0.641,04/05/2023,2023.0
2,Army West Point (Patriot),9,8-1,140,81,221,0.633,04/05/2023,2023.0
3,Lehigh (Patriot),9,6-3,163,101,264,0.617,04/05/2023,2023.0
4,Denver (Big East),8,4-4,119,76,195,0.610,04/05/2023,2023.0
5,Dartmouth (Ivy League),8,6-2,144,93,237,0.608,04/05/2023,2023.0
6,Maryland (Big Ten),9,6-3,147,96,243,0.605,04/05/2023,2023.0
7,Duke (ACC),11,10-1,191,125,316,0.604,04/05/2023,2023.0
8,Michigan (Big Ten),9,5-4,159,106,265,0.600,04/05/2023,2023.0
9,Vermont (America East),9,5-4,139,93,232,0.599,04/05/2023,2023.0
10,Bryant (America East),9,7-2,160,111,271,0.590,04/05/2023,2023.0
11,Binghamton (America East),9,7-2,153,107,260,0.588,04/05/2023,2023.0
12,Mount St. Mary's (MAAC),11,5-6,163,116,279,0.584,04/05/2023,2023.0
13,Hofstra (CAA),10,3-7,146,105,251,0.582,04/05/2023,2023.0
14,Mercer (ASUN),11,4-7,170,124,294,0.578,04/05/2023,2023.0
15,Rutgers (Big Ten),10,7-3,152,114,266,0.571,04/05/2023,2023.0
16,Brown (Ivy League),9,4-5,149,113,262,0.569,04/05/2023,2023.0
17,Virginia (ACC),9,7-2,173,133,306,0.565,04/05/2023,2023.0
18,Towson (CAA),9,2-7,132,105,237,0.557,04/05/2023,2023.0
19,High Point (Atlantic 10),11,6-5,188,150,338,0.556,04/05/2023,2023.0
20,Navy (Patriot),11,5-6,152,123,275,0.553,04/05/2023,2023.0
21,Quinnipiac (MAAC),9,4-5,138,114,252,0.548,04/05/2023,2023.0
22,Massachusetts (Atlantic 10),9,6-3,102,86,188,0.543,04/05/2023,2023.0
23,Marquette (Big East),9,5-4,130,110,240,0.542,04/05/2023,2023.0
24,Villanova (Big East),10,8-2,144,122,266,0.541,04/05/2023,2023.0
25,Drexel (CAA),9,6-3,129,114,243,0.531,04/05/2023,2023.0
26,Monmouth (CAA),10,4-6,124,110,234,0.530,04/05/2023,2023.0
27,Richmond (Atlantic 10),9,5-4,119,108,227,0.524,04/05/2023,2023.0
28,Ohio St. (Big Ten),10,5-5,141,129,270,0.522,04/05/2023,2023.0
29,Hobart (Atlantic 10),9,5-4,148,136,284,0.521,04/05/2023,2023.0
30,Georgetown (Big East),8,5-3,118,109,227,0.520,04/05/2023,2023.0
31,Boston U. (Patriot),10,7-3,145,138,283,0.512,04/05/2023,2023.0
32,Colgate (Patriot),7,1-6,90,86,176,0.511,04/05/2023,2023.0
33,Manhattan (MAAC),10,7-3,108,104,212,0.509,04/05/2023,2023.0
34,Delaware (CAA),10,7-3,135,131,266,0.508,04/05/2023,2023.0
35,Cleveland St. (ASUN),8,3-5,111,109,220,0.505,04/05/2023,2023.0
36,Cornell (Ivy League),8,7-1,115,114,229,0.502,04/05/2023,2023.0
37,St. Bonaventure (Atlantic 10),10,1-9,127,126,253,0.502,04/05/2023,2023.0
38,Utah (ASUN),9,5-4,139,139,278,0.500,04/05/2023,2023.0
39,Robert Morris (ASUN),9,4-5,110,111,221,0.498,04/05/2023,2023.0
40,Yale (Ivy League),8,4-4,124,126,250,0.496,04/05/2023,2023.0
41,Stony Brook (CAA),10,6-4,137,143,280,0.489,04/05/2023,2023.0
42,Penn St. (Big Ten),9,6-3,125,131,256,0.488,04/05/2023,2023.0
43,Canisius (MAAC),11,2-9,149,158,307,0.485,04/05/2023,2023.0
44,NJIT (America East),9,2-7,116,125,241,0.481,04/05/2023,2023.0
45,Johns Hopkins (Big Ten),12,9-3,156,169,325,0.480,04/05/2023,2023.0
46,Bellarmine (ASUN),10,7-3,133,145,278,0.478,04/05/2023,2023.0
47,VMI (MAAC),11,5-6,143,157,300,0.477,04/05/2023,2023.0
48,UAlbany (America East),8,3-5,90,99,189,0.476,04/05/2023,2023.0
49,Marist (MAAC),10,4-6,131,147,278,0.471,04/05/2023,2023.0
50,Notre Dame (ACC),8,7-1,112,126,238,0.471,04/05/2023,2023.0
51,Jacksonville (ASUN),10,8-2,133,150,283,0.470,04/05/2023,2023.0
52,Princeton (Ivy League),8,4-4,104,121,225,0.462,04/05/2023,2023.0
53,Sacred Heart (MAAC),10,2-8,115,135,250,0.460,04/05/2023,2023.0
54,Hampton (CAA),10,2-8,118,139,257,0.459,04/05/2023,2023.0
55,North Carolina (ACC),10,7-3,129,153,282,0.457,04/05/2023,2023.0
56,LIU (MAAC),10,4-6,113,135,248,0.456,04/05/2023,2023.0
57,Fairfield (CAA),10,3-7,123,147,270,0.456,04/05/2023,2023.0
58,Harvard (Ivy League),8,4-4,111,133,244,0.455,04/05/2023,2023.0
59,UMBC (America East),9,6-3,96,117,213,0.451,04/05/2023,2023.0
60,Siena (MAAC),9,5-4,102,132,234,0.436,04/05/2023,2023.0
61,Loyola Maryland (Patriot),9,6-3,97,131,228,0.425,04/05/2023,2023.0
62,Bucknell (Patriot),9,2-7,102,138,240,0.425,04/05/2023,2023.0
63,Lafayette (Patriot),11,4-7,126,173,299,0.421,04/05/2023,2023.0
64,Penn (Ivy League),8,4-4,91,126,217,0.419,04/05/2023,2023.0
65,Wagner (MAAC),10,2-8,96,136,232,0.414,04/05/2023,2023.0
66,Syracuse (ACC),11,6-5,129,183,312,0.413,04/05/2023,2023.0
67,Holy Cross (Patriot),10,0-10,111,158,269,0.413,04/05/2023,2023.0
68,Air Force (ASUN),11,7-4,111,169,280,0.396,04/05/2023,2023.0
69,Providence (Big East),10,5-5,112,178,290,0.386,04/05/2023,2023.0
70,UMass Lowell (America East),8,0-8,82,138,220,0.373,04/05/2023,2023.0
71,Detroit Mercy (ASUN),8,1-7,73,137,210,0.348,04/05/2023,2023.0
72,St. John's (NY) (Big East),10,0-10,72,197,269,0.268,04/05/2023,2023.0
-,Hartford (DI Independent),5,5-0,86,28,114,0.754,04/05/2023,2023.0
-,Lindenwood (ASUN),7,2-5,81,97,178,0.455,04/05/2023,2023.0
-,Queens (NC) (ASUN),9,2-7,96,145,241,0.398,04/05/2023,2023.0
-,Merrimack (America East),9,4-5,87,141,228,0.382,04/05/2023,2023.0
1,Saint Joseph's (Atlantic 10),10,6-4,186,104,290,0.641,04/04/2023,2023.0
2,Army West Point (Patriot),9,8-1,140,81,221,0.633,04/04/2023,2023.0
3,Lehigh (Patriot),9,6-3,163,101,264,0.617,04/04/2023,2023.0
4,Denver (Big East),8,4-4,119,76,195,0.610,04/04/2023,2023.0
5,Dartmouth (Ivy League),8,6-2,144,93,237,0.608,04/04/2023,2023.0
6,Maryland (Big Ten),9,6-3,147,96,243,0.605,04/04/2023,2023.0
7,Duke (ACC),11,10-1,191,125,316,0.604,04/04/2023,2023.0
8,Michigan (Big Ten),9,5-4,159,106,265,0.600,04/04/2023,2023.0
9,Vermont (America East),9,5-4,139,93,232,0.599,04/04/2023,2023.0
10,Bryant (America East),9,7-2,160,111,271,0.590,04/04/2023,2023.0
11,Binghamton (America East),9,7-2,153,107,260,0.588,04/04/2023,2023.0
12,Mount St. Mary's (MAAC),11,5-6,163,116,279,0.584,04/04/2023,2023.0
13,Hofstra (CAA),10,3-7,146,105,251,0.582,04/04/2023,2023.0
14,Mercer (ASUN),11,4-7,170,124,294,0.578,04/04/2023,2023.0
15,Rutgers (Big Ten),10,7-3,152,114,266,0.571,04/04/2023,2023.0
16,Brown (Ivy League),9,4-5,149,113,262,0.569,04/04/2023,2023.0
17,Virginia (ACC),9,7-2,173,133,306,0.565,04/04/2023,2023.0
18,Towson (CAA),9,2-7,132,105,237,0.557,04/04/2023,2023.0
19,High Point (Atlantic 10),11,6-5,188,150,338,0.556,04/04/2023,2023.0
20,Navy (Patriot),11,5-6,152,123,275,0.553,04/04/2023,2023.0
21,Quinnipiac (MAAC),9,4-5,138,114,252,0.548,04/04/2023,2023.0
22,Massachusetts (Atlantic 10),9,6-3,102,86,188,0.543,04/04/2023,2023.0
23,Marquette (Big East),9,5-4,130,110,240,0.542,04/04/2023,2023.0
24,Villanova (Big East),10,8-2,144,122,266,0.541,04/04/2023,2023.0
25,Drexel (CAA),9,6-3,129,114,243,0.531,04/04/2023,2023.0
26,Monmouth (CAA),10,4-6,124,110,234,0.530,04/04/2023,2023.0
27,Richmond (Atlantic 10),9,5-4,119,108,227,0.524,04/04/2023,2023.0
28,Ohio St. (Big Ten),10,5-5,141,129,270,0.522,04/04/2023,2023.0
29,Hobart (Atlantic 10),9,5-4,148,136,284,0.521,04/04/2023,2023.0
30,Georgetown (Big East),8,5-3,118,109,227,0.520,04/04/2023,2023.0
31,Boston U. (Patriot),10,7-3,145,138,283,0.512,04/04/2023,2023.0
32,Colgate (Patriot),7,1-6,90,86,176,0.511,04/04/2023,2023.0
33,Manhattan (MAAC),10,7-3,108,104,212,0.509,04/04/2023,2023.0
34,Delaware (CAA),10,7-3,135,131,266,0.508,04/04/2023,2023.0
35,Cleveland St. (ASUN),8,3-5,111,109,220,0.505,04/04/2023,2023.0
36,Cornell (Ivy League),8,7-1,115,114,229,0.502,04/04/2023,2023.0
37,St. Bonaventure (Atlantic 10),10,1-9,127,126,253,0.502,04/04/2023,2023.0
38,Utah (ASUN),9,5-4,139,139,278,0.500,04/04/2023,2023.0
39,Robert Morris (ASUN),9,4-5,110,111,221,0.498,04/04/2023,2023.0
40,Yale (Ivy League),8,4-4,124,126,250,0.496,04/04/2023,2023.0
41,Stony Brook (CAA),10,6-4,137,143,280,0.489,04/04/2023,2023.0
42,Penn St. (Big Ten),9,6-3,125,131,256,0.488,04/04/2023,2023.0
43,Canisius (MAAC),11,2-9,149,158,307,0.485,04/04/2023,2023.0
44,NJIT (America East),9,2-7,116,125,241,0.481,04/04/2023,2023.0
45,Johns Hopkins (Big Ten),12,9-3,156,169,325,0.480,04/04/2023,2023.0
46,Bellarmine (ASUN),10,7-3,133,145,278,0.478,04/04/2023,2023.0
47,VMI (MAAC),11,5-6,143,157,300,0.477,04/04/2023,2023.0
48,UAlbany (America East),8,3-5,90,99,189,0.476,04/04/2023,2023.0
49,Marist (MAAC),10,4-6,131,147,278,0.471,04/04/2023,2023.0
50,Notre Dame (ACC),8,7-1,112,126,238,0.471,04/04/2023,2023.0
51,Jacksonville (ASUN),10,8-2,133,150,283,0.470,04/04/2023,2023.0
52,Princeton (Ivy League),8,4-4,104,121,225,0.462,04/04/2023,2023.0
53,Sacred Heart (MAAC),10,2-8,115,135,250,0.460,04/04/2023,2023.0
54,Hampton (CAA),10,2-8,118,139,257,0.459,04/04/2023,2023.0
55,North Carolina (ACC),10,7-3,129,153,282,0.457,04/04/2023,2023.0
56,LIU (MAAC),10,4-6,113,135,248,0.456,04/04/2023,2023.0
57,Fairfield (CAA),10,3-7,123,147,270,0.456,04/04/2023,2023.0
58,Harvard (Ivy League),8,4-4,111,133,244,0.455,04/04/2023,2023.0
59,UMBC (America East),9,6-3,96,117,213,0.451,04/04/2023,2023.0
60,Siena (MAAC),9,5-4,102,132,234,0.436,04/04/2023,2023.0
61,Loyola Maryland (Patriot),9,6-3,97,131,228,0.425,04/04/2023,2023.0
62,Bucknell (Patriot),9,2-7,102,138,240,0.425,04/04/2023,2023.0
63,Lafayette (Patriot),11,4-7,126,173,299,0.421,04/04/2023,2023.0
64,Penn (Ivy League),8,4-4,91,126,217,0.419,04/04/2023,2023.0
65,Wagner (MAAC),10,2-8,96,136,232,0.414,04/04/2023,2023.0
66,Syracuse (ACC),11,6-5,129,183,312,0.413,04/04/2023,2023.0
67,Holy Cross (Patriot),10,0-10,111,158,269,0.413,04/04/2023,2023.0
68,Air Force (ASUN),11,7-4,111,169,280,0.396,04/04/2023,2023.0
69,Providence (Big East),10,5-5,112,178,290,0.386,04/04/2023,2023.0
70,UMass Lowell (America East),8,0-8,82,138,220,0.373,04/04/2023,2023.0
71,Detroit Mercy (ASUN),8,1-7,73,137,210,0.348,04/04/2023,2023.0
72,St. John's (NY) (Big East),10,0-10,72,197,269,0.268,04/04/2023,2023.0
-,Hartford (DI Independent),4,4-0,62,24,86,0.721,04/04/2023,2023.0
-,Lindenwood (ASUN),7,2-5,81,97,178,0.455,04/04/2023,2023.0
-,Queens (NC) (ASUN),9,2-7,96,145,241,0.398,04/04/2023,2023.0
-,Merrimack (America East),9,4-5,87,141,228,0.382,04/04/2023,2023.0
1,Saint Joseph's (Atlantic 10),9,5-4,176,95,271,0.649,04/02/2023,2023.0
2,Army West Point (Patriot),9,8-1,140,81,221,0.633,04/02/2023,2023.0
3,Lehigh (Patriot),9,6-3,163,101,264,0.617,04/02/2023,2023.0
4,Denver (Big East),8,4-4,119,76,195,0.610,04/02/2023,2023.0
5,Dartmouth (Ivy League),8,6-2,144,93,237,0.608,04/02/2023,2023.0
6,Maryland (Big Ten),9,6-3,147,96,243,0.605,04/02/2023,2023.0
7,Duke (ACC),11,10-1,191,125,316,0.604,04/02/2023,2023.0
8,Michigan (Big Ten),9,5-4,159,106,265,0.600,04/02/2023,2023.0
9,Vermont (America East),9,5-4,139,93,232,0.599,04/02/2023,2023.0
10,Bryant (America East),9,7-2,160,111,271,0.590,04/02/2023,2023.0
11,Binghamton (America East),9,7-2,153,107,260,0.588,04/02/2023,2023.0
12,Mount St. Mary's (MAAC),11,5-6,163,116,279,0.584,04/02/2023,2023.0
13,Hofstra (CAA),10,3-7,146,105,251,0.582,04/02/2023,2023.0
14,Mercer (ASUN),11,4-7,170,124,294,0.578,04/02/2023,2023.0
15,Rutgers (Big Ten),10,7-3,152,114,266,0.571,04/02/2023,2023.0
16,Brown (Ivy League),9,4-5,149,113,262,0.569,04/02/2023,2023.0
17,Virginia (ACC),9,7-2,173,133,306,0.565,04/02/2023,2023.0
18,Towson (CAA),9,2-7,132,105,237,0.557,04/02/2023,2023.0
19,High Point (Atlantic 10),11,6-5,188,150,338,0.556,04/02/2023,2023.0
20,Navy (Patriot),11,5-6,152,123,275,0.553,04/02/2023,2023.0
21,Quinnipiac (MAAC),9,4-5,138,114,252,0.548,04/02/2023,2023.0
22,Massachusetts (Atlantic 10),9,6-3,102,86,188,0.543,04/02/2023,2023.0
23,Marquette (Big East),9,5-4,130,110,240,0.542,04/02/2023,2023.0
24,Villanova (Big East),10,8-2,144,122,266,0.541,04/02/2023,2023.0
25,Boston U. (Patriot),9,7-2,135,116,251,0.538,04/02/2023,2023.0
26,Monmouth (CAA),9,4-5,115,100,215,0.535,04/02/2023,2023.0
27,Drexel (CAA),9,6-3,129,114,243,0.531,04/02/2023,2023.0
28,Richmond (Atlantic 10),9,5-4,119,108,227,0.524,04/02/2023,2023.0
29,Ohio St. (Big Ten),10,5-5,141,129,270,0.522,04/02/2023,2023.0
30,Hobart (Atlantic 10),9,5-4,148,136,284,0.521,04/02/2023,2023.0
31,Georgetown (Big East),8,5-3,118,109,227,0.520,04/02/2023,2023.0
32,Colgate (Patriot),7,1-6,91,85,176,0.517,04/02/2023,2023.0
33,Manhattan (MAAC),10,7-3,108,104,212,0.509,04/02/2023,2023.0
34,Delaware (CAA),10,7-3,135,131,266,0.508,04/02/2023,2023.0
35,Cleveland St. (ASUN),8,3-5,111,109,220,0.505,04/02/2023,2023.0
36,Cornell (Ivy League),8,7-1,115,114,229,0.502,04/02/2023,2023.0
37,St. Bonaventure (Atlantic 10),10,1-9,127,126,253,0.502,04/02/2023,2023.0
38,Utah (ASUN),9,5-4,139,139,278,0.500,04/02/2023,2023.0
39,Robert Morris (ASUN),9,4-5,110,111,221,0.498,04/02/2023,2023.0
40,Stony Brook (CAA),10,6-4,137,143,280,0.489,04/02/2023,2023.0
41,Penn St. (Big Ten),9,6-3,125,131,256,0.488,04/02/2023,2023.0
42,Canisius (MAAC),11,2-9,149,158,307,0.485,04/02/2023,2023.0
43,NJIT (America East),9,2-7,116,125,241,0.481,04/02/2023,2023.0
44,Johns Hopkins (Big Ten),12,9-3,156,169,325,0.480,04/02/2023,2023.0
45,Bellarmine (ASUN),10,7-3,133,145,278,0.478,04/02/2023,2023.0
46,VMI (MAAC),11,5-6,143,157,300,0.477,04/02/2023,2023.0
47,UAlbany (America East),8,3-5,90,99,189,0.476,04/02/2023,2023.0
48,Marist (MAAC),10,4-6,131,147,278,0.471,04/02/2023,2023.0
49,Notre Dame (ACC),8,7-1,112,126,238,0.471,04/02/2023,2023.0
50,Jacksonville (ASUN),10,8-2,133,150,283,0.470,04/02/2023,2023.0
51,Yale (Ivy League),7,3-4,102,116,218,0.468,04/02/2023,2023.0
52,Princeton (Ivy League),8,4-4,104,121,225,0.462,04/02/2023,2023.0
53,Sacred Heart (MAAC),10,2-8,115,135,250,0.460,04/02/2023,2023.0
54,Hampton (CAA),10,2-8,118,139,257,0.459,04/02/2023,2023.0
55,North Carolina (ACC),10,7-3,129,153,282,0.457,04/02/2023,2023.0
56,LIU (MAAC),10,4-6,113,135,248,0.456,04/02/2023,2023.0
57,Fairfield (CAA),10,3-7,123,147,270,0.456,04/02/2023,2023.0
58,Harvard (Ivy League),8,4-4,110,134,244,0.451,04/02/2023,2023.0
59,UMBC (America East),9,6-3,96,117,213,0.451,04/02/2023,2023.0
60,Siena (MAAC),9,5-4,102,132,234,0.436,04/02/2023,2023.0
61,Loyola Maryland (Patriot),9,6-3,97,131,228,0.425,04/02/2023,2023.0
62,Bucknell (Patriot),9,2-7,102,138,240,0.425,04/02/2023,2023.0
63,Lafayette (Patriot),11,4-7,126,173,299,0.421,04/02/2023,2023.0
64,Penn (Ivy League),8,4-4,91,126,217,0.419,04/02/2023,2023.0
65,Wagner (MAAC),10,2-8,96,136,232,0.414,04/02/2023,2023.0
66,Syracuse (ACC),11,6-5,129,183,312,0.413,04/02/2023,2023.0
67,Holy Cross (Patriot),10,0-10,111,158,269,0.413,04/02/2023,2023.0
68,Air Force (ASUN),11,7-4,111,169,280,0.396,04/02/2023,2023.0
69,Providence (Big East),10,5-5,112,178,290,0.386,04/02/2023,2023.0
70,UMass Lowell (America East),8,0-8,82,138,220,0.373,04/02/2023,2023.0
71,Detroit Mercy (ASUN),8,1-7,73,137,210,0.348,04/02/2023,2023.0
72,St. John's (NY) (Big East),10,0-10,72,197,269,0.268,04/02/2023,2023.0
-,Hartford (DI Independent),4,4-0,62,24,86,0.721,04/02/2023,2023.0
-,Lindenwood (ASUN),7,2-5,81,97,178,0.455,04/02/2023,2023.0
-,Queens (NC) (ASUN),9,2-7,96,145,241,0.398,04/02/2023,2023.0
-,Merrimack (America East),9,4-5,87,141,228,0.382,04/02/2023,2023.0
1,Saint Joseph's (Atlantic 10),8,4-4,158,82,240,0.658,03/29/2023,2023.0
2,Denver (Big East),7,4-3,112,60,172,0.651,03/29/2023,2023.0
3,Dartmouth (Ivy League),7,6-1,128,72,200,0.640,03/29/2023,2023.0
4,Maryland (Big Ten),8,6-2,134,79,213,0.629,03/29/2023,2023.0
5,Duke (ACC),10,9-1,177,105,282,0.628,03/29/2023,2023.0
6,Army West Point (Patriot),8,7-1,122,76,198,0.616,03/29/2023,2023.0
7,Michigan (Big Ten),8,4-4,142,93,235,0.604,03/29/2023,2023.0
8,Lehigh (Patriot),8,5-3,142,94,236,0.602,03/29/2023,2023.0
9,Hofstra (CAA),9,2-7,136,93,229,0.594,03/29/2023,2023.0
10,Bryant (America East),8,6-2,143,101,244,0.586,03/29/2023,2023.0
11,Mercer (ASUN),10,3-7,159,114,273,0.582,03/29/2023,2023.0
12,Vermont (America East),8,4-4,120,87,207,0.580,03/29/2023,2023.0
13,Quinnipiac (MAAC),8,4-4,126,92,218,0.578,03/29/2023,2023.0
14,Mount St. Mary's (MAAC),10,4-6,141,104,245,0.576,03/29/2023,2023.0
15,Binghamton (America East),8,6-2,130,96,226,0.575,03/29/2023,2023.0
16,Rutgers (Big Ten),9,7-2,135,100,235,0.574,03/29/2023,2023.0
17,High Point (Atlantic 10),10,6-4,180,135,315,0.571,03/29/2023,2023.0
18,Virginia (ACC),8,7-1,153,119,272,0.563,03/29/2023,2023.0
19,Boston U. (Patriot),8,7-1,128,101,229,0.559,03/29/2023,2023.0
20,Brown (Ivy League),8,4-4,128,102,230,0.557,03/29/2023,2023.0
21,Marquette (Big East),8,5-3,112,94,206,0.544,03/29/2023,2023.0
22,Navy (Patriot),10,4-6,137,116,253,0.542,03/29/2023,2023.0
23,Richmond (Atlantic 10),8,5-3,106,90,196,0.541,03/29/2023,2023.0
24,Towson (CAA),8,2-6,112,96,208,0.538,03/29/2023,2023.0
25,Villanova (Big East),9,7-2,127,109,236,0.538,03/29/2023,2023.0
26,Monmouth (CAA),8,4-4,103,90,193,0.534,03/29/2023,2023.0
27,Ohio St. (Big Ten),9,5-4,128,113,241,0.531,03/29/2023,2023.0
28,Massachusetts (Atlantic 10),8,5-3,87,78,165,0.527,03/29/2023,2023.0
29,Cleveland St. (ASUN),7,3-4,102,94,196,0.520,03/29/2023,2023.0
30,Drexel (CAA),8,5-3,110,103,213,0.516,03/29/2023,2023.0
31,St. Bonaventure (Atlantic 10),9,1-8,111,104,215,0.516,03/29/2023,2023.0
32,Hobart (Atlantic 10),8,4-4,126,120,246,0.512,03/29/2023,2023.0
33,Stony Brook (CAA),9,5-4,128,123,251,0.510,03/29/2023,2023.0
34,Utah (ASUN),8,4-4,123,119,242,0.508,03/29/2023,2023.0
35,Colgate (Patriot),6,1-5,75,73,148,0.507,03/29/2023,2023.0
36,Delaware (CAA),9,6-3,122,121,243,0.502,03/29/2023,2023.0
37,Georgetown (Big East),7,4-3,102,102,204,0.500,03/29/2023,2023.0
37,Robert Morris (ASUN),8,4-4,100,100,200,0.500,03/29/2023,2023.0
39,NJIT (America East),8,2-6,106,108,214,0.495,03/29/2023,2023.0
40,Marist (MAAC),9,3-6,127,131,258,0.492,03/29/2023,2023.0
41,Cornell (Ivy League),7,6-1,94,98,192,0.490,03/29/2023,2023.0
42,Johns Hopkins (Big Ten),11,8-3,142,152,294,0.483,03/29/2023,2023.0
43,VMI (MAAC),10,4-6,133,143,276,0.482,03/29/2023,2023.0
44,Princeton (Ivy League),7,3-4,93,100,193,0.482,03/29/2023,2023.0
45,Penn St. (Big Ten),8,5-3,109,118,227,0.480,03/29/2023,2023.0
46,UAlbany (America East),7,2-5,81,88,169,0.479,03/29/2023,2023.0
47,Manhattan (MAAC),9,7-2,92,100,192,0.479,03/29/2023,2023.0
48,Canisius (MAAC),10,2-8,135,148,283,0.477,03/29/2023,2023.0
49,Yale (Ivy League),6,3-3,87,96,183,0.475,03/29/2023,2023.0
50,Bellarmine (ASUN),9,6-3,118,131,249,0.474,03/29/2023,2023.0
51,Sacred Heart (MAAC),9,1-8,108,120,228,0.474,03/29/2023,2023.0
52,Fairfield (CAA),9,3-6,112,128,240,0.467,03/29/2023,2023.0
53,Hampton (CAA),9,2-7,108,126,234,0.462,03/29/2023,2023.0
54,Jacksonville (ASUN),9,8-1,113,134,247,0.457,03/29/2023,2023.0
55,North Carolina (ACC),10,7-3,129,153,282,0.457,03/29/2023,2023.0
56,Harvard (Ivy League),7,3-4,98,118,216,0.454,03/29/2023,2023.0
57,Bucknell (Patriot),8,2-6,97,120,217,0.447,03/29/2023,2023.0
58,Notre Dame (ACC),7,6-1,89,113,202,0.441,03/29/2023,2023.0
59,UMBC (America East),8,6-2,85,108,193,0.440,03/29/2023,2023.0
60,Lafayette (Patriot),10,4-6,119,152,271,0.439,03/29/2023,2023.0
61,Siena (MAAC),8,4-4,92,120,212,0.434,03/29/2023,2023.0
62,LIU (MAAC),9,4-5,98,128,226,0.434,03/29/2023,2023.0
63,Syracuse (ACC),10,6-4,116,160,276,0.420,03/29/2023,2023.0
64,Loyola Maryland (Patriot),8,5-3,83,118,201,0.413,03/29/2023,2023.0
65,Holy Cross (Patriot),9,0-9,98,144,242,0.405,03/29/2023,2023.0
66,Wagner (MAAC),9,2-7,84,126,210,0.400,03/29/2023,2023.0
67,Penn (Ivy League),7,3-4,71,111,182,0.390,03/29/2023,2023.0
68,UMass Lowell (America East),7,0-7,71,115,186,0.382,03/29/2023,2023.0
69,Air Force (ASUN),10,6-4,96,160,256,0.375,03/29/2023,2023.0
69,Providence (Big East),9,4-5,96,160,256,0.375,03/29/2023,2023.0
71,Detroit Mercy (ASUN),7,1-6,63,130,193,0.326,03/29/2023,2023.0
72,St. John's (NY) (Big East),9,0-9,59,180,239,0.247,03/29/2023,2023.0
-,Hartford (DI Independent),4,4-0,62,24,86,0.721,03/29/2023,2023.0
-,Lindenwood (ASUN),6,2-4,67,82,149,0.450,03/29/2023,2023.0
-,Merrimack (America East),8,4-4,81,122,203,0.399,03/29/2023,2023.0
-,Queens (NC) (ASUN),8,1-7,89,135,224,0.397,03/29/2023,2023.0
1,Saint Joseph's (Atlantic 10),8,4-4,158,82,240,0.658,03/26/2023,2023.0
2,Denver (Big East),7,4-3,112,60,172,0.651,03/26/2023,2023.0
3,Dartmouth (Ivy League),7,6-1,127,73,200,0.635,03/26/2023,2023.0
4,Maryland (Big Ten),8,6-2,134,79,213,0.629,03/26/2023,2023.0
5,Duke (ACC),10,9-1,177,105,282,0.628,03/26/2023,2023.0
6,Army West Point (Patriot),8,7-1,122,76,198,0.616,03/26/2023,2023.0
7,Michigan (Big Ten),8,4-4,142,93,235,0.604,03/26/2023,2023.0
8,Lehigh (Patriot),8,5-3,142,94,236,0.602,03/26/2023,2023.0
9,Hofstra (CAA),9,2-7,136,93,229,0.594,03/26/2023,2023.0
10,Bryant (America East),8,6-2,143,101,244,0.586,03/26/2023,2023.0
11,Quinnipiac (MAAC),7,4-3,115,83,198,0.581,03/26/2023,2023.0
12,Vermont (America East),8,4-4,120,87,207,0.580,03/26/2023,2023.0
13,Mercer (ASUN),9,2-7,140,103,243,0.576,03/26/2023,2023.0
14,Binghamton (America East),8,6-2,130,96,226,0.575,03/26/2023,2023.0
15,Rutgers (Big Ten),9,7-2,135,100,235,0.574,03/26/2023,2023.0
16,High Point (Atlantic 10),10,6-4,180,135,315,0.571,03/26/2023,2023.0
17,Virginia (ACC),8,7-1,153,119,272,0.563,03/26/2023,2023.0
18,Boston U. (Patriot),8,7-1,128,101,229,0.559,03/26/2023,2023.0
19,Villanova (Big East),8,7-1,116,93,209,0.555,03/26/2023,2023.0
20,Brown (Ivy League),7,3-4,112,91,203,0.552,03/26/2023,2023.0
21,Mount St. Mary's (MAAC),9,3-6,120,98,218,0.550,03/26/2023,2023.0
22,Marquette (Big East),8,5-3,112,94,206,0.544,03/26/2023,2023.0
23,Navy (Patriot),10,4-6,137,116,253,0.542,03/26/2023,2023.0
24,Towson (CAA),8,2-6,112,96,208,0.538,03/26/2023,2023.0
25,Monmouth (CAA),8,4-4,103,90,193,0.534,03/26/2023,2023.0
26,Ohio St. (Big Ten),9,5-4,128,113,241,0.531,03/26/2023,2023.0
27,Massachusetts (Atlantic 10),8,5-3,87,78,165,0.527,03/26/2023,2023.0
28,Cleveland St. (ASUN),6,3-3,88,79,167,0.527,03/26/2023,2023.0
29,Richmond (Atlantic 10),8,5-3,91,83,174,0.523,03/26/2023,2023.0
30,Drexel (CAA),8,5-3,110,103,213,0.516,03/26/2023,2023.0
31,St. Bonaventure (Atlantic 10),9,1-8,111,104,215,0.516,03/26/2023,2023.0
32,Hobart (Atlantic 10),8,4-4,126,120,246,0.512,03/26/2023,2023.0
33,VMI (MAAC),9,4-5,127,122,249,0.510,03/26/2023,2023.0
34,Stony Brook (CAA),9,5-4,128,123,251,0.510,03/26/2023,2023.0
35,Colgate (Patriot),6,1-5,75,73,148,0.507,03/26/2023,2023.0
36,Utah (ASUN),7,3-4,105,104,209,0.502,03/26/2023,2023.0
37,Delaware (CAA),9,6-3,122,121,243,0.502,03/26/2023,2023.0
38,Marist (MAAC),8,2-6,116,116,232,0.500,03/26/2023,2023.0
38,Georgetown (Big East),7,4-3,102,102,204,0.500,03/26/2023,2023.0
40,NJIT (America East),8,2-6,106,108,214,0.495,03/26/2023,2023.0
41,Cornell (Ivy League),7,6-1,94,98,192,0.490,03/26/2023,2023.0
42,Bellarmine (ASUN),8,6-2,107,112,219,0.489,03/26/2023,2023.0
43,Johns Hopkins (Big Ten),11,8-3,142,152,294,0.483,03/26/2023,2023.0
44,Robert Morris (ASUN),7,4-3,84,90,174,0.483,03/26/2023,2023.0
45,Manhattan (MAAC),8,6-2,83,89,172,0.483,03/26/2023,2023.0
46,Princeton (Ivy League),7,3-4,93,100,193,0.482,03/26/2023,2023.0
47,Penn St. (Big Ten),8,5-3,109,118,227,0.480,03/26/2023,2023.0
48,UAlbany (America East),7,2-5,81,88,169,0.479,03/26/2023,2023.0
49,Yale (Ivy League),6,3-3,87,96,183,0.475,03/26/2023,2023.0
50,Fairfield (CAA),9,3-6,112,128,240,0.467,03/26/2023,2023.0
51,Hampton (CAA),9,2-7,108,126,234,0.462,03/26/2023,2023.0
52,Sacred Heart (MAAC),8,1-7,93,109,202,0.460,03/26/2023,2023.0
53,Harvard (Ivy League),7,3-4,99,117,216,0.458,03/26/2023,2023.0
54,North Carolina (ACC),10,7-3,129,153,282,0.457,03/26/2023,2023.0
55,Siena (MAAC),7,3-4,86,103,189,0.455,03/26/2023,2023.0
56,Canisius (MAAC),9,2-7,118,142,260,0.454,03/26/2023,2023.0
57,Jacksonville (ASUN),8,7-1,98,120,218,0.450,03/26/2023,2023.0
58,Bucknell (Patriot),8,2-6,97,120,217,0.447,03/26/2023,2023.0
59,Notre Dame (ACC),7,6-1,89,113,202,0.441,03/26/2023,2023.0
60,UMBC (America East),8,6-2,85,108,193,0.440,03/26/2023,2023.0
61,Lafayette (Patriot),10,4-6,119,152,271,0.439,03/26/2023,2023.0
62,LIU (MAAC),8,3-5,87,117,204,0.426,03/26/2023,2023.0
63,Syracuse (ACC),10,6-4,116,160,276,0.420,03/26/2023,2023.0
64,Loyola Maryland (Patriot),8,5-3,83,118,201,0.413,03/26/2023,2023.0
65,Holy Cross (Patriot),9,0-9,98,144,242,0.405,03/26/2023,2023.0
66,Penn (Ivy League),7,3-4,71,111,182,0.390,03/26/2023,2023.0
67,Wagner (MAAC),8,2-6,73,115,188,0.388,03/26/2023,2023.0
68,UMass Lowell (America East),7,0-7,71,115,186,0.382,03/26/2023,2023.0
69,Providence (Big East),9,4-5,96,160,256,0.375,03/26/2023,2023.0
70,Air Force (ASUN),9,6-3,81,142,223,0.363,03/26/2023,2023.0
71,Detroit Mercy (ASUN),6,0-6,53,114,167,0.317,03/26/2023,2023.0
72,St. John's (NY) (Big East),9,0-9,52,165,217,0.240,03/26/2023,2023.0
-,Hartford (DI Independent),3,3-0,50,15,65,0.769,03/26/2023,2023.0
-,Lindenwood (ASUN),5,1-4,53,72,125,0.424,03/26/2023,2023.0
-,Merrimack (America East),8,4-4,81,122,203,0.399,03/26/2023,2023.0
-,Queens (NC) (ASUN),7,1-6,79,121,200,0.395,03/26/2023,2023.0
1,Saint Joseph's (Atlantic 10),7,4-3,148,67,215,0.688,03/22/2023,2023.0
2,Dartmouth (Ivy League),6,5-1,117,60,177,0.661,03/22/2023,2023.0
3,Denver (Big East),7,4-3,112,60,172,0.651,03/22/2023,2023.0
4,Duke (ACC),9,8-1,162,95,257,0.630,03/22/2023,2023.0
5,Maryland (Big Ten),7,5-2,115,71,186,0.618,03/22/2023,2023.0
6,Army West Point (Patriot),7,6-1,110,70,180,0.611,03/22/2023,2023.0
7,Lehigh (Patriot),7,5-2,122,78,200,0.610,03/22/2023,2023.0
8,Michigan (Big Ten),7,4-3,123,82,205,0.600,03/22/2023,2023.0
8,Quinnipiac (MAAC),6,3-3,102,68,170,0.600,03/22/2023,2023.0
10,Binghamton (America East),7,5-2,113,76,189,0.598,03/22/2023,2023.0
11,Hofstra (CAA),8,2-6,119,84,203,0.586,03/22/2023,2023.0
12,Brown (Ivy League),6,3-3,104,76,180,0.578,03/22/2023,2023.0
13,High Point (Atlantic 10),10,6-4,180,135,315,0.571,03/22/2023,2023.0
13,Boston U. (Patriot),7,6-1,116,87,203,0.571,03/22/2023,2023.0
15,Mercer (ASUN),8,2-6,118,90,208,0.567,03/22/2023,2023.0
16,Rutgers (Big Ten),8,7-1,121,93,214,0.565,03/22/2023,2023.0
17,Bryant (America East),7,5-2,121,95,216,0.560,03/22/2023,2023.0
18,Virginia (ACC),7,6-1,136,107,243,0.560,03/22/2023,2023.0
19,Villanova (Big East),8,7-1,116,93,209,0.555,03/22/2023,2023.0
20,Vermont (America East),7,3-4,101,81,182,0.555,03/22/2023,2023.0
21,Cleveland St. (ASUN),5,3-2,81,66,147,0.551,03/22/2023,2023.0
22,Ohio St. (Big Ten),8,4-4,121,99,220,0.550,03/22/2023,2023.0
23,Mount St. Mary's (MAAC),8,2-6,108,89,197,0.548,03/22/2023,2023.0
24,Marquette (Big East),7,4-3,103,85,188,0.548,03/22/2023,2023.0
25,Navy (Patriot),9,3-6,123,105,228,0.539,03/22/2023,2023.0
26,Stony Brook (CAA),8,4-4,117,102,219,0.534,03/22/2023,2023.0
27,Towson (CAA),7,1-6,98,88,186,0.527,03/22/2023,2023.0
28,Richmond (Atlantic 10),7,4-3,91,83,174,0.523,03/22/2023,2023.0
29,VMI (MAAC),8,4-4,118,108,226,0.522,03/22/2023,2023.0
30,UAlbany (America East),6,2-4,75,69,144,0.521,03/22/2023,2023.0
31,Delaware (CAA),8,5-3,113,104,217,0.521,03/22/2023,2023.0
32,St. Bonaventure (Atlantic 10),8,1-7,102,95,197,0.518,03/22/2023,2023.0
33,Georgetown (Big East),6,3-3,86,82,168,0.512,03/22/2023,2023.0
34,Drexel (CAA),7,4-3,96,92,188,0.511,03/22/2023,2023.0
35,Massachusetts (Atlantic 10),7,4-3,72,70,142,0.507,03/22/2023,2023.0
36,Hobart (Atlantic 10),7,4-3,111,108,219,0.507,03/22/2023,2023.0
37,Monmouth (CAA),7,4-3,82,80,162,0.506,03/22/2023,2023.0
38,Penn St. (Big Ten),7,5-2,101,99,200,0.505,03/22/2023,2023.0
39,Johns Hopkins (Big Ten),10,7-3,131,133,264,0.496,03/22/2023,2023.0
40,Marist (MAAC),7,2-5,101,103,204,0.495,03/22/2023,2023.0
41,NJIT (America East),7,2-5,86,91,177,0.486,03/22/2023,2023.0
42,Colgate (Patriot),5,1-4,58,62,120,0.483,03/22/2023,2023.0
43,Princeton (Ivy League),6,2-4,75,82,157,0.478,03/22/2023,2023.0
44,Fairfield (CAA),8,3-5,104,114,218,0.477,03/22/2023,2023.0
45,Manhattan (MAAC),7,5-2,69,77,146,0.473,03/22/2023,2023.0
46,Yale (Ivy League),5,3-2,69,78,147,0.469,03/22/2023,2023.0
47,Hampton (CAA),8,2-6,97,111,208,0.466,03/22/2023,2023.0
48,Jacksonville (ASUN),7,6-1,85,98,183,0.464,03/22/2023,2023.0
49,Robert Morris (ASUN),6,3-3,71,83,154,0.461,03/22/2023,2023.0
50,Siena (MAAC),6,3-3,75,88,163,0.460,03/22/2023,2023.0
51,North Carolina (ACC),9,6-3,113,133,246,0.459,03/22/2023,2023.0
52,Utah (ASUN),6,2-4,78,93,171,0.456,03/22/2023,2023.0
53,Bucknell (Patriot),7,1-6,86,103,189,0.455,03/22/2023,2023.0
54,Bellarmine (ASUN),7,5-2,82,99,181,0.453,03/22/2023,2023.0
55,Canisius (MAAC),8,2-6,106,128,234,0.453,03/22/2023,2023.0
56,Harvard (Ivy League),6,3-3,87,106,193,0.451,03/22/2023,2023.0
57,Notre Dame (ACC),6,6-0,77,96,173,0.445,03/22/2023,2023.0
58,Cornell (Ivy League),6,5-1,70,88,158,0.443,03/22/2023,2023.0
59,Sacred Heart (MAAC),7,0-7,79,100,179,0.441,03/22/2023,2023.0
60,Lafayette (Patriot),9,4-5,104,141,245,0.424,03/22/2023,2023.0
61,Loyola Maryland (Patriot),7,5-2,77,106,183,0.421,03/22/2023,2023.0
62,UMBC (America East),7,5-2,71,98,169,0.420,03/22/2023,2023.0
63,Syracuse (ACC),9,5-4,103,144,247,0.417,03/22/2023,2023.0
64,Penn (Ivy League),6,3-3,61,87,148,0.412,03/22/2023,2023.0
65,UMass Lowell (America East),6,0-6,65,93,158,0.411,03/22/2023,2023.0
66,LIU (MAAC),7,2-5,72,106,178,0.404,03/22/2023,2023.0
67,Holy Cross (Patriot),8,0-8,87,130,217,0.401,03/22/2023,2023.0
68,Wagner (MAAC),7,2-5,64,103,167,0.383,03/22/2023,2023.0
69,Providence (Big East),8,4-4,77,145,222,0.347,03/22/2023,2023.0
70,Air Force (ASUN),8,5-3,68,130,198,0.343,03/22/2023,2023.0
71,Detroit Mercy (ASUN),5,0-5,42,87,129,0.326,03/22/2023,2023.0
72,St. John's (NY) (Big East),8,0-8,52,165,217,0.240,03/22/2023,2023.0
-,Hartford (DI Independent),2,2-0,35,9,44,0.795,03/22/2023,2023.0
-,Lindenwood (ASUN),4,1-3,41,59,100,0.410,03/22/2023,2023.0
-,Queens (NC) (ASUN),6,1-5,66,96,162,0.407,03/22/2023,2023.0
-,Merrimack (America East),7,4-3,71,108,179,0.397,03/22/2023,2023.0
1,Saint Joseph's (Atlantic 10),7,4-3,148,67,215,0.688,03/21/2023,2023.0
2,Dartmouth (Ivy League),6,5-1,117,60,177,0.661,03/21/2023,2023.0
3,Denver (Big East),7,4-3,112,60,172,0.651,03/21/2023,2023.0
4,Duke (ACC),9,8-1,162,95,257,0.630,03/21/2023,2023.0
5,Maryland (Big Ten),7,5-2,115,71,186,0.618,03/21/2023,2023.0
6,Army West Point (Patriot),7,6-1,110,70,180,0.611,03/21/2023,2023.0
7,Lehigh (Patriot),7,5-2,122,78,200,0.610,03/21/2023,2023.0
8,Michigan (Big Ten),7,4-3,123,82,205,0.600,03/21/2023,2023.0
8,Quinnipiac (MAAC),6,3-3,102,68,170,0.600,03/21/2023,2023.0
10,Binghamton (America East),7,5-2,113,76,189,0.598,03/21/2023,2023.0
11,Hofstra (CAA),8,2-6,119,84,203,0.586,03/21/2023,2023.0
12,Brown (Ivy League),6,3-3,104,76,180,0.578,03/21/2023,2023.0
13,High Point (Atlantic 10),9,6-3,165,121,286,0.577,03/21/2023,2023.0
14,Boston U. (Patriot),7,6-1,116,87,203,0.571,03/21/2023,2023.0
15,Mercer (ASUN),8,2-6,118,90,208,0.567,03/21/2023,2023.0
16,Rutgers (Big Ten),8,7-1,121,93,214,0.565,03/21/2023,2023.0
17,Bryant (America East),7,5-2,121,95,216,0.560,03/21/2023,2023.0
18,Virginia (ACC),7,6-1,136,107,243,0.560,03/21/2023,2023.0
19,Villanova (Big East),8,7-1,116,93,209,0.555,03/21/2023,2023.0
20,Vermont (America East),7,3-4,101,81,182,0.555,03/21/2023,2023.0
21,Cleveland St. (ASUN),5,3-2,81,66,147,0.551,03/21/2023,2023.0
22,Ohio St. (Big Ten),8,4-4,121,99,220,0.550,03/21/2023,2023.0
23,Mount St. Mary's (MAAC),8,2-6,108,89,197,0.548,03/21/2023,2023.0
24,Marquette (Big East),7,4-3,103,85,188,0.548,03/21/2023,2023.0
25,Navy (Patriot),9,3-6,123,105,228,0.539,03/21/2023,2023.0
26,Stony Brook (CAA),8,4-4,117,102,219,0.534,03/21/2023,2023.0
27,Towson (CAA),7,1-6,98,88,186,0.527,03/21/2023,2023.0
28,Richmond (Atlantic 10),7,4-3,91,83,174,0.523,03/21/2023,2023.0
29,VMI (MAAC),8,4-4,118,108,226,0.522,03/21/2023,2023.0
30,UAlbany (America East),6,2-4,75,69,144,0.521,03/21/2023,2023.0
31,Delaware (CAA),8,5-3,113,104,217,0.521,03/21/2023,2023.0
32,St. Bonaventure (Atlantic 10),8,1-7,102,95,197,0.518,03/21/2023,2023.0
33,Georgetown (Big East),6,3-3,86,82,168,0.512,03/21/2023,2023.0
34,Drexel (CAA),7,4-3,96,92,188,0.511,03/21/2023,2023.0
35,Massachusetts (Atlantic 10),7,4-3,72,70,142,0.507,03/21/2023,2023.0
36,Hobart (Atlantic 10),7,4-3,111,108,219,0.507,03/21/2023,2023.0
37,Monmouth (CAA),7,4-3,82,80,162,0.506,03/21/2023,2023.0
38,Penn St. (Big Ten),7,5-2,101,99,200,0.505,03/21/2023,2023.0
39,Johns Hopkins (Big Ten),10,7-3,131,133,264,0.496,03/21/2023,2023.0
40,Marist (MAAC),7,2-5,101,103,204,0.495,03/21/2023,2023.0
41,NJIT (America East),7,2-5,86,91,177,0.486,03/21/2023,2023.0
42,Colgate (Patriot),5,1-4,58,62,120,0.483,03/21/2023,2023.0
43,Princeton (Ivy League),6,2-4,75,82,157,0.478,03/21/2023,2023.0
44,Fairfield (CAA),8,3-5,104,114,218,0.477,03/21/2023,2023.0
45,Manhattan (MAAC),7,5-2,69,77,146,0.473,03/21/2023,2023.0
46,Yale (Ivy League),5,3-2,69,78,147,0.469,03/21/2023,2023.0
47,Hampton (CAA),8,2-6,97,111,208,0.466,03/21/2023,2023.0
48,Jacksonville (ASUN),7,6-1,85,98,183,0.464,03/21/2023,2023.0
49,Robert Morris (ASUN),6,3-3,71,83,154,0.461,03/21/2023,2023.0
50,Siena (MAAC),6,3-3,75,88,163,0.460,03/21/2023,2023.0
51,North Carolina (ACC),8,5-3,99,118,217,0.456,03/21/2023,2023.0
52,Utah (ASUN),6,2-4,78,93,171,0.456,03/21/2023,2023.0
53,Bucknell (Patriot),7,1-6,86,103,189,0.455,03/21/2023,2023.0
54,Bellarmine (ASUN),7,5-2,82,99,181,0.453,03/21/2023,2023.0
55,Canisius (MAAC),8,2-6,106,128,234,0.453,03/21/2023,2023.0
56,Harvard (Ivy League),6,3-3,87,106,193,0.451,03/21/2023,2023.0
57,Notre Dame (ACC),6,6-0,77,96,173,0.445,03/21/2023,2023.0
58,Cornell (Ivy League),6,5-1,70,88,158,0.443,03/21/2023,2023.0
59,Sacred Heart (MAAC),7,0-7,79,100,179,0.441,03/21/2023,2023.0
60,Lafayette (Patriot),9,4-5,104,141,245,0.424,03/21/2023,2023.0
61,Loyola Maryland (Patriot),7,5-2,77,106,183,0.421,03/21/2023,2023.0
62,UMBC (America East),7,5-2,71,98,169,0.420,03/21/2023,2023.0
63,Syracuse (ACC),9,5-4,103,144,247,0.417,03/21/2023,2023.0
64,Penn (Ivy League),6,3-3,61,87,148,0.412,03/21/2023,2023.0
65,UMass Lowell (America East),6,0-6,65,93,158,0.411,03/21/2023,2023.0
66,LIU (MAAC),7,2-5,72,106,178,0.404,03/21/2023,2023.0
67,Holy Cross (Patriot),8,0-8,87,130,217,0.401,03/21/2023,2023.0
68,Wagner (MAAC),7,2-5,64,103,167,0.383,03/21/2023,2023.0
69,Providence (Big East),8,4-4,77,145,222,0.347,03/21/2023,2023.0
70,Air Force (ASUN),8,5-3,68,130,198,0.343,03/21/2023,2023.0
71,Detroit Mercy (ASUN),5,0-5,42,87,129,0.326,03/21/2023,2023.0
72,St. John's (NY) (Big East),8,0-8,52,165,217,0.240,03/21/2023,2023.0
-,Hartford (DI Independent),2,2-0,35,9,44,0.795,03/21/2023,2023.0
-,Lindenwood (ASUN),4,1-3,41,59,100,0.410,03/21/2023,2023.0
-,Queens (NC) (ASUN),6,1-5,66,96,162,0.407,03/21/2023,2023.0
-,Merrimack (America East),7,4-3,71,108,179,0.397,03/21/2023,2023.0
1,Saint Joseph's (Atlantic 10),7,4-3,148,67,215,0.688,03/20/2023,2023.0
2,Dartmouth (Ivy League),5,4-1,101,48,149,0.678,03/20/2023,2023.0
3,Denver (Big East),7,4-3,112,60,172,0.651,03/20/2023,2023.0
4,Duke (ACC),9,8-1,162,95,257,0.630,03/20/2023,2023.0
5,Maryland (Big Ten),7,5-2,115,71,186,0.618,03/20/2023,2023.0
6,Army West Point (Patriot),7,6-1,110,70,180,0.611,03/20/2023,2023.0
7,Lehigh (Patriot),7,5-2,122,78,200,0.610,03/20/2023,2023.0
8,Michigan (Big Ten),7,4-3,123,82,205,0.600,03/20/2023,2023.0
8,Quinnipiac (MAAC),6,3-3,102,68,170,0.600,03/20/2023,2023.0
10,Binghamton (America East),7,5-2,113,76,189,0.598,03/20/2023,2023.0
11,Hofstra (CAA),8,2-6,119,84,203,0.586,03/20/2023,2023.0
12,Boston U. (Patriot),6,5-1,100,73,173,0.578,03/20/2023,2023.0
13,Brown (Ivy League),6,3-3,104,76,180,0.578,03/20/2023,2023.0
14,High Point (Atlantic 10),9,6-3,165,121,286,0.577,03/20/2023,2023.0
15,Mercer (ASUN),8,2-6,118,90,208,0.567,03/20/2023,2023.0
16,Rutgers (Big Ten),8,7-1,121,93,214,0.565,03/20/2023,2023.0
17,Bryant (America East),7,5-2,121,95,216,0.560,03/20/2023,2023.0
18,Virginia (ACC),7,6-1,136,107,243,0.560,03/20/2023,2023.0
19,Navy (Patriot),8,3-5,113,90,203,0.557,03/20/2023,2023.0
20,Vermont (America East),7,3-4,101,81,182,0.555,03/20/2023,2023.0
21,Cleveland St. (ASUN),5,3-2,81,66,147,0.551,03/20/2023,2023.0
22,Ohio St. (Big Ten),8,4-4,121,99,220,0.550,03/20/2023,2023.0
23,Villanova (Big East),7,6-1,101,83,184,0.549,03/20/2023,2023.0
24,Mount St. Mary's (MAAC),8,2-6,108,89,197,0.548,03/20/2023,2023.0
25,Marquette (Big East),7,4-3,103,85,188,0.548,03/20/2023,2023.0
26,Stony Brook (CAA),8,4-4,117,102,219,0.534,03/20/2023,2023.0
27,Towson (CAA),7,1-6,98,88,186,0.527,03/20/2023,2023.0
28,VMI (MAAC),8,4-4,118,107,225,0.524,03/20/2023,2023.0
29,Richmond (Atlantic 10),7,4-3,91,83,174,0.523,03/20/2023,2023.0
30,St. Bonaventure (Atlantic 10),7,1-6,87,80,167,0.521,03/20/2023,2023.0
31,UAlbany (America East),6,2-4,75,69,144,0.521,03/20/2023,2023.0
32,Delaware (CAA),8,5-3,113,104,217,0.521,03/20/2023,2023.0
33,Georgetown (Big East),6,3-3,86,82,168,0.512,03/20/2023,2023.0
34,Drexel (CAA),7,4-3,96,92,188,0.511,03/20/2023,2023.0
35,Massachusetts (Atlantic 10),7,4-3,72,70,142,0.507,03/20/2023,2023.0
36,Hobart (Atlantic 10),7,4-3,111,108,219,0.507,03/20/2023,2023.0
37,Monmouth (CAA),7,4-3,82,80,162,0.506,03/20/2023,2023.0
38,Penn St. (Big Ten),7,5-2,101,99,200,0.505,03/20/2023,2023.0
39,Johns Hopkins (Big Ten),10,7-3,131,133,264,0.496,03/20/2023,2023.0
40,Marist (MAAC),7,2-5,101,103,204,0.495,03/20/2023,2023.0
41,NJIT (America East),7,2-5,86,91,177,0.486,03/20/2023,2023.0
42,Colgate (Patriot),5,1-4,58,62,120,0.483,03/20/2023,2023.0
43,Princeton (Ivy League),6,2-4,75,82,157,0.478,03/20/2023,2023.0
44,Fairfield (CAA),8,3-5,104,114,218,0.477,03/20/2023,2023.0
45,Manhattan (MAAC),7,5-2,69,77,146,0.473,03/20/2023,2023.0
46,Hampton (CAA),7,2-5,85,95,180,0.472,03/20/2023,2023.0
47,Yale (Ivy League),5,3-2,69,78,147,0.469,03/20/2023,2023.0
48,Jacksonville (ASUN),7,6-1,85,98,183,0.464,03/20/2023,2023.0
49,Robert Morris (ASUN),6,3-3,71,83,154,0.461,03/20/2023,2023.0
50,Siena (MAAC),6,3-3,74,88,162,0.457,03/20/2023,2023.0
51,North Carolina (ACC),8,5-3,99,118,217,0.456,03/20/2023,2023.0
52,Utah (ASUN),6,2-4,78,93,171,0.456,03/20/2023,2023.0
53,Bucknell (Patriot),7,1-6,86,103,189,0.455,03/20/2023,2023.0
54,Bellarmine (ASUN),7,5-2,82,99,181,0.453,03/20/2023,2023.0
55,Canisius (MAAC),8,2-6,106,128,234,0.453,03/20/2023,2023.0
56,Harvard (Ivy League),5,3-2,73,90,163,0.448,03/20/2023,2023.0
57,Notre Dame (ACC),6,6-0,77,96,173,0.445,03/20/2023,2023.0
58,Cornell (Ivy League),6,5-1,70,88,158,0.443,03/20/2023,2023.0
59,Sacred Heart (MAAC),7,0-7,79,100,179,0.441,03/20/2023,2023.0
60,Lafayette (Patriot),9,4-5,104,141,245,0.424,03/20/2023,2023.0
61,Loyola Maryland (Patriot),7,5-2,77,106,183,0.421,03/20/2023,2023.0
62,UMBC (America East),7,5-2,71,98,169,0.420,03/20/2023,2023.0
63,Penn (Ivy League),6,3-3,61,87,148,0.412,03/20/2023,2023.0
64,UMass Lowell (America East),6,0-6,65,93,158,0.411,03/20/2023,2023.0
65,Syracuse (ACC),8,4-4,88,129,217,0.406,03/20/2023,2023.0
66,LIU (MAAC),7,2-5,72,106,178,0.404,03/20/2023,2023.0
67,Holy Cross (Patriot),8,0-8,87,130,217,0.401,03/20/2023,2023.0
68,Wagner (MAAC),7,2-5,64,103,167,0.383,03/20/2023,2023.0
69,Providence (Big East),8,4-4,77,145,222,0.347,03/20/2023,2023.0
70,Air Force (ASUN),8,5-3,68,130,198,0.343,03/20/2023,2023.0
71,Detroit Mercy (ASUN),5,0-5,42,87,129,0.326,03/20/2023,2023.0
72,St. John's (NY) (Big East),8,0-8,52,165,217,0.240,03/20/2023,2023.0
-,Hartford (DI Independent),2,2-0,35,9,44,0.795,03/20/2023,2023.0
-,Lindenwood (ASUN),4,1-3,41,59,100,0.410,03/20/2023,2023.0
-,Queens (NC) (ASUN),6,1-5,66,96,162,0.407,03/20/2023,2023.0
-,Merrimack (America East),7,4-3,71,108,179,0.397,03/20/2023,2023.0
1,Saint Joseph's (Atlantic 10),7,4-3,148,67,215,0.688,03/19/2023,2023.0
2,Dartmouth (Ivy League),5,4-1,101,48,149,0.678,03/19/2023,2023.0
3,Denver (Big East),7,4-3,112,60,172,0.651,03/19/2023,2023.0
4,Maryland (Big Ten),7,5-2,115,71,186,0.618,03/19/2023,2023.0
5,Duke (ACC),8,7-1,142,88,230,0.617,03/19/2023,2023.0
6,Army West Point (Patriot),7,6-1,110,70,180,0.611,03/19/2023,2023.0
7,Lehigh (Patriot),7,5-2,122,78,200,0.610,03/19/2023,2023.0
8,Michigan (Big Ten),7,4-3,123,82,205,0.600,03/19/2023,2023.0
8,Quinnipiac (MAAC),6,3-3,102,68,170,0.600,03/19/2023,2023.0
10,Binghamton (America East),7,5-2,113,76,189,0.598,03/19/2023,2023.0
11,Hofstra (CAA),8,2-6,119,84,203,0.586,03/19/2023,2023.0
12,Boston U. (Patriot),6,5-1,100,73,173,0.578,03/19/2023,2023.0
13,Brown (Ivy League),6,3-3,104,76,180,0.578,03/19/2023,2023.0
14,High Point (Atlantic 10),9,6-3,165,121,286,0.577,03/19/2023,2023.0
15,Mercer (ASUN),8,2-6,118,90,208,0.567,03/19/2023,2023.0
16,Rutgers (Big Ten),8,7-1,121,93,214,0.565,03/19/2023,2023.0
17,Bryant (America East),7,5-2,121,95,216,0.560,03/19/2023,2023.0
18,Virginia (ACC),7,6-1,136,107,243,0.560,03/19/2023,2023.0
19,Navy (Patriot),8,3-5,113,90,203,0.557,03/19/2023,2023.0
20,Vermont (America East),7,3-4,101,81,182,0.555,03/19/2023,2023.0
21,Cleveland St. (ASUN),5,3-2,81,66,147,0.551,03/19/2023,2023.0
22,Ohio St. (Big Ten),8,4-4,121,99,220,0.550,03/19/2023,2023.0
23,Villanova (Big East),7,6-1,101,83,184,0.549,03/19/2023,2023.0
24,Mount St. Mary's (MAAC),8,2-6,108,89,197,0.548,03/19/2023,2023.0
25,Marquette (Big East),7,4-3,103,85,188,0.548,03/19/2023,2023.0
26,Stony Brook (CAA),8,4-4,117,102,219,0.534,03/19/2023,2023.0
27,Towson (CAA),7,1-6,98,88,186,0.527,03/19/2023,2023.0
28,VMI (MAAC),8,4-4,118,107,225,0.524,03/19/2023,2023.0
29,Richmond (Atlantic 10),7,4-3,91,83,174,0.523,03/19/2023,2023.0
30,St. Bonaventure (Atlantic 10),7,1-6,87,80,167,0.521,03/19/2023,2023.0
31,UAlbany (America East),6,2-4,75,69,144,0.521,03/19/2023,2023.0
32,Delaware (CAA),8,5-3,113,104,217,0.521,03/19/2023,2023.0
33,Georgetown (Big East),6,3-3,86,82,168,0.512,03/19/2023,2023.0
34,Drexel (CAA),7,4-3,96,92,188,0.511,03/19/2023,2023.0
35,Massachusetts (Atlantic 10),7,4-3,72,70,142,0.507,03/19/2023,2023.0
36,Hobart (Atlantic 10),7,4-3,111,108,219,0.507,03/19/2023,2023.0
37,Monmouth (CAA),7,4-3,82,80,162,0.506,03/19/2023,2023.0
38,Penn St. (Big Ten),7,5-2,101,99,200,0.505,03/19/2023,2023.0
39,Johns Hopkins (Big Ten),10,7-3,131,133,264,0.496,03/19/2023,2023.0
40,Marist (MAAC),7,2-5,101,103,204,0.495,03/19/2023,2023.0
41,NJIT (America East),7,2-5,86,91,177,0.486,03/19/2023,2023.0
42,Colgate (Patriot),5,1-4,58,62,120,0.483,03/19/2023,2023.0
43,Princeton (Ivy League),6,2-4,75,82,157,0.478,03/19/2023,2023.0
44,Fairfield (CAA),8,3-5,104,114,218,0.477,03/19/2023,2023.0
45,Manhattan (MAAC),7,5-2,69,77,146,0.473,03/19/2023,2023.0
46,Hampton (CAA),7,2-5,85,95,180,0.472,03/19/2023,2023.0
47,Yale (Ivy League),5,3-2,69,78,147,0.469,03/19/2023,2023.0
48,Jacksonville (ASUN),7,6-1,85,98,183,0.464,03/19/2023,2023.0
49,Robert Morris (ASUN),6,3-3,71,83,154,0.461,03/19/2023,2023.0
50,Siena (MAAC),6,3-3,74,88,162,0.457,03/19/2023,2023.0
51,North Carolina (ACC),8,5-3,99,118,217,0.456,03/19/2023,2023.0
52,Utah (ASUN),6,2-4,78,93,171,0.456,03/19/2023,2023.0
53,Bucknell (Patriot),7,1-6,86,103,189,0.455,03/19/2023,2023.0
54,Bellarmine (ASUN),7,5-2,82,99,181,0.453,03/19/2023,2023.0
55,Canisius (MAAC),8,2-6,106,128,234,0.453,03/19/2023,2023.0
56,Harvard (Ivy League),5,3-2,73,90,163,0.448,03/19/2023,2023.0
57,Notre Dame (ACC),6,6-0,77,96,173,0.445,03/19/2023,2023.0
58,Cornell (Ivy League),6,5-1,70,88,158,0.443,03/19/2023,2023.0
59,Sacred Heart (MAAC),7,0-7,79,100,179,0.441,03/19/2023,2023.0
60,Lafayette (Patriot),9,4-5,104,141,245,0.424,03/19/2023,2023.0
61,Loyola Maryland (Patriot),7,5-2,77,106,183,0.421,03/19/2023,2023.0
62,UMBC (America East),7,5-2,71,98,169,0.420,03/19/2023,2023.0
63,Penn (Ivy League),6,3-3,61,87,148,0.412,03/19/2023,2023.0
64,UMass Lowell (America East),6,0-6,65,93,158,0.411,03/19/2023,2023.0
65,Syracuse (ACC),8,4-4,88,129,217,0.406,03/19/2023,2023.0
66,LIU (MAAC),7,2-5,72,106,178,0.404,03/19/2023,2023.0
67,Holy Cross (Patriot),8,0-8,87,130,217,0.401,03/19/2023,2023.0
68,Wagner (MAAC),7,2-5,64,103,167,0.383,03/19/2023,2023.0
69,Air Force (ASUN),7,5-2,61,110,171,0.357,03/19/2023,2023.0
70,Providence (Big East),8,4-4,77,145,222,0.347,03/19/2023,2023.0
71,Detroit Mercy (ASUN),5,0-5,42,87,129,0.326,03/19/2023,2023.0
72,St. John's (NY) (Big East),8,0-8,52,165,217,0.240,03/19/2023,2023.0
-,Hartford (DI Independent),2,2-0,35,9,44,0.795,03/19/2023,2023.0
-,Lindenwood (ASUN),4,1-3,41,59,100,0.410,03/19/2023,2023.0
-,Queens (NC) (ASUN),6,1-5,66,96,162,0.407,03/19/2023,2023.0
-,Merrimack (America East),7,4-3,71,108,179,0.397,03/19/2023,2023.0
1,Dartmouth (Ivy League),4,4-0,77,37,114,0.675,03/15/2023,2023.0
2,Saint Joseph's (Atlantic 10),6,3-3,124,61,185,0.670,03/15/2023,2023.0
3,Denver (Big East),6,3-3,92,47,139,0.662,03/15/2023,2023.0
4,Maryland (Big Ten),6,4-2,100,56,156,0.641,03/15/2023,2023.0
5,Army West Point (Patriot),6,5-1,101,57,158,0.639,03/15/2023,2023.0
6,Duke (ACC),7,6-1,125,79,204,0.613,03/15/2023,2023.0
7,Lehigh (Patriot),6,5-1,109,69,178,0.612,03/15/2023,2023.0
8,Binghamton (America East),6,4-2,99,65,164,0.604,03/15/2023,2023.0
9,Quinnipiac (MAAC),5,3-2,88,58,146,0.603,03/15/2023,2023.0
10,Hofstra (CAA),7,2-5,106,71,177,0.599,03/15/2023,2023.0
11,High Point (Atlantic 10),8,6-2,148,102,250,0.592,03/15/2023,2023.0
12,Michigan (Big Ten),6,4-2,102,73,175,0.583,03/15/2023,2023.0
13,Ohio St. (Big Ten),7,4-3,108,79,187,0.578,03/15/2023,2023.0
14,Rutgers (Big Ten),7,6-1,111,83,194,0.572,03/15/2023,2023.0
15,Virginia (ACC),6,6-0,121,92,213,0.568,03/15/2023,2023.0
16,Boston U. (Patriot),5,4-1,77,60,137,0.562,03/15/2023,2023.0
17,Brown (Ivy League),5,3-2,82,64,146,0.562,03/15/2023,2023.0
18,Delaware (CAA),7,5-2,106,85,191,0.555,03/15/2023,2023.0
19,Bryant (America East),6,4-2,100,83,183,0.546,03/15/2023,2023.0
20,Cleveland St. (ASUN),4,2-2,65,54,119,0.546,03/15/2023,2023.0
21,Villanova (Big East),6,5-1,90,75,165,0.545,03/15/2023,2023.0
22,Navy (Patriot),7,3-4,97,81,178,0.545,03/15/2023,2023.0
23,Stony Brook (CAA),7,3-4,105,89,194,0.541,03/15/2023,2023.0
24,Vermont (America East),6,2-4,83,71,154,0.539,03/15/2023,2023.0
25,Penn St. (Big Ten),6,5-1,93,80,173,0.538,03/15/2023,2023.0
26,Drexel (CAA),6,3-3,87,75,162,0.537,03/15/2023,2023.0
27,Mercer (ASUN),7,1-6,95,83,178,0.534,03/15/2023,2023.0
28,St. Bonaventure (Atlantic 10),7,1-6,88,79,167,0.527,03/15/2023,2023.0
29,Mount St. Mary's (MAAC),7,1-6,86,78,164,0.524,03/15/2023,2023.0
30,Hobart (Atlantic 10),6,3-3,99,90,189,0.524,03/15/2023,2023.0
31,Richmond (Atlantic 10),7,4-3,91,83,174,0.523,03/15/2023,2023.0
32,Marquette (Big East),6,3-3,84,77,161,0.522,03/15/2023,2023.0
33,Monmouth (CAA),6,4-2,74,69,143,0.517,03/15/2023,2023.0
34,NJIT (America East),6,2-4,76,73,149,0.510,03/15/2023,2023.0
35,Massachusetts (Atlantic 10),6,4-2,62,60,122,0.508,03/15/2023,2023.0
36,Georgetown (Big East),5,2-3,67,65,132,0.508,03/15/2023,2023.0
37,North Carolina (ACC),6,4-2,79,77,156,0.506,03/15/2023,2023.0
38,Towson (CAA),6,1-5,81,79,160,0.506,03/15/2023,2023.0
39,Marist (MAAC),6,2-4,84,83,167,0.503,03/15/2023,2023.0
40,VMI (MAAC),7,3-4,99,99,198,0.500,03/15/2023,2023.0
41,Princeton (Ivy League),5,2-3,67,69,136,0.493,03/15/2023,2023.0
42,Siena (MAAC),5,3-2,66,69,135,0.489,03/15/2023,2023.0
43,UAlbany (America East),5,1-4,58,61,119,0.487,03/15/2023,2023.0
44,Johns Hopkins (Big Ten),8,5-3,103,110,213,0.484,03/15/2023,2023.0
45,Manhattan (MAAC),6,4-2,60,66,126,0.476,03/15/2023,2023.0
46,Notre Dame (ACC),5,5-0,68,75,143,0.476,03/15/2023,2023.0
47,Bellarmine (ASUN),6,5-1,74,82,156,0.474,03/15/2023,2023.0
48,Fairfield (CAA),7,2-5,91,101,192,0.474,03/15/2023,2023.0
49,Harvard (Ivy League),4,2-2,61,68,129,0.473,03/15/2023,2023.0
50,Robert Morris (ASUN),5,3-2,62,71,133,0.466,03/15/2023,2023.0
51,Hampton (CAA),6,2-4,72,83,155,0.465,03/15/2023,2023.0
52,Yale (Ivy League),4,3-1,52,61,113,0.460,03/15/2023,2023.0
53,Jacksonville (ASUN),6,5-1,73,89,162,0.451,03/15/2023,2023.0
54,Colgate (Patriot),4,1-3,44,55,99,0.444,03/15/2023,2023.0
55,UMBC (America East),6,5-1,59,77,136,0.434,03/15/2023,2023.0
56,Lafayette (Patriot),8,3-5,97,127,224,0.433,03/15/2023,2023.0
57,Canisius (MAAC),7,1-6,85,112,197,0.431,03/15/2023,2023.0
58,Loyola Maryland (Patriot),6,4-2,66,87,153,0.431,03/15/2023,2023.0
59,UMass Lowell (America East),5,0-5,57,76,133,0.429,03/15/2023,2023.0
60,Sacred Heart (MAAC),6,0-6,68,91,159,0.428,03/15/2023,2023.0
61,Cornell (Ivy League),5,4-1,53,71,124,0.427,03/15/2023,2023.0
62,Bucknell (Patriot),6,1-5,67,92,159,0.421,03/15/2023,2023.0
63,LIU (MAAC),6,2-4,61,84,145,0.421,03/15/2023,2023.0
64,Utah (ASUN),5,1-4,61,85,146,0.418,03/15/2023,2023.0
65,Holy Cross (Patriot),7,0-7,74,107,181,0.409,03/15/2023,2023.0
66,Syracuse (ACC),8,4-4,88,129,217,0.406,03/15/2023,2023.0
67,Penn (Ivy League),5,2-3,48,79,127,0.378,03/15/2023,2023.0
68,Wagner (MAAC),6,1-5,54,89,143,0.378,03/15/2023,2023.0
69,Detroit Mercy (ASUN),4,0-4,35,64,99,0.354,03/15/2023,2023.0
70,Air Force (ASUN),6,4-2,47,98,145,0.324,03/15/2023,2023.0
71,Providence (Big East),7,4-3,59,133,192,0.307,03/15/2023,2023.0
72,St. John's (NY) (Big East),7,0-7,46,141,187,0.246,03/15/2023,2023.0
-,Hartford (DI Independent),2,2-0,35,9,44,0.795,03/15/2023,2023.0
-,Lindenwood (ASUN),3,1-2,29,43,72,0.403,03/15/2023,2023.0
-,Queens (NC) (ASUN),5,1-4,54,82,136,0.397,03/15/2023,2023.0
-,Merrimack (America East),6,4-2,60,94,154,0.390,03/15/2023,2023.0
1,Dartmouth (Ivy League),4,4-0,77,37,114,0.675,03/14/2023,2023.0
2,Saint Joseph's (Atlantic 10),6,3-3,124,61,185,0.670,03/14/2023,2023.0
3,Denver (Big East),6,3-3,92,47,139,0.662,03/14/2023,2023.0
4,Maryland (Big Ten),6,4-2,100,56,156,0.641,03/14/2023,2023.0
5,Army West Point (Patriot),6,5-1,101,57,158,0.639,03/14/2023,2023.0
6,Duke (ACC),7,6-1,125,79,204,0.613,03/14/2023,2023.0
7,Binghamton (America East),6,4-2,99,65,164,0.604,03/14/2023,2023.0
8,Quinnipiac (MAAC),5,3-2,88,58,146,0.603,03/14/2023,2023.0
9,Lehigh (Patriot),6,5-1,107,71,178,0.601,03/14/2023,2023.0
10,Hofstra (CAA),7,2-5,106,71,177,0.599,03/14/2023,2023.0
11,High Point (Atlantic 10),8,6-2,148,102,250,0.592,03/14/2023,2023.0
12,Ohio St. (Big Ten),7,4-3,108,79,187,0.578,03/14/2023,2023.0
13,Rutgers (Big Ten),7,6-1,111,83,194,0.572,03/14/2023,2023.0
14,Virginia (ACC),6,6-0,121,92,213,0.568,03/14/2023,2023.0
15,Boston U. (Patriot),5,4-1,77,60,137,0.562,03/14/2023,2023.0
16,Brown (Ivy League),5,3-2,82,64,146,0.562,03/14/2023,2023.0
17,Michigan (Big Ten),6,4-2,78,62,140,0.557,03/14/2023,2023.0
18,Delaware (CAA),7,5-2,106,85,191,0.555,03/14/2023,2023.0
19,Cleveland St. (ASUN),4,2-2,66,53,119,0.555,03/14/2023,2023.0
20,Bryant (America East),6,4-2,100,83,183,0.546,03/14/2023,2023.0
21,Villanova (Big East),6,5-1,90,75,165,0.545,03/14/2023,2023.0
22,Navy (Patriot),7,3-4,97,81,178,0.545,03/14/2023,2023.0
23,Vermont (America East),6,2-4,83,71,154,0.539,03/14/2023,2023.0
24,Penn St. (Big Ten),6,5-1,93,80,173,0.538,03/14/2023,2023.0
25,Drexel (CAA),6,3-3,87,75,162,0.537,03/14/2023,2023.0
26,Mercer (ASUN),7,1-6,95,83,178,0.534,03/14/2023,2023.0
27,Harvard (Ivy League),4,2-2,50,44,94,0.532,03/14/2023,2023.0
28,Mount St. Mary's (MAAC),7,1-6,86,78,164,0.524,03/14/2023,2023.0
29,Hobart (Atlantic 10),6,3-3,99,90,189,0.524,03/14/2023,2023.0
30,Richmond (Atlantic 10),7,4-3,91,83,174,0.523,03/14/2023,2023.0
31,Marquette (Big East),6,3-3,84,77,161,0.522,03/14/2023,2023.0
32,St. Bonaventure (Atlantic 10),7,1-6,87,80,167,0.521,03/14/2023,2023.0
33,Monmouth (CAA),6,4-2,74,69,143,0.517,03/14/2023,2023.0
34,NJIT (America East),6,2-4,76,73,149,0.510,03/14/2023,2023.0
35,Massachusetts (Atlantic 10),6,4-2,62,60,122,0.508,03/14/2023,2023.0
36,Georgetown (Big East),5,2-3,67,65,132,0.508,03/14/2023,2023.0
37,North Carolina (ACC),6,4-2,79,77,156,0.506,03/14/2023,2023.0
38,Towson (CAA),6,1-5,81,79,160,0.506,03/14/2023,2023.0
39,Marist (MAAC),6,2-4,84,83,167,0.503,03/14/2023,2023.0
40,VMI (MAAC),7,3-4,99,99,198,0.500,03/14/2023,2023.0
40,Stony Brook (CAA),6,2-4,82,82,164,0.500,03/14/2023,2023.0
42,Princeton (Ivy League),5,2-3,67,69,136,0.493,03/14/2023,2023.0
43,Siena (MAAC),5,3-2,66,69,135,0.489,03/14/2023,2023.0
44,UAlbany (America East),5,1-4,58,61,119,0.487,03/14/2023,2023.0
45,Johns Hopkins (Big Ten),8,5-3,103,110,213,0.484,03/14/2023,2023.0
46,Manhattan (MAAC),6,4-2,60,66,126,0.476,03/14/2023,2023.0
47,Notre Dame (ACC),5,5-0,68,75,143,0.476,03/14/2023,2023.0
48,Bellarmine (ASUN),6,5-1,74,82,156,0.474,03/14/2023,2023.0
49,Fairfield (CAA),7,2-5,91,101,192,0.474,03/14/2023,2023.0
50,Robert Morris (ASUN),5,3-2,62,71,133,0.466,03/14/2023,2023.0
51,Hampton (CAA),6,2-4,72,83,155,0.465,03/14/2023,2023.0
52,Yale (Ivy League),4,3-1,52,61,113,0.460,03/14/2023,2023.0
53,Jacksonville (ASUN),6,5-1,73,89,162,0.451,03/14/2023,2023.0
54,Colgate (Patriot),4,1-3,44,55,99,0.444,03/14/2023,2023.0
55,UMBC (America East),6,5-1,59,77,136,0.434,03/14/2023,2023.0
56,Lafayette (Patriot),8,3-5,97,127,224,0.433,03/14/2023,2023.0
57,Canisius (MAAC),7,1-6,85,112,197,0.431,03/14/2023,2023.0
58,Loyola Maryland (Patriot),6,4-2,66,87,153,0.431,03/14/2023,2023.0
59,UMass Lowell (America East),5,0-5,57,76,133,0.429,03/14/2023,2023.0
60,Sacred Heart (MAAC),6,0-6,68,91,159,0.428,03/14/2023,2023.0
61,Cornell (Ivy League),5,4-1,53,71,124,0.427,03/14/2023,2023.0
62,Bucknell (Patriot),6,1-5,67,92,159,0.421,03/14/2023,2023.0
63,LIU (MAAC),6,2-4,61,84,145,0.421,03/14/2023,2023.0
64,Holy Cross (Patriot),7,0-7,76,105,181,0.420,03/14/2023,2023.0
65,Utah (ASUN),5,1-4,61,85,146,0.418,03/14/2023,2023.0
66,Syracuse (ACC),8,4-4,88,129,217,0.406,03/14/2023,2023.0
67,Penn (Ivy League),5,2-3,48,79,127,0.378,03/14/2023,2023.0
68,Wagner (MAAC),6,1-5,54,89,143,0.378,03/14/2023,2023.0
69,Detroit Mercy (ASUN),4,0-4,35,64,99,0.354,03/14/2023,2023.0
70,Air Force (ASUN),6,4-2,47,98,145,0.324,03/14/2023,2023.0
71,Providence (Big East),7,4-3,59,133,192,0.307,03/14/2023,2023.0
72,St. John's (NY) (Big East),6,0-6,39,118,157,0.248,03/14/2023,2023.0
-,Hartford (DI Independent),1,1-0,22,6,28,0.786,03/14/2023,2023.0
-,Lindenwood (ASUN),3,1-2,29,43,72,0.403,03/14/2023,2023.0
-,Queens (NC) (ASUN),5,1-4,54,82,136,0.397,03/14/2023,2023.0
-,Merrimack (America East),6,4-2,60,94,154,0.390,03/14/2023,2023.0
1,Dartmouth (Ivy League),4,4-0,77,37,114,0.675,03/12/2023,2023.0
2,Saint Joseph's (Atlantic 10),6,3-3,124,61,185,0.670,03/12/2023,2023.0
3,Denver (Big East),6,3-3,92,47,139,0.662,03/12/2023,2023.0
4,Maryland (Big Ten),6,4-2,100,56,156,0.641,03/12/2023,2023.0
5,Army West Point (Patriot),6,5-1,101,57,158,0.639,03/12/2023,2023.0
6,Duke (ACC),7,6-1,125,79,204,0.613,03/12/2023,2023.0
7,Binghamton (America East),6,4-2,99,65,164,0.604,03/12/2023,2023.0
8,Quinnipiac (MAAC),5,3-2,88,58,146,0.603,03/12/2023,2023.0
9,Lehigh (Patriot),6,5-1,107,71,178,0.601,03/12/2023,2023.0
10,High Point (Atlantic 10),8,6-2,148,102,250,0.592,03/12/2023,2023.0
11,Hofstra (CAA),6,2-4,87,62,149,0.584,03/12/2023,2023.0
12,Michigan (Big Ten),6,4-2,102,73,175,0.583,03/12/2023,2023.0
13,Rutgers (Big Ten),7,6-1,111,83,194,0.572,03/12/2023,2023.0
14,Virginia (ACC),6,6-0,121,92,213,0.568,03/12/2023,2023.0
15,Boston U. (Patriot),5,4-1,77,60,137,0.562,03/12/2023,2023.0
16,St. Bonaventure (Atlantic 10),6,1-5,82,64,146,0.562,03/12/2023,2023.0
17,Ohio St. (Big Ten),6,3-3,88,70,158,0.557,03/12/2023,2023.0
18,Delaware (CAA),7,5-2,106,85,191,0.555,03/12/2023,2023.0
19,Brown (Ivy League),5,3-2,81,65,146,0.555,03/12/2023,2023.0
20,Bryant (America East),6,4-2,100,83,183,0.546,03/12/2023,2023.0
21,Cleveland St. (ASUN),4,2-2,65,54,119,0.546,03/12/2023,2023.0
22,Villanova (Big East),6,5-1,90,75,165,0.545,03/12/2023,2023.0
23,Navy (Patriot),7,3-4,97,81,178,0.545,03/12/2023,2023.0
24,Vermont (America East),6,2-4,83,71,154,0.539,03/12/2023,2023.0
25,Penn St. (Big Ten),6,5-1,93,80,173,0.538,03/12/2023,2023.0
26,Drexel (CAA),6,3-3,87,75,162,0.537,03/12/2023,2023.0
27,Mercer (ASUN),7,1-6,95,83,178,0.534,03/12/2023,2023.0
28,Mount St. Mary's (MAAC),7,1-6,86,78,164,0.524,03/12/2023,2023.0
29,Hobart (Atlantic 10),6,3-3,99,90,189,0.524,03/12/2023,2023.0
30,Richmond (Atlantic 10),7,4-3,91,83,174,0.523,03/12/2023,2023.0
31,Marquette (Big East),6,3-3,84,77,161,0.522,03/12/2023,2023.0
32,Monmouth (CAA),6,4-2,74,69,143,0.517,03/12/2023,2023.0
33,North Carolina (ACC),6,4-2,80,76,156,0.513,03/12/2023,2023.0
34,NJIT (America East),6,2-4,62,59,121,0.512,03/12/2023,2023.0
35,Massachusetts (Atlantic 10),6,4-2,62,60,122,0.508,03/12/2023,2023.0
36,Georgetown (Big East),5,2-3,67,65,132,0.508,03/12/2023,2023.0
37,Towson (CAA),6,1-5,81,79,160,0.506,03/12/2023,2023.0
38,Marist (MAAC),6,2-4,84,83,167,0.503,03/12/2023,2023.0
39,VMI (MAAC),7,3-4,99,99,198,0.500,03/12/2023,2023.0
39,Stony Brook (CAA),6,2-4,82,82,164,0.500,03/12/2023,2023.0
41,Hampton (CAA),5,2-3,62,63,125,0.496,03/12/2023,2023.0
42,Princeton (Ivy League),5,2-3,67,69,136,0.493,03/12/2023,2023.0
43,Siena (MAAC),5,3-2,66,69,135,0.489,03/12/2023,2023.0
44,UAlbany (America East),5,1-4,58,61,119,0.487,03/12/2023,2023.0
45,Johns Hopkins (Big Ten),8,5-3,103,110,213,0.484,03/12/2023,2023.0
46,Manhattan (MAAC),6,4-2,60,66,126,0.476,03/12/2023,2023.0
47,Notre Dame (ACC),5,5-0,68,75,143,0.476,03/12/2023,2023.0
48,Bellarmine (ASUN),6,5-1,74,82,156,0.474,03/12/2023,2023.0
49,Fairfield (CAA),7,2-5,91,101,192,0.474,03/12/2023,2023.0
50,Harvard (Ivy League),4,2-2,61,68,129,0.473,03/12/2023,2023.0
51,Robert Morris (ASUN),5,3-2,62,71,133,0.466,03/12/2023,2023.0
52,Yale (Ivy League),4,3-1,52,61,113,0.460,03/12/2023,2023.0
53,Jacksonville (ASUN),6,5-1,73,89,162,0.451,03/12/2023,2023.0
54,Colgate (Patriot),4,1-3,44,55,99,0.444,03/12/2023,2023.0
55,UMBC (America East),6,5-1,59,77,136,0.434,03/12/2023,2023.0
56,Loyola Maryland (Patriot),6,4-2,66,87,153,0.431,03/12/2023,2023.0
57,UMass Lowell (America East),5,0-5,57,76,133,0.429,03/12/2023,2023.0
58,Sacred Heart (MAAC),6,0-6,68,91,159,0.428,03/12/2023,2023.0
59,Cornell (Ivy League),5,4-1,53,71,124,0.427,03/12/2023,2023.0
60,Bucknell (Patriot),6,1-5,67,92,159,0.421,03/12/2023,2023.0
61,LIU (MAAC),6,2-4,61,84,145,0.421,03/12/2023,2023.0
62,Holy Cross (Patriot),7,0-7,76,105,181,0.420,03/12/2023,2023.0
63,Syracuse (ACC),7,3-4,79,110,189,0.418,03/12/2023,2023.0
64,Utah (ASUN),5,1-4,61,85,146,0.418,03/12/2023,2023.0
65,Canisius (MAAC),6,0-6,70,106,176,0.398,03/12/2023,2023.0
66,Lafayette (Patriot),7,2-5,77,117,194,0.397,03/12/2023,2023.0
67,Penn (Ivy League),5,2-3,48,79,127,0.378,03/12/2023,2023.0
68,Wagner (MAAC),6,1-5,54,89,143,0.378,03/12/2023,2023.0
69,Detroit Mercy (ASUN),3,0-3,26,44,70,0.371,03/12/2023,2023.0
70,Air Force (ASUN),6,4-2,47,98,145,0.324,03/12/2023,2023.0
71,Providence (Big East),7,4-3,59,133,192,0.307,03/12/2023,2023.0
72,St. John's (NY) (Big East),6,0-6,39,118,157,0.248,03/12/2023,2023.0
-,Hartford (DI Independent),1,1-0,22,6,28,0.786,03/12/2023,2023.0
-,Queens (NC) (ASUN),5,1-4,54,82,136,0.397,03/12/2023,2023.0
-,Merrimack (America East),6,4-2,60,94,154,0.390,03/12/2023,2023.0
-,Lindenwood (ASUN),3,1-2,15,29,44,0.341,03/12/2023,2023.0
1,Maryland (Big Ten),5,3-2,87,40,127,0.685,03/10/2023,2023.0
2,Saint Joseph's (Atlantic 10),5,3-2,101,47,148,0.682,03/10/2023,2023.0
3,Dartmouth (Ivy League),4,4-0,77,37,114,0.675,03/10/2023,2023.0
4,Denver (Big East),5,3-2,77,40,117,0.658,03/10/2023,2023.0
5,Army West Point (Patriot),6,5-1,84,45,129,0.651,03/10/2023,2023.0
6,Duke (ACC),7,6-1,125,79,204,0.613,03/10/2023,2023.0
7,Quinnipiac (MAAC),4,2-2,71,47,118,0.602,03/10/2023,2023.0
8,Brown (Ivy League),4,3-1,69,47,116,0.595,03/10/2023,2023.0
9,Lehigh (Patriot),5,4-1,85,60,145,0.586,03/10/2023,2023.0
10,High Point (Atlantic 10),7,5-2,127,90,217,0.585,03/10/2023,2023.0
11,Rutgers (Big Ten),6,5-1,97,69,166,0.584,03/10/2023,2023.0
12,Virginia (ACC),5,5-0,104,74,178,0.584,03/10/2023,2023.0
13,Drexel (CAA),5,2-3,73,52,125,0.584,03/10/2023,2023.0
14,Hofstra (CAA),6,2-4,87,62,149,0.584,03/10/2023,2023.0
15,Ohio St. (Big Ten),5,3-2,79,57,136,0.581,03/10/2023,2023.0
16,Binghamton (America East),5,3-2,79,58,137,0.577,03/10/2023,2023.0
17,Boston U. (Patriot),4,3-1,63,47,110,0.573,03/10/2023,2023.0
18,Cleveland St. (ASUN),3,1-2,56,42,98,0.571,03/10/2023,2023.0
19,Delaware (CAA),6,4-2,93,70,163,0.571,03/10/2023,2023.0
20,St. Bonaventure (Atlantic 10),5,1-4,70,55,125,0.560,03/10/2023,2023.0
21,Vermont (America East),5,2-3,75,59,134,0.560,03/10/2023,2023.0
22,Michigan (Big Ten),5,3-2,78,62,140,0.557,03/10/2023,2023.0
23,Penn St. (Big Ten),5,4-1,83,70,153,0.542,03/10/2023,2023.0
24,Villanova (Big East),5,4-1,78,67,145,0.538,03/10/2023,2023.0
25,Bryant (America East),5,4-1,87,75,162,0.537,03/10/2023,2023.0
26,Georgetown (Big East),4,1-3,55,48,103,0.534,03/10/2023,2023.0
27,Harvard (Ivy League),3,2-1,50,44,94,0.532,03/10/2023,2023.0
28,Navy (Patriot),6,3-3,79,71,150,0.527,03/10/2023,2023.0
29,Hobart (Atlantic 10),6,3-3,99,90,189,0.524,03/10/2023,2023.0
30,Siena (MAAC),4,2-2,59,54,113,0.522,03/10/2023,2023.0
31,Marquette (Big East),5,3-2,71,65,136,0.522,03/10/2023,2023.0
32,Mount St. Mary's (MAAC),6,1-5,77,71,148,0.520,03/10/2023,2023.0
33,Monmouth (CAA),5,4-1,59,56,115,0.513,03/10/2023,2023.0
34,NJIT (America East),5,1-4,62,59,121,0.512,03/10/2023,2023.0
35,Richmond (Atlantic 10),6,4-2,74,71,145,0.510,03/10/2023,2023.0
36,Mercer (ASUN),6,1-5,79,76,155,0.510,03/10/2023,2023.0
37,Fairfield (CAA),6,2-4,84,81,165,0.509,03/10/2023,2023.0
38,Towson (CAA),5,1-4,63,62,125,0.504,03/10/2023,2023.0
39,Robert Morris (ASUN),4,3-1,50,50,100,0.500,03/10/2023,2023.0
40,Stony Brook (CAA),5,2-3,71,72,143,0.497,03/10/2023,2023.0
41,Hampton (CAA),5,2-3,62,63,125,0.496,03/10/2023,2023.0
42,Yale (Ivy League),3,2-1,45,46,91,0.495,03/10/2023,2023.0
43,North Carolina (ACC),5,3-2,62,64,126,0.492,03/10/2023,2023.0
44,Princeton (Ivy League),4,2-2,53,55,108,0.491,03/10/2023,2023.0
45,Massachusetts (Atlantic 10),5,3-2,50,52,102,0.490,03/10/2023,2023.0
46,VMI (MAAC),6,3-3,82,86,168,0.488,03/10/2023,2023.0
47,Johns Hopkins (Big Ten),7,4-3,92,98,190,0.484,03/10/2023,2023.0
48,Manhattan (MAAC),5,3-2,53,57,110,0.482,03/10/2023,2023.0
49,Colgate (Patriot),3,0-3,34,37,71,0.479,03/10/2023,2023.0
50,Bellarmine (ASUN),5,4-1,62,69,131,0.473,03/10/2023,2023.0
51,Marist (MAAC),5,1-4,66,74,140,0.471,03/10/2023,2023.0
52,UAlbany (America East),4,1-3,42,48,90,0.467,03/10/2023,2023.0
53,UMBC (America East),5,4-1,52,61,113,0.460,03/10/2023,2023.0
54,Notre Dame (ACC),4,4-0,55,66,121,0.455,03/10/2023,2023.0
55,Holy Cross (Patriot),6,0-6,65,83,148,0.439,03/10/2023,2023.0
56,Loyola Maryland (Patriot),6,4-2,66,87,153,0.431,03/10/2023,2023.0
57,UMass Lowell (America East),5,0-5,57,76,133,0.429,03/10/2023,2023.0
58,Utah (ASUN),5,1-4,61,85,146,0.418,03/10/2023,2023.0
59,LIU (MAAC),5,1-4,48,67,115,0.417,03/10/2023,2023.0
60,Cornell (Ivy League),4,4-0,43,61,104,0.413,03/10/2023,2023.0
61,Bucknell (Patriot),5,1-4,54,78,132,0.409,03/10/2023,2023.0
62,Syracuse (ACC),6,3-3,67,99,166,0.404,03/10/2023,2023.0
63,Canisius (MAAC),5,0-5,59,89,148,0.399,03/10/2023,2023.0
64,Lafayette (Patriot),7,2-5,65,100,165,0.394,03/10/2023,2023.0
65,Wagner (MAAC),5,1-4,45,71,116,0.388,03/10/2023,2023.0
66,Sacred Heart (MAAC),5,0-5,53,84,137,0.387,03/10/2023,2023.0
67,Jacksonville (ASUN),5,4-1,51,81,132,0.386,03/10/2023,2023.0
68,Penn (Ivy League),4,2-2,40,67,107,0.374,03/10/2023,2023.0
69,Detroit Mercy (ASUN),3,0-3,26,44,70,0.371,03/10/2023,2023.0
70,Air Force (ASUN),5,3-2,39,85,124,0.315,03/10/2023,2023.0
71,Providence (Big East),6,3-3,49,122,171,0.287,03/10/2023,2023.0
72,St. John's (NY) (Big East),5,0-5,31,96,127,0.244,03/10/2023,2023.0
-,Hartford (DI Independent),1,1-0,22,6,28,0.786,03/10/2023,2023.0
-,Queens (NC) (ASUN),5,1-4,54,82,136,0.397,03/10/2023,2023.0
-,Merrimack (America East),6,4-2,60,94,154,0.390,03/10/2023,2023.0
-,Lindenwood (ASUN),2,1-1,15,29,44,0.341,03/10/2023,2023.0
1,Maryland (Big Ten),5,3-2,87,40,127,0.685,03/08/2023,2023.0
2,Saint Joseph's (Atlantic 10),5,3-2,101,47,148,0.682,03/08/2023,2023.0
3,Dartmouth (Ivy League),4,4-0,77,37,114,0.675,03/08/2023,2023.0
4,Denver (Big East),5,3-2,77,40,117,0.658,03/08/2023,2023.0
5,Army West Point (Patriot),5,4-1,84,45,129,0.651,03/08/2023,2023.0
6,Duke (ACC),6,5-1,107,67,174,0.615,03/08/2023,2023.0
7,Quinnipiac (MAAC),4,2-2,71,47,118,0.602,03/08/2023,2023.0
8,Brown (Ivy League),4,3-1,69,47,116,0.595,03/08/2023,2023.0
9,Lehigh (Patriot),5,4-1,85,60,145,0.586,03/08/2023,2023.0
10,High Point (Atlantic 10),7,5-2,127,90,217,0.585,03/08/2023,2023.0
11,Rutgers (Big Ten),6,5-1,97,69,166,0.584,03/08/2023,2023.0
12,Virginia (ACC),5,5-0,104,74,178,0.584,03/08/2023,2023.0
13,Drexel (CAA),5,2-3,73,52,125,0.584,03/08/2023,2023.0
14,Hofstra (CAA),6,2-4,87,62,149,0.584,03/08/2023,2023.0
15,Ohio St. (Big Ten),5,3-2,79,57,136,0.581,03/08/2023,2023.0
16,Binghamton (America East),5,3-2,79,58,137,0.577,03/08/2023,2023.0
17,Boston U. (Patriot),4,3-1,63,47,110,0.573,03/08/2023,2023.0
18,Cleveland St. (ASUN),3,1-2,56,42,98,0.571,03/08/2023,2023.0
19,Delaware (CAA),6,4-2,93,70,163,0.571,03/08/2023,2023.0
20,St. Bonaventure (Atlantic 10),5,1-4,70,55,125,0.560,03/08/2023,2023.0
21,Vermont (America East),5,2-3,75,59,134,0.560,03/08/2023,2023.0
22,Michigan (Big Ten),5,3-2,78,62,140,0.557,03/08/2023,2023.0
23,Penn St. (Big Ten),5,4-1,83,70,153,0.542,03/08/2023,2023.0
24,Villanova (Big East),5,4-1,78,67,145,0.538,03/08/2023,2023.0
25,Bryant (America East),5,4-1,87,75,162,0.537,03/08/2023,2023.0
26,Georgetown (Big East),4,1-3,55,48,103,0.534,03/08/2023,2023.0
27,Harvard (Ivy League),3,2-1,50,44,94,0.532,03/08/2023,2023.0
28,Navy (Patriot),6,3-3,79,71,150,0.527,03/08/2023,2023.0
29,Hobart (Atlantic 10),6,3-3,99,90,189,0.524,03/08/2023,2023.0
30,Siena (MAAC),4,2-2,59,54,113,0.522,03/08/2023,2023.0
31,Marquette (Big East),5,3-2,71,65,136,0.522,03/08/2023,2023.0
32,Mount St. Mary's (MAAC),6,1-5,77,71,148,0.520,03/08/2023,2023.0
33,Monmouth (CAA),5,4-1,59,56,115,0.513,03/08/2023,2023.0
34,NJIT (America East),5,1-4,62,59,121,0.512,03/08/2023,2023.0
35,Richmond (Atlantic 10),6,4-2,74,71,145,0.510,03/08/2023,2023.0
36,Mercer (ASUN),6,1-5,79,76,155,0.510,03/08/2023,2023.0
37,Fairfield (CAA),6,2-4,84,81,165,0.509,03/08/2023,2023.0
38,Towson (CAA),5,1-4,63,62,125,0.504,03/08/2023,2023.0
39,Robert Morris (ASUN),4,3-1,50,50,100,0.500,03/08/2023,2023.0
40,Stony Brook (CAA),5,2-3,71,72,143,0.497,03/08/2023,2023.0
41,Yale (Ivy League),3,2-1,45,46,91,0.495,03/08/2023,2023.0
42,North Carolina (ACC),5,3-2,62,64,126,0.492,03/08/2023,2023.0
43,Princeton (Ivy League),4,2-2,53,55,108,0.491,03/08/2023,2023.0
44,Massachusetts (Atlantic 10),5,3-2,50,52,102,0.490,03/08/2023,2023.0
45,VMI (MAAC),6,3-3,82,86,168,0.488,03/08/2023,2023.0
46,Johns Hopkins (Big Ten),7,4-3,92,98,190,0.484,03/08/2023,2023.0
47,Manhattan (MAAC),5,3-2,53,57,110,0.482,03/08/2023,2023.0
48,Colgate (Patriot),3,0-3,34,37,71,0.479,03/08/2023,2023.0
49,Bellarmine (ASUN),5,4-1,62,69,131,0.473,03/08/2023,2023.0
50,Marist (MAAC),5,1-4,66,74,140,0.471,03/08/2023,2023.0
51,UAlbany (America East),4,1-3,42,48,90,0.467,03/08/2023,2023.0
52,UMBC (America East),5,4-1,52,61,113,0.460,03/08/2023,2023.0
53,Notre Dame (ACC),4,4-0,55,66,121,0.455,03/08/2023,2023.0
54,Holy Cross (Patriot),6,0-6,65,83,148,0.439,03/08/2023,2023.0
55,Loyola Maryland (Patriot),5,4-1,54,69,123,0.439,03/08/2023,2023.0
56,UMass Lowell (America East),5,0-5,57,76,133,0.429,03/08/2023,2023.0
57,Utah (ASUN),5,1-4,61,85,146,0.418,03/08/2023,2023.0
58,LIU (MAAC),5,1-4,48,67,115,0.417,03/08/2023,2023.0
59,Cornell (Ivy League),4,4-0,43,61,104,0.413,03/08/2023,2023.0
60,Bucknell (Patriot),5,1-4,54,78,132,0.409,03/08/2023,2023.0
61,Hampton (CAA),4,1-3,41,60,101,0.406,03/08/2023,2023.0
62,Syracuse (ACC),6,3-3,67,99,166,0.404,03/08/2023,2023.0
63,Canisius (MAAC),5,0-5,59,89,148,0.399,03/08/2023,2023.0
64,Lafayette (Patriot),6,2-4,65,100,165,0.394,03/08/2023,2023.0
65,Wagner (MAAC),5,1-4,45,71,116,0.388,03/08/2023,2023.0
66,Sacred Heart (MAAC),5,0-5,53,84,137,0.387,03/08/2023,2023.0
67,Jacksonville (ASUN),5,4-1,51,81,132,0.386,03/08/2023,2023.0
68,Penn (Ivy League),4,2-2,40,67,107,0.374,03/08/2023,2023.0
69,Detroit Mercy (ASUN),3,0-3,26,44,70,0.371,03/08/2023,2023.0
70,Air Force (ASUN),5,3-2,39,85,124,0.315,03/08/2023,2023.0
71,Providence (Big East),6,3-3,49,122,171,0.287,03/08/2023,2023.0
72,St. John's (NY) (Big East),5,0-5,31,96,127,0.244,03/08/2023,2023.0
-,Hartford (DI Independent),1,1-0,22,6,28,0.786,03/08/2023,2023.0
-,Queens (NC) (ASUN),5,1-4,54,82,136,0.397,03/08/2023,2023.0
-,Merrimack (America East),6,4-2,60,94,154,0.390,03/08/2023,2023.0
-,Lindenwood (ASUN),2,1-1,15,29,44,0.341,03/08/2023,2023.0
1,Maryland (Big Ten),5,3-2,87,40,127,0.685,03/07/2023,2023.0
2,Dartmouth (Ivy League),4,4-0,77,37,114,0.675,03/07/2023,2023.0
3,Saint Joseph's (Atlantic 10),4,3-1,80,39,119,0.672,03/07/2023,2023.0
4,Denver (Big East),5,3-2,77,40,117,0.658,03/07/2023,2023.0
5,Army West Point (Patriot),5,4-1,84,45,129,0.651,03/07/2023,2023.0
6,Duke (ACC),6,5-1,107,67,174,0.615,03/07/2023,2023.0
7,Quinnipiac (MAAC),4,2-2,71,47,118,0.602,03/07/2023,2023.0
8,Brown (Ivy League),4,3-1,69,47,116,0.595,03/07/2023,2023.0
9,Drexel (CAA),4,2-2,59,41,100,0.590,03/07/2023,2023.0
10,Lehigh (Patriot),5,4-1,85,60,145,0.586,03/07/2023,2023.0
11,High Point (Atlantic 10),7,5-2,127,90,217,0.585,03/07/2023,2023.0
12,Rutgers (Big Ten),6,5-1,97,69,166,0.584,03/07/2023,2023.0
13,Virginia (ACC),5,5-0,104,74,178,0.584,03/07/2023,2023.0
14,Hofstra (CAA),6,2-4,87,62,149,0.584,03/07/2023,2023.0
15,Ohio St. (Big Ten),5,3-2,79,57,136,0.581,03/07/2023,2023.0
16,Binghamton (America East),5,3-2,79,58,137,0.577,03/07/2023,2023.0
17,Boston U. (Patriot),4,3-1,63,47,110,0.573,03/07/2023,2023.0
18,Cleveland St. (ASUN),3,1-2,56,42,98,0.571,03/07/2023,2023.0
19,Delaware (CAA),6,4-2,93,70,163,0.571,03/07/2023,2023.0
20,St. Bonaventure (Atlantic 10),5,1-4,70,55,125,0.560,03/07/2023,2023.0
21,Vermont (America East),5,2-3,75,59,134,0.560,03/07/2023,2023.0
22,Villanova (Big East),4,3-1,67,53,120,0.558,03/07/2023,2023.0
23,Michigan (Big Ten),5,3-2,78,62,140,0.557,03/07/2023,2023.0
24,Penn St. (Big Ten),5,4-1,83,70,153,0.542,03/07/2023,2023.0
25,Bryant (America East),5,4-1,87,75,162,0.537,03/07/2023,2023.0
26,Georgetown (Big East),4,1-3,55,48,103,0.534,03/07/2023,2023.0
27,Harvard (Ivy League),3,2-1,50,44,94,0.532,03/07/2023,2023.0
28,Navy (Patriot),6,3-3,79,71,150,0.527,03/07/2023,2023.0
29,Hobart (Atlantic 10),6,3-3,99,90,189,0.524,03/07/2023,2023.0
30,Siena (MAAC),4,2-2,59,54,113,0.522,03/07/2023,2023.0
31,Marquette (Big East),5,3-2,71,65,136,0.522,03/07/2023,2023.0
32,Mount St. Mary's (MAAC),6,1-5,77,71,148,0.520,03/07/2023,2023.0
33,Monmouth (CAA),5,4-1,59,56,115,0.513,03/07/2023,2023.0
34,NJIT (America East),5,1-4,62,59,121,0.512,03/07/2023,2023.0
35,Mercer (ASUN),6,1-5,79,76,155,0.510,03/07/2023,2023.0
36,Fairfield (CAA),6,2-4,84,81,165,0.509,03/07/2023,2023.0
37,Richmond (Atlantic 10),6,4-2,73,71,144,0.507,03/07/2023,2023.0
38,Towson (CAA),5,1-4,63,62,125,0.504,03/07/2023,2023.0
39,Robert Morris (ASUN),4,3-1,50,50,100,0.500,03/07/2023,2023.0
40,Stony Brook (CAA),5,2-3,71,72,143,0.497,03/07/2023,2023.0
41,Yale (Ivy League),3,2-1,45,46,91,0.495,03/07/2023,2023.0
42,North Carolina (ACC),5,3-2,62,64,126,0.492,03/07/2023,2023.0
43,Princeton (Ivy League),4,2-2,53,55,108,0.491,03/07/2023,2023.0
44,Massachusetts (Atlantic 10),5,3-2,50,52,102,0.490,03/07/2023,2023.0
45,VMI (MAAC),6,3-3,82,86,168,0.488,03/07/2023,2023.0
46,Johns Hopkins (Big Ten),7,4-3,92,98,190,0.484,03/07/2023,2023.0
47,Manhattan (MAAC),5,3-2,53,57,110,0.482,03/07/2023,2023.0
48,Colgate (Patriot),3,0-3,34,37,71,0.479,03/07/2023,2023.0
49,Bellarmine (ASUN),5,4-1,62,69,131,0.473,03/07/2023,2023.0
50,Marist (MAAC),5,1-4,66,74,140,0.471,03/07/2023,2023.0
51,UAlbany (America East),4,1-3,42,48,90,0.467,03/07/2023,2023.0
52,UMBC (America East),5,4-1,52,61,113,0.460,03/07/2023,2023.0
53,Notre Dame (ACC),4,4-0,55,66,121,0.455,03/07/2023,2023.0
54,Holy Cross (Patriot),6,0-6,65,83,148,0.439,03/07/2023,2023.0
55,Loyola Maryland (Patriot),5,4-1,54,69,123,0.439,03/07/2023,2023.0
56,UMass Lowell (America East),4,0-4,45,62,107,0.421,03/07/2023,2023.0
57,Utah (ASUN),5,1-4,61,85,146,0.418,03/07/2023,2023.0
58,LIU (MAAC),5,1-4,48,67,115,0.417,03/07/2023,2023.0
59,Cornell (Ivy League),4,4-0,43,61,104,0.413,03/07/2023,2023.0
60,Bucknell (Patriot),5,1-4,54,77,131,0.412,03/07/2023,2023.0
61,Penn (Ivy League),3,1-2,32,46,78,0.410,03/07/2023,2023.0
62,Hampton (CAA),4,1-3,41,60,101,0.406,03/07/2023,2023.0
63,Syracuse (ACC),6,3-3,67,99,166,0.404,03/07/2023,2023.0
64,Canisius (MAAC),5,0-5,59,89,148,0.399,03/07/2023,2023.0
65,Lafayette (Patriot),6,2-4,65,100,165,0.394,03/07/2023,2023.0
66,Wagner (MAAC),5,1-4,45,71,116,0.388,03/07/2023,2023.0
67,Sacred Heart (MAAC),5,0-5,53,84,137,0.387,03/07/2023,2023.0
68,Detroit Mercy (ASUN),3,0-3,26,44,70,0.371,03/07/2023,2023.0
69,Jacksonville (ASUN),4,3-1,37,69,106,0.349,03/07/2023,2023.0
70,Air Force (ASUN),5,3-2,39,85,124,0.315,03/07/2023,2023.0
71,Providence (Big East),6,3-3,49,122,171,0.287,03/07/2023,2023.0
72,St. John's (NY) (Big East),5,0-5,31,96,127,0.244,03/07/2023,2023.0
-,Hartford (DI Independent),1,1-0,22,6,28,0.786,03/07/2023,2023.0
-,Queens (NC) (ASUN),5,1-4,54,82,136,0.397,03/07/2023,2023.0
-,Merrimack (America East),6,4-2,60,94,154,0.390,03/07/2023,2023.0
-,Lindenwood (ASUN),2,1-1,15,29,44,0.341,03/07/2023,2023.0
1,Hartford (DI Independent),1,1-0,22,6,28,0.786,03/05/2023,2023.0
2,Dartmouth (Ivy League),3,3-0,56,19,75,0.747,03/05/2023,2023.0
3,Maryland (Big Ten),5,3-2,87,40,127,0.685,03/05/2023,2023.0
4,Saint Joseph's (Atlantic 10),4,3-1,80,39,119,0.672,03/05/2023,2023.0
5,Denver (Big East),5,3-2,77,40,117,0.658,03/05/2023,2023.0
6,Army West Point (Patriot),5,4-1,84,45,129,0.651,03/05/2023,2023.0
7,Duke (ACC),6,5-1,107,67,174,0.615,03/05/2023,2023.0
8,Binghamton (America East),4,3-1,65,41,106,0.613,03/05/2023,2023.0
9,Quinnipiac (MAAC),4,2-2,71,47,118,0.602,03/05/2023,2023.0
10,Lehigh (Patriot),4,3-1,68,46,114,0.596,03/05/2023,2023.0
11,Brown (Ivy League),4,3-1,69,47,116,0.595,03/05/2023,2023.0
12,Drexel (CAA),4,2-2,59,41,100,0.590,03/05/2023,2023.0
13,Rutgers (Big Ten),6,5-1,97,69,166,0.584,03/05/2023,2023.0
14,Hofstra (CAA),6,2-4,87,62,149,0.584,03/05/2023,2023.0
15,Ohio St. (Big Ten),5,3-2,79,57,136,0.581,03/05/2023,2023.0
16,Boston U. (Patriot),4,3-1,63,47,110,0.573,03/05/2023,2023.0
17,Virginia (ACC),4,4-0,81,62,143,0.566,03/05/2023,2023.0
18,Delaware (CAA),5,3-2,74,58,132,0.561,03/05/2023,2023.0
19,St. Bonaventure (Atlantic 10),5,1-4,70,55,125,0.560,03/05/2023,2023.0
20,Villanova (Big East),4,3-1,67,53,120,0.558,03/05/2023,2023.0
21,Michigan (Big Ten),5,3-2,78,62,140,0.557,03/05/2023,2023.0
22,Vermont (America East),5,2-3,74,60,134,0.552,03/05/2023,2023.0
23,High Point (Atlantic 10),6,4-2,83,68,151,0.550,03/05/2023,2023.0
24,Harvard (Ivy League),3,2-1,51,43,94,0.543,03/05/2023,2023.0
25,Penn St. (Big Ten),5,4-1,83,70,153,0.542,03/05/2023,2023.0
26,Hobart (Atlantic 10),5,3-2,81,69,150,0.540,03/05/2023,2023.0
27,Bryant (America East),4,3-1,71,61,132,0.538,03/05/2023,2023.0
28,Georgetown (Big East),4,1-3,55,48,103,0.534,03/05/2023,2023.0
29,Navy (Patriot),6,3-3,79,71,150,0.527,03/05/2023,2023.0
30,Siena (MAAC),4,2-2,59,54,113,0.522,03/05/2023,2023.0
31,Marquette (Big East),5,3-2,71,65,136,0.522,03/05/2023,2023.0
32,Mount St. Mary's (MAAC),6,1-5,77,71,148,0.520,03/05/2023,2023.0
33,Richmond (Atlantic 10),5,3-2,65,60,125,0.520,03/05/2023,2023.0
34,Fairfield (CAA),5,2-3,70,65,135,0.519,03/05/2023,2023.0
35,Johns Hopkins (Big Ten),6,4-2,80,75,155,0.516,03/05/2023,2023.0
36,Monmouth (CAA),5,4-1,59,56,115,0.513,03/05/2023,2023.0
37,NJIT (America East),5,1-4,62,59,121,0.512,03/05/2023,2023.0
38,Towson (CAA),5,1-4,63,62,125,0.504,03/05/2023,2023.0
39,Robert Morris (ASUN),4,3-1,50,50,100,0.500,03/05/2023,2023.0
40,Stony Brook (CAA),5,2-3,71,72,143,0.497,03/05/2023,2023.0
41,Yale (Ivy League),3,2-1,45,46,91,0.495,03/05/2023,2023.0
42,North Carolina (ACC),5,3-2,62,64,126,0.492,03/05/2023,2023.0
43,Princeton (Ivy League),4,2-2,53,55,108,0.491,03/05/2023,2023.0
44,VMI (MAAC),6,3-3,82,86,168,0.488,03/05/2023,2023.0
45,UMBC (America East),4,4-0,40,42,82,0.488,03/05/2023,2023.0
46,Cleveland St. (ASUN),2,0-2,31,33,64,0.484,03/05/2023,2023.0
47,Massachusetts (Atlantic 10),4,2-2,40,43,83,0.482,03/05/2023,2023.0
48,Manhattan (MAAC),5,3-2,53,57,110,0.482,03/05/2023,2023.0
49,Colgate (Patriot),3,0-3,34,37,71,0.479,03/05/2023,2023.0
50,Bellarmine (ASUN),5,4-1,62,69,131,0.473,03/05/2023,2023.0
51,Mercer (ASUN),4,1-3,52,58,110,0.473,03/05/2023,2023.0
52,Marist (MAAC),5,1-4,66,74,140,0.471,03/05/2023,2023.0
53,UAlbany (America East),3,1-2,33,38,71,0.465,03/05/2023,2023.0
54,Notre Dame (ACC),4,4-0,55,66,121,0.455,03/05/2023,2023.0
55,Holy Cross (Patriot),6,0-6,65,83,148,0.439,03/05/2023,2023.0
56,Loyola Maryland (Patriot),5,4-1,54,69,123,0.439,03/05/2023,2023.0
57,Canisius (MAAC),4,0-4,50,64,114,0.439,03/05/2023,2023.0
58,UMass Lowell (America East),4,0-4,45,62,107,0.421,03/05/2023,2023.0
59,Utah (ASUN),5,1-4,61,85,146,0.418,03/05/2023,2023.0
60,LIU (MAAC),5,1-4,48,67,115,0.417,03/05/2023,2023.0
61,Cornell (Ivy League),4,4-0,43,61,104,0.413,03/05/2023,2023.0
62,Penn (Ivy League),3,1-2,32,46,78,0.410,03/05/2023,2023.0
63,Bucknell (Patriot),5,1-4,54,78,132,0.409,03/05/2023,2023.0
64,Hampton (CAA),4,1-3,41,60,101,0.406,03/05/2023,2023.0
65,Syracuse (ACC),6,3-3,67,99,166,0.404,03/05/2023,2023.0
66,Lafayette (Patriot),6,2-4,65,100,165,0.394,03/05/2023,2023.0
67,Wagner (MAAC),5,1-4,45,71,116,0.388,03/05/2023,2023.0
68,Sacred Heart (MAAC),5,0-5,53,84,137,0.387,03/05/2023,2023.0
69,Detroit Mercy (ASUN),3,0-3,26,44,70,0.371,03/05/2023,2023.0
70,Air Force (ASUN),4,2-2,30,69,99,0.303,03/05/2023,2023.0
71,Jacksonville (ASUN),4,3-1,21,51,72,0.292,03/05/2023,2023.0
72,Providence (Big East),6,3-3,49,122,171,0.287,03/05/2023,2023.0
73,St. John's (NY) (Big East),5,0-5,31,96,127,0.244,03/05/2023,2023.0
-,Queens (NC) (ASUN),4,1-3,48,56,104,0.462,03/05/2023,2023.0
-,Merrimack (America East),6,4-2,60,94,154,0.390,03/05/2023,2023.0
-,Lindenwood (ASUN),2,1-1,15,29,44,0.341,03/05/2023,2023.0
1,Saint Joseph's (Atlantic 10),3,3-0,65,21,86,0.756,03/01/2023,2023.0
2,Dartmouth (Ivy League),2,2-0,37,15,52,0.712,03/01/2023,2023.0
3,Maryland (Big Ten),4,3-1,67,29,96,0.698,03/01/2023,2023.0
4,Army West Point (Patriot),4,3-1,69,37,106,0.651,03/01/2023,2023.0
5,Denver (Big East),4,2-2,63,34,97,0.649,03/01/2023,2023.0
6,Hofstra (CAA),5,2-3,78,45,123,0.634,03/01/2023,2023.0
7,Lehigh (Patriot),3,2-1,54,34,88,0.614,03/01/2023,2023.0
8,Siena (MAAC),3,2-1,55,35,90,0.611,03/01/2023,2023.0
9,Drexel (CAA),3,1-2,44,29,73,0.603,03/01/2023,2023.0
10,Rutgers (Big Ten),5,4-1,78,52,130,0.600,03/01/2023,2023.0
11,Duke (ACC),5,4-1,86,58,144,0.597,03/01/2023,2023.0
12,Richmond (Atlantic 10),4,3-1,53,36,89,0.596,03/01/2023,2023.0
13,Brown (Ivy League),3,2-1,50,34,84,0.595,03/01/2023,2023.0
14,Delaware (CAA),4,3-1,61,42,103,0.592,03/01/2023,2023.0
15,Ohio St. (Big Ten),4,3-1,60,43,103,0.583,03/01/2023,2023.0
16,Vermont (America East),4,2-2,66,48,114,0.579,03/01/2023,2023.0
17,Quinnipiac (MAAC),3,2-1,53,39,92,0.576,03/01/2023,2023.0
18,St. Bonaventure (Atlantic 10),5,1-4,70,55,125,0.560,03/01/2023,2023.0
19,Michigan (Big Ten),4,2-2,62,49,111,0.559,03/01/2023,2023.0
20,Colgate (Patriot),2,0-2,25,20,45,0.556,03/01/2023,2023.0
21,High Point (Atlantic 10),5,4-1,83,68,151,0.550,03/01/2023,2023.0
22,Boston U. (Patriot),3,2-1,46,38,84,0.548,03/01/2023,2023.0
23,Binghamton (America East),3,2-1,42,35,77,0.545,03/01/2023,2023.0
24,Navy (Patriot),5,3-2,67,57,124,0.540,03/01/2023,2023.0
25,Hobart (Atlantic 10),4,2-2,65,57,122,0.533,03/01/2023,2023.0
26,Virginia (ACC),3,3-0,57,50,107,0.533,03/01/2023,2023.0
27,Villanova (Big East),3,2-1,50,44,94,0.532,03/01/2023,2023.0
28,North Carolina (ACC),4,3-1,56,50,106,0.528,03/01/2023,2023.0
29,Robert Morris (ASUN),3,3-0,38,34,72,0.528,03/01/2023,2023.0
30,Harvard (Ivy League),2,1-1,39,35,74,0.527,03/01/2023,2023.0
31,Georgetown (Big East),3,0-3,40,36,76,0.526,03/01/2023,2023.0
32,Bryant (America East),3,2-1,53,48,101,0.525,03/01/2023,2023.0
33,Stony Brook (CAA),4,2-2,58,53,111,0.523,03/01/2023,2023.0
34,Marquette (Big East),4,2-2,61,56,117,0.521,03/01/2023,2023.0
35,Monmouth (CAA),4,3-1,50,46,96,0.521,03/01/2023,2023.0
36,Mount St. Mary's (MAAC),5,1-4,67,62,129,0.519,03/01/2023,2023.0
37,Fairfield (CAA),4,2-2,54,50,104,0.519,03/01/2023,2023.0
38,Penn St. (Big Ten),4,3-1,64,60,124,0.516,03/01/2023,2023.0
39,VMI (MAAC),5,3-2,72,69,141,0.511,03/01/2023,2023.0
40,Johns Hopkins (Big Ten),5,3-2,62,60,122,0.508,03/01/2023,2023.0
41,Manhattan (MAAC),4,3-1,40,39,79,0.506,03/01/2023,2023.0
42,Princeton (Ivy League),3,2-1,41,40,81,0.506,03/01/2023,2023.0
43,Towson (CAA),4,1-3,55,54,109,0.505,03/01/2023,2023.0
44,Massachusetts (Atlantic 10),3,2-1,28,29,57,0.491,03/01/2023,2023.0
45,NJIT (America East),4,0-4,49,51,100,0.490,03/01/2023,2023.0
46,Notre Dame (ACC),3,3-0,44,46,90,0.489,03/01/2023,2023.0
47,UMBC (America East),3,3-0,32,34,66,0.485,03/01/2023,2023.0
48,Cleveland St. (ASUN),2,0-2,31,33,64,0.484,03/01/2023,2023.0
49,Yale (Ivy League),2,1-1,31,34,65,0.477,03/01/2023,2023.0
50,Mercer (ASUN),4,1-3,52,58,110,0.473,03/01/2023,2023.0
51,UAlbany (America East),3,1-2,33,38,71,0.465,03/01/2023,2023.0
52,Holy Cross (Patriot),5,0-5,57,68,125,0.456,03/01/2023,2023.0
53,Marist (MAAC),4,0-4,51,61,112,0.455,03/01/2023,2023.0
54,Penn (Ivy League),2,1-1,22,27,49,0.449,03/01/2023,2023.0
55,Canisius (MAAC),4,0-4,50,64,114,0.439,03/01/2023,2023.0
56,Bellarmine (ASUN),4,3-1,45,59,104,0.433,03/01/2023,2023.0
57,Syracuse (ACC),5,3-2,58,78,136,0.426,03/01/2023,2023.0
58,LIU (MAAC),4,0-4,38,54,92,0.413,03/01/2023,2023.0
59,Cornell (Ivy League),3,3-0,29,42,71,0.408,03/01/2023,2023.0
60,Hampton (CAA),4,1-3,41,60,101,0.406,03/01/2023,2023.0
61,Lafayette (Patriot),5,2-3,54,81,135,0.400,03/01/2023,2023.0
61,Utah (ASUN),4,1-3,44,66,110,0.400,03/01/2023,2023.0
63,Bucknell (Patriot),4,1-3,41,63,104,0.394,03/01/2023,2023.0
64,Wagner (MAAC),4,1-3,37,58,95,0.389,03/01/2023,2023.0
65,UMass Lowell (America East),3,0-3,32,52,84,0.381,03/01/2023,2023.0
66,Loyola Maryland (Patriot),4,3-1,35,58,93,0.376,03/01/2023,2023.0
67,Sacred Heart (MAAC),4,0-4,41,69,110,0.373,03/01/2023,2023.0
68,Detroit Mercy (ASUN),2,0-2,17,34,51,0.333,03/01/2023,2023.0
69,Air Force (ASUN),4,2-2,30,69,99,0.303,03/01/2023,2023.0
70,Jacksonville (ASUN),3,2-1,21,51,72,0.292,03/01/2023,2023.0
71,St. John's (NY) (Big East),4,0-4,25,73,98,0.255,03/01/2023,2023.0
72,Providence (Big East),5,2-3,34,106,140,0.243,03/01/2023,2023.0
-,Queens (NC) (ASUN),4,1-3,48,56,104,0.462,03/01/2023,2023.0
-,Merrimack (America East),5,3-2,52,76,128,0.406,03/01/2023,2023.0
-,Lindenwood (ASUN),2,1-1,15,29,44,0.341,03/01/2023,2023.0
1,Saint Joseph's (Atlantic 10),3,3-0,65,21,86,0.756,02/28/2023,2023.0
2,Dartmouth (Ivy League),2,2-0,37,15,52,0.712,02/28/2023,2023.0
3,Maryland (Big Ten),4,3-1,67,29,96,0.698,02/28/2023,2023.0
4,Army West Point (Patriot),4,3-1,69,37,106,0.651,02/28/2023,2023.0
5,Denver (Big East),4,2-2,63,34,97,0.649,02/28/2023,2023.0
6,Hofstra (CAA),5,2-3,78,45,123,0.634,02/28/2023,2023.0
7,Lehigh (Patriot),3,2-1,54,34,88,0.614,02/28/2023,2023.0
8,Siena (MAAC),3,2-1,55,35,90,0.611,02/28/2023,2023.0
9,Drexel (CAA),3,1-2,44,29,73,0.603,02/28/2023,2023.0
10,Rutgers (Big Ten),5,4-1,78,52,130,0.600,02/28/2023,2023.0
11,Duke (ACC),5,4-1,86,58,144,0.597,02/28/2023,2023.0
12,Richmond (Atlantic 10),4,3-1,53,36,89,0.596,02/28/2023,2023.0
13,Brown (Ivy League),3,2-1,50,34,84,0.595,02/28/2023,2023.0
14,Delaware (CAA),4,3-1,61,42,103,0.592,02/28/2023,2023.0
15,St. Bonaventure (Atlantic 10),4,1-3,61,43,104,0.587,02/28/2023,2023.0
16,Ohio St. (Big Ten),4,3-1,60,43,103,0.583,02/28/2023,2023.0
17,Vermont (America East),4,2-2,66,48,114,0.579,02/28/2023,2023.0
18,Quinnipiac (MAAC),3,2-1,53,39,92,0.576,02/28/2023,2023.0
19,Michigan (Big Ten),4,2-2,62,49,111,0.559,02/28/2023,2023.0
20,Colgate (Patriot),2,0-2,25,20,45,0.556,02/28/2023,2023.0
21,High Point (Atlantic 10),5,4-1,83,68,151,0.550,02/28/2023,2023.0
22,Boston U. (Patriot),3,2-1,46,38,84,0.548,02/28/2023,2023.0
23,Binghamton (America East),3,2-1,42,35,77,0.545,02/28/2023,2023.0
24,Navy (Patriot),5,3-2,67,57,124,0.540,02/28/2023,2023.0
25,Hobart (Atlantic 10),4,2-2,65,57,122,0.533,02/28/2023,2023.0
26,Virginia (ACC),3,3-0,57,50,107,0.533,02/28/2023,2023.0
27,Villanova (Big East),3,2-1,50,44,94,0.532,02/28/2023,2023.0
28,North Carolina (ACC),4,3-1,56,50,106,0.528,02/28/2023,2023.0
29,Robert Morris (ASUN),3,3-0,38,34,72,0.528,02/28/2023,2023.0
30,Harvard (Ivy League),2,1-1,39,35,74,0.527,02/28/2023,2023.0
31,Georgetown (Big East),3,0-3,40,36,76,0.526,02/28/2023,2023.0
32,Bryant (America East),3,2-1,53,48,101,0.525,02/28/2023,2023.0
33,Stony Brook (CAA),4,2-2,58,53,111,0.523,02/28/2023,2023.0
34,Marquette (Big East),4,2-2,61,56,117,0.521,02/28/2023,2023.0
35,Monmouth (CAA),4,3-1,50,46,96,0.521,02/28/2023,2023.0
36,Mount St. Mary's (MAAC),5,1-4,67,62,129,0.519,02/28/2023,2023.0
37,Fairfield (CAA),4,2-2,54,50,104,0.519,02/28/2023,2023.0
38,Penn St. (Big Ten),4,3-1,64,60,124,0.516,02/28/2023,2023.0
39,VMI (MAAC),5,3-2,72,69,141,0.511,02/28/2023,2023.0
40,Johns Hopkins (Big Ten),5,3-2,62,60,122,0.508,02/28/2023,2023.0
41,Manhattan (MAAC),4,3-1,40,39,79,0.506,02/28/2023,2023.0
42,Princeton (Ivy League),3,2-1,41,40,81,0.506,02/28/2023,2023.0
43,Massachusetts (Atlantic 10),3,2-1,28,29,57,0.491,02/28/2023,2023.0
44,NJIT (America East),4,0-4,49,51,100,0.490,02/28/2023,2023.0
45,Notre Dame (ACC),3,3-0,44,46,90,0.489,02/28/2023,2023.0
46,Cleveland St. (ASUN),2,0-2,31,33,64,0.484,02/28/2023,2023.0
47,Yale (Ivy League),2,1-1,31,34,65,0.477,02/28/2023,2023.0
48,Mercer (ASUN),4,1-3,52,58,110,0.473,02/28/2023,2023.0
49,UAlbany (America East),3,1-2,33,38,71,0.465,02/28/2023,2023.0
50,Holy Cross (Patriot),5,0-5,57,68,125,0.456,02/28/2023,2023.0
51,Marist (MAAC),4,0-4,51,61,112,0.455,02/28/2023,2023.0
52,Towson (CAA),3,1-2,37,45,82,0.451,02/28/2023,2023.0
53,Penn (Ivy League),2,1-1,22,27,49,0.449,02/28/2023,2023.0
54,UMBC (America East),2,2-0,20,25,45,0.444,02/28/2023,2023.0
55,Canisius (MAAC),4,0-4,50,64,114,0.439,02/28/2023,2023.0
56,Bellarmine (ASUN),4,3-1,45,59,104,0.433,02/28/2023,2023.0
57,Syracuse (ACC),5,3-2,58,78,136,0.426,02/28/2023,2023.0
58,LIU (MAAC),4,0-4,38,54,92,0.413,02/28/2023,2023.0
59,Cornell (Ivy League),3,3-0,29,42,71,0.408,02/28/2023,2023.0
60,Hampton (CAA),3,0-3,41,60,101,0.406,02/28/2023,2023.0
61,Lafayette (Patriot),5,2-3,54,81,135,0.400,02/28/2023,2023.0
61,Utah (ASUN),4,1-3,44,66,110,0.400,02/28/2023,2023.0
63,Bucknell (Patriot),4,1-3,41,63,104,0.394,02/28/2023,2023.0
64,Loyola Maryland (Patriot),3,2-1,26,40,66,0.394,02/28/2023,2023.0
65,Wagner (MAAC),4,1-3,37,58,95,0.389,02/28/2023,2023.0
66,UMass Lowell (America East),3,0-3,32,52,84,0.381,02/28/2023,2023.0
67,Sacred Heart (MAAC),4,0-4,41,69,110,0.373,02/28/2023,2023.0
68,Detroit Mercy (ASUN),2,0-2,17,34,51,0.333,02/28/2023,2023.0
69,Air Force (ASUN),4,2-2,30,69,99,0.303,02/28/2023,2023.0
70,Jacksonville (ASUN),3,2-1,21,51,72,0.292,02/28/2023,2023.0
71,St. John's (NY) (Big East),4,0-4,25,73,98,0.255,02/28/2023,2023.0
72,Providence (Big East),5,2-3,34,106,140,0.243,02/28/2023,2023.0
-,Queens (NC) (ASUN),4,1-3,48,56,104,0.462,02/28/2023,2023.0
-,Merrimack (America East),5,3-2,52,76,128,0.406,02/28/2023,2023.0
-,Lindenwood (ASUN),2,1-1,15,29,44,0.341,02/28/2023,2023.0
1,Saint Joseph's (Atlantic 10),3,3-0,65,21,86,0.756,02/26/2023,2023.0
2,Dartmouth (Ivy League),2,2-0,37,15,52,0.712,02/26/2023,2023.0
3,Maryland (Big Ten),4,3-1,67,29,96,0.698,02/26/2023,2023.0
4,Army West Point (Patriot),4,3-1,69,37,106,0.651,02/26/2023,2023.0
5,Denver (Big East),4,2-2,63,34,97,0.649,02/26/2023,2023.0
6,Hofstra (CAA),5,2-3,78,45,123,0.634,02/26/2023,2023.0
7,Lehigh (Patriot),3,2-1,54,34,88,0.614,02/26/2023,2023.0
8,Siena (MAAC),3,2-1,55,35,90,0.611,02/26/2023,2023.0
9,Drexel (CAA),3,1-2,44,29,73,0.603,02/26/2023,2023.0
10,Duke (ACC),5,4-1,86,58,144,0.597,02/26/2023,2023.0
11,Richmond (Atlantic 10),4,3-1,53,36,89,0.596,02/26/2023,2023.0
12,Brown (Ivy League),3,2-1,50,34,84,0.595,02/26/2023,2023.0
13,Delaware (CAA),4,3-1,61,42,103,0.592,02/26/2023,2023.0
14,St. Bonaventure (Atlantic 10),4,1-3,61,43,104,0.587,02/26/2023,2023.0
15,Ohio St. (Big Ten),4,3-1,60,43,103,0.583,02/26/2023,2023.0
16,Vermont (America East),4,2-2,66,48,114,0.579,02/26/2023,2023.0
17,Quinnipiac (MAAC),3,2-1,53,39,92,0.576,02/26/2023,2023.0
18,Robert Morris (ASUN),3,3-0,27,20,47,0.574,02/26/2023,2023.0
19,Rutgers (Big Ten),4,3-1,59,44,103,0.573,02/26/2023,2023.0
20,Michigan (Big Ten),4,2-2,62,49,111,0.559,02/26/2023,2023.0
21,Colgate (Patriot),2,0-2,25,20,45,0.556,02/26/2023,2023.0
22,High Point (Atlantic 10),5,4-1,83,68,151,0.550,02/26/2023,2023.0
23,Boston U. (Patriot),3,2-1,46,38,84,0.548,02/26/2023,2023.0
24,Binghamton (America East),3,2-1,42,35,77,0.545,02/26/2023,2023.0
25,Monmouth (CAA),3,2-1,44,37,81,0.543,02/26/2023,2023.0
26,Navy (Patriot),5,3-2,67,57,124,0.540,02/26/2023,2023.0
27,Virginia (ACC),3,3-0,57,50,107,0.533,02/26/2023,2023.0
28,Hobart (Atlantic 10),3,2-1,50,44,94,0.532,02/26/2023,2023.0
28,Villanova (Big East),3,2-1,50,44,94,0.532,02/26/2023,2023.0
30,North Carolina (ACC),4,3-1,56,50,106,0.528,02/26/2023,2023.0
31,Harvard (Ivy League),2,1-1,39,35,74,0.527,02/26/2023,2023.0
32,Georgetown (Big East),3,0-3,40,36,76,0.526,02/26/2023,2023.0
33,Bryant (America East),3,2-1,53,48,101,0.525,02/26/2023,2023.0
34,Stony Brook (CAA),4,2-2,58,53,111,0.523,02/26/2023,2023.0
35,Marquette (Big East),4,2-2,61,56,117,0.521,02/26/2023,2023.0
36,Mount St. Mary's (MAAC),5,1-4,67,62,129,0.519,02/26/2023,2023.0
37,Fairfield (CAA),4,2-2,54,50,104,0.519,02/26/2023,2023.0
38,Penn St. (Big Ten),4,3-1,64,60,124,0.516,02/26/2023,2023.0
39,VMI (MAAC),5,3-2,72,69,141,0.511,02/26/2023,2023.0
40,Johns Hopkins (Big Ten),5,3-2,62,60,122,0.508,02/26/2023,2023.0
41,Manhattan (MAAC),4,3-1,40,39,79,0.506,02/26/2023,2023.0
42,Princeton (Ivy League),3,2-1,41,40,81,0.506,02/26/2023,2023.0
43,Massachusetts (Atlantic 10),3,2-1,28,29,57,0.491,02/26/2023,2023.0
44,NJIT (America East),4,0-4,49,51,100,0.490,02/26/2023,2023.0
45,Notre Dame (ACC),3,3-0,44,46,90,0.489,02/26/2023,2023.0
46,Cleveland St. (ASUN),2,0-2,31,33,64,0.484,02/26/2023,2023.0
47,Yale (Ivy League),2,1-1,31,34,65,0.477,02/26/2023,2023.0
48,Mercer (ASUN),4,1-3,52,58,110,0.473,02/26/2023,2023.0
49,UAlbany (America East),3,1-2,33,38,71,0.465,02/26/2023,2023.0
50,Holy Cross (Patriot),5,0-5,57,68,125,0.456,02/26/2023,2023.0
51,Marist (MAAC),4,0-4,51,61,112,0.455,02/26/2023,2023.0
52,Towson (CAA),3,1-2,37,45,82,0.451,02/26/2023,2023.0
53,Penn (Ivy League),2,1-1,22,27,49,0.449,02/26/2023,2023.0
54,UMBC (America East),2,2-0,20,25,45,0.444,02/26/2023,2023.0
55,Bellarmine (ASUN),4,3-1,45,59,104,0.433,02/26/2023,2023.0
56,Syracuse (ACC),5,3-2,58,78,136,0.426,02/26/2023,2023.0
57,LIU (MAAC),4,0-4,38,54,92,0.413,02/26/2023,2023.0
58,Hampton (CAA),3,0-3,41,60,101,0.406,02/26/2023,2023.0
59,Canisius (MAAC),4,0-4,36,53,89,0.404,02/26/2023,2023.0
60,Lafayette (Patriot),5,2-3,54,81,135,0.400,02/26/2023,2023.0
60,Utah (ASUN),4,1-3,44,66,110,0.400,02/26/2023,2023.0
62,Bucknell (Patriot),4,1-3,41,63,104,0.394,02/26/2023,2023.0
63,Loyola Maryland (Patriot),3,2-1,26,40,66,0.394,02/26/2023,2023.0
64,UMass Lowell (America East),3,0-3,32,52,84,0.381,02/26/2023,2023.0
65,Sacred Heart (MAAC),4,0-4,41,69,110,0.373,02/26/2023,2023.0
66,Cornell (Ivy League),2,2-0,16,27,43,0.372,02/26/2023,2023.0
67,Wagner (MAAC),3,1-2,28,52,80,0.350,02/26/2023,2023.0
68,Detroit Mercy (ASUN),2,0-2,17,34,51,0.333,02/26/2023,2023.0
69,Air Force (ASUN),4,2-2,30,69,99,0.303,02/26/2023,2023.0
70,Jacksonville (ASUN),3,2-1,21,51,72,0.292,02/26/2023,2023.0
71,Providence (Big East),5,2-3,34,106,140,0.243,02/26/2023,2023.0
72,St. John's (NY) (Big East),3,0-3,17,54,71,0.239,02/26/2023,2023.0
-,Queens (NC) (ASUN),4,1-3,48,56,104,0.462,02/26/2023,2023.0
-,Merrimack (America East),5,3-2,52,76,128,0.406,02/26/2023,2023.0
-,Lindenwood (ASUN),2,1-1,15,29,44,0.341,02/26/2023,2023.0
1,Maryland (Big Ten),3,2-1,54,22,76,0.711,02/22/2023,2023.0
2,Army West Point (Patriot),3,2-1,56,25,81,0.691,02/22/2023,2023.0
3,Saint Joseph's (Atlantic 10),2,2-0,39,19,58,0.672,02/22/2023,2023.0
4,Dartmouth (Ivy League),1,1-0,17,9,26,0.654,02/22/2023,2023.0
5,Vermont (America East),3,2-1,49,27,76,0.645,02/22/2023,2023.0
6,Delaware (CAA),3,3-0,47,27,74,0.635,02/22/2023,2023.0
7,Brown (Ivy League),2,1-1,29,17,46,0.630,02/22/2023,2023.0
8,Richmond (Atlantic 10),2,1-1,30,18,48,0.625,02/22/2023,2023.0
8,Colgate (Patriot),1,0-1,15,9,24,0.625,02/22/2023,2023.0
10,Siena (MAAC),2,1-1,36,22,58,0.621,02/22/2023,2023.0
11,Denver (Big East),3,1-2,44,27,71,0.620,02/22/2023,2023.0
12,Drexel (CAA),2,1-1,33,21,54,0.611,02/22/2023,2023.0
13,Quinnipiac (MAAC),2,2-0,36,23,59,0.610,02/22/2023,2023.0
14,Hofstra (CAA),4,1-3,57,37,94,0.606,02/22/2023,2023.0
15,Ohio St. (Big Ten),3,3-0,46,31,77,0.597,02/22/2023,2023.0
16,Duke (ACC),4,3-1,68,47,115,0.591,02/22/2023,2023.0
17,Rutgers (Big Ten),3,2-1,49,34,83,0.590,02/22/2023,2023.0
18,Lehigh (Patriot),2,2-0,40,28,68,0.588,02/22/2023,2023.0
19,High Point (Atlantic 10),3,2-1,47,34,81,0.580,02/22/2023,2023.0
20,Robert Morris (ASUN),2,2-0,27,20,47,0.574,02/22/2023,2023.0
21,VMI (MAAC),4,3-1,65,50,115,0.565,02/22/2023,2023.0
22,Michigan (Big Ten),3,2-1,48,37,85,0.565,02/22/2023,2023.0
23,Princeton (Ivy League),2,2-0,34,27,61,0.557,02/22/2023,2023.0
24,Virginia (ACC),2,2-0,45,36,81,0.556,02/22/2023,2023.0
25,Binghamton (America East),2,2-0,33,27,60,0.550,02/22/2023,2023.0
25,Penn (Ivy League),1,1-0,11,9,20,0.550,02/22/2023,2023.0
27,Boston U. (Patriot),2,1-1,35,29,64,0.547,02/22/2023,2023.0
28,Bryant (America East),2,1-1,37,31,68,0.544,02/22/2023,2023.0
29,Fairfield (CAA),3,2-1,45,38,83,0.542,02/22/2023,2023.0
30,Marquette (Big East),3,1-2,49,42,91,0.538,02/22/2023,2023.0
30,St. Bonaventure (Atlantic 10),3,0-3,42,36,78,0.538,02/22/2023,2023.0
30,Villanova (Big East),2,1-1,35,30,65,0.538,02/22/2023,2023.0
33,Hobart (Atlantic 10),2,1-1,39,34,73,0.534,02/22/2023,2023.0
34,Notre Dame (ACC),2,2-0,33,30,63,0.524,02/22/2023,2023.0
35,North Carolina (ACC),3,2-1,37,34,71,0.521,02/22/2023,2023.0
36,Penn St. (Big Ten),3,2-1,50,46,96,0.521,02/22/2023,2023.0
37,Holy Cross (Patriot),4,0-4,51,48,99,0.515,02/22/2023,2023.0
38,Massachusetts (Atlantic 10),2,2-0,19,18,37,0.514,02/22/2023,2023.0
39,Johns Hopkins (Big Ten),4,2-2,50,48,98,0.510,02/22/2023,2023.0
40,NJIT (America East),3,0-3,39,38,77,0.506,02/22/2023,2023.0
41,Mount St. Mary's (MAAC),4,1-3,52,52,104,0.500,02/22/2023,2023.0
41,UMBC (America East),1,1-0,10,10,20,0.500,02/22/2023,2023.0
43,Navy (Patriot),4,3-1,46,47,93,0.495,02/22/2023,2023.0
44,Monmouth (CAA),2,1-1,30,31,61,0.492,02/22/2023,2023.0
45,Georgetown (Big East),2,0-2,24,25,49,0.490,02/22/2023,2023.0
46,Cleveland St. (ASUN),2,0-2,31,33,64,0.484,02/22/2023,2023.0
47,Manhattan (MAAC),3,2-1,27,29,56,0.482,02/22/2023,2023.0
48,UAlbany (America East),2,0-2,25,27,52,0.481,02/22/2023,2023.0
49,Mercer (ASUN),3,1-2,40,45,85,0.471,02/22/2023,2023.0
50,Yale (Ivy League),1,1-0,17,20,37,0.459,02/22/2023,2023.0
51,Hampton (CAA),2,0-2,28,34,62,0.452,02/22/2023,2023.0
51,Towson (CAA),2,1-1,28,34,62,0.452,02/22/2023,2023.0
53,Harvard (Ivy League),1,0-1,22,27,49,0.449,02/22/2023,2023.0
54,LIU (MAAC),3,0-3,32,40,72,0.444,02/22/2023,2023.0
54,Stony Brook (CAA),2,0-2,24,30,54,0.444,02/22/2023,2023.0
56,Cornell (Ivy League),1,1-0,10,13,23,0.435,02/22/2023,2023.0
57,Marist (MAAC),3,0-3,37,49,86,0.430,02/22/2023,2023.0
58,Bellarmine (ASUN),3,2-1,33,45,78,0.423,02/22/2023,2023.0
59,Bucknell (Patriot),3,1-2,33,46,79,0.418,02/22/2023,2023.0
60,Syracuse (ACC),4,3-1,42,59,101,0.416,02/22/2023,2023.0
61,Canisius (MAAC),3,0-3,36,53,89,0.404,02/22/2023,2023.0
62,Lafayette (Patriot),4,1-3,46,72,118,0.390,02/22/2023,2023.0
63,Utah (ASUN),3,1-2,32,54,86,0.372,02/22/2023,2023.0
64,Sacred Heart (MAAC),3,0-3,29,50,79,0.367,02/22/2023,2023.0
65,UMass Lowell (America East),2,0-2,19,33,52,0.365,02/22/2023,2023.0
66,Loyola Maryland (Patriot),2,2-0,16,30,46,0.348,02/22/2023,2023.0
67,Detroit Mercy (ASUN),2,0-2,17,34,51,0.333,02/22/2023,2023.0
68,Jacksonville (ASUN),3,2-1,21,51,72,0.292,02/22/2023,2023.0
69,Providence (Big East),4,2-2,32,80,112,0.286,02/22/2023,2023.0
70,Wagner (MAAC),2,0-2,15,39,54,0.278,02/22/2023,2023.0
71,Air Force (ASUN),3,2-1,19,54,73,0.260,02/22/2023,2023.0
72,St. John's (NY) (Big East),2,0-2,9,33,42,0.214,02/22/2023,2023.0
-,Queens (NC) (ASUN),3,1-2,35,43,78,0.449,02/22/2023,2023.0
-,Merrimack (America East),4,3-1,45,57,102,0.441,02/22/2023,2023.0
-,Lindenwood (ASUN),2,1-1,15,29,44,0.341,02/22/2023,2023.0
1,Maryland (Big Ten),3,2-1,54,22,76,0.711,02/21/2023,2023.0
2,Army West Point (Patriot),3,2-1,56,25,81,0.691,02/21/2023,2023.0
3,Saint Joseph's (Atlantic 10),2,2-0,39,19,58,0.672,02/21/2023,2023.0
4,Dartmouth (Ivy League),1,1-0,17,9,26,0.654,02/21/2023,2023.0
5,Vermont (America East),3,2-1,49,27,76,0.645,02/21/2023,2023.0
6,Delaware (CAA),3,3-0,47,27,74,0.635,02/21/2023,2023.0
7,Brown (Ivy League),2,1-1,29,17,46,0.630,02/21/2023,2023.0
8,Richmond (Atlantic 10),2,1-1,30,18,48,0.625,02/21/2023,2023.0
8,Colgate (Patriot),1,0-1,15,9,24,0.625,02/21/2023,2023.0
10,Siena (MAAC),2,1-1,36,22,58,0.621,02/21/2023,2023.0
11,Denver (Big East),3,1-2,44,27,71,0.620,02/21/2023,2023.0
12,Drexel (CAA),2,1-1,33,21,54,0.611,02/21/2023,2023.0
13,Quinnipiac (MAAC),2,2-0,36,23,59,0.610,02/21/2023,2023.0
14,Hofstra (CAA),4,1-3,57,37,94,0.606,02/21/2023,2023.0
15,Ohio St. (Big Ten),3,3-0,46,31,77,0.597,02/21/2023,2023.0
16,Duke (ACC),4,3-1,68,47,115,0.591,02/21/2023,2023.0
17,Rutgers (Big Ten),3,2-1,49,34,83,0.590,02/21/2023,2023.0
18,Lehigh (Patriot),2,2-0,40,28,68,0.588,02/21/2023,2023.0
19,High Point (Atlantic 10),3,2-1,47,34,81,0.580,02/21/2023,2023.0
20,Robert Morris (ASUN),2,2-0,27,20,47,0.574,02/21/2023,2023.0
21,VMI (MAAC),4,3-1,65,50,115,0.565,02/21/2023,2023.0
22,Michigan (Big Ten),3,2-1,48,37,85,0.565,02/21/2023,2023.0
23,Princeton (Ivy League),2,2-0,34,27,61,0.557,02/21/2023,2023.0
24,Virginia (ACC),2,2-0,45,36,81,0.556,02/21/2023,2023.0
25,Binghamton (America East),2,2-0,33,27,60,0.550,02/21/2023,2023.0
25,Penn (Ivy League),1,1-0,11,9,20,0.550,02/21/2023,2023.0
27,Boston U. (Patriot),2,1-1,35,29,64,0.547,02/21/2023,2023.0
28,Bryant (America East),2,1-1,37,31,68,0.544,02/21/2023,2023.0
29,Marquette (Big East),3,1-2,49,42,91,0.538,02/21/2023,2023.0
29,St. Bonaventure (Atlantic 10),3,0-3,42,36,78,0.538,02/21/2023,2023.0
29,Villanova (Big East),2,1-1,35,30,65,0.538,02/21/2023,2023.0
32,Hobart (Atlantic 10),2,1-1,39,34,73,0.534,02/21/2023,2023.0
33,Notre Dame (ACC),2,2-0,33,30,63,0.524,02/21/2023,2023.0
34,North Carolina (ACC),3,2-1,37,34,71,0.521,02/21/2023,2023.0
35,Penn St. (Big Ten),3,2-1,50,46,96,0.521,02/21/2023,2023.0
36,Holy Cross (Patriot),4,0-4,51,48,99,0.515,02/21/2023,2023.0
37,Massachusetts (Atlantic 10),2,2-0,19,18,37,0.514,02/21/2023,2023.0
38,Johns Hopkins (Big Ten),4,2-2,50,48,98,0.510,02/21/2023,2023.0
39,NJIT (America East),3,0-3,39,38,77,0.506,02/21/2023,2023.0
40,Mount St. Mary's (MAAC),4,1-3,52,52,104,0.500,02/21/2023,2023.0
40,UMBC (America East),1,1-0,10,10,20,0.500,02/21/2023,2023.0
42,Navy (Patriot),4,3-1,46,47,93,0.495,02/21/2023,2023.0
43,Monmouth (CAA),2,1-1,30,31,61,0.492,02/21/2023,2023.0
44,Georgetown (Big East),2,0-2,24,25,49,0.490,02/21/2023,2023.0
45,Cleveland St. (ASUN),2,0-2,31,33,64,0.484,02/21/2023,2023.0
46,Manhattan (MAAC),3,2-1,27,29,56,0.482,02/21/2023,2023.0
47,Cornell (Ivy League),1,1-0,11,12,23,0.478,02/21/2023,2023.0
48,Fairfield (CAA),2,1-1,27,30,57,0.474,02/21/2023,2023.0
49,Mercer (ASUN),3,1-2,40,45,85,0.471,02/21/2023,2023.0
50,UAlbany (America East),2,0-2,24,28,52,0.462,02/21/2023,2023.0
51,Yale (Ivy League),1,1-0,17,20,37,0.459,02/21/2023,2023.0
52,Hampton (CAA),2,0-2,28,34,62,0.452,02/21/2023,2023.0
52,Towson (CAA),2,1-1,28,34,62,0.452,02/21/2023,2023.0
54,Harvard (Ivy League),1,0-1,22,27,49,0.449,02/21/2023,2023.0
55,LIU (MAAC),3,0-3,32,40,72,0.444,02/21/2023,2023.0
55,Stony Brook (CAA),2,0-2,24,30,54,0.444,02/21/2023,2023.0
57,Marist (MAAC),3,0-3,37,49,86,0.430,02/21/2023,2023.0
58,Bellarmine (ASUN),3,2-1,33,45,78,0.423,02/21/2023,2023.0
59,Bucknell (Patriot),3,1-2,33,46,79,0.418,02/21/2023,2023.0
60,Syracuse (ACC),4,3-1,42,59,101,0.416,02/21/2023,2023.0
61,Canisius (MAAC),3,0-3,36,53,89,0.404,02/21/2023,2023.0
62,Sacred Heart (MAAC),2,0-2,21,32,53,0.396,02/21/2023,2023.0
63,Lafayette (Patriot),4,1-3,46,72,118,0.390,02/21/2023,2023.0
64,Utah (ASUN),3,1-2,32,54,86,0.372,02/21/2023,2023.0
65,UMass Lowell (America East),2,0-2,19,33,52,0.365,02/21/2023,2023.0
66,Loyola Maryland (Patriot),2,2-0,16,30,46,0.348,02/21/2023,2023.0
67,Detroit Mercy (ASUN),2,0-2,17,34,51,0.333,02/21/2023,2023.0
68,Jacksonville (ASUN),3,2-1,21,51,72,0.292,02/21/2023,2023.0
69,Providence (Big East),4,2-2,32,80,112,0.286,02/21/2023,2023.0
70,Wagner (MAAC),2,0-2,15,39,54,0.278,02/21/2023,2023.0
71,Air Force (ASUN),3,2-1,19,54,73,0.260,02/21/2023,2023.0
72,St. John's (NY) (Big East),2,0-2,9,33,42,0.214,02/21/2023,2023.0
-,Queens (NC) (ASUN),3,1-2,35,43,78,0.449,02/21/2023,2023.0
-,Merrimack (America East),4,3-1,45,57,102,0.441,02/21/2023,2023.0
-,Lindenwood (ASUN),2,1-1,15,29,44,0.341,02/21/2023,2023.0
1,Maryland (Big Ten),3,2-1,54,22,76,0.711,02/19/2023,2023.0
2,Saint Joseph's (Atlantic 10),2,2-0,39,19,58,0.672,02/19/2023,2023.0
3,Dartmouth (Ivy League),1,1-0,17,9,26,0.654,02/19/2023,2023.0
4,Delaware (CAA),3,3-0,47,27,74,0.635,02/19/2023,2023.0
5,Quinnipiac (MAAC),2,2-0,37,22,59,0.627,02/19/2023,2023.0
6,Colgate (Patriot),1,0-1,15,9,24,0.625,02/19/2023,2023.0
6,Robert Morris (ASUN),1,1-0,15,9,24,0.625,02/19/2023,2023.0
8,Siena (MAAC),2,1-1,36,22,58,0.621,02/19/2023,2023.0
9,Denver (Big East),3,1-2,44,27,71,0.620,02/19/2023,2023.0
10,Richmond (Atlantic 10),2,1-1,29,18,47,0.617,02/19/2023,2023.0
11,Army West Point (Patriot),2,1-1,31,20,51,0.608,02/19/2023,2023.0
12,Ohio St. (Big Ten),3,3-0,46,31,77,0.597,02/19/2023,2023.0
13,Duke (ACC),4,3-1,68,47,115,0.591,02/19/2023,2023.0
14,Rutgers (Big Ten),3,2-1,49,34,83,0.590,02/19/2023,2023.0
15,High Point (Atlantic 10),3,2-1,47,33,80,0.588,02/19/2023,2023.0
16,LIU (MAAC),2,0-2,28,21,49,0.571,02/19/2023,2023.0
17,Manhattan (MAAC),2,2-0,17,13,30,0.567,02/19/2023,2023.0
18,St. Bonaventure (Atlantic 10),2,0-2,31,24,55,0.564,02/19/2023,2023.0
19,Hobart (Atlantic 10),2,1-1,41,32,73,0.562,02/19/2023,2023.0
20,Lehigh (Patriot),2,2-0,38,30,68,0.559,02/19/2023,2023.0
21,Virginia (ACC),2,2-0,45,36,81,0.556,02/19/2023,2023.0
22,VMI (MAAC),3,2-1,44,36,80,0.550,02/19/2023,2023.0
22,Binghamton (America East),2,2-0,33,27,60,0.550,02/19/2023,2023.0
22,Penn (Ivy League),1,1-0,11,9,20,0.550,02/19/2023,2023.0
25,Boston U. (Patriot),2,1-1,35,29,64,0.547,02/19/2023,2023.0
26,Michigan (Big Ten),2,1-1,30,25,55,0.545,02/19/2023,2023.0
27,Bryant (America East),2,1-1,37,31,68,0.544,02/19/2023,2023.0
28,Marquette (Big East),3,1-2,49,42,91,0.538,02/19/2023,2023.0
28,Villanova (Big East),2,1-1,35,30,65,0.538,02/19/2023,2023.0
30,Hofstra (CAA),3,0-3,38,33,71,0.535,02/19/2023,2023.0
31,Vermont (America East),2,1-1,24,21,45,0.533,02/19/2023,2023.0
32,Notre Dame (ACC),2,2-0,33,30,63,0.524,02/19/2023,2023.0
33,North Carolina (ACC),3,2-1,37,34,71,0.521,02/19/2023,2023.0
34,Penn St. (Big Ten),3,2-1,50,46,96,0.521,02/19/2023,2023.0
35,Princeton (Ivy League),1,1-0,18,17,35,0.514,02/19/2023,2023.0
36,Massachusetts (Atlantic 10),2,2-0,19,18,37,0.514,02/19/2023,2023.0
37,Johns Hopkins (Big Ten),4,2-2,50,48,98,0.510,02/19/2023,2023.0
38,NJIT (America East),2,0-2,26,25,51,0.510,02/19/2023,2023.0
39,Mount St. Mary's (MAAC),4,1-3,52,52,104,0.500,02/19/2023,2023.0
39,Holy Cross (Patriot),3,0-3,38,38,76,0.500,02/19/2023,2023.0
39,Hampton (CAA),1,0-1,14,14,28,0.500,02/19/2023,2023.0
39,Drexel (CAA),1,0-1,10,10,20,0.500,02/19/2023,2023.0
39,UMBC (America East),1,1-0,10,10,20,0.500,02/19/2023,2023.0
44,Navy (Patriot),4,3-1,46,47,93,0.495,02/19/2023,2023.0
45,Georgetown (Big East),2,0-2,24,25,49,0.490,02/19/2023,2023.0
46,Monmouth (CAA),1,0-1,17,18,35,0.486,02/19/2023,2023.0
47,Cleveland St. (ASUN),2,0-2,31,33,64,0.484,02/19/2023,2023.0
48,Mercer (ASUN),2,0-2,30,32,62,0.484,02/19/2023,2023.0
49,Cornell (Ivy League),1,1-0,11,12,23,0.478,02/19/2023,2023.0
50,Fairfield (CAA),2,1-1,27,30,57,0.474,02/19/2023,2023.0
51,Utah (ASUN),2,1-1,26,29,55,0.473,02/19/2023,2023.0
52,UAlbany (America East),2,0-2,24,28,52,0.462,02/19/2023,2023.0
53,Yale (Ivy League),1,1-0,17,20,37,0.459,02/19/2023,2023.0
54,Towson (CAA),2,1-1,28,34,62,0.452,02/19/2023,2023.0
55,Harvard (Ivy League),1,0-1,22,27,49,0.449,02/19/2023,2023.0
56,Stony Brook (CAA),2,0-2,24,30,54,0.444,02/19/2023,2023.0
57,Marist (MAAC),3,0-3,37,49,86,0.430,02/19/2023,2023.0
58,Bucknell (Patriot),3,1-2,33,45,78,0.423,02/19/2023,2023.0
59,Lafayette (Patriot),3,1-2,35,49,84,0.417,02/19/2023,2023.0
59,Wagner (MAAC),1,0-1,10,14,24,0.417,02/19/2023,2023.0
61,Syracuse (ACC),4,3-1,42,59,101,0.416,02/19/2023,2023.0
62,Sacred Heart (MAAC),2,0-2,21,32,53,0.396,02/19/2023,2023.0
63,Brown (Ivy League),1,0-1,9,14,23,0.391,02/19/2023,2023.0
64,Bellarmine (ASUN),2,1-1,22,35,57,0.386,02/19/2023,2023.0
65,Canisius (MAAC),1,0-1,14,24,38,0.368,02/19/2023,2023.0
66,UMass Lowell (America East),2,0-2,19,33,52,0.365,02/19/2023,2023.0
67,Loyola Maryland (Patriot),2,2-0,16,30,46,0.348,02/19/2023,2023.0
68,Detroit Mercy (ASUN),2,0-2,17,34,51,0.333,02/19/2023,2023.0
69,Providence (Big East),3,2-1,28,61,89,0.315,02/19/2023,2023.0
70,Jacksonville (ASUN),3,2-1,21,51,72,0.292,02/19/2023,2023.0
71,Air Force (ASUN),3,2-1,19,54,73,0.260,02/19/2023,2023.0
72,St. John's (NY) (Big East),2,0-2,9,33,42,0.214,02/19/2023,2023.0
-,Queens (NC) (ASUN),3,1-2,35,43,78,0.449,02/19/2023,2023.0
-,Merrimack (America East),4,3-1,45,57,102,0.441,02/19/2023,2023.0
-,Lindenwood (ASUN),2,1-1,15,29,44,0.341,02/19/2023,2023.0
1,Manhattan (MAAC),1,1-0,12,3,15,0.800,02/15/2023,2023.0
2,Saint Joseph's (Atlantic 10),1,1-0,19,7,26,0.731,02/15/2023,2023.0
3,Rutgers (Big Ten),2,2-0,38,15,53,0.717,02/15/2023,2023.0
4,Denver (Big East),2,1-1,30,13,43,0.698,02/15/2023,2023.0
5,Bryant (America East),1,1-0,23,10,33,0.697,02/15/2023,2023.0
6,Maryland (Big Ten),2,1-1,30,15,45,0.667,02/15/2023,2023.0
7,Ohio St. (Big Ten),2,2-0,39,21,60,0.650,02/15/2023,2023.0
8,Hofstra (CAA),2,0-2,31,17,48,0.646,02/15/2023,2023.0
9,Quinnipiac (MAAC),1,1-0,23,13,36,0.639,02/15/2023,2023.0
10,Binghamton (America East),1,1-0,21,12,33,0.636,02/15/2023,2023.0
11,VMI (MAAC),2,2-0,33,19,52,0.635,02/15/2023,2023.0
12,Hobart (Atlantic 10),1,1-0,24,14,38,0.632,02/15/2023,2023.0
13,Robert Morris (ASUN),1,1-0,15,9,24,0.625,02/15/2023,2023.0
14,Duke (ACC),3,2-1,54,33,87,0.621,02/15/2023,2023.0
15,Lehigh (Patriot),1,1-0,20,13,33,0.606,02/15/2023,2023.0
16,High Point (Atlantic 10),2,1-1,30,22,52,0.577,02/15/2023,2023.0
17,LIU (MAAC),1,0-1,16,12,28,0.571,02/15/2023,2023.0
17,St. Bonaventure (Atlantic 10),1,0-1,16,12,28,0.571,02/15/2023,2023.0
17,Army West Point (Patriot),1,0-1,12,9,21,0.571,02/15/2023,2023.0
20,Virginia (ACC),1,1-0,18,14,32,0.563,02/15/2023,2023.0
21,Penn St. (Big Ten),2,1-1,35,28,63,0.556,02/15/2023,2023.0
22,Delaware (CAA),2,2-0,26,21,47,0.553,02/15/2023,2023.0
23,Marquette (Big East),3,1-2,49,42,91,0.538,02/15/2023,2023.0
24,Villanova (Big East),1,1-0,15,13,28,0.536,02/15/2023,2023.0
25,Vermont (America East),2,1-1,24,21,45,0.533,02/15/2023,2023.0
25,Towson (CAA),1,1-0,16,14,30,0.533,02/15/2023,2023.0
27,Georgetown (Big East),1,0-1,15,14,29,0.517,02/15/2023,2023.0
28,Notre Dame (ACC),1,1-0,17,16,33,0.515,02/15/2023,2023.0
29,Johns Hopkins (Big Ten),3,2-1,38,36,74,0.514,02/15/2023,2023.0
30,Mount St. Mary's (MAAC),3,0-3,40,39,79,0.506,02/15/2023,2023.0
31,Holy Cross (Patriot),3,0-3,38,38,76,0.500,02/15/2023,2023.0
31,Syracuse (ACC),3,3-0,35,35,70,0.500,02/15/2023,2023.0
31,Bucknell (Patriot),2,1-1,27,27,54,0.500,02/15/2023,2023.0
31,North Carolina (ACC),2,2-0,27,27,54,0.500,02/15/2023,2023.0
31,Cleveland St. (ASUN),1,0-1,17,17,34,0.500,02/15/2023,2023.0
31,NJIT (America East),1,0-1,13,13,26,0.500,02/15/2023,2023.0
31,Siena (MAAC),1,1-0,13,13,26,0.500,02/15/2023,2023.0
38,Mercer (ASUN),2,0-2,30,32,62,0.484,02/15/2023,2023.0
39,Boston U. (Patriot),1,0-1,14,15,29,0.483,02/15/2023,2023.0
40,Richmond (Atlantic 10),1,0-1,11,12,23,0.478,02/15/2023,2023.0
41,Utah (ASUN),2,1-1,26,29,55,0.473,02/15/2023,2023.0
42,Navy (Patriot),3,3-0,36,42,78,0.462,02/15/2023,2023.0
43,Michigan (Big Ten),1,0-1,14,18,32,0.438,02/15/2023,2023.0
44,Massachusetts (Atlantic 10),1,1-0,9,12,21,0.429,02/15/2023,2023.0
45,UAlbany (America East),1,0-1,12,17,29,0.414,02/15/2023,2023.0
46,Fairfield (CAA),1,0-1,13,20,33,0.394,02/15/2023,2023.0
47,Bellarmine (ASUN),2,1-1,22,35,57,0.386,02/15/2023,2023.0
47,Lafayette (Patriot),2,0-2,22,35,57,0.386,02/15/2023,2023.0
49,Canisius (MAAC),1,0-1,14,24,38,0.368,02/15/2023,2023.0
50,UMass Lowell (America East),1,0-1,13,23,36,0.361,02/15/2023,2023.0
51,Providence (Big East),2,1-1,19,38,57,0.333,02/15/2023,2023.0
51,Detroit Mercy (ASUN),2,0-2,17,34,51,0.333,02/15/2023,2023.0
53,Marist (MAAC),2,0-2,21,44,65,0.323,02/15/2023,2023.0
54,Jacksonville (ASUN),2,1-1,16,35,51,0.314,02/15/2023,2023.0
55,Stony Brook (CAA),1,0-1,6,15,21,0.286,02/15/2023,2023.0
56,Sacred Heart (MAAC),1,0-1,7,19,26,0.269,02/15/2023,2023.0
57,Air Force (ASUN),2,1-1,10,39,49,0.204,02/15/2023,2023.0
58,St. John's (NY) (Big East),1,0-1,3,12,15,0.200,02/15/2023,2023.0
59,Loyola Maryland (Patriot),1,1-0,4,18,22,0.182,02/15/2023,2023.0
-,Merrimack (America East),3,3-0,36,40,76,0.474,02/15/2023,2023.0
-,Queens (NC) (ASUN),2,0-2,21,29,50,0.420,02/15/2023,2023.0
-,Lindenwood (ASUN),1,0-1,6,17,23,0.261,02/15/2023,2023.0
1,Manhattan (MAAC),1,1-0,12,3,15,0.800,02/14/2023,2023.0
2,Saint Joseph's (Atlantic 10),1,1-0,19,7,26,0.731,02/14/2023,2023.0
3,Rutgers (Big Ten),2,2-0,38,15,53,0.717,02/14/2023,2023.0
4,Denver (Big East),2,1-1,30,13,43,0.698,02/14/2023,2023.0
5,Bryant (America East),1,1-0,23,10,33,0.697,02/14/2023,2023.0
6,Maryland (Big Ten),2,1-1,30,15,45,0.667,02/14/2023,2023.0
7,Ohio St. (Big Ten),2,2-0,39,21,60,0.650,02/14/2023,2023.0
8,Hofstra (CAA),2,0-2,31,17,48,0.646,02/14/2023,2023.0
9,Quinnipiac (MAAC),1,1-0,23,13,36,0.639,02/14/2023,2023.0
10,Binghamton (America East),1,1-0,21,12,33,0.636,02/14/2023,2023.0
11,VMI (MAAC),2,2-0,33,19,52,0.635,02/14/2023,2023.0
12,Hobart (Atlantic 10),1,1-0,24,14,38,0.632,02/14/2023,2023.0
13,Robert Morris (ASUN),1,1-0,15,9,24,0.625,02/14/2023,2023.0
14,Duke (ACC),3,2-1,54,33,87,0.621,02/14/2023,2023.0
15,Lehigh (Patriot),1,1-0,20,13,33,0.606,02/14/2023,2023.0
16,Delaware (CAA),1,1-0,13,9,22,0.591,02/14/2023,2023.0
17,High Point (Atlantic 10),2,1-1,30,22,52,0.577,02/14/2023,2023.0
18,LIU (MAAC),1,0-1,16,12,28,0.571,02/14/2023,2023.0
18,St. Bonaventure (Atlantic 10),1,0-1,16,12,28,0.571,02/14/2023,2023.0
18,Army West Point (Patriot),1,0-1,12,9,21,0.571,02/14/2023,2023.0
21,Marquette (Big East),2,1-1,33,25,58,0.569,02/14/2023,2023.0
22,Virginia (ACC),1,1-0,18,14,32,0.563,02/14/2023,2023.0
23,Penn St. (Big Ten),2,1-1,35,28,63,0.556,02/14/2023,2023.0
24,Villanova (Big East),1,1-0,15,13,28,0.536,02/14/2023,2023.0
25,Vermont (America East),2,1-1,24,21,45,0.533,02/14/2023,2023.0
25,Towson (CAA),1,1-0,16,14,30,0.533,02/14/2023,2023.0
27,Mount St. Mary's (MAAC),2,0-2,28,26,54,0.519,02/14/2023,2023.0
28,Georgetown (Big East),1,0-1,15,14,29,0.517,02/14/2023,2023.0
29,Johns Hopkins (Big Ten),3,2-1,38,36,74,0.514,02/14/2023,2023.0
30,Holy Cross (Patriot),3,0-3,38,38,76,0.500,02/14/2023,2023.0
30,Syracuse (ACC),3,3-0,35,35,70,0.500,02/14/2023,2023.0
30,Bucknell (Patriot),2,1-1,27,27,54,0.500,02/14/2023,2023.0
30,North Carolina (ACC),2,2-0,27,27,54,0.500,02/14/2023,2023.0
30,Cleveland St. (ASUN),1,0-1,17,17,34,0.500,02/14/2023,2023.0
30,NJIT (America East),1,0-1,13,13,26,0.500,02/14/2023,2023.0
30,Siena (MAAC),1,1-0,13,13,26,0.500,02/14/2023,2023.0
37,Mercer (ASUN),2,0-2,30,32,62,0.484,02/14/2023,2023.0
38,Boston U. (Patriot),1,0-1,14,15,29,0.483,02/14/2023,2023.0
39,Richmond (Atlantic 10),1,0-1,11,12,23,0.478,02/14/2023,2023.0
40,Utah (ASUN),2,1-1,26,29,55,0.473,02/14/2023,2023.0
41,Navy (Patriot),3,3-0,36,42,78,0.462,02/14/2023,2023.0
42,Michigan (Big Ten),1,0-1,14,18,32,0.438,02/14/2023,2023.0
43,Massachusetts (Atlantic 10),1,1-0,9,12,21,0.429,02/14/2023,2023.0
44,UAlbany (America East),1,0-1,12,17,29,0.414,02/14/2023,2023.0
45,Fairfield (CAA),1,0-1,13,20,33,0.394,02/14/2023,2023.0
46,Bellarmine (ASUN),2,1-1,22,35,57,0.386,02/14/2023,2023.0
46,Lafayette (Patriot),2,0-2,22,35,57,0.386,02/14/2023,2023.0
48,Canisius (MAAC),1,0-1,14,24,38,0.368,02/14/2023,2023.0
49,UMass Lowell (America East),1,0-1,13,23,36,0.361,02/14/2023,2023.0
50,Providence (Big East),2,1-1,19,38,57,0.333,02/14/2023,2023.0
50,Detroit Mercy (ASUN),2,0-2,17,34,51,0.333,02/14/2023,2023.0
52,Marist (MAAC),2,0-2,21,44,65,0.323,02/14/2023,2023.0
53,Jacksonville (ASUN),2,1-1,16,35,51,0.314,02/14/2023,2023.0
54,Stony Brook (CAA),1,0-1,6,15,21,0.286,02/14/2023,2023.0
55,Sacred Heart (MAAC),1,0-1,7,19,26,0.269,02/14/2023,2023.0
56,Air Force (ASUN),2,1-1,10,39,49,0.204,02/14/2023,2023.0
57,St. John's (NY) (Big East),1,0-1,3,12,15,0.200,02/14/2023,2023.0
58,Loyola Maryland (Patriot),1,1-0,4,18,22,0.182,02/14/2023,2023.0
-,Merrimack (America East),3,3-0,36,40,76,0.474,02/14/2023,2023.0
-,Queens (NC) (ASUN),2,0-2,21,29,50,0.420,02/14/2023,2023.0
-,Lindenwood (ASUN),1,0-1,6,17,23,0.261,02/14/2023,2023.0
1,Manhattan (MAAC),1,1-0,12,3,15,0.800,02/12/2023,2023.0
2,Saint Joseph's (Atlantic 10),1,1-0,19,7,26,0.731,02/12/2023,2023.0
3,Rutgers (Big Ten),2,2-0,38,15,53,0.717,02/12/2023,2023.0
4,Bryant (America East),1,1-0,23,10,33,0.697,02/12/2023,2023.0
5,Denver (Big East),2,1-1,29,13,42,0.690,02/12/2023,2023.0
6,Maryland (Big Ten),2,1-1,30,15,45,0.667,02/12/2023,2023.0
7,Ohio St. (Big Ten),2,2-0,39,21,60,0.650,02/12/2023,2023.0
8,Hofstra (CAA),2,0-2,31,17,48,0.646,02/12/2023,2023.0
9,Quinnipiac (MAAC),1,1-0,23,13,36,0.639,02/12/2023,2023.0
10,Binghamton (America East),1,1-0,21,12,33,0.636,02/12/2023,2023.0
11,VMI (MAAC),2,2-0,33,19,52,0.635,02/12/2023,2023.0
12,Hobart (Atlantic 10),1,1-0,24,14,38,0.632,02/12/2023,2023.0
13,Robert Morris (ASUN),1,1-0,15,9,24,0.625,02/12/2023,2023.0
14,Duke (ACC),3,2-1,54,33,87,0.621,02/12/2023,2023.0
15,Lehigh (Patriot),1,1-0,20,13,33,0.606,02/12/2023,2023.0
16,Delaware (CAA),1,1-0,13,9,22,0.591,02/12/2023,2023.0
17,High Point (Atlantic 10),2,1-1,30,22,52,0.577,02/12/2023,2023.0
18,LIU (MAAC),1,0-1,16,12,28,0.571,02/12/2023,2023.0
18,Army West Point (Patriot),1,0-1,12,9,21,0.571,02/12/2023,2023.0
20,Marquette (Big East),2,1-1,33,25,58,0.569,02/12/2023,2023.0
21,Virginia (ACC),1,1-0,18,14,32,0.563,02/12/2023,2023.0
22,Johns Hopkins (Big Ten),2,2-0,29,23,52,0.558,02/12/2023,2023.0
23,Penn St. (Big Ten),2,1-1,35,28,63,0.556,02/12/2023,2023.0
24,St. Bonaventure (Atlantic 10),1,0-1,15,13,28,0.536,02/12/2023,2023.0
24,Villanova (Big East),1,1-0,15,13,28,0.536,02/12/2023,2023.0
26,Vermont (America East),2,1-1,24,21,45,0.533,02/12/2023,2023.0
26,Towson (CAA),1,1-0,16,14,30,0.533,02/12/2023,2023.0
28,Mount St. Mary's (MAAC),2,0-2,28,26,54,0.519,02/12/2023,2023.0
29,Georgetown (Big East),1,0-1,15,14,29,0.517,02/12/2023,2023.0
30,Holy Cross (Patriot),3,0-3,38,38,76,0.500,02/12/2023,2023.0
30,Syracuse (ACC),3,3-0,35,35,70,0.500,02/12/2023,2023.0
30,Bucknell (Patriot),2,1-1,27,27,54,0.500,02/12/2023,2023.0
30,Cleveland St. (ASUN),1,0-1,17,17,34,0.500,02/12/2023,2023.0
30,NJIT (America East),1,0-1,13,13,26,0.500,02/12/2023,2023.0
30,Siena (MAAC),1,1-0,13,13,26,0.500,02/12/2023,2023.0
36,Mercer (ASUN),2,0-2,30,32,62,0.484,02/12/2023,2023.0
37,Boston U. (Patriot),1,0-1,14,15,29,0.483,02/12/2023,2023.0
38,Richmond (Atlantic 10),1,0-1,11,12,23,0.478,02/12/2023,2023.0
39,Utah (ASUN),2,1-1,26,29,55,0.473,02/12/2023,2023.0
40,Navy (Patriot),3,3-0,36,42,78,0.462,02/12/2023,2023.0
41,Michigan (Big Ten),1,0-1,14,18,32,0.438,02/12/2023,2023.0
41,North Carolina (ACC),1,1-0,14,18,32,0.438,02/12/2023,2023.0
43,Massachusetts (Atlantic 10),1,1-0,9,12,21,0.429,02/12/2023,2023.0
44,UAlbany (America East),1,0-1,12,17,29,0.414,02/12/2023,2023.0
45,Bellarmine (ASUN),2,1-1,23,34,57,0.404,02/12/2023,2023.0
46,Fairfield (CAA),1,0-1,13,20,33,0.394,02/12/2023,2023.0
47,Lafayette (Patriot),2,0-2,22,35,57,0.386,02/12/2023,2023.0
48,Canisius (MAAC),1,0-1,14,24,38,0.368,02/12/2023,2023.0
49,UMass Lowell (America East),1,0-1,13,23,36,0.361,02/12/2023,2023.0
50,Providence (Big East),2,1-1,19,38,57,0.333,02/12/2023,2023.0
50,Detroit Mercy (ASUN),2,0-2,17,34,51,0.333,02/12/2023,2023.0
52,Marist (MAAC),2,0-2,21,44,65,0.323,02/12/2023,2023.0
53,Jacksonville (ASUN),2,1-1,16,35,51,0.314,02/12/2023,2023.0
54,Stony Brook (CAA),1,0-1,6,15,21,0.286,02/12/2023,2023.0
55,Sacred Heart (MAAC),1,0-1,7,19,26,0.269,02/12/2023,2023.0
56,Air Force (ASUN),2,1-1,10,38,48,0.208,02/12/2023,2023.0
57,St. John's (NY) (Big East),1,0-1,3,12,15,0.200,02/12/2023,2023.0
58,Loyola Maryland (Patriot),1,1-0,4,18,22,0.182,02/12/2023,2023.0
-,Merrimack (America East),3,3-0,36,40,76,0.474,02/12/2023,2023.0
-,Queens (NC) (ASUN),2,0-2,21,29,50,0.420,02/12/2023,2023.0
-,Lindenwood (ASUN),1,0-1,6,17,23,0.261,02/12/2023,2023.0
1,Ohio St. (Big Ten),1,1-0,22,4,26,0.846,02/08/2023,2023.0
2,Marquette (Big East),1,1-0,17,6,23,0.739,02/08/2023,2023.0
3,Rutgers (Big Ten),1,1-0,23,9,32,0.719,02/08/2023,2023.0
4,Hofstra (CAA),1,0-1,15,6,21,0.714,02/08/2023,2023.0
5,VMI (MAAC),1,1-0,19,10,29,0.655,02/08/2023,2023.0
6,Johns Hopkins (Big Ten),1,1-0,15,8,23,0.652,02/08/2023,2023.0
7,Denver (Big East),1,1-0,13,7,20,0.650,02/08/2023,2023.0
8,Penn St. (Big Ten),1,1-0,22,13,35,0.629,02/08/2023,2023.0
9,Bucknell (Patriot),1,1-0,18,12,30,0.600,02/08/2023,2023.0
10,Mount St. Mary's (MAAC),1,0-1,14,10,24,0.583,02/08/2023,2023.0
11,Duke (ACC),2,2-0,34,25,59,0.576,02/08/2023,2023.0
12,Vermont (America East),1,0-1,9,7,16,0.563,02/08/2023,2023.0
13,Maryland (Big Ten),1,1-0,12,11,23,0.522,02/08/2023,2023.0
14,High Point (Atlantic 10),1,0-1,15,15,30,0.500,02/08/2023,2023.0
15,Navy (Patriot),2,2-0,25,26,51,0.490,02/08/2023,2023.0
16,Richmond (Atlantic 10),1,0-1,11,12,23,0.478,02/08/2023,2023.0
17,Holy Cross (Patriot),2,0-2,24,27,51,0.471,02/08/2023,2023.0
18,Syracuse (ACC),1,1-0,7,9,16,0.438,02/08/2023,2023.0
19,Mercer (ASUN),1,0-1,12,18,30,0.400,02/08/2023,2023.0
20,Providence (Big East),1,1-0,9,15,24,0.375,02/08/2023,2023.0
21,Lafayette (Patriot),1,0-1,13,22,35,0.371,02/08/2023,2023.0
22,Utah (ASUN),1,0-1,7,13,20,0.350,02/08/2023,2023.0
23,Jacksonville (ASUN),1,0-1,8,15,23,0.348,02/08/2023,2023.0
24,Bellarmine (ASUN),1,0-1,10,19,29,0.345,02/08/2023,2023.0
24,Detroit Mercy (ASUN),1,0-1,10,19,29,0.345,02/08/2023,2023.0
26,Marist (MAAC),1,0-1,9,23,32,0.281,02/08/2023,2023.0
27,Air Force (ASUN),1,0-1,4,22,26,0.154,02/08/2023,2023.0
-,Merrimack (America East),2,2-0,24,24,48,0.500,02/08/2023,2023.0
-,Queens (NC) (ASUN),1,0-1,12,15,27,0.444,02/08/2023,2023.0
-,Lindenwood (ASUN),1,0-1,6,17,23,0.261,02/08/2023,2023.0
1,Ohio St. (Big Ten),1,1-0,22,4,26,0.846,02/05/2023,2023.0
2,Marquette (Big East),1,1-0,17,6,23,0.739,02/05/2023,2023.0
3,Rutgers (Big Ten),1,1-0,23,9,32,0.719,02/05/2023,2023.0
4,Hofstra (CAA),1,0-1,15,6,21,0.714,02/05/2023,2023.0
5,Duke (ACC),1,1-0,19,10,29,0.655,02/05/2023,2023.0
5,VMI (MAAC),1,1-0,19,10,29,0.655,02/05/2023,2023.0
7,Johns Hopkins (Big Ten),1,1-0,15,8,23,0.652,02/05/2023,2023.0
8,Denver (Big East),1,1-0,13,7,20,0.650,02/05/2023,2023.0
9,Penn St. (Big Ten),1,1-0,22,13,35,0.629,02/05/2023,2023.0
10,Holy Cross (Patriot),1,0-1,15,9,24,0.625,02/05/2023,2023.0
11,Bucknell (Patriot),1,1-0,18,12,30,0.600,02/05/2023,2023.0
12,Mount St. Mary's (MAAC),1,0-1,14,10,24,0.583,02/05/2023,2023.0
13,Vermont (America East),1,0-1,9,7,16,0.563,02/05/2023,2023.0
14,Maryland (Big Ten),1,1-0,12,11,23,0.522,02/05/2023,2023.0
15,Navy (Patriot),2,2-0,25,26,51,0.490,02/05/2023,2023.0
16,Richmond (Atlantic 10),1,0-1,11,12,23,0.478,02/05/2023,2023.0
17,Syracuse (ACC),1,1-0,7,9,16,0.438,02/05/2023,2023.0
18,Mercer (ASUN),1,0-1,12,18,30,0.400,02/05/2023,2023.0
19,Providence (Big East),1,1-0,9,15,24,0.375,02/05/2023,2023.0
20,Lafayette (Patriot),1,0-1,13,22,35,0.371,02/05/2023,2023.0
21,Utah (ASUN),1,0-1,7,13,20,0.350,02/05/2023,2023.0
22,Jacksonville (ASUN),1,0-1,8,15,23,0.348,02/05/2023,2023.0
23,Bellarmine (ASUN),1,0-1,10,19,29,0.345,02/05/2023,2023.0
23,Detroit Mercy (ASUN),1,0-1,10,19,29,0.345,02/05/2023,2023.0
25,Marist (MAAC),1,0-1,9,23,32,0.281,02/05/2023,2023.0
26,Air Force (ASUN),1,0-1,4,22,26,0.154,02/05/2023,2023.0
-,Queens (NC) (ASUN),1,0-1,12,15,27,0.444,02/05/2023,2023.0
-,Merrimack (America East),1,1-0,6,15,21,0.286,02/05/2023,2023.0
-,Lindenwood (ASUN),1,0-1,6,17,23,0.261,02/05/2023,2023.0
1,North Carolina (ACC),14,7-7,228,141,369,0.618,05/27/2024-Final Statistics,2024.0
2,Maryland (Big Ten),17,11-6,263,164,427,0.616,05/27/2024-Final Statistics,2024.0
3,Army West Point (Patriot),14,11-3,239,159,398,0.601,05/27/2024-Final Statistics,2024.0
4,Bryant (America East),14,9-5,222,152,374,0.594,05/27/2024-Final Statistics,2024.0
5,NJIT (America East),14,8-6,212,148,360,0.589,05/27/2024-Final Statistics,2024.0
6,Michigan (Big Ten),17,10-7,274,192,466,0.588,05/27/2024-Final Statistics,2024.0
7,Syracuse (ACC),18,12-6,304,220,524,0.580,05/27/2024-Final Statistics,2024.0
8,Hofstra (CAA),15,6-9,240,175,415,0.578,05/27/2024-Final Statistics,2024.0
9,Marquette (Big East),14,4-10,200,147,347,0.576,05/27/2024-Final Statistics,2024.0
10,Hobart (Atlantic 10),13,4-9,207,153,360,0.575,05/27/2024-Final Statistics,2024.0
11,High Point (Atlantic 10),16,9-7,255,189,444,0.574,05/27/2024-Final Statistics,2024.0
12,Denver (Big East),17,13-4,240,180,420,0.571,05/27/2024-Final Statistics,2024.0
13,Notre Dame (ACC),17,16-1,270,203,473,0.571,05/27/2024-Final Statistics,2024.0
14,Navy (Patriot),16,9-7,230,173,403,0.571,05/27/2024-Final Statistics,2024.0
15,Towson (CAA),17,13-4,256,197,453,0.565,05/27/2024-Final Statistics,2024.0
16,Jacksonville (ASUN),18,13-5,279,216,495,0.564,05/27/2024-Final Statistics,2024.0
17,UAlbany (America East),18,10-8,273,215,488,0.559,05/27/2024-Final Statistics,2024.0
18,Vermont (America East),16,8-8,249,201,450,0.553,05/27/2024-Final Statistics,2024.0
19,Yale (Ivy League),15,11-4,260,218,478,0.544,05/27/2024-Final Statistics,2024.0
20,Lehigh (Patriot),17,10-7,229,193,422,0.543,05/27/2024-Final Statistics,2024.0
21,Ohio St. (Big Ten),15,6-9,197,167,364,0.541,05/27/2024-Final Statistics,2024.0
22,Robert Morris (ASUN),15,5-10,215,189,404,0.532,05/27/2024-Final Statistics,2024.0
23,VMI (MAAC),15,7-8,218,196,414,0.527,05/27/2024-Final Statistics,2024.0
24,Sacred Heart (MAAC),18,13-5,248,224,472,0.525,05/27/2024-Final Statistics,2024.0
25,Dartmouth (Ivy League),13,3-10,187,169,356,0.525,05/27/2024-Final Statistics,2024.0
26,Georgetown (Big East),17,13-4,230,208,438,0.525,05/27/2024-Final Statistics,2024.0
27,Mercer (ASUN),14,4-10,188,172,360,0.522,05/27/2024-Final Statistics,2024.0
28,Rutgers (Big Ten),14,7-7,184,169,353,0.521,05/27/2024-Final Statistics,2024.0
29,Binghamton (America East),13,6-7,190,175,365,0.521,05/27/2024-Final Statistics,2024.0
30,Villanova (Big East),16,9-7,204,190,394,0.518,05/27/2024-Final Statistics,2024.0
31,Virginia (ACC),18,12-6,266,248,514,0.518,05/27/2024-Final Statistics,2024.0
32,Lafayette (Patriot),13,6-7,184,172,356,0.517,05/27/2024-Final Statistics,2024.0
33,Duke (ACC),19,13-6,277,264,541,0.512,05/27/2024-Final Statistics,2024.0
34,Princeton (Ivy League),16,11-5,222,215,437,0.508,05/27/2024-Final Statistics,2024.0
35,Canisius (MAAC),15,5-10,193,188,381,0.507,05/27/2024-Final Statistics,2024.0
36,Saint Joseph's (Atlantic 10),16,12-4,209,208,417,0.501,05/27/2024-Final Statistics,2024.0
37,Delaware (CAA),14,9-5,177,178,355,0.499,05/27/2024-Final Statistics,2024.0
38,Drexel (CAA),15,6-9,188,190,378,0.497,05/27/2024-Final Statistics,2024.0
39,LIU (MAAC),14,10-4,176,178,354,0.497,05/27/2024-Final Statistics,2024.0
40,Marist (MAAC),15,8-7,194,201,395,0.491,05/27/2024-Final Statistics,2024.0
41,Bellarmine (ASUN),17,9-8,220,228,448,0.491,05/27/2024-Final Statistics,2024.0
42,UMBC (America East),12,5-7,160,166,326,0.491,05/27/2024-Final Statistics,2024.0
43,Brown (Ivy League),14,3-11,167,180,347,0.481,05/27/2024-Final Statistics,2024.0
44,Richmond (Atlantic 10),16,10-6,204,220,424,0.481,05/27/2024-Final Statistics,2024.0
45,Boston U. (Patriot),17,10-7,227,245,472,0.481,05/27/2024-Final Statistics,2024.0
46,Massachusetts (Atlantic 10),14,6-8,175,190,365,0.479,05/27/2024-Final Statistics,2024.0
47,Johns Hopkins (Big Ten),16,11-5,188,205,393,0.478,05/27/2024-Final Statistics,2024.0
48,Air Force (ASUN),15,9-6,176,192,368,0.478,05/27/2024-Final Statistics,2024.0
49,Monmouth (CAA),13,5-8,147,163,310,0.474,05/27/2024-Final Statistics,2024.0
50,Siena (MAAC),16,8-8,203,226,429,0.473,05/27/2024-Final Statistics,2024.0
51,Cornell (Ivy League),14,9-5,207,233,440,0.470,05/27/2024-Final Statistics,2024.0
52,Cleveland St. (ASUN),17,9-8,205,231,436,0.470,05/27/2024-Final Statistics,2024.0
53,St. John's (NY) (Big East),15,4-11,188,213,401,0.469,05/27/2024-Final Statistics,2024.0
54,Stony Brook (CAA),14,4-10,176,201,377,0.467,05/27/2024-Final Statistics,2024.0
55,UMass Lowell (America East),12,0-12,140,160,300,0.467,05/27/2024-Final Statistics,2024.0
56,Penn (Ivy League),15,9-6,177,207,384,0.461,05/27/2024-Final Statistics,2024.0
57,Utah (ASUN),17,12-5,226,268,494,0.457,05/27/2024-Final Statistics,2024.0
58,Fairfield (CAA),15,8-7,183,218,401,0.456,05/27/2024-Final Statistics,2024.0
59,Bucknell (Patriot),14,4-10,168,205,373,0.450,05/27/2024-Final Statistics,2024.0
60,Penn St. (Big Ten),16,11-5,192,240,432,0.444,05/27/2024-Final Statistics,2024.0
60,Providence (Big East),15,7-8,188,235,423,0.444,05/27/2024-Final Statistics,2024.0
62,Manhattan (MAAC),17,8-9,179,228,407,0.440,05/27/2024-Final Statistics,2024.0
63,Mount St. Mary's (MAAC),15,1-14,163,208,371,0.439,05/27/2024-Final Statistics,2024.0
64,Harvard (Ivy League),13,8-5,158,209,367,0.431,05/27/2024-Final Statistics,2024.0
65,Holy Cross (Patriot),13,2-11,142,194,336,0.423,05/27/2024-Final Statistics,2024.0
66,Quinnipiac (MAAC),14,9-5,161,222,383,0.420,05/27/2024-Final Statistics,2024.0
67,Wagner (MAAC),15,1-14,150,209,359,0.418,05/27/2024-Final Statistics,2024.0
68,Loyola Maryland (Patriot),15,7-8,157,237,394,0.398,05/27/2024-Final Statistics,2024.0
69,Colgate (Patriot),15,8-7,166,260,426,0.390,05/27/2024-Final Statistics,2024.0
70,St. Bonaventure (Atlantic 10),12,1-11,120,188,308,0.390,05/27/2024-Final Statistics,2024.0
71,Merrimack (America East),15,6-9,152,268,420,0.362,05/27/2024-Final Statistics,2024.0
72,Detroit Mercy (ASUN),13,3-10,129,236,365,0.353,05/27/2024-Final Statistics,2024.0
73,Hampton (CAA),13,0-13,120,252,372,0.323,05/27/2024-Final Statistics,2024.0
-,Le Moyne (NEC),11,3-8,124,144,268,0.463,05/27/2024-Final Statistics,2024.0
-,Queens (NC) (ASUN),13,2-11,145,179,324,0.448,05/27/2024-Final Statistics,2024.0
-,Lindenwood (ASUN),12,0-12,111,175,286,0.388,05/27/2024-Final Statistics,2024.0
1,Maryland (Big Ten),4,3-1,73,30,103,0.709,05/08/2024 - 05/27/2024-2024 NCAA DI MLA Championship,2024.0
2,Notre Dame (ACC),4,4-0,66,39,105,0.629,05/08/2024 - 05/27/2024-2024 NCAA DI MLA Championship,2024.0
3,Lehigh (Patriot),1,0-1,15,12,27,0.556,05/08/2024 - 05/27/2024-2024 NCAA DI MLA Championship,2024.0
4,Syracuse (ACC),2,1-1,33,27,60,0.550,05/08/2024 - 05/27/2024-2024 NCAA DI MLA Championship,2024.0
5,Michigan (Big Ten),1,0-1,17,14,31,0.548,05/08/2024 - 05/27/2024-2024 NCAA DI MLA Championship,2024.0
6,Penn St. (Big Ten),1,0-1,13,12,25,0.520,05/08/2024 - 05/27/2024-2024 NCAA DI MLA Championship,2024.0
7,Virginia (ACC),3,2-1,40,39,79,0.506,05/08/2024 - 05/27/2024-2024 NCAA DI MLA Championship,2024.0
8,UAlbany (America East),2,1-1,23,27,50,0.460,05/08/2024 - 05/27/2024-2024 NCAA DI MLA Championship,2024.0
9,Saint Joseph's (Atlantic 10),1,0-1,14,17,31,0.452,05/08/2024 - 05/27/2024-2024 NCAA DI MLA Championship,2024.0
10,Utah (ASUN),1,0-1,13,16,29,0.448,05/08/2024 - 05/27/2024-2024 NCAA DI MLA Championship,2024.0
11,Duke (ACC),2,1-1,25,33,58,0.431,05/08/2024 - 05/27/2024-2024 NCAA DI MLA Championship,2024.0
12,Johns Hopkins (Big Ten),2,1-1,22,31,53,0.415,05/08/2024 - 05/27/2024-2024 NCAA DI MLA Championship,2024.0
13,Denver (Big East),3,2-1,31,45,76,0.408,05/08/2024 - 05/27/2024-2024 NCAA DI MLA Championship,2024.0
14,Towson (CAA),1,0-1,15,23,38,0.395,05/08/2024 - 05/27/2024-2024 NCAA DI MLA Championship,2024.0
15,Sacred Heart (MAAC),1,0-1,9,14,23,0.391,05/08/2024 - 05/27/2024-2024 NCAA DI MLA Championship,2024.0
16,Georgetown (Big East),2,1-1,20,36,56,0.357,05/08/2024 - 05/27/2024-2024 NCAA DI MLA Championship,2024.0
17,Princeton (Ivy League),1,0-1,7,21,28,0.250,05/08/2024 - 05/27/2024-2024 NCAA DI MLA Championship,2024.0
1,North Carolina (ACC),14,7-7,228,141,369,0.618,05/25/2024,2024.0
2,Maryland (Big Ten),16,11-5,246,157,403,0.610,05/25/2024,2024.0
3,Army West Point (Patriot),14,11-3,239,159,398,0.601,05/25/2024,2024.0
4,Bryant (America East),14,9-5,222,152,374,0.594,05/25/2024,2024.0
5,NJIT (America East),14,8-6,212,148,360,0.589,05/25/2024,2024.0
6,Michigan (Big Ten),17,10-7,274,192,466,0.588,05/25/2024,2024.0
7,Notre Dame (ACC),16,15-1,263,186,449,0.586,05/25/2024,2024.0
8,Syracuse (ACC),18,12-6,304,220,524,0.580,05/25/2024,2024.0
9,Hofstra (CAA),15,6-9,240,175,415,0.578,05/25/2024,2024.0
10,Marquette (Big East),14,4-10,200,147,347,0.576,05/25/2024,2024.0
11,Hobart (Atlantic 10),13,4-9,207,153,360,0.575,05/25/2024,2024.0
12,High Point (Atlantic 10),16,9-7,255,189,444,0.574,05/25/2024,2024.0
13,Denver (Big East),17,13-4,240,180,420,0.571,05/25/2024,2024.0
14,Navy (Patriot),16,9-7,230,173,403,0.571,05/25/2024,2024.0
15,Jacksonville (ASUN),18,13-5,280,215,495,0.566,05/25/2024,2024.0
16,Towson (CAA),17,13-4,256,197,453,0.565,05/25/2024,2024.0
17,UAlbany (America East),18,10-8,273,215,488,0.559,05/25/2024,2024.0
18,Vermont (America East),16,8-8,249,201,450,0.553,05/25/2024,2024.0
19,Yale (Ivy League),15,11-4,260,218,478,0.544,05/25/2024,2024.0
20,Lehigh (Patriot),17,10-7,229,193,422,0.543,05/25/2024,2024.0
21,Ohio St. (Big Ten),15,6-9,197,167,364,0.541,05/25/2024,2024.0
22,Robert Morris (ASUN),15,5-10,215,189,404,0.532,05/25/2024,2024.0
23,VMI (MAAC),15,7-8,218,196,414,0.527,05/25/2024,2024.0
24,Sacred Heart (MAAC),18,13-5,248,224,472,0.525,05/25/2024,2024.0
25,Dartmouth (Ivy League),13,3-10,187,169,356,0.525,05/25/2024,2024.0
26,Georgetown (Big East),17,13-4,230,208,438,0.525,05/25/2024,2024.0
27,Mercer (ASUN),14,4-10,188,172,360,0.522,05/25/2024,2024.0
28,Rutgers (Big Ten),14,7-7,184,169,353,0.521,05/25/2024,2024.0
29,Binghamton (America East),13,6-7,190,175,365,0.521,05/25/2024,2024.0
30,Villanova (Big East),16,9-7,204,190,394,0.518,05/25/2024,2024.0
31,Virginia (ACC),18,12-6,266,248,514,0.518,05/25/2024,2024.0
32,Lafayette (Patriot),13,6-7,184,172,356,0.517,05/25/2024,2024.0
33,Duke (ACC),19,13-6,277,264,541,0.512,05/25/2024,2024.0
34,Princeton (Ivy League),16,11-5,222,215,437,0.508,05/25/2024,2024.0
35,Canisius (MAAC),15,5-10,193,188,381,0.507,05/25/2024,2024.0
36,Saint Joseph's (Atlantic 10),16,12-4,209,208,417,0.501,05/25/2024,2024.0
37,Delaware (CAA),14,9-5,177,178,355,0.499,05/25/2024,2024.0
38,Drexel (CAA),15,6-9,188,190,378,0.497,05/25/2024,2024.0
39,LIU (MAAC),14,10-4,176,178,354,0.497,05/25/2024,2024.0
40,Marist (MAAC),15,8-7,194,201,395,0.491,05/25/2024,2024.0
41,UMBC (America East),12,5-7,160,166,326,0.491,05/25/2024,2024.0
42,Bellarmine (ASUN),17,9-8,219,229,448,0.489,05/25/2024,2024.0
43,Brown (Ivy League),14,3-11,167,180,347,0.481,05/25/2024,2024.0
44,Richmond (Atlantic 10),16,10-6,204,220,424,0.481,05/25/2024,2024.0
45,Boston U. (Patriot),17,10-7,227,245,472,0.481,05/25/2024,2024.0
46,Massachusetts (Atlantic 10),14,6-8,175,190,365,0.479,05/25/2024,2024.0
47,Johns Hopkins (Big Ten),16,11-5,188,205,393,0.478,05/25/2024,2024.0
48,Air Force (ASUN),15,9-6,176,192,368,0.478,05/25/2024,2024.0
49,Monmouth (CAA),13,5-8,147,163,310,0.474,05/25/2024,2024.0
50,Siena (MAAC),16,8-8,203,226,429,0.473,05/25/2024,2024.0
51,Cornell (Ivy League),14,9-5,207,233,440,0.470,05/25/2024,2024.0
52,Cleveland St. (ASUN),17,9-8,205,231,436,0.470,05/25/2024,2024.0
53,St. John's (NY) (Big East),15,4-11,188,213,401,0.469,05/25/2024,2024.0
54,Stony Brook (CAA),14,4-10,176,201,377,0.467,05/25/2024,2024.0
55,UMass Lowell (America East),12,0-12,140,160,300,0.467,05/25/2024,2024.0
56,Penn (Ivy League),15,9-6,177,207,384,0.461,05/25/2024,2024.0
57,Utah (ASUN),17,12-5,226,268,494,0.457,05/25/2024,2024.0
58,Fairfield (CAA),15,8-7,183,218,401,0.456,05/25/2024,2024.0
59,Bucknell (Patriot),14,4-10,168,205,373,0.450,05/25/2024,2024.0
60,Penn St. (Big Ten),16,11-5,192,240,432,0.444,05/25/2024,2024.0
60,Providence (Big East),15,7-8,188,235,423,0.444,05/25/2024,2024.0
62,Manhattan (MAAC),17,8-9,179,228,407,0.440,05/25/2024,2024.0
63,Mount St. Mary's (MAAC),15,1-14,163,208,371,0.439,05/25/2024,2024.0
64,Harvard (Ivy League),13,8-5,158,209,367,0.431,05/25/2024,2024.0
65,Holy Cross (Patriot),13,2-11,142,194,336,0.423,05/25/2024,2024.0
66,Quinnipiac (MAAC),14,9-5,161,222,383,0.420,05/25/2024,2024.0
67,Wagner (MAAC),15,1-14,150,209,359,0.418,05/25/2024,2024.0
68,Loyola Maryland (Patriot),15,7-8,157,237,394,0.398,05/25/2024,2024.0
69,Colgate (Patriot),15,8-7,166,260,426,0.390,05/25/2024,2024.0
70,St. Bonaventure (Atlantic 10),12,1-11,120,188,308,0.390,05/25/2024,2024.0
71,Merrimack (America East),15,6-9,152,268,420,0.362,05/25/2024,2024.0
72,Detroit Mercy (ASUN),13,3-10,129,236,365,0.353,05/25/2024,2024.0
73,Hampton (CAA),13,0-13,120,252,372,0.323,05/25/2024,2024.0
-,Le Moyne (NEC),11,3-8,124,144,268,0.463,05/25/2024,2024.0
-,Queens (NC) (ASUN),13,2-11,145,179,324,0.448,05/25/2024,2024.0
-,Lindenwood (ASUN),12,0-12,111,175,286,0.388,05/25/2024,2024.0
1,North Carolina (ACC),14,7-7,228,141,369,0.618,05/19/2024,2024.0
2,Maryland (Big Ten),15,10-5,231,150,381,0.606,05/19/2024,2024.0
3,Army West Point (Patriot),14,11-3,239,159,398,0.601,05/19/2024,2024.0
4,Bryant (America East),14,9-5,222,152,374,0.594,05/19/2024,2024.0
5,Denver (Big East),16,13-3,235,162,397,0.592,05/19/2024,2024.0
6,NJIT (America East),14,8-6,212,148,360,0.589,05/19/2024,2024.0
7,Michigan (Big Ten),17,10-7,274,192,466,0.588,05/19/2024,2024.0
8,Syracuse (ACC),18,12-6,304,220,524,0.580,05/19/2024,2024.0
9,Hofstra (CAA),15,6-9,240,175,415,0.578,05/19/2024,2024.0
10,Marquette (Big East),14,4-10,200,147,347,0.576,05/19/2024,2024.0
11,Notre Dame (ACC),15,14-1,245,181,426,0.575,05/19/2024,2024.0
12,Hobart (Atlantic 10),13,4-9,207,153,360,0.575,05/19/2024,2024.0
13,High Point (Atlantic 10),16,9-7,255,189,444,0.574,05/19/2024,2024.0
14,Navy (Patriot),16,9-7,230,173,403,0.571,05/19/2024,2024.0
15,Jacksonville (ASUN),18,13-5,280,215,495,0.566,05/19/2024,2024.0
16,Towson (CAA),17,13-4,256,197,453,0.565,05/19/2024,2024.0
17,UAlbany (America East),18,10-8,273,215,488,0.559,05/19/2024,2024.0
18,Vermont (America East),16,8-8,249,201,450,0.553,05/19/2024,2024.0
19,Yale (Ivy League),15,11-4,260,218,478,0.544,05/19/2024,2024.0
20,Lehigh (Patriot),17,10-7,229,193,422,0.543,05/19/2024,2024.0
21,Ohio St. (Big Ten),15,6-9,197,167,364,0.541,05/19/2024,2024.0
22,Robert Morris (ASUN),15,5-10,215,189,404,0.532,05/19/2024,2024.0
23,VMI (MAAC),15,7-8,218,196,414,0.527,05/19/2024,2024.0
24,Virginia (ACC),17,12-5,259,233,492,0.526,05/19/2024,2024.0
25,Sacred Heart (MAAC),18,13-5,248,224,472,0.525,05/19/2024,2024.0
26,Dartmouth (Ivy League),13,3-10,187,169,356,0.525,05/19/2024,2024.0
27,Georgetown (Big East),17,13-4,230,208,438,0.525,05/19/2024,2024.0
28,Mercer (ASUN),14,4-10,188,172,360,0.522,05/19/2024,2024.0
29,Rutgers (Big Ten),14,7-7,184,169,353,0.521,05/19/2024,2024.0
30,Binghamton (America East),13,6-7,190,175,365,0.521,05/19/2024,2024.0
31,Villanova (Big East),16,9-7,204,190,394,0.518,05/19/2024,2024.0
32,Lafayette (Patriot),13,6-7,184,172,356,0.517,05/19/2024,2024.0
33,Duke (ACC),19,13-6,277,264,541,0.512,05/19/2024,2024.0
34,Princeton (Ivy League),16,11-5,222,215,437,0.508,05/19/2024,2024.0
35,Canisius (MAAC),15,5-10,193,188,381,0.507,05/19/2024,2024.0
36,Saint Joseph's (Atlantic 10),16,12-4,209,208,417,0.501,05/19/2024,2024.0
37,Delaware (CAA),14,9-5,177,178,355,0.499,05/19/2024,2024.0
38,Drexel (CAA),15,6-9,188,190,378,0.497,05/19/2024,2024.0
39,LIU (MAAC),14,10-4,176,178,354,0.497,05/19/2024,2024.0
40,Marist (MAAC),15,8-7,194,201,395,0.491,05/19/2024,2024.0
41,UMBC (America East),12,5-7,160,166,326,0.491,05/19/2024,2024.0
42,Bellarmine (ASUN),17,9-8,219,229,448,0.489,05/19/2024,2024.0
43,Brown (Ivy League),14,3-11,167,180,347,0.481,05/19/2024,2024.0
44,Richmond (Atlantic 10),16,10-6,204,220,424,0.481,05/19/2024,2024.0
45,Boston U. (Patriot),17,10-7,227,245,472,0.481,05/19/2024,2024.0
46,Massachusetts (Atlantic 10),14,6-8,175,190,365,0.479,05/19/2024,2024.0
47,Johns Hopkins (Big Ten),16,11-5,188,205,393,0.478,05/19/2024,2024.0
48,Air Force (ASUN),15,9-6,176,192,368,0.478,05/19/2024,2024.0
49,Monmouth (CAA),13,5-8,147,163,310,0.474,05/19/2024,2024.0
50,Siena (MAAC),16,8-8,203,226,429,0.473,05/19/2024,2024.0
51,Cornell (Ivy League),14,9-5,207,233,440,0.470,05/19/2024,2024.0
52,Cleveland St. (ASUN),17,9-8,205,231,436,0.470,05/19/2024,2024.0
53,St. John's (NY) (Big East),15,4-11,188,213,401,0.469,05/19/2024,2024.0
54,Stony Brook (CAA),14,4-10,176,201,377,0.467,05/19/2024,2024.0
55,UMass Lowell (America East),12,0-12,140,160,300,0.467,05/19/2024,2024.0
56,Penn (Ivy League),15,9-6,177,207,384,0.461,05/19/2024,2024.0
57,Utah (ASUN),17,12-5,226,268,494,0.457,05/19/2024,2024.0
58,Fairfield (CAA),15,8-7,183,218,401,0.456,05/19/2024,2024.0
59,Bucknell (Patriot),14,4-10,168,205,373,0.450,05/19/2024,2024.0
60,Penn St. (Big Ten),16,11-5,192,240,432,0.444,05/19/2024,2024.0
60,Providence (Big East),15,7-8,188,235,423,0.444,05/19/2024,2024.0
62,Manhattan (MAAC),17,8-9,179,228,407,0.440,05/19/2024,2024.0
63,Mount St. Mary's (MAAC),15,1-14,163,208,371,0.439,05/19/2024,2024.0
64,Harvard (Ivy League),13,8-5,158,209,367,0.431,05/19/2024,2024.0
65,Holy Cross (Patriot),13,2-11,142,194,336,0.423,05/19/2024,2024.0
66,Quinnipiac (MAAC),14,9-5,161,222,383,0.420,05/19/2024,2024.0
67,Wagner (MAAC),15,1-14,150,209,359,0.418,05/19/2024,2024.0
68,Loyola Maryland (Patriot),15,7-8,157,237,394,0.398,05/19/2024,2024.0
69,Colgate (Patriot),15,8-7,166,260,426,0.390,05/19/2024,2024.0
70,St. Bonaventure (Atlantic 10),12,1-11,120,188,308,0.390,05/19/2024,2024.0
71,Merrimack (America East),15,6-9,152,268,420,0.362,05/19/2024,2024.0
72,Detroit Mercy (ASUN),13,3-10,129,236,365,0.353,05/19/2024,2024.0
73,Hampton (CAA),13,0-13,120,252,372,0.323,05/19/2024,2024.0
-,Le Moyne (NEC),11,3-8,124,144,268,0.463,05/19/2024,2024.0
-,Queens (NC) (ASUN),13,2-11,145,179,324,0.448,05/19/2024,2024.0
-,Lindenwood (ASUN),12,0-12,111,175,286,0.388,05/19/2024,2024.0
1,North Carolina (ACC),14,7-7,228,141,369,0.618,05/18/2024,2024.0
2,Maryland (Big Ten),15,10-5,231,150,381,0.606,05/18/2024,2024.0
3,Army West Point (Patriot),14,11-3,239,159,398,0.601,05/18/2024,2024.0
4,Denver (Big East),15,12-3,223,152,375,0.595,05/18/2024,2024.0
5,Bryant (America East),14,9-5,222,152,374,0.594,05/18/2024,2024.0
6,NJIT (America East),14,8-6,212,148,360,0.589,05/18/2024,2024.0
7,Michigan (Big Ten),17,10-7,274,192,466,0.588,05/18/2024,2024.0
8,Syracuse (ACC),17,12-5,294,208,502,0.586,05/18/2024,2024.0
9,Hofstra (CAA),15,6-9,240,175,415,0.578,05/18/2024,2024.0
10,Marquette (Big East),14,4-10,200,147,347,0.576,05/18/2024,2024.0
11,Notre Dame (ACC),15,14-1,245,181,426,0.575,05/18/2024,2024.0
12,Hobart (Atlantic 10),13,4-9,207,153,360,0.575,05/18/2024,2024.0
13,High Point (Atlantic 10),16,9-7,255,189,444,0.574,05/18/2024,2024.0
14,Navy (Patriot),16,9-7,230,173,403,0.571,05/18/2024,2024.0
15,Jacksonville (ASUN),18,13-5,280,215,495,0.566,05/18/2024,2024.0
16,Towson (CAA),17,13-4,256,197,453,0.565,05/18/2024,2024.0
17,UAlbany (America East),18,10-8,273,215,488,0.559,05/18/2024,2024.0
18,Vermont (America East),16,8-8,249,201,450,0.553,05/18/2024,2024.0
19,Yale (Ivy League),15,11-4,260,218,478,0.544,05/18/2024,2024.0
20,Lehigh (Patriot),17,10-7,229,193,422,0.543,05/18/2024,2024.0
21,Ohio St. (Big Ten),15,6-9,197,167,364,0.541,05/18/2024,2024.0
22,Robert Morris (ASUN),15,5-10,215,189,404,0.532,05/18/2024,2024.0
23,VMI (MAAC),15,7-8,218,196,414,0.527,05/18/2024,2024.0
24,Sacred Heart (MAAC),18,13-5,248,224,472,0.525,05/18/2024,2024.0
25,Dartmouth (Ivy League),13,3-10,187,169,356,0.525,05/18/2024,2024.0
26,Georgetown (Big East),17,13-4,230,208,438,0.525,05/18/2024,2024.0
27,Mercer (ASUN),14,4-10,188,172,360,0.522,05/18/2024,2024.0
28,Virginia (ACC),16,11-5,243,223,466,0.521,05/18/2024,2024.0
29,Rutgers (Big Ten),14,7-7,184,169,353,0.521,05/18/2024,2024.0
30,Binghamton (America East),13,6-7,190,175,365,0.521,05/18/2024,2024.0
31,Villanova (Big East),16,9-7,204,190,394,0.518,05/18/2024,2024.0
32,Lafayette (Patriot),13,6-7,184,172,356,0.517,05/18/2024,2024.0
33,Duke (ACC),19,13-6,277,264,541,0.512,05/18/2024,2024.0
34,Princeton (Ivy League),16,11-5,222,215,437,0.508,05/18/2024,2024.0
35,Canisius (MAAC),15,5-10,193,188,381,0.507,05/18/2024,2024.0
36,Saint Joseph's (Atlantic 10),16,12-4,209,208,417,0.501,05/18/2024,2024.0
37,Delaware (CAA),14,9-5,177,178,355,0.499,05/18/2024,2024.0
38,Drexel (CAA),15,6-9,188,190,378,0.497,05/18/2024,2024.0
39,LIU (MAAC),14,10-4,176,178,354,0.497,05/18/2024,2024.0
40,Marist (MAAC),15,8-7,194,201,395,0.491,05/18/2024,2024.0
41,UMBC (America East),12,5-7,160,166,326,0.491,05/18/2024,2024.0
42,Bellarmine (ASUN),17,9-8,219,229,448,0.489,05/18/2024,2024.0
43,Johns Hopkins (Big Ten),15,11-4,178,189,367,0.485,05/18/2024,2024.0
44,Brown (Ivy League),14,3-11,167,180,347,0.481,05/18/2024,2024.0
45,Richmond (Atlantic 10),16,10-6,204,220,424,0.481,05/18/2024,2024.0
46,Boston U. (Patriot),17,10-7,227,245,472,0.481,05/18/2024,2024.0
47,Massachusetts (Atlantic 10),14,6-8,175,190,365,0.479,05/18/2024,2024.0
48,Air Force (ASUN),15,9-6,176,192,368,0.478,05/18/2024,2024.0
49,Monmouth (CAA),13,5-8,147,163,310,0.474,05/18/2024,2024.0
50,Siena (MAAC),16,8-8,203,226,429,0.473,05/18/2024,2024.0
51,Cornell (Ivy League),14,9-5,207,233,440,0.470,05/18/2024,2024.0
52,Cleveland St. (ASUN),17,9-8,205,231,436,0.470,05/18/2024,2024.0
53,St. John's (NY) (Big East),15,4-11,188,213,401,0.469,05/18/2024,2024.0
54,Stony Brook (CAA),14,4-10,176,201,377,0.467,05/18/2024,2024.0
55,UMass Lowell (America East),12,0-12,140,160,300,0.467,05/18/2024,2024.0
56,Penn (Ivy League),15,9-6,177,207,384,0.461,05/18/2024,2024.0
57,Utah (ASUN),17,12-5,226,268,494,0.457,05/18/2024,2024.0
58,Fairfield (CAA),15,8-7,183,218,401,0.456,05/18/2024,2024.0
59,Bucknell (Patriot),14,4-10,168,205,373,0.450,05/18/2024,2024.0
60,Penn St. (Big Ten),16,11-5,192,240,432,0.444,05/18/2024,2024.0
60,Providence (Big East),15,7-8,188,235,423,0.444,05/18/2024,2024.0
62,Manhattan (MAAC),17,8-9,179,228,407,0.440,05/18/2024,2024.0
63,Mount St. Mary's (MAAC),15,1-14,163,208,371,0.439,05/18/2024,2024.0
64,Harvard (Ivy League),13,8-5,158,209,367,0.431,05/18/2024,2024.0
65,Holy Cross (Patriot),13,2-11,142,194,336,0.423,05/18/2024,2024.0
66,Quinnipiac (MAAC),14,9-5,161,222,383,0.420,05/18/2024,2024.0
67,Wagner (MAAC),15,1-14,150,209,359,0.418,05/18/2024,2024.0
68,Loyola Maryland (Patriot),15,7-8,157,237,394,0.398,05/18/2024,2024.0
69,Colgate (Patriot),15,8-7,166,260,426,0.390,05/18/2024,2024.0
70,St. Bonaventure (Atlantic 10),12,1-11,120,188,308,0.390,05/18/2024,2024.0
71,Merrimack (America East),15,6-9,152,268,420,0.362,05/18/2024,2024.0
72,Detroit Mercy (ASUN),13,3-10,129,236,365,0.353,05/18/2024,2024.0
73,Hampton (CAA),13,0-13,120,252,372,0.323,05/18/2024,2024.0
-,Le Moyne (NEC),11,3-8,124,144,268,0.463,05/18/2024,2024.0
-,Queens (NC) (ASUN),13,2-11,145,179,324,0.448,05/18/2024,2024.0
-,Lindenwood (ASUN),12,0-12,111,175,286,0.388,05/18/2024,2024.0
1,North Carolina (ACC),14,7-7,228,141,369,0.618,05/12/2024,2024.0
2,Army West Point (Patriot),14,11-3,239,159,398,0.601,05/12/2024,2024.0
3,Maryland (Big Ten),14,9-5,211,141,352,0.599,05/12/2024,2024.0
4,Denver (Big East),15,12-3,223,152,375,0.595,05/12/2024,2024.0
5,Bryant (America East),14,9-5,222,152,374,0.594,05/12/2024,2024.0
6,NJIT (America East),14,8-6,212,148,360,0.589,05/12/2024,2024.0
7,Michigan (Big Ten),17,10-7,274,192,466,0.588,05/12/2024,2024.0
8,Syracuse (ACC),17,12-5,294,208,502,0.586,05/12/2024,2024.0
9,Hofstra (CAA),15,6-9,240,175,415,0.578,05/12/2024,2024.0
10,Marquette (Big East),14,4-10,200,147,347,0.576,05/12/2024,2024.0
11,Hobart (Atlantic 10),13,4-9,207,153,360,0.575,05/12/2024,2024.0
12,High Point (Atlantic 10),16,9-7,255,189,444,0.574,05/12/2024,2024.0
13,Navy (Patriot),16,9-7,230,173,403,0.571,05/12/2024,2024.0
14,Jacksonville (ASUN),18,13-5,280,215,495,0.566,05/12/2024,2024.0
15,Towson (CAA),17,13-4,256,197,453,0.565,05/12/2024,2024.0
16,Notre Dame (ACC),14,13-1,222,173,395,0.562,05/12/2024,2024.0
17,UAlbany (America East),18,10-8,273,215,488,0.559,05/12/2024,2024.0
18,Vermont (America East),16,8-8,249,201,450,0.553,05/12/2024,2024.0
19,Georgetown (Big East),16,13-3,222,185,407,0.545,05/12/2024,2024.0
20,Yale (Ivy League),15,11-4,260,218,478,0.544,05/12/2024,2024.0
21,Lehigh (Patriot),17,10-7,229,193,422,0.543,05/12/2024,2024.0
22,Ohio St. (Big Ten),15,6-9,197,167,364,0.541,05/12/2024,2024.0
23,Robert Morris (ASUN),15,5-10,215,189,404,0.532,05/12/2024,2024.0
24,VMI (MAAC),15,7-8,218,196,414,0.527,05/12/2024,2024.0
25,Sacred Heart (MAAC),18,13-5,248,224,472,0.525,05/12/2024,2024.0
26,Dartmouth (Ivy League),13,3-10,187,169,356,0.525,05/12/2024,2024.0
27,Duke (ACC),18,13-5,268,244,512,0.523,05/12/2024,2024.0
28,Mercer (ASUN),14,4-10,188,172,360,0.522,05/12/2024,2024.0
29,Virginia (ACC),16,11-5,243,223,466,0.521,05/12/2024,2024.0
30,Rutgers (Big Ten),14,7-7,184,169,353,0.521,05/12/2024,2024.0
31,Binghamton (America East),13,6-7,190,175,365,0.521,05/12/2024,2024.0
32,Villanova (Big East),16,9-7,204,190,394,0.518,05/12/2024,2024.0
33,Lafayette (Patriot),13,6-7,184,172,356,0.517,05/12/2024,2024.0
34,Princeton (Ivy League),16,11-5,222,215,437,0.508,05/12/2024,2024.0
35,Canisius (MAAC),15,5-10,193,188,381,0.507,05/12/2024,2024.0
36,Saint Joseph's (Atlantic 10),16,12-4,209,208,417,0.501,05/12/2024,2024.0
37,Delaware (CAA),14,9-5,177,178,355,0.499,05/12/2024,2024.0
38,Drexel (CAA),15,6-9,188,190,378,0.497,05/12/2024,2024.0
39,LIU (MAAC),14,10-4,176,178,354,0.497,05/12/2024,2024.0
40,Marist (MAAC),15,8-7,194,201,395,0.491,05/12/2024,2024.0
41,UMBC (America East),12,5-7,160,166,326,0.491,05/12/2024,2024.0
42,Bellarmine (ASUN),17,9-8,219,229,448,0.489,05/12/2024,2024.0
43,Johns Hopkins (Big Ten),15,11-4,178,189,367,0.485,05/12/2024,2024.0
44,Brown (Ivy League),14,3-11,167,180,347,0.481,05/12/2024,2024.0
45,Richmond (Atlantic 10),16,10-6,204,220,424,0.481,05/12/2024,2024.0
46,Boston U. (Patriot),17,10-7,227,245,472,0.481,05/12/2024,2024.0
47,Massachusetts (Atlantic 10),14,6-8,175,190,365,0.479,05/12/2024,2024.0
48,Air Force (ASUN),15,9-6,176,192,368,0.478,05/12/2024,2024.0
49,Monmouth (CAA),13,5-8,147,163,310,0.474,05/12/2024,2024.0
50,Siena (MAAC),16,8-8,203,226,429,0.473,05/12/2024,2024.0
51,Cornell (Ivy League),14,9-5,207,233,440,0.470,05/12/2024,2024.0
52,Cleveland St. (ASUN),17,9-8,205,231,436,0.470,05/12/2024,2024.0
53,St. John's (NY) (Big East),15,4-11,188,213,401,0.469,05/12/2024,2024.0
54,Stony Brook (CAA),14,4-10,176,201,377,0.467,05/12/2024,2024.0
55,UMass Lowell (America East),12,0-12,140,160,300,0.467,05/12/2024,2024.0
56,Penn (Ivy League),15,9-6,177,207,384,0.461,05/12/2024,2024.0
57,Utah (ASUN),17,12-5,226,268,494,0.457,05/12/2024,2024.0
58,Fairfield (CAA),15,8-7,183,218,401,0.456,05/12/2024,2024.0
59,Bucknell (Patriot),14,4-10,168,205,373,0.450,05/12/2024,2024.0
60,Penn St. (Big Ten),16,11-5,192,240,432,0.444,05/12/2024,2024.0
60,Providence (Big East),15,7-8,188,235,423,0.444,05/12/2024,2024.0
62,Manhattan (MAAC),17,8-9,179,228,407,0.440,05/12/2024,2024.0
63,Mount St. Mary's (MAAC),15,1-14,163,208,371,0.439,05/12/2024,2024.0
64,Harvard (Ivy League),13,8-5,158,209,367,0.431,05/12/2024,2024.0
65,Holy Cross (Patriot),13,2-11,142,194,336,0.423,05/12/2024,2024.0
66,Quinnipiac (MAAC),14,9-5,161,222,383,0.420,05/12/2024,2024.0
67,Wagner (MAAC),15,1-14,150,209,359,0.418,05/12/2024,2024.0
68,Loyola Maryland (Patriot),15,7-8,157,237,394,0.398,05/12/2024,2024.0
69,Colgate (Patriot),15,8-7,166,260,426,0.390,05/12/2024,2024.0
70,St. Bonaventure (Atlantic 10),12,1-11,120,188,308,0.390,05/12/2024,2024.0
71,Merrimack (America East),15,6-9,152,268,420,0.362,05/12/2024,2024.0
72,Detroit Mercy (ASUN),13,3-10,129,236,365,0.353,05/12/2024,2024.0
73,Hampton (CAA),13,0-13,120,252,372,0.323,05/12/2024,2024.0
-,Le Moyne (NEC),11,3-8,124,144,268,0.463,05/12/2024,2024.0
-,Queens (NC) (ASUN),13,2-11,145,179,324,0.448,05/12/2024,2024.0
-,Lindenwood (ASUN),12,0-12,111,175,286,0.388,05/12/2024,2024.0
1,North Carolina (ACC),14,7-7,228,141,369,0.618,05/11/2024,2024.0
2,Army West Point (Patriot),14,11-3,239,159,398,0.601,05/11/2024,2024.0
3,Maryland (Big Ten),14,9-5,211,141,352,0.599,05/11/2024,2024.0
4,Denver (Big East),15,12-3,223,152,375,0.595,05/11/2024,2024.0
5,Bryant (America East),14,9-5,222,152,374,0.594,05/11/2024,2024.0
6,NJIT (America East),14,8-6,212,148,360,0.589,05/11/2024,2024.0
7,Michigan (Big Ten),17,10-7,274,192,466,0.588,05/11/2024,2024.0
8,Syracuse (ACC),16,11-5,271,193,464,0.584,05/11/2024,2024.0
9,Towson (CAA),16,13-3,241,174,415,0.581,05/11/2024,2024.0
10,Hofstra (CAA),15,6-9,240,175,415,0.578,05/11/2024,2024.0
11,Marquette (Big East),14,4-10,200,147,347,0.576,05/11/2024,2024.0
12,Hobart (Atlantic 10),13,4-9,207,153,360,0.575,05/11/2024,2024.0
13,High Point (Atlantic 10),16,9-7,255,189,444,0.574,05/11/2024,2024.0
14,UAlbany (America East),17,10-7,264,197,461,0.573,05/11/2024,2024.0
15,Navy (Patriot),16,9-7,230,173,403,0.571,05/11/2024,2024.0
16,Jacksonville (ASUN),18,13-5,280,215,495,0.566,05/11/2024,2024.0
17,Notre Dame (ACC),13,12-1,204,164,368,0.554,05/11/2024,2024.0
18,Vermont (America East),16,8-8,249,201,450,0.553,05/11/2024,2024.0
19,Georgetown (Big East),15,12-3,210,172,382,0.550,05/11/2024,2024.0
20,Yale (Ivy League),15,11-4,260,218,478,0.544,05/11/2024,2024.0
21,Lehigh (Patriot),16,10-6,214,181,395,0.542,05/11/2024,2024.0
22,Ohio St. (Big Ten),15,6-9,197,167,364,0.541,05/11/2024,2024.0
23,Robert Morris (ASUN),15,5-10,215,189,404,0.532,05/11/2024,2024.0
24,VMI (MAAC),15,7-8,218,196,414,0.527,05/11/2024,2024.0
25,Sacred Heart (MAAC),18,13-5,248,224,472,0.525,05/11/2024,2024.0
26,Dartmouth (Ivy League),13,3-10,187,169,356,0.525,05/11/2024,2024.0
27,Duke (ACC),18,13-5,268,244,512,0.523,05/11/2024,2024.0
28,Mercer (ASUN),14,4-10,188,172,360,0.522,05/11/2024,2024.0
29,Virginia (ACC),16,11-5,243,223,466,0.521,05/11/2024,2024.0
30,Rutgers (Big Ten),14,7-7,184,169,353,0.521,05/11/2024,2024.0
31,Binghamton (America East),13,6-7,190,175,365,0.521,05/11/2024,2024.0
32,Villanova (Big East),16,9-7,204,190,394,0.518,05/11/2024,2024.0
33,Lafayette (Patriot),13,6-7,184,172,356,0.517,05/11/2024,2024.0
34,Princeton (Ivy League),16,11-5,222,215,437,0.508,05/11/2024,2024.0
35,Canisius (MAAC),15,5-10,193,188,381,0.507,05/11/2024,2024.0
36,Saint Joseph's (Atlantic 10),16,12-4,209,208,417,0.501,05/11/2024,2024.0
37,Delaware (CAA),14,9-5,177,178,355,0.499,05/11/2024,2024.0
38,Drexel (CAA),15,6-9,188,190,378,0.497,05/11/2024,2024.0
39,LIU (MAAC),14,10-4,176,178,354,0.497,05/11/2024,2024.0
40,Marist (MAAC),15,8-7,194,201,395,0.491,05/11/2024,2024.0
41,UMBC (America East),12,5-7,160,166,326,0.491,05/11/2024,2024.0
42,Bellarmine (ASUN),17,9-8,219,229,448,0.489,05/11/2024,2024.0
43,Johns Hopkins (Big Ten),14,10-4,166,174,340,0.488,05/11/2024,2024.0
44,Brown (Ivy League),14,3-11,167,180,347,0.481,05/11/2024,2024.0
45,Richmond (Atlantic 10),16,10-6,204,220,424,0.481,05/11/2024,2024.0
46,Boston U. (Patriot),17,10-7,227,245,472,0.481,05/11/2024,2024.0
47,Massachusetts (Atlantic 10),14,6-8,175,190,365,0.479,05/11/2024,2024.0
48,Air Force (ASUN),15,9-6,176,192,368,0.478,05/11/2024,2024.0
49,Monmouth (CAA),13,5-8,147,163,310,0.474,05/11/2024,2024.0
50,Siena (MAAC),16,8-8,203,226,429,0.473,05/11/2024,2024.0
51,Cornell (Ivy League),14,9-5,207,233,440,0.470,05/11/2024,2024.0
52,Cleveland St. (ASUN),17,9-8,205,231,436,0.470,05/11/2024,2024.0
53,St. John's (NY) (Big East),15,4-11,188,213,401,0.469,05/11/2024,2024.0
54,Stony Brook (CAA),14,4-10,176,201,377,0.467,05/11/2024,2024.0
55,UMass Lowell (America East),12,0-12,140,160,300,0.467,05/11/2024,2024.0
56,Penn (Ivy League),15,9-6,177,207,384,0.461,05/11/2024,2024.0
57,Utah (ASUN),17,12-5,226,268,494,0.457,05/11/2024,2024.0
58,Fairfield (CAA),15,8-7,183,218,401,0.456,05/11/2024,2024.0
59,Bucknell (Patriot),14,4-10,168,205,373,0.450,05/11/2024,2024.0
60,Providence (Big East),15,7-8,188,235,423,0.444,05/11/2024,2024.0
61,Manhattan (MAAC),17,8-9,179,228,407,0.440,05/11/2024,2024.0
61,Penn St. (Big Ten),15,11-4,179,228,407,0.440,05/11/2024,2024.0
63,Mount St. Mary's (MAAC),15,1-14,163,208,371,0.439,05/11/2024,2024.0
64,Harvard (Ivy League),13,8-5,158,209,367,0.431,05/11/2024,2024.0
65,Holy Cross (Patriot),13,2-11,142,194,336,0.423,05/11/2024,2024.0
66,Quinnipiac (MAAC),14,9-5,161,222,383,0.420,05/11/2024,2024.0
67,Wagner (MAAC),15,1-14,150,209,359,0.418,05/11/2024,2024.0
68,Loyola Maryland (Patriot),15,7-8,157,237,394,0.398,05/11/2024,2024.0
69,Colgate (Patriot),15,8-7,166,260,426,0.390,05/11/2024,2024.0
70,St. Bonaventure (Atlantic 10),12,1-11,120,188,308,0.390,05/11/2024,2024.0
71,Merrimack (America East),15,6-9,152,268,420,0.362,05/11/2024,2024.0
72,Detroit Mercy (ASUN),13,3-10,129,236,365,0.353,05/11/2024,2024.0
73,Hampton (CAA),13,0-13,120,252,372,0.323,05/11/2024,2024.0
-,Le Moyne (NEC),11,3-8,124,144,268,0.463,05/11/2024,2024.0
-,Queens (NC) (ASUN),13,2-11,145,179,324,0.448,05/11/2024,2024.0
-,Lindenwood (ASUN),12,0-12,111,175,286,0.388,05/11/2024,2024.0
1,North Carolina (ACC),14,7-7,228,141,369,0.618,05/08/2024,2024.0
2,Denver (Big East),14,11-3,209,135,344,0.608,05/08/2024,2024.0
3,Army West Point (Patriot),14,11-3,239,159,398,0.601,05/08/2024,2024.0
4,Bryant (America East),14,9-5,222,152,374,0.594,05/08/2024,2024.0
5,Michigan (Big Ten),16,10-6,257,178,435,0.591,05/08/2024,2024.0
6,NJIT (America East),14,8-6,212,148,360,0.589,05/08/2024,2024.0
7,Maryland (Big Ten),13,8-5,190,134,324,0.586,05/08/2024,2024.0
8,Syracuse (ACC),16,11-5,271,193,464,0.584,05/08/2024,2024.0
9,Towson (CAA),16,13-3,241,174,415,0.581,05/08/2024,2024.0
10,Hofstra (CAA),15,6-9,240,175,415,0.578,05/08/2024,2024.0
11,Marquette (Big East),14,4-10,200,147,347,0.576,05/08/2024,2024.0
12,Hobart (Atlantic 10),13,4-9,207,153,360,0.575,05/08/2024,2024.0
13,High Point (Atlantic 10),16,9-7,255,189,444,0.574,05/08/2024,2024.0
14,UAlbany (America East),17,10-7,264,197,461,0.573,05/08/2024,2024.0
15,Navy (Patriot),16,9-7,230,173,403,0.571,05/08/2024,2024.0
16,Jacksonville (ASUN),18,13-5,280,215,495,0.566,05/08/2024,2024.0
17,Notre Dame (ACC),13,12-1,204,164,368,0.554,05/08/2024,2024.0
18,Vermont (America East),16,8-8,249,201,450,0.553,05/08/2024,2024.0
19,Georgetown (Big East),15,12-3,210,172,382,0.550,05/08/2024,2024.0
20,Yale (Ivy League),15,11-4,260,218,478,0.544,05/08/2024,2024.0
21,Lehigh (Patriot),16,10-6,214,181,395,0.542,05/08/2024,2024.0
22,Ohio St. (Big Ten),15,6-9,197,167,364,0.541,05/08/2024,2024.0
23,Robert Morris (ASUN),15,5-10,215,189,404,0.532,05/08/2024,2024.0
24,VMI (MAAC),15,7-8,218,196,414,0.527,05/08/2024,2024.0
25,Princeton (Ivy League),15,11-4,215,194,409,0.526,05/08/2024,2024.0
26,Sacred Heart (MAAC),18,13-5,248,224,472,0.525,05/08/2024,2024.0
27,Dartmouth (Ivy League),13,3-10,187,169,356,0.525,05/08/2024,2024.0
28,Mercer (ASUN),14,4-10,188,172,360,0.522,05/08/2024,2024.0
29,Duke (ACC),17,12-5,252,231,483,0.522,05/08/2024,2024.0
30,Rutgers (Big Ten),14,7-7,184,169,353,0.521,05/08/2024,2024.0
31,Binghamton (America East),13,6-7,190,175,365,0.521,05/08/2024,2024.0
32,Virginia (ACC),15,10-5,226,209,435,0.520,05/08/2024,2024.0
33,Villanova (Big East),16,9-7,204,190,394,0.518,05/08/2024,2024.0
34,Lafayette (Patriot),13,6-7,184,172,356,0.517,05/08/2024,2024.0
35,Canisius (MAAC),15,5-10,193,188,381,0.507,05/08/2024,2024.0
36,Saint Joseph's (Atlantic 10),15,12-3,195,191,386,0.505,05/08/2024,2024.0
37,Delaware (CAA),14,9-5,177,178,355,0.499,05/08/2024,2024.0
38,Drexel (CAA),15,6-9,188,190,378,0.497,05/08/2024,2024.0
39,LIU (MAAC),14,10-4,176,178,354,0.497,05/08/2024,2024.0
40,Marist (MAAC),15,8-7,194,201,395,0.491,05/08/2024,2024.0
41,UMBC (America East),12,5-7,160,166,326,0.491,05/08/2024,2024.0
42,Bellarmine (ASUN),17,9-8,219,229,448,0.489,05/08/2024,2024.0
43,Johns Hopkins (Big Ten),14,10-4,166,174,340,0.488,05/08/2024,2024.0
44,Brown (Ivy League),14,3-11,167,180,347,0.481,05/08/2024,2024.0
45,Richmond (Atlantic 10),16,10-6,204,220,424,0.481,05/08/2024,2024.0
46,Boston U. (Patriot),17,10-7,227,245,472,0.481,05/08/2024,2024.0
47,Massachusetts (Atlantic 10),14,6-8,175,190,365,0.479,05/08/2024,2024.0
48,Air Force (ASUN),15,9-6,176,192,368,0.478,05/08/2024,2024.0
49,Monmouth (CAA),13,5-8,147,163,310,0.474,05/08/2024,2024.0
50,Siena (MAAC),16,8-8,203,226,429,0.473,05/08/2024,2024.0
51,Cornell (Ivy League),14,9-5,207,233,440,0.470,05/08/2024,2024.0
52,Cleveland St. (ASUN),17,9-8,205,231,436,0.470,05/08/2024,2024.0
53,St. John's (NY) (Big East),15,4-11,188,213,401,0.469,05/08/2024,2024.0
54,Stony Brook (CAA),14,4-10,176,201,377,0.467,05/08/2024,2024.0
55,UMass Lowell (America East),12,0-12,140,160,300,0.467,05/08/2024,2024.0
56,Penn (Ivy League),15,9-6,177,207,384,0.461,05/08/2024,2024.0
57,Utah (ASUN),16,12-4,213,252,465,0.458,05/08/2024,2024.0
58,Fairfield (CAA),15,8-7,183,218,401,0.456,05/08/2024,2024.0
59,Bucknell (Patriot),14,4-10,168,205,373,0.450,05/08/2024,2024.0
60,Providence (Big East),15,7-8,188,235,423,0.444,05/08/2024,2024.0
61,Manhattan (MAAC),17,8-9,179,228,407,0.440,05/08/2024,2024.0
61,Penn St. (Big Ten),15,11-4,179,228,407,0.440,05/08/2024,2024.0
63,Mount St. Mary's (MAAC),15,1-14,163,208,371,0.439,05/08/2024,2024.0
64,Harvard (Ivy League),13,8-5,158,209,367,0.431,05/08/2024,2024.0
65,Holy Cross (Patriot),13,2-11,142,194,336,0.423,05/08/2024,2024.0
66,Quinnipiac (MAAC),14,9-5,161,222,383,0.420,05/08/2024,2024.0
67,Wagner (MAAC),15,1-14,150,209,359,0.418,05/08/2024,2024.0
68,Loyola Maryland (Patriot),15,7-8,157,237,394,0.398,05/08/2024,2024.0
69,Colgate (Patriot),15,8-7,166,260,426,0.390,05/08/2024,2024.0
70,St. Bonaventure (Atlantic 10),12,1-11,120,188,308,0.390,05/08/2024,2024.0
71,Merrimack (America East),15,6-9,152,268,420,0.362,05/08/2024,2024.0
72,Detroit Mercy (ASUN),13,3-10,129,236,365,0.353,05/08/2024,2024.0
73,Hampton (CAA),13,0-13,120,252,372,0.323,05/08/2024,2024.0
-,Le Moyne (NEC),11,3-8,124,144,268,0.463,05/08/2024,2024.0
-,Queens (NC) (ASUN),13,2-11,145,179,324,0.448,05/08/2024,2024.0
-,Lindenwood (ASUN),12,0-12,111,175,286,0.388,05/08/2024,2024.0
1,North Carolina (ACC),14,7-7,228,141,369,0.618,05/05/2024,2024.0
2,Denver (Big East),14,11-3,209,135,344,0.608,05/05/2024,2024.0
3,Army West Point (Patriot),14,11-3,239,159,398,0.601,05/05/2024,2024.0
4,Bryant (America East),14,9-5,222,152,374,0.594,05/05/2024,2024.0
5,Michigan (Big Ten),16,10-6,258,177,435,0.593,05/05/2024,2024.0
6,NJIT (America East),14,8-6,212,148,360,0.589,05/05/2024,2024.0
7,Maryland (Big Ten),13,8-5,190,134,324,0.586,05/05/2024,2024.0
8,Syracuse (ACC),16,11-5,271,193,464,0.584,05/05/2024,2024.0
9,Towson (CAA),16,13-3,241,174,415,0.581,05/05/2024,2024.0
10,Hofstra (CAA),15,6-9,240,175,415,0.578,05/05/2024,2024.0
11,Marquette (Big East),14,4-10,200,147,347,0.576,05/05/2024,2024.0
12,Hobart (Atlantic 10),13,4-9,207,153,360,0.575,05/05/2024,2024.0
13,High Point (Atlantic 10),16,9-7,255,189,444,0.574,05/05/2024,2024.0
14,UAlbany (America East),16,9-7,250,188,438,0.571,05/05/2024,2024.0
15,Navy (Patriot),16,9-7,230,173,403,0.571,05/05/2024,2024.0
16,Jacksonville (ASUN),18,13-5,280,215,495,0.566,05/05/2024,2024.0
17,Notre Dame (ACC),13,12-1,204,164,368,0.554,05/05/2024,2024.0
18,Vermont (America East),16,8-8,249,201,450,0.553,05/05/2024,2024.0
19,Georgetown (Big East),15,12-3,210,172,382,0.550,05/05/2024,2024.0
20,Yale (Ivy League),15,11-4,260,218,478,0.544,05/05/2024,2024.0
21,Ohio St. (Big Ten),15,6-9,197,167,364,0.541,05/05/2024,2024.0
22,Lehigh (Patriot),15,9-6,202,173,375,0.539,05/05/2024,2024.0
23,Sacred Heart (MAAC),17,13-4,239,210,449,0.532,05/05/2024,2024.0
24,Robert Morris (ASUN),15,5-10,215,189,404,0.532,05/05/2024,2024.0
25,VMI (MAAC),15,7-8,218,196,414,0.527,05/05/2024,2024.0
26,Princeton (Ivy League),15,11-4,215,194,409,0.526,05/05/2024,2024.0
27,Dartmouth (Ivy League),13,3-10,187,169,356,0.525,05/05/2024,2024.0
28,Mercer (ASUN),14,4-10,188,172,360,0.522,05/05/2024,2024.0
29,Duke (ACC),17,12-5,252,231,483,0.522,05/05/2024,2024.0
30,Rutgers (Big Ten),14,7-7,184,169,353,0.521,05/05/2024,2024.0
31,Binghamton (America East),13,6-7,190,175,365,0.521,05/05/2024,2024.0
32,Virginia (ACC),15,10-5,226,209,435,0.520,05/05/2024,2024.0
33,Villanova (Big East),16,9-7,204,190,394,0.518,05/05/2024,2024.0
34,Lafayette (Patriot),13,6-7,184,172,356,0.517,05/05/2024,2024.0
35,Canisius (MAAC),15,5-10,193,188,381,0.507,05/05/2024,2024.0
36,Saint Joseph's (Atlantic 10),15,12-3,195,191,386,0.505,05/05/2024,2024.0
37,Delaware (CAA),14,9-5,177,178,355,0.499,05/05/2024,2024.0
38,Drexel (CAA),15,6-9,188,190,378,0.497,05/05/2024,2024.0
39,LIU (MAAC),14,10-4,176,178,354,0.497,05/05/2024,2024.0
40,Marist (MAAC),15,8-7,194,201,395,0.491,05/05/2024,2024.0
41,UMBC (America East),12,5-7,160,166,326,0.491,05/05/2024,2024.0
42,Bellarmine (ASUN),17,9-8,219,229,448,0.489,05/05/2024,2024.0
43,Johns Hopkins (Big Ten),14,10-4,165,175,340,0.485,05/05/2024,2024.0
44,Boston U. (Patriot),16,10-6,219,233,452,0.485,05/05/2024,2024.0
45,Brown (Ivy League),14,3-11,167,180,347,0.481,05/05/2024,2024.0
46,Richmond (Atlantic 10),16,10-6,204,220,424,0.481,05/05/2024,2024.0
47,Massachusetts (Atlantic 10),14,6-8,175,190,365,0.479,05/05/2024,2024.0
48,Air Force (ASUN),15,9-6,176,192,368,0.478,05/05/2024,2024.0
49,Monmouth (CAA),13,5-8,147,163,310,0.474,05/05/2024,2024.0
50,Siena (MAAC),16,8-8,203,226,429,0.473,05/05/2024,2024.0
51,Cornell (Ivy League),14,9-5,207,233,440,0.470,05/05/2024,2024.0
52,Cleveland St. (ASUN),17,9-8,205,231,436,0.470,05/05/2024,2024.0
53,St. John's (NY) (Big East),15,4-11,188,213,401,0.469,05/05/2024,2024.0
54,Stony Brook (CAA),14,4-10,176,201,377,0.467,05/05/2024,2024.0
55,UMass Lowell (America East),12,0-12,140,160,300,0.467,05/05/2024,2024.0
56,Penn (Ivy League),15,9-6,177,207,384,0.461,05/05/2024,2024.0
57,Utah (ASUN),16,12-4,213,252,465,0.458,05/05/2024,2024.0
58,Fairfield (CAA),15,8-7,183,218,401,0.456,05/05/2024,2024.0
59,Bucknell (Patriot),14,4-10,168,205,373,0.450,05/05/2024,2024.0
60,Providence (Big East),15,7-8,188,235,423,0.444,05/05/2024,2024.0
61,Manhattan (MAAC),17,8-9,179,228,407,0.440,05/05/2024,2024.0
61,Penn St. (Big Ten),15,11-4,179,228,407,0.440,05/05/2024,2024.0
63,Mount St. Mary's (MAAC),15,1-14,163,208,371,0.439,05/05/2024,2024.0
64,Harvard (Ivy League),13,8-5,158,209,367,0.431,05/05/2024,2024.0
65,Holy Cross (Patriot),13,2-11,142,194,336,0.423,05/05/2024,2024.0
66,Quinnipiac (MAAC),14,9-5,161,222,383,0.420,05/05/2024,2024.0
67,Wagner (MAAC),15,1-14,150,209,359,0.418,05/05/2024,2024.0
68,Loyola Maryland (Patriot),15,7-8,157,237,394,0.398,05/05/2024,2024.0
69,Colgate (Patriot),15,8-7,166,260,426,0.390,05/05/2024,2024.0
70,St. Bonaventure (Atlantic 10),12,1-11,120,188,308,0.390,05/05/2024,2024.0
71,Merrimack (America East),15,6-9,152,268,420,0.362,05/05/2024,2024.0
72,Detroit Mercy (ASUN),13,3-10,129,236,365,0.353,05/05/2024,2024.0
73,Hampton (CAA),13,0-13,120,252,372,0.323,05/05/2024,2024.0
-,Le Moyne (NEC),11,3-8,124,144,268,0.463,05/05/2024,2024.0
-,Queens (NC) (ASUN),13,2-11,145,179,324,0.448,05/05/2024,2024.0
-,Lindenwood (ASUN),12,0-12,111,175,286,0.388,05/05/2024,2024.0
1,North Carolina (ACC),14,7-7,228,141,369,0.618,05/04/2024,2024.0
2,Army West Point (Patriot),14,11-3,230,145,375,0.613,05/04/2024,2024.0
3,Denver (Big East),14,11-3,209,135,344,0.608,05/04/2024,2024.0
4,Bryant (America East),14,9-5,222,152,374,0.594,05/04/2024,2024.0
5,Michigan (Big Ten),16,10-6,258,177,435,0.593,05/04/2024,2024.0
6,NJIT (America East),14,8-6,212,148,360,0.589,05/04/2024,2024.0
7,Maryland (Big Ten),13,8-5,190,134,324,0.586,05/04/2024,2024.0
8,Syracuse (ACC),16,11-5,271,193,464,0.584,05/04/2024,2024.0
9,Towson (CAA),16,13-3,241,174,415,0.581,05/04/2024,2024.0
10,Hofstra (CAA),15,6-9,240,175,415,0.578,05/04/2024,2024.0
11,Marquette (Big East),14,4-10,200,147,347,0.576,05/04/2024,2024.0
12,Hobart (Atlantic 10),13,4-9,207,153,360,0.575,05/04/2024,2024.0
13,High Point (Atlantic 10),16,9-7,255,189,444,0.574,05/04/2024,2024.0
14,UAlbany (America East),16,9-7,250,188,438,0.571,05/04/2024,2024.0
15,Navy (Patriot),16,9-7,230,173,403,0.571,05/04/2024,2024.0
16,Jacksonville (ASUN),17,13-4,262,201,463,0.566,05/04/2024,2024.0
17,Vermont (America East),16,8-8,249,201,450,0.553,05/04/2024,2024.0
18,Georgetown (Big East),15,12-3,210,172,382,0.550,05/04/2024,2024.0
19,Notre Dame (ACC),12,11-1,188,155,343,0.548,05/04/2024,2024.0
20,Yale (Ivy League),15,11-4,260,218,478,0.544,05/04/2024,2024.0
21,Ohio St. (Big Ten),15,6-9,197,167,364,0.541,05/04/2024,2024.0
22,Lehigh (Patriot),15,9-6,202,173,375,0.539,05/04/2024,2024.0
23,Sacred Heart (MAAC),17,13-4,230,199,429,0.536,05/04/2024,2024.0
24,Robert Morris (ASUN),15,5-10,215,189,404,0.532,05/04/2024,2024.0
25,Duke (ACC),16,12-4,243,215,458,0.531,05/04/2024,2024.0
26,VMI (MAAC),15,7-8,218,196,414,0.527,05/04/2024,2024.0
27,Dartmouth (Ivy League),13,3-10,187,169,356,0.525,05/04/2024,2024.0
28,Princeton (Ivy League),14,10-4,197,179,376,0.524,05/04/2024,2024.0
29,Mercer (ASUN),14,4-10,188,172,360,0.522,05/04/2024,2024.0
30,Rutgers (Big Ten),14,7-7,184,169,353,0.521,05/04/2024,2024.0
31,Binghamton (America East),13,6-7,190,175,365,0.521,05/04/2024,2024.0
32,Virginia (ACC),15,10-5,226,209,435,0.520,05/04/2024,2024.0
33,Villanova (Big East),16,9-7,204,190,394,0.518,05/04/2024,2024.0
34,Lafayette (Patriot),13,6-7,184,172,356,0.517,05/04/2024,2024.0
35,Canisius (MAAC),15,5-10,193,188,381,0.507,05/04/2024,2024.0
36,Saint Joseph's (Atlantic 10),15,12-3,195,191,386,0.505,05/04/2024,2024.0
37,Delaware (CAA),14,9-5,177,178,355,0.499,05/04/2024,2024.0
38,Drexel (CAA),15,6-9,188,190,378,0.497,05/04/2024,2024.0
39,LIU (MAAC),14,10-4,176,178,354,0.497,05/04/2024,2024.0
40,Marist (MAAC),15,8-7,194,201,395,0.491,05/04/2024,2024.0
41,UMBC (America East),12,5-7,160,166,326,0.491,05/04/2024,2024.0
42,Bellarmine (ASUN),17,9-8,219,229,448,0.489,05/04/2024,2024.0
43,Johns Hopkins (Big Ten),14,10-4,165,175,340,0.485,05/04/2024,2024.0
44,Brown (Ivy League),14,3-11,167,180,347,0.481,05/04/2024,2024.0
45,Richmond (Atlantic 10),16,10-6,204,220,424,0.481,05/04/2024,2024.0
46,Massachusetts (Atlantic 10),14,6-8,175,190,365,0.479,05/04/2024,2024.0
47,Air Force (ASUN),15,9-6,176,192,368,0.478,05/04/2024,2024.0
48,Boston U. (Patriot),16,10-6,205,224,429,0.478,05/04/2024,2024.0
49,Monmouth (CAA),13,5-8,147,163,310,0.474,05/04/2024,2024.0
50,Siena (MAAC),16,8-8,203,226,429,0.473,05/04/2024,2024.0
51,Cornell (Ivy League),14,9-5,207,233,440,0.470,05/04/2024,2024.0
52,Cleveland St. (ASUN),17,9-8,205,231,436,0.470,05/04/2024,2024.0
53,St. John's (NY) (Big East),15,4-11,188,213,401,0.469,05/04/2024,2024.0
54,Stony Brook (CAA),14,4-10,176,201,377,0.467,05/04/2024,2024.0
55,UMass Lowell (America East),12,0-12,140,160,300,0.467,05/04/2024,2024.0
56,Penn (Ivy League),14,9-5,162,189,351,0.462,05/04/2024,2024.0
57,Utah (ASUN),15,11-4,199,234,433,0.460,05/04/2024,2024.0
58,Fairfield (CAA),15,8-7,183,218,401,0.456,05/04/2024,2024.0
59,Bucknell (Patriot),14,4-10,168,205,373,0.450,05/04/2024,2024.0
60,Providence (Big East),15,7-8,188,235,423,0.444,05/04/2024,2024.0
61,Penn St. (Big Ten),15,11-4,179,228,407,0.440,05/04/2024,2024.0
62,Mount St. Mary's (MAAC),15,1-14,163,208,371,0.439,05/04/2024,2024.0
63,Manhattan (MAAC),17,8-9,168,219,387,0.434,05/04/2024,2024.0
64,Harvard (Ivy League),13,8-5,158,209,367,0.431,05/04/2024,2024.0
65,Holy Cross (Patriot),13,2-11,142,194,336,0.423,05/04/2024,2024.0
66,Quinnipiac (MAAC),14,9-5,161,222,383,0.420,05/04/2024,2024.0
67,Wagner (MAAC),15,1-14,150,209,359,0.418,05/04/2024,2024.0
68,Loyola Maryland (Patriot),15,7-8,157,237,394,0.398,05/04/2024,2024.0
69,Colgate (Patriot),15,8-7,166,260,426,0.390,05/04/2024,2024.0
70,St. Bonaventure (Atlantic 10),12,1-11,120,188,308,0.390,05/04/2024,2024.0
71,Merrimack (America East),15,6-9,152,268,420,0.362,05/04/2024,2024.0
72,Detroit Mercy (ASUN),13,3-10,129,236,365,0.353,05/04/2024,2024.0
73,Hampton (CAA),13,0-13,120,252,372,0.323,05/04/2024,2024.0
-,Le Moyne (NEC),11,3-8,124,144,268,0.463,05/04/2024,2024.0
-,Queens (NC) (ASUN),13,2-11,145,179,324,0.448,05/04/2024,2024.0
-,Lindenwood (ASUN),12,0-12,111,175,286,0.388,05/04/2024,2024.0
1,North Carolina (ACC),14,7-7,228,141,369,0.618,05/03/2024,2024.0
2,Denver (Big East),14,11-3,209,135,344,0.608,05/03/2024,2024.0
3,Army West Point (Patriot),14,11-3,239,159,398,0.601,05/03/2024,2024.0
4,Bryant (America East),14,9-5,222,152,374,0.594,05/03/2024,2024.0
5,NJIT (America East),14,8-6,212,148,360,0.589,05/03/2024,2024.0
6,Maryland (Big Ten),13,8-5,190,134,324,0.586,05/03/2024,2024.0
7,Syracuse (ACC),16,11-5,271,193,464,0.584,05/03/2024,2024.0
8,UAlbany (America East),15,8-7,241,172,413,0.584,05/03/2024,2024.0
9,Michigan (Big Ten),15,9-6,239,172,411,0.582,05/03/2024,2024.0
10,Towson (CAA),15,12-3,227,164,391,0.581,05/03/2024,2024.0
11,Hofstra (CAA),15,6-9,240,175,415,0.578,05/03/2024,2024.0
12,Marquette (Big East),14,4-10,200,147,347,0.576,05/03/2024,2024.0
13,Hobart (Atlantic 10),13,4-9,207,153,360,0.575,05/03/2024,2024.0
14,High Point (Atlantic 10),16,9-7,255,189,444,0.574,05/03/2024,2024.0
15,Navy (Patriot),16,9-7,230,173,403,0.571,05/03/2024,2024.0
16,Jacksonville (ASUN),17,13-4,262,201,463,0.566,05/03/2024,2024.0
17,Vermont (America East),15,8-7,233,192,425,0.548,05/03/2024,2024.0
18,Notre Dame (ACC),12,11-1,188,155,343,0.548,05/03/2024,2024.0
19,Yale (Ivy League),15,11-4,260,218,478,0.544,05/03/2024,2024.0
20,Ohio St. (Big Ten),15,6-9,197,167,364,0.541,05/03/2024,2024.0
21,Lehigh (Patriot),15,9-6,202,173,375,0.539,05/03/2024,2024.0
22,Georgetown (Big East),14,11-3,192,166,358,0.536,05/03/2024,2024.0
23,Sacred Heart (MAAC),16,12-4,230,199,429,0.536,05/03/2024,2024.0
24,Villanova (Big East),15,9-6,198,172,370,0.535,05/03/2024,2024.0
25,Robert Morris (ASUN),15,5-10,215,189,404,0.532,05/03/2024,2024.0
26,Duke (ACC),16,12-4,243,215,458,0.531,05/03/2024,2024.0
27,VMI (MAAC),15,7-8,218,196,414,0.527,05/03/2024,2024.0
28,Dartmouth (Ivy League),13,3-10,187,169,356,0.525,05/03/2024,2024.0
29,Princeton (Ivy League),14,10-4,197,179,376,0.524,05/03/2024,2024.0
30,Mercer (ASUN),14,4-10,188,172,360,0.522,05/03/2024,2024.0
31,Rutgers (Big Ten),14,7-7,184,169,353,0.521,05/03/2024,2024.0
32,Binghamton (America East),13,6-7,190,175,365,0.521,05/03/2024,2024.0
33,Virginia (ACC),15,10-5,226,209,435,0.520,05/03/2024,2024.0
34,Lafayette (Patriot),13,6-7,184,172,356,0.517,05/03/2024,2024.0
35,Saint Joseph's (Atlantic 10),14,11-3,181,172,353,0.513,05/03/2024,2024.0
36,Canisius (MAAC),15,5-10,193,188,381,0.507,05/03/2024,2024.0
37,LIU (MAAC),14,10-4,170,166,336,0.506,05/03/2024,2024.0
38,Delaware (CAA),13,9-4,167,164,331,0.505,05/03/2024,2024.0
39,Drexel (CAA),15,6-9,188,190,378,0.497,05/03/2024,2024.0
40,Marist (MAAC),15,8-7,194,201,395,0.491,05/03/2024,2024.0
41,UMBC (America East),12,5-7,160,166,326,0.491,05/03/2024,2024.0
42,Bellarmine (ASUN),17,9-8,219,229,448,0.489,05/03/2024,2024.0
43,Johns Hopkins (Big Ten),14,10-4,165,175,340,0.485,05/03/2024,2024.0
44,Boston U. (Patriot),16,10-6,219,233,452,0.485,05/03/2024,2024.0
45,Brown (Ivy League),14,3-11,167,180,347,0.481,05/03/2024,2024.0
46,Massachusetts (Atlantic 10),14,6-8,175,190,365,0.479,05/03/2024,2024.0
47,Air Force (ASUN),15,9-6,176,192,368,0.478,05/03/2024,2024.0
48,Monmouth (CAA),13,5-8,147,163,310,0.474,05/03/2024,2024.0
49,Siena (MAAC),16,8-8,203,226,429,0.473,05/03/2024,2024.0
50,Richmond (Atlantic 10),15,10-5,185,206,391,0.473,05/03/2024,2024.0
51,Cornell (Ivy League),14,9-5,207,233,440,0.470,05/03/2024,2024.0
52,Cleveland St. (ASUN),17,9-8,205,231,436,0.470,05/03/2024,2024.0
53,St. John's (NY) (Big East),15,4-11,188,213,401,0.469,05/03/2024,2024.0
54,Stony Brook (CAA),14,4-10,176,201,377,0.467,05/03/2024,2024.0
55,UMass Lowell (America East),12,0-12,140,160,300,0.467,05/03/2024,2024.0
56,Penn (Ivy League),14,9-5,162,189,351,0.462,05/03/2024,2024.0
57,Utah (ASUN),15,11-4,199,234,433,0.460,05/03/2024,2024.0
58,Fairfield (CAA),15,8-7,183,218,401,0.456,05/03/2024,2024.0
59,Penn St. (Big Ten),14,11-3,174,209,383,0.454,05/03/2024,2024.0
60,Bucknell (Patriot),14,4-10,168,205,373,0.450,05/03/2024,2024.0
61,Providence (Big East),15,7-8,188,235,423,0.444,05/03/2024,2024.0
62,Mount St. Mary's (MAAC),15,1-14,163,208,371,0.439,05/03/2024,2024.0
63,Harvard (Ivy League),13,8-5,158,209,367,0.431,05/03/2024,2024.0
64,Manhattan (MAAC),16,8-8,156,213,369,0.423,05/03/2024,2024.0
65,Holy Cross (Patriot),13,2-11,142,194,336,0.423,05/03/2024,2024.0
66,Quinnipiac (MAAC),14,9-5,161,222,383,0.420,05/03/2024,2024.0
67,Wagner (MAAC),15,1-14,150,209,359,0.418,05/03/2024,2024.0
68,Loyola Maryland (Patriot),15,7-8,157,237,394,0.398,05/03/2024,2024.0
69,Colgate (Patriot),15,8-7,166,260,426,0.390,05/03/2024,2024.0
70,St. Bonaventure (Atlantic 10),12,1-11,120,188,308,0.390,05/03/2024,2024.0
71,Merrimack (America East),15,6-9,152,268,420,0.362,05/03/2024,2024.0
72,Detroit Mercy (ASUN),13,3-10,129,236,365,0.353,05/03/2024,2024.0
73,Hampton (CAA),13,0-13,120,252,372,0.323,05/03/2024,2024.0
-,Le Moyne (NEC),11,3-8,124,144,268,0.463,05/03/2024,2024.0
-,Queens (NC) (ASUN),13,2-11,145,179,324,0.448,05/03/2024,2024.0
-,Lindenwood (ASUN),12,0-12,111,175,286,0.388,05/03/2024,2024.0
1,North Carolina (ACC),14,7-7,228,141,369,0.618,05/02/2024,2024.0
2,Army West Point (Patriot),13,11-2,230,145,375,0.613,05/02/2024,2024.0
3,Denver (Big East),14,11-3,209,135,344,0.608,05/02/2024,2024.0
4,Bryant (America East),14,9-5,222,152,374,0.594,05/02/2024,2024.0
5,NJIT (America East),14,8-6,212,148,360,0.589,05/02/2024,2024.0
6,Maryland (Big Ten),13,8-5,190,134,324,0.586,05/02/2024,2024.0
7,Syracuse (ACC),15,11-4,253,179,432,0.586,05/02/2024,2024.0
8,UAlbany (America East),15,8-7,241,172,413,0.584,05/02/2024,2024.0
9,Michigan (Big Ten),15,9-6,239,172,411,0.582,05/02/2024,2024.0
10,Towson (CAA),15,12-3,227,164,391,0.581,05/02/2024,2024.0
11,Hofstra (CAA),15,6-9,240,175,415,0.578,05/02/2024,2024.0
12,Navy (Patriot),15,9-6,219,160,379,0.578,05/02/2024,2024.0
13,Marquette (Big East),14,4-10,200,147,347,0.576,05/02/2024,2024.0
14,Hobart (Atlantic 10),13,4-9,207,153,360,0.575,05/02/2024,2024.0
15,High Point (Atlantic 10),16,9-7,255,189,444,0.574,05/02/2024,2024.0
16,Jacksonville (ASUN),16,12-4,244,190,434,0.562,05/02/2024,2024.0
17,Yale (Ivy League),14,11-3,252,198,450,0.560,05/02/2024,2024.0
18,Vermont (America East),15,8-7,233,192,425,0.548,05/02/2024,2024.0
19,Notre Dame (ACC),11,10-1,170,143,313,0.543,05/02/2024,2024.0
20,Ohio St. (Big Ten),15,6-9,197,167,364,0.541,05/02/2024,2024.0
21,Lehigh (Patriot),14,8-6,189,162,351,0.538,05/02/2024,2024.0
22,Duke (ACC),15,11-4,229,197,426,0.538,05/02/2024,2024.0
23,Georgetown (Big East),14,11-3,192,166,358,0.536,05/02/2024,2024.0
24,Sacred Heart (MAAC),16,12-4,230,199,429,0.536,05/02/2024,2024.0
25,Villanova (Big East),15,9-6,198,172,370,0.535,05/02/2024,2024.0
26,Robert Morris (ASUN),15,5-10,215,189,404,0.532,05/02/2024,2024.0
27,Virginia (ACC),14,10-4,214,191,405,0.528,05/02/2024,2024.0
28,VMI (MAAC),15,7-8,218,196,414,0.527,05/02/2024,2024.0
29,Dartmouth (Ivy League),13,3-10,187,169,356,0.525,05/02/2024,2024.0
30,Mercer (ASUN),14,4-10,188,172,360,0.522,05/02/2024,2024.0
31,Rutgers (Big Ten),14,7-7,184,169,353,0.521,05/02/2024,2024.0
32,Binghamton (America East),13,6-7,190,175,365,0.521,05/02/2024,2024.0
33,Lafayette (Patriot),13,6-7,184,172,356,0.517,05/02/2024,2024.0
34,Saint Joseph's (Atlantic 10),14,11-3,181,172,353,0.513,05/02/2024,2024.0
35,Princeton (Ivy League),13,9-4,177,171,348,0.509,05/02/2024,2024.0
36,Canisius (MAAC),15,5-10,193,188,381,0.507,05/02/2024,2024.0
37,LIU (MAAC),14,10-4,170,166,336,0.506,05/02/2024,2024.0
38,Delaware (CAA),13,9-4,167,164,331,0.505,05/02/2024,2024.0
39,Drexel (CAA),15,6-9,188,190,378,0.497,05/02/2024,2024.0
40,Marist (MAAC),15,8-7,194,201,395,0.491,05/02/2024,2024.0
41,UMBC (America East),12,5-7,160,166,326,0.491,05/02/2024,2024.0
42,Bellarmine (ASUN),17,9-8,219,229,448,0.489,05/02/2024,2024.0
43,Air Force (ASUN),14,9-5,165,174,339,0.487,05/02/2024,2024.0
44,Johns Hopkins (Big Ten),14,10-4,165,175,340,0.485,05/02/2024,2024.0
45,Brown (Ivy League),14,3-11,167,180,347,0.481,05/02/2024,2024.0
46,Massachusetts (Atlantic 10),14,6-8,175,190,365,0.479,05/02/2024,2024.0
47,Boston U. (Patriot),15,9-6,205,224,429,0.478,05/02/2024,2024.0
48,Monmouth (CAA),13,5-8,147,163,310,0.474,05/02/2024,2024.0
49,Siena (MAAC),16,8-8,203,226,429,0.473,05/02/2024,2024.0
50,Richmond (Atlantic 10),15,10-5,185,206,391,0.473,05/02/2024,2024.0
51,Cornell (Ivy League),13,9-4,195,219,414,0.471,05/02/2024,2024.0
52,St. John's (NY) (Big East),15,4-11,188,213,401,0.469,05/02/2024,2024.0
53,Stony Brook (CAA),14,4-10,176,201,377,0.467,05/02/2024,2024.0
54,UMass Lowell (America East),12,0-12,140,160,300,0.467,05/02/2024,2024.0
55,Cleveland St. (ASUN),16,9-7,189,217,406,0.466,05/02/2024,2024.0
56,Utah (ASUN),14,10-4,185,218,403,0.459,05/02/2024,2024.0
57,Fairfield (CAA),15,8-7,183,218,401,0.456,05/02/2024,2024.0
58,Penn (Ivy League),13,8-5,148,177,325,0.455,05/02/2024,2024.0
59,Penn St. (Big Ten),14,11-3,174,209,383,0.454,05/02/2024,2024.0
60,Bucknell (Patriot),14,4-10,168,205,373,0.450,05/02/2024,2024.0
61,Providence (Big East),15,7-8,188,235,423,0.444,05/02/2024,2024.0
62,Mount St. Mary's (MAAC),15,1-14,163,208,371,0.439,05/02/2024,2024.0
63,Harvard (Ivy League),13,8-5,158,209,367,0.431,05/02/2024,2024.0
64,Manhattan (MAAC),16,8-8,156,213,369,0.423,05/02/2024,2024.0
65,Holy Cross (Patriot),13,2-11,142,194,336,0.423,05/02/2024,2024.0
66,Quinnipiac (MAAC),14,9-5,161,222,383,0.420,05/02/2024,2024.0
67,Wagner (MAAC),15,1-14,150,209,359,0.418,05/02/2024,2024.0
68,Loyola Maryland (Patriot),15,7-8,157,237,394,0.398,05/02/2024,2024.0
69,Colgate (Patriot),15,8-7,166,260,426,0.390,05/02/2024,2024.0
70,St. Bonaventure (Atlantic 10),12,1-11,120,188,308,0.390,05/02/2024,2024.0
71,Merrimack (America East),15,6-9,152,268,420,0.362,05/02/2024,2024.0
72,Detroit Mercy (ASUN),13,3-10,129,236,365,0.353,05/02/2024,2024.0
73,Hampton (CAA),13,0-13,120,252,372,0.323,05/02/2024,2024.0
-,Le Moyne (NEC),11,3-8,124,144,268,0.463,05/02/2024,2024.0
-,Queens (NC) (ASUN),13,2-11,145,179,324,0.448,05/02/2024,2024.0
-,Lindenwood (ASUN),12,0-12,111,175,286,0.388,05/02/2024,2024.0
1,North Carolina (ACC),14,7-7,228,141,369,0.618,04/30/2024,2024.0
2,Army West Point (Patriot),13,11-2,230,145,375,0.613,04/30/2024,2024.0
3,Denver (Big East),13,11-2,194,129,323,0.601,04/30/2024,2024.0
4,Bryant (America East),14,9-5,222,152,374,0.594,04/30/2024,2024.0
5,Michigan (Big Ten),14,8-6,232,159,391,0.593,04/30/2024,2024.0
6,NJIT (America East),14,8-6,212,148,360,0.589,04/30/2024,2024.0
7,Syracuse (ACC),15,11-4,253,179,432,0.586,04/30/2024,2024.0
8,Maryland (Big Ten),12,8-4,170,123,293,0.580,04/30/2024,2024.0
9,Hofstra (CAA),15,6-9,240,175,415,0.578,04/30/2024,2024.0
10,Navy (Patriot),15,9-6,219,160,379,0.578,04/30/2024,2024.0
11,Marquette (Big East),14,4-10,200,147,347,0.576,04/30/2024,2024.0
12,Hobart (Atlantic 10),13,4-9,207,153,360,0.575,04/30/2024,2024.0
13,Towson (CAA),14,11-3,207,154,361,0.573,04/30/2024,2024.0
14,UAlbany (America East),14,7-7,221,166,387,0.571,04/30/2024,2024.0
15,High Point (Atlantic 10),15,9-6,238,181,419,0.568,04/30/2024,2024.0
16,Jacksonville (ASUN),16,12-4,244,190,434,0.562,04/30/2024,2024.0
17,Yale (Ivy League),14,11-3,252,198,450,0.560,04/30/2024,2024.0
18,Villanova (Big East),14,8-6,192,157,349,0.550,04/30/2024,2024.0
19,Georgetown (Big East),13,10-3,178,149,327,0.544,04/30/2024,2024.0
20,Sacred Heart (MAAC),15,11-4,216,181,397,0.544,04/30/2024,2024.0
21,Vermont (America East),14,7-7,219,184,403,0.543,04/30/2024,2024.0
22,Notre Dame (ACC),11,10-1,170,143,313,0.543,04/30/2024,2024.0
23,Ohio St. (Big Ten),15,6-9,197,167,364,0.541,04/30/2024,2024.0
24,Lehigh (Patriot),14,8-6,189,162,351,0.538,04/30/2024,2024.0
25,Duke (ACC),15,11-4,229,197,426,0.538,04/30/2024,2024.0
26,Robert Morris (ASUN),15,5-10,215,189,404,0.532,04/30/2024,2024.0
27,Virginia (ACC),14,10-4,214,191,405,0.528,04/30/2024,2024.0
28,VMI (MAAC),15,7-8,218,196,414,0.527,04/30/2024,2024.0
29,Dartmouth (Ivy League),13,3-10,187,169,356,0.525,04/30/2024,2024.0
30,Mercer (ASUN),14,4-10,188,172,360,0.522,04/30/2024,2024.0
31,Rutgers (Big Ten),14,7-7,184,169,353,0.521,04/30/2024,2024.0
32,Binghamton (America East),13,6-7,190,175,365,0.521,04/30/2024,2024.0
33,Lafayette (Patriot),13,6-7,184,172,356,0.517,04/30/2024,2024.0
34,Saint Joseph's (Atlantic 10),13,10-3,169,161,330,0.512,04/30/2024,2024.0
35,Drexel (CAA),14,6-8,178,170,348,0.511,04/30/2024,2024.0
36,Princeton (Ivy League),13,9-4,177,171,348,0.509,04/30/2024,2024.0
37,Canisius (MAAC),15,5-10,193,188,381,0.507,04/30/2024,2024.0
38,LIU (MAAC),13,10-3,170,166,336,0.506,04/30/2024,2024.0
39,UMBC (America East),11,5-6,152,152,304,0.500,04/30/2024,2024.0
40,Delaware (CAA),12,8-4,149,153,302,0.493,04/30/2024,2024.0
41,Marist (MAAC),15,8-7,194,201,395,0.491,04/30/2024,2024.0
42,Bellarmine (ASUN),17,9-8,219,229,448,0.489,04/30/2024,2024.0
43,Air Force (ASUN),14,9-5,165,174,339,0.487,04/30/2024,2024.0
44,Richmond (Atlantic 10),14,9-5,177,189,366,0.484,04/30/2024,2024.0
45,Brown (Ivy League),14,3-11,167,180,347,0.481,04/30/2024,2024.0
46,Massachusetts (Atlantic 10),13,6-7,164,178,342,0.480,04/30/2024,2024.0
47,Boston U. (Patriot),15,9-6,205,224,429,0.478,04/30/2024,2024.0
48,Johns Hopkins (Big Ten),13,10-3,152,168,320,0.475,04/30/2024,2024.0
49,Monmouth (CAA),13,5-8,147,163,310,0.474,04/30/2024,2024.0
50,Cornell (Ivy League),13,9-4,195,219,414,0.471,04/30/2024,2024.0
51,St. John's (NY) (Big East),15,4-11,188,213,401,0.469,04/30/2024,2024.0
52,Stony Brook (CAA),14,4-10,176,201,377,0.467,04/30/2024,2024.0
53,UMass Lowell (America East),12,0-12,140,160,300,0.467,04/30/2024,2024.0
54,Siena (MAAC),15,8-7,185,212,397,0.466,04/30/2024,2024.0
55,Cleveland St. (ASUN),16,9-7,189,217,406,0.466,04/30/2024,2024.0
56,Penn St. (Big Ten),13,10-3,163,189,352,0.463,04/30/2024,2024.0
57,Fairfield (CAA),14,8-6,172,200,372,0.462,04/30/2024,2024.0
58,Utah (ASUN),14,10-4,185,218,403,0.459,04/30/2024,2024.0
59,Penn (Ivy League),13,8-5,148,177,325,0.455,04/30/2024,2024.0
60,Bucknell (Patriot),14,4-10,168,205,373,0.450,04/30/2024,2024.0
61,Mount St. Mary's (MAAC),15,1-14,163,208,371,0.439,04/30/2024,2024.0
62,Providence (Big East),14,7-7,171,221,392,0.436,04/30/2024,2024.0
63,Harvard (Ivy League),13,8-5,158,209,367,0.431,04/30/2024,2024.0
64,Manhattan (MAAC),15,7-8,156,213,369,0.423,04/30/2024,2024.0
65,Holy Cross (Patriot),13,2-11,142,194,336,0.423,04/30/2024,2024.0
66,Quinnipiac (MAAC),14,9-5,161,222,383,0.420,04/30/2024,2024.0
67,Wagner (MAAC),15,1-14,150,209,359,0.418,04/30/2024,2024.0
68,Loyola Maryland (Patriot),15,7-8,157,237,394,0.398,04/30/2024,2024.0
69,Colgate (Patriot),15,8-7,166,260,426,0.390,04/30/2024,2024.0
70,St. Bonaventure (Atlantic 10),12,1-11,120,188,308,0.390,04/30/2024,2024.0
71,Merrimack (America East),14,6-8,146,248,394,0.371,04/30/2024,2024.0
72,Detroit Mercy (ASUN),13,3-10,129,236,365,0.353,04/30/2024,2024.0
73,Hampton (CAA),13,0-13,120,252,372,0.323,04/30/2024,2024.0
-,Le Moyne (NEC),11,3-8,124,144,268,0.463,04/30/2024,2024.0
-,Queens (NC) (ASUN),13,2-11,145,179,324,0.448,04/30/2024,2024.0
-,Lindenwood (ASUN),12,0-12,111,175,286,0.388,04/30/2024,2024.0
1,North Carolina (ACC),14,7-7,228,141,369,0.618,04/27/2024,2024.0
2,Army West Point (Patriot),13,11-2,230,145,375,0.613,04/27/2024,2024.0
3,Denver (Big East),13,11-2,194,129,323,0.601,04/27/2024,2024.0
4,Bryant (America East),14,9-5,222,152,374,0.594,04/27/2024,2024.0
5,Michigan (Big Ten),14,8-6,232,159,391,0.593,04/27/2024,2024.0
6,NJIT (America East),14,8-6,212,148,360,0.589,04/27/2024,2024.0
7,Syracuse (ACC),15,11-4,253,179,432,0.586,04/27/2024,2024.0
8,Maryland (Big Ten),12,8-4,170,123,293,0.580,04/27/2024,2024.0
9,Hofstra (CAA),15,6-9,240,175,415,0.578,04/27/2024,2024.0
10,Marquette (Big East),14,4-10,200,147,347,0.576,04/27/2024,2024.0
11,Hobart (Atlantic 10),13,4-9,207,153,360,0.575,04/27/2024,2024.0
12,Towson (CAA),14,11-3,207,154,361,0.573,04/27/2024,2024.0
13,UAlbany (America East),14,7-7,221,166,387,0.571,04/27/2024,2024.0
14,Navy (Patriot),14,8-6,201,152,353,0.569,04/27/2024,2024.0
15,High Point (Atlantic 10),15,9-6,238,181,419,0.568,04/27/2024,2024.0
16,Jacksonville (ASUN),15,11-4,228,174,402,0.567,04/27/2024,2024.0
17,Yale (Ivy League),14,11-3,252,198,450,0.560,04/27/2024,2024.0
18,Villanova (Big East),14,8-6,192,157,349,0.550,04/27/2024,2024.0
19,Georgetown (Big East),13,10-3,178,149,327,0.544,04/27/2024,2024.0
20,Sacred Heart (MAAC),15,11-4,216,181,397,0.544,04/27/2024,2024.0
21,Vermont (America East),14,7-7,219,184,403,0.543,04/27/2024,2024.0
22,Notre Dame (ACC),11,10-1,170,143,313,0.543,04/27/2024,2024.0
23,Ohio St. (Big Ten),15,6-9,197,167,364,0.541,04/27/2024,2024.0
24,Lehigh (Patriot),14,8-6,189,162,351,0.538,04/27/2024,2024.0
25,Duke (ACC),15,11-4,229,197,426,0.538,04/27/2024,2024.0
26,Robert Morris (ASUN),14,5-9,199,173,372,0.535,04/27/2024,2024.0
27,Virginia (ACC),14,10-4,214,191,405,0.528,04/27/2024,2024.0
28,VMI (MAAC),15,7-8,218,196,414,0.527,04/27/2024,2024.0
29,Dartmouth (Ivy League),13,3-10,187,169,356,0.525,04/27/2024,2024.0
30,Mercer (ASUN),14,4-10,188,172,360,0.522,04/27/2024,2024.0
31,Rutgers (Big Ten),14,7-7,184,169,353,0.521,04/27/2024,2024.0
32,Binghamton (America East),13,6-7,190,175,365,0.521,04/27/2024,2024.0
33,Lafayette (Patriot),13,6-7,184,172,356,0.517,04/27/2024,2024.0
34,Saint Joseph's (Atlantic 10),13,10-3,169,161,330,0.512,04/27/2024,2024.0
35,Drexel (CAA),14,6-8,178,170,348,0.511,04/27/2024,2024.0
36,Princeton (Ivy League),13,9-4,177,171,348,0.509,04/27/2024,2024.0
37,Canisius (MAAC),15,5-10,193,188,381,0.507,04/27/2024,2024.0
38,LIU (MAAC),13,10-3,170,166,336,0.506,04/27/2024,2024.0
39,UMBC (America East),11,5-6,152,152,304,0.500,04/27/2024,2024.0
40,Delaware (CAA),12,8-4,149,153,302,0.493,04/27/2024,2024.0
41,Marist (MAAC),15,8-7,194,201,395,0.491,04/27/2024,2024.0
42,Bellarmine (ASUN),16,9-7,205,213,418,0.490,04/27/2024,2024.0
43,Air Force (ASUN),14,9-5,165,174,339,0.487,04/27/2024,2024.0
44,Richmond (Atlantic 10),14,9-5,177,189,366,0.484,04/27/2024,2024.0
45,Brown (Ivy League),14,3-11,167,180,347,0.481,04/27/2024,2024.0
46,Massachusetts (Atlantic 10),13,6-7,164,178,342,0.480,04/27/2024,2024.0
47,Johns Hopkins (Big Ten),13,10-3,152,168,320,0.475,04/27/2024,2024.0
48,Monmouth (CAA),13,5-8,147,163,310,0.474,04/27/2024,2024.0
49,Cornell (Ivy League),13,9-4,195,219,414,0.471,04/27/2024,2024.0
50,St. John's (NY) (Big East),15,4-11,188,213,401,0.469,04/27/2024,2024.0
51,Stony Brook (CAA),14,4-10,176,201,377,0.467,04/27/2024,2024.0
52,UMass Lowell (America East),12,0-12,140,160,300,0.467,04/27/2024,2024.0
53,Siena (MAAC),15,8-7,185,212,397,0.466,04/27/2024,2024.0
54,Penn St. (Big Ten),13,10-3,163,189,352,0.463,04/27/2024,2024.0
55,Fairfield (CAA),14,8-6,172,200,372,0.462,04/27/2024,2024.0
56,Boston U. (Patriot),14,8-6,180,210,390,0.462,04/27/2024,2024.0
57,Cleveland St. (ASUN),15,8-7,173,203,376,0.460,04/27/2024,2024.0
58,Utah (ASUN),14,10-4,185,218,403,0.459,04/27/2024,2024.0
59,Penn (Ivy League),13,8-5,148,177,325,0.455,04/27/2024,2024.0
60,Bucknell (Patriot),14,4-10,168,205,373,0.450,04/27/2024,2024.0
61,Mount St. Mary's (MAAC),15,1-14,163,208,371,0.439,04/27/2024,2024.0
62,Providence (Big East),14,7-7,171,221,392,0.436,04/27/2024,2024.0
63,Harvard (Ivy League),13,8-5,158,209,367,0.431,04/27/2024,2024.0
64,Manhattan (MAAC),15,7-8,156,213,369,0.423,04/27/2024,2024.0
65,Holy Cross (Patriot),13,2-11,142,194,336,0.423,04/27/2024,2024.0
66,Quinnipiac (MAAC),14,9-5,161,222,383,0.420,04/27/2024,2024.0
67,Wagner (MAAC),15,1-14,150,209,359,0.418,04/27/2024,2024.0
68,Loyola Maryland (Patriot),14,7-7,149,219,368,0.405,04/27/2024,2024.0
69,Colgate (Patriot),14,8-6,152,235,387,0.393,04/27/2024,2024.0
70,St. Bonaventure (Atlantic 10),12,1-11,120,188,308,0.390,04/27/2024,2024.0
71,Merrimack (America East),14,6-8,146,248,394,0.371,04/27/2024,2024.0
72,Detroit Mercy (ASUN),13,3-10,129,236,365,0.353,04/27/2024,2024.0
73,Hampton (CAA),13,0-13,120,252,372,0.323,04/27/2024,2024.0
-,Le Moyne (NEC),11,3-8,124,144,268,0.463,04/27/2024,2024.0
-,Queens (NC) (ASUN),13,2-11,145,179,324,0.448,04/27/2024,2024.0
-,Lindenwood (ASUN),12,0-12,111,175,286,0.388,04/27/2024,2024.0
1,North Carolina (ACC),13,6-7,209,131,340,0.615,04/26/2024,2024.0
2,Army West Point (Patriot),13,11-2,230,145,375,0.613,04/26/2024,2024.0
3,Denver (Big East),13,11-2,194,129,323,0.601,04/26/2024,2024.0
4,Michigan (Big Ten),13,7-6,218,145,363,0.601,04/26/2024,2024.0
5,Bryant (America East),13,9-4,203,138,341,0.595,04/26/2024,2024.0
6,NJIT (America East),13,7-6,200,141,341,0.587,04/26/2024,2024.0
7,Syracuse (ACC),15,11-4,253,179,432,0.586,04/26/2024,2024.0
8,Yale (Ivy League),13,11-2,246,177,423,0.582,04/26/2024,2024.0
9,Maryland (Big Ten),12,8-4,170,123,293,0.580,04/26/2024,2024.0
10,Towson (CAA),14,11-3,195,142,337,0.579,04/26/2024,2024.0
11,Marquette (Big East),14,4-10,200,147,347,0.576,04/26/2024,2024.0
12,Hofstra (CAA),14,5-9,225,166,391,0.575,04/26/2024,2024.0
13,UAlbany (America East),13,6-7,204,152,356,0.573,04/26/2024,2024.0
14,Navy (Patriot),14,8-6,201,152,353,0.569,04/26/2024,2024.0
15,High Point (Atlantic 10),15,9-6,238,181,419,0.568,04/26/2024,2024.0
16,Hobart (Atlantic 10),12,3-9,190,145,335,0.567,04/26/2024,2024.0
17,Villanova (Big East),14,8-6,186,144,330,0.564,04/26/2024,2024.0
18,Jacksonville (ASUN),14,10-4,206,164,370,0.557,04/26/2024,2024.0
19,Notre Dame (ACC),10,9-1,160,130,290,0.552,04/26/2024,2024.0
20,Duke (ACC),14,11-3,219,178,397,0.552,04/26/2024,2024.0
21,Ohio St. (Big Ten),14,6-8,183,153,336,0.545,04/26/2024,2024.0
22,Sacred Heart (MAAC),15,11-4,216,181,397,0.544,04/26/2024,2024.0
23,Robert Morris (ASUN),13,5-8,186,157,343,0.542,04/26/2024,2024.0
24,Lehigh (Patriot),14,8-6,189,162,351,0.538,04/26/2024,2024.0
25,Georgetown (Big East),13,10-3,165,143,308,0.536,04/26/2024,2024.0
26,Rutgers (Big Ten),13,7-6,175,152,327,0.535,04/26/2024,2024.0
27,Vermont (America East),13,6-7,198,173,371,0.534,04/26/2024,2024.0
28,Binghamton (America East),12,6-6,176,158,334,0.527,04/26/2024,2024.0
29,VMI (MAAC),15,7-8,218,196,414,0.527,04/26/2024,2024.0
30,Virginia (ACC),13,10-3,201,181,382,0.526,04/26/2024,2024.0
31,Mercer (ASUN),13,3-10,174,159,333,0.523,04/26/2024,2024.0
32,UMBC (America East),10,5-5,141,131,272,0.518,04/26/2024,2024.0
33,Dartmouth (Ivy League),12,3-9,170,158,328,0.518,04/26/2024,2024.0
34,Lafayette (Patriot),13,6-7,184,172,356,0.517,04/26/2024,2024.0
35,Drexel (CAA),14,6-8,178,170,348,0.511,04/26/2024,2024.0
36,Saint Joseph's (Atlantic 10),12,9-3,157,152,309,0.508,04/26/2024,2024.0
37,Canisius (MAAC),15,5-10,193,188,381,0.507,04/26/2024,2024.0
38,LIU (MAAC),13,10-3,170,166,336,0.506,04/26/2024,2024.0
39,Bellarmine (ASUN),15,9-6,195,191,386,0.505,04/26/2024,2024.0
40,Delaware (CAA),12,8-4,137,141,278,0.493,04/26/2024,2024.0
41,Marist (MAAC),14,8-6,182,189,371,0.491,04/26/2024,2024.0
42,Richmond (Atlantic 10),13,9-4,168,177,345,0.487,04/26/2024,2024.0
43,Princeton (Ivy League),12,8-4,156,165,321,0.486,04/26/2024,2024.0
44,Air Force (ASUN),13,8-5,149,161,310,0.481,04/26/2024,2024.0
45,Massachusetts (Atlantic 10),13,6-7,164,178,342,0.480,04/26/2024,2024.0
46,Cornell (Ivy League),12,8-4,184,202,386,0.477,04/26/2024,2024.0
47,Brown (Ivy League),13,3-10,154,170,324,0.475,04/26/2024,2024.0
48,Johns Hopkins (Big Ten),13,10-3,152,168,320,0.475,04/26/2024,2024.0
49,Monmouth (CAA),13,5-8,147,163,310,0.474,04/26/2024,2024.0
50,UMass Lowell (America East),11,0-11,133,148,281,0.473,04/26/2024,2024.0
51,Stony Brook (CAA),13,4-9,167,186,353,0.473,04/26/2024,2024.0
52,Cleveland St. (ASUN),14,7-7,166,186,352,0.472,04/26/2024,2024.0
53,St. John's (NY) (Big East),15,4-11,188,213,401,0.469,04/26/2024,2024.0
54,Siena (MAAC),14,7-7,173,200,373,0.464,04/26/2024,2024.0
55,Boston U. (Patriot),14,8-6,166,195,361,0.460,04/26/2024,2024.0
56,Fairfield (CAA),13,7-6,156,186,342,0.456,04/26/2024,2024.0
57,Penn (Ivy League),13,8-5,148,177,325,0.455,04/26/2024,2024.0
58,Bucknell (Patriot),14,4-10,168,205,373,0.450,04/26/2024,2024.0
59,Utah (ASUN),13,9-4,164,202,366,0.448,04/26/2024,2024.0
60,Penn St. (Big Ten),12,9-3,146,180,326,0.448,04/26/2024,2024.0
61,Mount St. Mary's (MAAC),15,1-14,163,208,371,0.439,04/26/2024,2024.0
62,Providence (Big East),14,7-7,171,221,392,0.436,04/26/2024,2024.0
63,Quinnipiac (MAAC),13,9-4,153,200,353,0.433,04/26/2024,2024.0
64,Harvard (Ivy League),12,7-5,148,196,344,0.430,04/26/2024,2024.0
65,Holy Cross (Patriot),13,2-11,142,194,336,0.423,04/26/2024,2024.0
66,Wagner (MAAC),15,1-14,150,209,359,0.418,04/26/2024,2024.0
67,Loyola Maryland (Patriot),14,7-7,149,219,368,0.405,04/26/2024,2024.0
68,St. Bonaventure (Atlantic 10),11,1-10,112,171,283,0.396,04/26/2024,2024.0
69,Manhattan (MAAC),14,6-8,134,205,339,0.395,04/26/2024,2024.0
70,Colgate (Patriot),14,8-6,137,221,358,0.383,04/26/2024,2024.0
71,Merrimack (America East),13,5-8,132,229,361,0.366,04/26/2024,2024.0
72,Detroit Mercy (ASUN),12,3-9,112,229,341,0.328,04/26/2024,2024.0
73,Hampton (CAA),12,0-12,106,236,342,0.310,04/26/2024,2024.0
-,Le Moyne (NEC),11,3-8,124,144,268,0.463,04/26/2024,2024.0
-,Queens (NC) (ASUN),12,2-10,129,158,287,0.449,04/26/2024,2024.0
-,Lindenwood (ASUN),11,0-11,98,161,259,0.378,04/26/2024,2024.0
1,North Carolina (ACC),13,6-7,209,131,340,0.615,04/25/2024,2024.0
2,Army West Point (Patriot),12,10-2,212,135,347,0.611,04/25/2024,2024.0
3,Denver (Big East),12,10-2,178,117,295,0.603,04/25/2024,2024.0
4,Michigan (Big Ten),13,7-6,218,145,363,0.601,04/25/2024,2024.0
5,Bryant (America East),13,9-4,203,138,341,0.595,04/25/2024,2024.0
6,Marquette (Big East),13,4-9,188,131,319,0.589,04/25/2024,2024.0
7,NJIT (America East),13,7-6,200,141,341,0.587,04/25/2024,2024.0
8,Syracuse (ACC),15,11-4,253,179,432,0.586,04/25/2024,2024.0
9,Yale (Ivy League),13,11-2,246,177,423,0.582,04/25/2024,2024.0
10,Maryland (Big Ten),12,8-4,170,123,293,0.580,04/25/2024,2024.0
11,Towson (CAA),13,10-3,195,142,337,0.579,04/25/2024,2024.0
12,Hofstra (CAA),14,5-9,225,166,391,0.575,04/25/2024,2024.0
13,UAlbany (America East),13,6-7,204,152,356,0.573,04/25/2024,2024.0
14,High Point (Atlantic 10),14,8-6,221,167,388,0.570,04/25/2024,2024.0
15,Hobart (Atlantic 10),12,3-9,190,145,335,0.567,04/25/2024,2024.0
16,Villanova (Big East),13,8-5,186,144,330,0.564,04/25/2024,2024.0
17,Navy (Patriot),13,7-6,181,144,325,0.557,04/25/2024,2024.0
18,Jacksonville (ASUN),14,10-4,206,164,370,0.557,04/25/2024,2024.0
19,Notre Dame (ACC),10,9-1,160,130,290,0.552,04/25/2024,2024.0
20,Duke (ACC),14,11-3,219,178,397,0.552,04/25/2024,2024.0
21,Ohio St. (Big Ten),14,6-8,183,153,336,0.545,04/25/2024,2024.0
22,Sacred Heart (MAAC),15,11-4,216,181,397,0.544,04/25/2024,2024.0
23,Robert Morris (ASUN),13,5-8,186,157,343,0.542,04/25/2024,2024.0
24,Georgetown (Big East),12,9-3,165,143,308,0.536,04/25/2024,2024.0
25,Rutgers (Big Ten),13,7-6,175,152,327,0.535,04/25/2024,2024.0
26,Vermont (America East),13,6-7,198,173,371,0.534,04/25/2024,2024.0
27,Lafayette (Patriot),12,6-6,175,153,328,0.534,04/25/2024,2024.0
28,Binghamton (America East),12,6-6,176,158,334,0.527,04/25/2024,2024.0
29,VMI (MAAC),15,7-8,218,196,414,0.527,04/25/2024,2024.0
30,Lehigh (Patriot),13,7-6,170,153,323,0.526,04/25/2024,2024.0
31,Virginia (ACC),13,10-3,201,181,382,0.526,04/25/2024,2024.0
32,Mercer (ASUN),13,3-10,174,159,333,0.523,04/25/2024,2024.0
33,UMBC (America East),10,5-5,141,131,272,0.518,04/25/2024,2024.0
34,Dartmouth (Ivy League),12,3-9,170,158,328,0.518,04/25/2024,2024.0
35,Saint Joseph's (Atlantic 10),12,9-3,157,152,309,0.508,04/25/2024,2024.0
36,Canisius (MAAC),15,5-10,193,188,381,0.507,04/25/2024,2024.0
37,Drexel (CAA),13,5-8,169,165,334,0.506,04/25/2024,2024.0
38,LIU (MAAC),13,10-3,170,166,336,0.506,04/25/2024,2024.0
39,Bellarmine (ASUN),15,9-6,195,191,386,0.505,04/25/2024,2024.0
40,Delaware (CAA),11,8-3,137,141,278,0.493,04/25/2024,2024.0
41,Marist (MAAC),14,8-6,182,189,371,0.491,04/25/2024,2024.0
42,Richmond (Atlantic 10),13,9-4,168,177,345,0.487,04/25/2024,2024.0
43,Princeton (Ivy League),12,8-4,156,165,321,0.486,04/25/2024,2024.0
44,Massachusetts (Atlantic 10),12,6-6,150,161,311,0.482,04/25/2024,2024.0
45,Air Force (ASUN),13,8-5,149,161,310,0.481,04/25/2024,2024.0
46,Monmouth (CAA),12,5-7,142,154,296,0.480,04/25/2024,2024.0
47,Cornell (Ivy League),12,8-4,184,202,386,0.477,04/25/2024,2024.0
48,Brown (Ivy League),13,3-10,154,170,324,0.475,04/25/2024,2024.0
49,Johns Hopkins (Big Ten),13,10-3,152,168,320,0.475,04/25/2024,2024.0
50,UMass Lowell (America East),11,0-11,133,148,281,0.473,04/25/2024,2024.0
51,Stony Brook (CAA),13,4-9,167,186,353,0.473,04/25/2024,2024.0
52,Cleveland St. (ASUN),14,7-7,166,186,352,0.472,04/25/2024,2024.0
53,Siena (MAAC),14,7-7,173,200,373,0.464,04/25/2024,2024.0
54,Bucknell (Patriot),13,4-9,160,185,345,0.464,04/25/2024,2024.0
55,St. John's (NY) (Big East),14,4-10,170,199,369,0.461,04/25/2024,2024.0
56,Boston U. (Patriot),13,7-6,166,195,361,0.460,04/25/2024,2024.0
57,Fairfield (CAA),13,7-6,156,186,342,0.456,04/25/2024,2024.0
58,Penn (Ivy League),13,8-5,148,177,325,0.455,04/25/2024,2024.0
59,Utah (ASUN),13,9-4,164,202,366,0.448,04/25/2024,2024.0
60,Penn St. (Big Ten),12,9-3,146,180,326,0.448,04/25/2024,2024.0
61,Mount St. Mary's (MAAC),15,1-14,163,208,371,0.439,04/25/2024,2024.0
62,Providence (Big East),13,6-7,157,203,360,0.436,04/25/2024,2024.0
63,Quinnipiac (MAAC),13,9-4,153,200,353,0.433,04/25/2024,2024.0
64,Harvard (Ivy League),12,7-5,148,196,344,0.430,04/25/2024,2024.0
65,Holy Cross (Patriot),13,2-11,142,194,336,0.423,04/25/2024,2024.0
66,Wagner (MAAC),15,1-14,150,209,359,0.418,04/25/2024,2024.0
67,Loyola Maryland (Patriot),13,7-6,139,201,340,0.409,04/25/2024,2024.0
68,St. Bonaventure (Atlantic 10),11,1-10,112,171,283,0.396,04/25/2024,2024.0
69,Manhattan (MAAC),14,6-8,134,205,339,0.395,04/25/2024,2024.0
70,Colgate (Patriot),13,8-5,137,221,358,0.383,04/25/2024,2024.0
71,Merrimack (America East),13,5-8,132,229,361,0.366,04/25/2024,2024.0
72,Detroit Mercy (ASUN),12,3-9,112,229,341,0.328,04/25/2024,2024.0
73,Hampton (CAA),12,0-12,106,236,342,0.310,04/25/2024,2024.0
-,Le Moyne (NEC),11,3-8,124,144,268,0.463,04/25/2024,2024.0
-,Queens (NC) (ASUN),12,2-10,129,158,287,0.449,04/25/2024,2024.0
-,Lindenwood (ASUN),11,0-11,98,161,259,0.378,04/25/2024,2024.0
1,North Carolina (ACC),13,6-7,209,131,340,0.615,04/23/2024,2024.0
2,Army West Point (Patriot),12,10-2,212,135,347,0.611,04/23/2024,2024.0
3,Denver (Big East),12,10-2,178,117,295,0.603,04/23/2024,2024.0
4,Michigan (Big Ten),13,7-6,218,145,363,0.601,04/23/2024,2024.0
5,Bryant (America East),13,9-4,203,138,341,0.595,04/23/2024,2024.0
6,Marquette (Big East),13,4-9,188,131,319,0.589,04/23/2024,2024.0
7,Syracuse (ACC),15,11-4,253,179,432,0.586,04/23/2024,2024.0
8,NJIT (America East),13,7-6,199,142,341,0.584,04/23/2024,2024.0
9,Yale (Ivy League),13,11-2,246,177,423,0.582,04/23/2024,2024.0
10,Maryland (Big Ten),12,8-4,170,123,293,0.580,04/23/2024,2024.0
11,Towson (CAA),13,10-3,195,142,337,0.579,04/23/2024,2024.0
12,UAlbany (America East),13,6-7,205,151,356,0.576,04/23/2024,2024.0
13,Hofstra (CAA),14,5-9,225,166,391,0.575,04/23/2024,2024.0
14,High Point (Atlantic 10),14,8-6,221,167,388,0.570,04/23/2024,2024.0
15,Hobart (Atlantic 10),12,3-9,190,145,335,0.567,04/23/2024,2024.0
16,Villanova (Big East),13,8-5,186,144,330,0.564,04/23/2024,2024.0
17,Navy (Patriot),13,7-6,181,144,325,0.557,04/23/2024,2024.0
18,Notre Dame (ACC),10,9-1,160,130,290,0.552,04/23/2024,2024.0
19,Duke (ACC),14,11-3,219,178,397,0.552,04/23/2024,2024.0
20,Robert Morris (ASUN),13,5-8,174,143,317,0.549,04/23/2024,2024.0
21,Ohio St. (Big Ten),14,6-8,183,153,336,0.545,04/23/2024,2024.0
22,Sacred Heart (MAAC),15,11-4,216,181,397,0.544,04/23/2024,2024.0
23,Georgetown (Big East),12,9-3,165,143,308,0.536,04/23/2024,2024.0
24,Rutgers (Big Ten),13,7-6,175,152,327,0.535,04/23/2024,2024.0
25,Vermont (America East),13,6-7,198,173,371,0.534,04/23/2024,2024.0
26,Lafayette (Patriot),12,6-6,175,153,328,0.534,04/23/2024,2024.0
27,Binghamton (America East),12,6-6,176,158,334,0.527,04/23/2024,2024.0
28,VMI (MAAC),15,7-8,218,196,414,0.527,04/23/2024,2024.0
29,Lehigh (Patriot),13,7-6,170,153,323,0.526,04/23/2024,2024.0
30,Virginia (ACC),13,10-3,201,181,382,0.526,04/23/2024,2024.0
31,Mercer (ASUN),13,3-10,174,159,333,0.523,04/23/2024,2024.0
32,UMBC (America East),10,5-5,141,131,272,0.518,04/23/2024,2024.0
33,Dartmouth (Ivy League),12,3-9,170,158,328,0.518,04/23/2024,2024.0
34,Jacksonville (ASUN),14,10-4,145,138,283,0.512,04/23/2024,2024.0
35,Saint Joseph's (Atlantic 10),12,9-3,157,152,309,0.508,04/23/2024,2024.0
36,Canisius (MAAC),15,5-10,193,188,381,0.507,04/23/2024,2024.0
37,Drexel (CAA),13,5-8,169,165,334,0.506,04/23/2024,2024.0
38,LIU (MAAC),13,10-3,170,166,336,0.506,04/23/2024,2024.0
39,Bellarmine (ASUN),15,9-6,195,191,386,0.505,04/23/2024,2024.0
40,Delaware (CAA),11,8-3,137,141,278,0.493,04/23/2024,2024.0
41,Marist (MAAC),14,8-6,182,189,371,0.491,04/23/2024,2024.0
42,Richmond (Atlantic 10),13,9-4,168,177,345,0.487,04/23/2024,2024.0
43,Princeton (Ivy League),12,8-4,156,165,321,0.486,04/23/2024,2024.0
44,Massachusetts (Atlantic 10),12,6-6,150,161,311,0.482,04/23/2024,2024.0
45,Air Force (ASUN),13,8-5,149,161,310,0.481,04/23/2024,2024.0
46,Monmouth (CAA),12,5-7,142,154,296,0.480,04/23/2024,2024.0
47,Cornell (Ivy League),12,8-4,184,202,386,0.477,04/23/2024,2024.0
48,Brown (Ivy League),13,3-10,154,170,324,0.475,04/23/2024,2024.0
49,Johns Hopkins (Big Ten),13,10-3,152,168,320,0.475,04/23/2024,2024.0
50,Cleveland St. (ASUN),14,7-7,167,185,352,0.474,04/23/2024,2024.0
51,UMass Lowell (America East),11,0-11,133,148,281,0.473,04/23/2024,2024.0
52,Stony Brook (CAA),13,4-9,167,186,353,0.473,04/23/2024,2024.0
53,Utah (ASUN),13,9-4,157,177,334,0.470,04/23/2024,2024.0
54,Siena (MAAC),14,7-7,173,200,373,0.464,04/23/2024,2024.0
55,Bucknell (Patriot),13,4-9,160,185,345,0.464,04/23/2024,2024.0
56,St. John's (NY) (Big East),14,4-10,170,199,369,0.461,04/23/2024,2024.0
57,Boston U. (Patriot),13,7-6,166,195,361,0.460,04/23/2024,2024.0
58,Fairfield (CAA),13,7-6,156,186,342,0.456,04/23/2024,2024.0
59,Penn (Ivy League),13,8-5,148,177,325,0.455,04/23/2024,2024.0
60,Penn St. (Big Ten),12,9-3,146,180,326,0.448,04/23/2024,2024.0
61,Mount St. Mary's (MAAC),15,1-14,163,208,371,0.439,04/23/2024,2024.0
62,Providence (Big East),13,6-7,157,203,360,0.436,04/23/2024,2024.0
63,Quinnipiac (MAAC),13,9-4,153,200,353,0.433,04/23/2024,2024.0
64,Harvard (Ivy League),12,7-5,148,196,344,0.430,04/23/2024,2024.0
65,Holy Cross (Patriot),12,2-10,131,182,313,0.419,04/23/2024,2024.0
66,Wagner (MAAC),15,1-14,150,209,359,0.418,04/23/2024,2024.0
67,Loyola Maryland (Patriot),13,7-6,139,201,340,0.409,04/23/2024,2024.0
68,St. Bonaventure (Atlantic 10),11,1-10,112,171,283,0.396,04/23/2024,2024.0
69,Manhattan (MAAC),14,6-8,134,205,339,0.395,04/23/2024,2024.0
70,Colgate (Patriot),13,8-5,137,221,358,0.383,04/23/2024,2024.0
71,Merrimack (America East),13,5-8,132,229,361,0.366,04/23/2024,2024.0
72,Detroit Mercy (ASUN),12,3-9,112,229,341,0.328,04/23/2024,2024.0
73,Hampton (CAA),12,0-12,106,236,342,0.310,04/23/2024,2024.0
-,Le Moyne (NEC),10,2-8,112,133,245,0.457,04/23/2024,2024.0
-,Queens (NC) (ASUN),12,2-10,129,158,287,0.449,04/23/2024,2024.0
-,Lindenwood (ASUN),11,0-11,90,140,230,0.391,04/23/2024,2024.0
1,North Carolina (ACC),13,6-7,209,131,340,0.615,04/21/2024,2024.0
2,Army West Point (Patriot),12,10-2,212,135,347,0.611,04/21/2024,2024.0
3,Bryant (America East),12,8-4,196,125,321,0.611,04/21/2024,2024.0
4,Denver (Big East),12,10-2,178,117,295,0.603,04/21/2024,2024.0
5,Michigan (Big Ten),13,7-6,218,145,363,0.601,04/21/2024,2024.0
6,Marquette (Big East),13,4-9,188,131,319,0.589,04/21/2024,2024.0
7,Syracuse (ACC),15,11-4,253,179,432,0.586,04/21/2024,2024.0
8,NJIT (America East),13,7-6,199,142,341,0.584,04/21/2024,2024.0
9,Yale (Ivy League),13,11-2,246,177,423,0.582,04/21/2024,2024.0
10,Maryland (Big Ten),12,8-4,170,123,293,0.580,04/21/2024,2024.0
11,Towson (CAA),13,10-3,195,142,337,0.579,04/21/2024,2024.0
12,UAlbany (America East),13,6-7,205,151,356,0.576,04/21/2024,2024.0
13,Hofstra (CAA),14,5-9,225,166,391,0.575,04/21/2024,2024.0
14,High Point (Atlantic 10),14,8-6,221,167,388,0.570,04/21/2024,2024.0
15,Hobart (Atlantic 10),12,3-9,190,145,335,0.567,04/21/2024,2024.0
16,Villanova (Big East),13,8-5,186,144,330,0.564,04/21/2024,2024.0
17,Navy (Patriot),13,7-6,181,144,325,0.557,04/21/2024,2024.0
18,Notre Dame (ACC),10,9-1,160,130,290,0.552,04/21/2024,2024.0
19,Duke (ACC),14,11-3,219,178,397,0.552,04/21/2024,2024.0
20,Robert Morris (ASUN),13,5-8,174,143,317,0.549,04/21/2024,2024.0
21,Ohio St. (Big Ten),14,6-8,183,153,336,0.545,04/21/2024,2024.0
22,Sacred Heart (MAAC),15,11-4,216,181,397,0.544,04/21/2024,2024.0
23,Georgetown (Big East),12,9-3,165,143,308,0.536,04/21/2024,2024.0
24,Rutgers (Big Ten),13,7-6,175,152,327,0.535,04/21/2024,2024.0
25,Vermont (America East),13,6-7,198,173,371,0.534,04/21/2024,2024.0
26,Lafayette (Patriot),12,6-6,175,153,328,0.534,04/21/2024,2024.0
27,Binghamton (America East),12,6-6,176,158,334,0.527,04/21/2024,2024.0
28,VMI (MAAC),15,7-8,218,196,414,0.527,04/21/2024,2024.0
29,Lehigh (Patriot),13,7-6,170,153,323,0.526,04/21/2024,2024.0
30,Virginia (ACC),13,10-3,201,181,382,0.526,04/21/2024,2024.0
31,Mercer (ASUN),13,3-10,174,159,333,0.523,04/21/2024,2024.0
32,UMBC (America East),10,5-5,141,131,272,0.518,04/21/2024,2024.0
33,Dartmouth (Ivy League),12,3-9,170,158,328,0.518,04/21/2024,2024.0
34,Jacksonville (ASUN),14,10-4,145,138,283,0.512,04/21/2024,2024.0
35,Saint Joseph's (Atlantic 10),12,9-3,157,152,309,0.508,04/21/2024,2024.0
36,Canisius (MAAC),15,5-10,193,188,381,0.507,04/21/2024,2024.0
37,Drexel (CAA),13,5-8,169,165,334,0.506,04/21/2024,2024.0
38,Bellarmine (ASUN),15,9-6,195,191,386,0.505,04/21/2024,2024.0
39,LIU (MAAC),13,10-3,155,159,314,0.494,04/21/2024,2024.0
40,Delaware (CAA),11,8-3,137,141,278,0.493,04/21/2024,2024.0
41,Marist (MAAC),14,8-6,182,189,371,0.491,04/21/2024,2024.0
42,Richmond (Atlantic 10),13,9-4,168,177,345,0.487,04/21/2024,2024.0
43,Princeton (Ivy League),12,8-4,156,165,321,0.486,04/21/2024,2024.0
44,Massachusetts (Atlantic 10),12,6-6,150,161,311,0.482,04/21/2024,2024.0
45,Air Force (ASUN),13,8-5,149,161,310,0.481,04/21/2024,2024.0
46,Monmouth (CAA),12,5-7,142,154,296,0.480,04/21/2024,2024.0
47,Cornell (Ivy League),12,8-4,184,202,386,0.477,04/21/2024,2024.0
48,Johns Hopkins (Big Ten),13,10-3,152,168,320,0.475,04/21/2024,2024.0
49,Cleveland St. (ASUN),14,7-7,154,171,325,0.474,04/21/2024,2024.0
50,UMass Lowell (America East),11,0-11,133,148,281,0.473,04/21/2024,2024.0
51,Stony Brook (CAA),13,4-9,167,186,353,0.473,04/21/2024,2024.0
52,Utah (ASUN),13,9-4,143,164,307,0.466,04/21/2024,2024.0
53,Brown (Ivy League),12,3-9,141,163,304,0.464,04/21/2024,2024.0
54,Siena (MAAC),14,7-7,173,200,373,0.464,04/21/2024,2024.0
55,Bucknell (Patriot),13,4-9,160,185,345,0.464,04/21/2024,2024.0
56,St. John's (NY) (Big East),14,4-10,170,199,369,0.461,04/21/2024,2024.0
57,Boston U. (Patriot),13,7-6,166,195,361,0.460,04/21/2024,2024.0
58,Fairfield (CAA),13,7-6,156,186,342,0.456,04/21/2024,2024.0
59,Penn (Ivy League),13,8-5,148,177,325,0.455,04/21/2024,2024.0
60,Penn St. (Big Ten),12,9-3,146,180,326,0.448,04/21/2024,2024.0
61,Quinnipiac (MAAC),13,9-4,146,185,331,0.441,04/21/2024,2024.0
62,Mount St. Mary's (MAAC),15,1-14,163,208,371,0.439,04/21/2024,2024.0
63,Providence (Big East),13,6-7,157,203,360,0.436,04/21/2024,2024.0
64,Harvard (Ivy League),12,7-5,148,196,344,0.430,04/21/2024,2024.0
65,Wagner (MAAC),15,1-14,143,198,341,0.419,04/21/2024,2024.0
66,Holy Cross (Patriot),12,2-10,131,182,313,0.419,04/21/2024,2024.0
67,Loyola Maryland (Patriot),13,7-6,139,201,340,0.409,04/21/2024,2024.0
68,St. Bonaventure (Atlantic 10),11,1-10,112,171,283,0.396,04/21/2024,2024.0
69,Manhattan (MAAC),14,6-8,123,198,321,0.383,04/21/2024,2024.0
70,Colgate (Patriot),13,8-5,137,221,358,0.383,04/21/2024,2024.0
71,Merrimack (America East),13,5-8,132,229,361,0.366,04/21/2024,2024.0
72,Detroit Mercy (ASUN),12,3-9,112,229,341,0.328,04/21/2024,2024.0
73,Hampton (CAA),12,0-12,106,236,342,0.310,04/21/2024,2024.0
-,Le Moyne (NEC),10,2-8,112,133,245,0.457,04/21/2024,2024.0
-,Queens (NC) (ASUN),12,2-10,129,158,287,0.449,04/21/2024,2024.0
-,Lindenwood (ASUN),11,0-11,90,140,230,0.391,04/21/2024,2024.0
1,North Carolina (ACC),12,6-6,197,120,317,0.621,04/19/2024,2024.0
2,Army West Point (Patriot),12,10-2,212,135,347,0.611,04/19/2024,2024.0
3,Bryant (America East),11,7-4,177,113,290,0.610,04/19/2024,2024.0
4,Michigan (Big Ten),12,6-6,200,134,334,0.599,04/19/2024,2024.0
5,Marquette (Big East),12,4-8,178,121,299,0.595,04/19/2024,2024.0
6,Denver (Big East),11,9-2,167,114,281,0.594,04/19/2024,2024.0
7,Syracuse (ACC),14,10-4,232,161,393,0.590,04/19/2024,2024.0
8,NJIT (America East),12,7-5,186,133,319,0.583,04/19/2024,2024.0
9,Yale (Ivy League),13,11-2,246,177,423,0.582,04/19/2024,2024.0
10,Maryland (Big Ten),11,8-3,161,117,278,0.579,04/19/2024,2024.0
11,High Point (Atlantic 10),13,7-6,210,154,364,0.577,04/19/2024,2024.0
12,Towson (CAA),12,9-3,180,134,314,0.573,04/19/2024,2024.0
13,Hobart (Atlantic 10),11,3-8,177,134,311,0.569,04/19/2024,2024.0
14,Villanova (Big East),12,7-5,176,134,310,0.568,04/19/2024,2024.0
15,Ohio St. (Big Ten),13,6-7,172,135,307,0.560,04/19/2024,2024.0
16,UAlbany (America East),12,5-7,185,146,331,0.559,04/19/2024,2024.0
17,Notre Dame (ACC),9,8-1,149,118,267,0.558,04/19/2024,2024.0
18,Navy (Patriot),13,7-6,181,144,325,0.557,04/19/2024,2024.0
19,Sacred Heart (MAAC),14,10-4,204,164,368,0.554,04/19/2024,2024.0
20,Hofstra (CAA),13,4-9,200,162,362,0.552,04/19/2024,2024.0
21,Duke (ACC),14,11-3,219,178,397,0.552,04/19/2024,2024.0
22,Binghamton (America East),11,6-5,164,139,303,0.541,04/19/2024,2024.0
23,Rutgers (Big Ten),13,7-6,175,152,327,0.535,04/19/2024,2024.0
24,Lafayette (Patriot),12,6-6,175,153,328,0.534,04/19/2024,2024.0
25,Virginia (ACC),12,10-2,183,160,343,0.534,04/19/2024,2024.0
26,Robert Morris (ASUN),12,4-8,157,138,295,0.532,04/19/2024,2024.0
27,VMI (MAAC),14,7-7,204,182,386,0.528,04/19/2024,2024.0
28,UMBC (America East),9,4-5,132,118,250,0.528,04/19/2024,2024.0
29,Georgetown (Big East),11,8-3,147,132,279,0.527,04/19/2024,2024.0
30,Lehigh (Patriot),12,6-6,154,140,294,0.524,04/19/2024,2024.0
31,Jacksonville (ASUN),13,9-4,136,125,261,0.521,04/19/2024,2024.0
32,Dartmouth (Ivy League),11,3-8,155,145,300,0.517,04/19/2024,2024.0
33,Vermont (America East),12,5-7,176,166,342,0.515,04/19/2024,2024.0
34,Mercer (ASUN),12,2-10,156,153,309,0.505,04/19/2024,2024.0
35,Drexel (CAA),12,5-7,157,154,311,0.505,04/19/2024,2024.0
36,Bellarmine (ASUN),14,9-5,177,177,354,0.500,04/19/2024,2024.0
36,Canisius (MAAC),14,5-9,176,176,352,0.500,04/19/2024,2024.0
36,UMass Lowell (America East),10,0-10,126,126,252,0.500,04/19/2024,2024.0
39,Delaware (CAA),10,7-3,126,129,255,0.494,04/19/2024,2024.0
40,LIU (MAAC),12,9-3,155,159,314,0.494,04/19/2024,2024.0
41,Monmouth (CAA),11,5-6,134,139,273,0.491,04/19/2024,2024.0
42,Marist (MAAC),13,7-6,168,175,343,0.490,04/19/2024,2024.0
43,Saint Joseph's (Atlantic 10),11,8-3,136,143,279,0.487,04/19/2024,2024.0
44,Richmond (Atlantic 10),12,8-4,153,163,316,0.484,04/19/2024,2024.0
45,Massachusetts (Atlantic 10),11,6-5,136,146,282,0.482,04/19/2024,2024.0
46,Princeton (Ivy League),11,7-4,140,152,292,0.479,04/19/2024,2024.0
47,Johns Hopkins (Big Ten),12,9-3,146,159,305,0.479,04/19/2024,2024.0
48,Siena (MAAC),13,6-7,166,182,348,0.477,04/19/2024,2024.0
49,Cornell (Ivy League),11,7-4,171,189,360,0.475,04/19/2024,2024.0
50,Cleveland St. (ASUN),13,7-6,154,171,325,0.474,04/19/2024,2024.0
51,Air Force (ASUN),12,8-4,136,152,288,0.472,04/19/2024,2024.0
52,Stony Brook (CAA),12,4-8,154,174,328,0.470,04/19/2024,2024.0
53,St. John's (NY) (Big East),13,4-9,159,181,340,0.468,04/19/2024,2024.0
54,Utah (ASUN),12,8-4,143,164,307,0.466,04/19/2024,2024.0
55,Bucknell (Patriot),13,4-9,160,185,345,0.464,04/19/2024,2024.0
55,Brown (Ivy League),11,2-9,128,148,276,0.464,04/19/2024,2024.0
57,Boston U. (Patriot),12,7-5,153,179,332,0.461,04/19/2024,2024.0
58,Penn (Ivy League),12,8-4,135,161,296,0.456,04/19/2024,2024.0
59,Fairfield (CAA),12,6-6,144,173,317,0.454,04/19/2024,2024.0
60,Penn St. (Big Ten),12,9-3,146,180,326,0.448,04/19/2024,2024.0
61,Providence (Big East),12,6-6,154,192,346,0.445,04/19/2024,2024.0
62,Quinnipiac (MAAC),12,9-3,146,185,331,0.441,04/19/2024,2024.0
63,Harvard (Ivy League),11,7-4,135,183,318,0.425,04/19/2024,2024.0
64,Wagner (MAAC),14,1-13,143,198,341,0.419,04/19/2024,2024.0
65,Mount St. Mary's (MAAC),14,1-13,145,201,346,0.419,04/19/2024,2024.0
66,Loyola Maryland (Patriot),13,7-6,139,201,340,0.409,04/19/2024,2024.0
67,St. Bonaventure (Atlantic 10),10,1-9,103,150,253,0.407,04/19/2024,2024.0
68,Holy Cross (Patriot),11,2-9,112,171,283,0.396,04/19/2024,2024.0
69,Colgate (Patriot),12,7-5,126,202,328,0.384,04/19/2024,2024.0
70,Manhattan (MAAC),13,5-8,123,198,321,0.383,04/19/2024,2024.0
71,Merrimack (America East),12,5-7,127,209,336,0.378,04/19/2024,2024.0
72,Hampton (CAA),11,0-11,102,211,313,0.326,04/19/2024,2024.0
73,Detroit Mercy (ASUN),11,2-9,98,211,309,0.317,04/19/2024,2024.0
-,Queens (NC) (ASUN),11,2-9,123,140,263,0.468,04/19/2024,2024.0
-,Le Moyne (NEC),10,2-8,112,133,245,0.457,04/19/2024,2024.0
-,Lindenwood (ASUN),10,0-10,85,123,208,0.409,04/19/2024,2024.0
1,North Carolina (ACC),12,6-6,197,120,317,0.621,04/17/2024,2024.0
2,Army West Point (Patriot),11,9-2,192,122,314,0.611,04/17/2024,2024.0
3,Bryant (America East),11,7-4,177,113,290,0.610,04/17/2024,2024.0
4,Michigan (Big Ten),12,6-6,200,134,334,0.599,04/17/2024,2024.0
5,Yale (Ivy League),12,10-2,234,159,393,0.595,04/17/2024,2024.0
6,Marquette (Big East),12,4-8,178,121,299,0.595,04/17/2024,2024.0
7,Denver (Big East),11,9-2,167,114,281,0.594,04/17/2024,2024.0
8,Syracuse (ACC),14,10-4,232,161,393,0.590,04/17/2024,2024.0
9,NJIT (America East),12,7-5,186,133,319,0.583,04/17/2024,2024.0
10,Maryland (Big Ten),11,8-3,161,117,278,0.579,04/17/2024,2024.0
11,High Point (Atlantic 10),13,7-6,210,154,364,0.577,04/17/2024,2024.0
12,Towson (CAA),12,9-3,180,134,314,0.573,04/17/2024,2024.0
13,Hobart (Atlantic 10),11,3-8,177,134,311,0.569,04/17/2024,2024.0
14,Villanova (Big East),12,7-5,176,134,310,0.568,04/17/2024,2024.0
15,Ohio St. (Big Ten),13,6-7,172,135,307,0.560,04/17/2024,2024.0
16,Navy (Patriot),12,7-5,167,132,299,0.559,04/17/2024,2024.0
17,Notre Dame (ACC),9,8-1,149,118,267,0.558,04/17/2024,2024.0
18,UAlbany (America East),11,5-6,167,134,301,0.555,04/17/2024,2024.0
19,Sacred Heart (MAAC),14,10-4,204,164,368,0.554,04/17/2024,2024.0
20,Hofstra (CAA),13,4-9,200,162,362,0.552,04/17/2024,2024.0
21,Duke (ACC),14,11-3,219,178,397,0.552,04/17/2024,2024.0
22,Binghamton (America East),11,6-5,164,139,303,0.541,04/17/2024,2024.0
23,Rutgers (Big Ten),12,7-5,160,139,299,0.535,04/17/2024,2024.0
24,Virginia (ACC),12,10-2,183,160,343,0.534,04/17/2024,2024.0
25,Robert Morris (ASUN),12,4-8,157,138,295,0.532,04/17/2024,2024.0
26,VMI (MAAC),14,7-7,204,182,386,0.528,04/17/2024,2024.0
27,UMBC (America East),9,4-5,132,118,250,0.528,04/17/2024,2024.0
28,Georgetown (Big East),11,8-3,147,132,279,0.527,04/17/2024,2024.0
29,Lehigh (Patriot),12,6-6,154,140,294,0.524,04/17/2024,2024.0
30,Jacksonville (ASUN),13,9-4,136,125,261,0.521,04/17/2024,2024.0
31,Lafayette (Patriot),11,5-6,156,145,301,0.518,04/17/2024,2024.0
32,Dartmouth (Ivy League),11,3-8,155,145,300,0.517,04/17/2024,2024.0
33,Vermont (America East),12,5-7,176,166,342,0.515,04/17/2024,2024.0
34,Mercer (ASUN),12,2-10,156,153,309,0.505,04/17/2024,2024.0
35,Drexel (CAA),12,5-7,157,154,311,0.505,04/17/2024,2024.0
36,Bellarmine (ASUN),14,9-5,177,177,354,0.500,04/17/2024,2024.0
36,Canisius (MAAC),14,5-9,176,176,352,0.500,04/17/2024,2024.0
36,UMass Lowell (America East),10,0-10,126,126,252,0.500,04/17/2024,2024.0
39,Delaware (CAA),10,7-3,126,129,255,0.494,04/17/2024,2024.0
40,LIU (MAAC),12,9-3,155,159,314,0.494,04/17/2024,2024.0
41,Monmouth (CAA),11,5-6,134,139,273,0.491,04/17/2024,2024.0
42,Marist (MAAC),13,7-6,168,175,343,0.490,04/17/2024,2024.0
43,Saint Joseph's (Atlantic 10),11,8-3,136,143,279,0.487,04/17/2024,2024.0
44,Richmond (Atlantic 10),12,8-4,153,163,316,0.484,04/17/2024,2024.0
45,Massachusetts (Atlantic 10),11,6-5,136,146,282,0.482,04/17/2024,2024.0
46,Princeton (Ivy League),11,7-4,140,152,292,0.479,04/17/2024,2024.0
47,Johns Hopkins (Big Ten),12,9-3,146,159,305,0.479,04/17/2024,2024.0
48,Siena (MAAC),13,6-7,166,182,348,0.477,04/17/2024,2024.0
49,Cornell (Ivy League),11,7-4,171,189,360,0.475,04/17/2024,2024.0
50,Cleveland St. (ASUN),13,7-6,154,171,325,0.474,04/17/2024,2024.0
51,Air Force (ASUN),12,8-4,136,152,288,0.472,04/17/2024,2024.0
52,Bucknell (Patriot),12,4-8,147,165,312,0.471,04/17/2024,2024.0
53,Stony Brook (CAA),12,4-8,154,174,328,0.470,04/17/2024,2024.0
54,St. John's (NY) (Big East),13,4-9,159,181,340,0.468,04/17/2024,2024.0
55,Utah (ASUN),12,8-4,143,164,307,0.466,04/17/2024,2024.0
56,Brown (Ivy League),11,2-9,128,148,276,0.464,04/17/2024,2024.0
57,Boston U. (Patriot),12,7-5,153,179,332,0.461,04/17/2024,2024.0
58,Penn (Ivy League),12,8-4,135,161,296,0.456,04/17/2024,2024.0
59,Fairfield (CAA),12,6-6,144,173,317,0.454,04/17/2024,2024.0
60,Penn St. (Big Ten),11,8-3,133,165,298,0.446,04/17/2024,2024.0
61,Providence (Big East),12,6-6,154,192,346,0.445,04/17/2024,2024.0
62,Quinnipiac (MAAC),12,9-3,146,185,331,0.441,04/17/2024,2024.0
63,Harvard (Ivy League),11,7-4,135,183,318,0.425,04/17/2024,2024.0
64,Wagner (MAAC),14,1-13,143,198,341,0.419,04/17/2024,2024.0
65,Mount St. Mary's (MAAC),14,1-13,145,201,346,0.419,04/17/2024,2024.0
66,St. Bonaventure (Atlantic 10),10,1-9,103,150,253,0.407,04/17/2024,2024.0
67,Loyola Maryland (Patriot),12,6-6,127,187,314,0.404,04/17/2024,2024.0
68,Holy Cross (Patriot),11,2-9,112,171,283,0.396,04/17/2024,2024.0
69,Colgate (Patriot),12,7-5,126,202,328,0.384,04/17/2024,2024.0
70,Manhattan (MAAC),13,5-8,123,198,321,0.383,04/17/2024,2024.0
71,Merrimack (America East),12,5-7,127,209,336,0.378,04/17/2024,2024.0
72,Hampton (CAA),11,0-11,102,211,313,0.326,04/17/2024,2024.0
73,Detroit Mercy (ASUN),11,2-9,98,211,309,0.317,04/17/2024,2024.0
-,Le Moyne (NEC),9,2-7,104,114,218,0.477,04/17/2024,2024.0
-,Queens (NC) (ASUN),11,2-9,123,140,263,0.468,04/17/2024,2024.0
-,Lindenwood (ASUN),10,0-10,85,123,208,0.409,04/17/2024,2024.0
1,North Carolina (ACC),12,6-6,197,120,317,0.621,04/16/2024,2024.0
2,Army West Point (Patriot),11,9-2,192,122,314,0.611,04/16/2024,2024.0
3,Bryant (America East),11,7-4,177,113,290,0.610,04/16/2024,2024.0
4,Michigan (Big Ten),12,6-6,200,134,334,0.599,04/16/2024,2024.0
5,Yale (Ivy League),12,10-2,234,159,393,0.595,04/16/2024,2024.0
6,Marquette (Big East),12,4-8,178,121,299,0.595,04/16/2024,2024.0
7,Denver (Big East),11,9-2,167,114,281,0.594,04/16/2024,2024.0
8,Syracuse (ACC),14,10-4,232,161,393,0.590,04/16/2024,2024.0
9,NJIT (America East),12,7-5,186,133,319,0.583,04/16/2024,2024.0
10,Maryland (Big Ten),11,8-3,161,117,278,0.579,04/16/2024,2024.0
11,High Point (Atlantic 10),13,7-6,210,154,364,0.577,04/16/2024,2024.0
12,Towson (CAA),12,9-3,180,134,314,0.573,04/16/2024,2024.0
13,Hobart (Atlantic 10),11,3-8,177,134,311,0.569,04/16/2024,2024.0
14,Villanova (Big East),12,7-5,176,134,310,0.568,04/16/2024,2024.0
15,Ohio St. (Big Ten),13,6-7,172,135,307,0.560,04/16/2024,2024.0
16,Navy (Patriot),12,7-5,167,132,299,0.559,04/16/2024,2024.0
17,Notre Dame (ACC),9,8-1,149,118,267,0.558,04/16/2024,2024.0
18,UAlbany (America East),11,5-6,167,134,301,0.555,04/16/2024,2024.0
19,Sacred Heart (MAAC),14,10-4,204,164,368,0.554,04/16/2024,2024.0
20,Hofstra (CAA),13,4-9,200,162,362,0.552,04/16/2024,2024.0
21,Duke (ACC),14,11-3,219,178,397,0.552,04/16/2024,2024.0
22,Binghamton (America East),11,6-5,164,139,303,0.541,04/16/2024,2024.0
23,Rutgers (Big Ten),12,7-5,160,139,299,0.535,04/16/2024,2024.0
24,Virginia (ACC),12,10-2,183,160,343,0.534,04/16/2024,2024.0
25,Robert Morris (ASUN),12,4-8,157,138,295,0.532,04/16/2024,2024.0
26,VMI (MAAC),14,7-7,204,182,386,0.528,04/16/2024,2024.0
27,UMBC (America East),9,4-5,132,118,250,0.528,04/16/2024,2024.0
28,Georgetown (Big East),11,8-3,147,132,279,0.527,04/16/2024,2024.0
29,Lehigh (Patriot),12,6-6,154,140,294,0.524,04/16/2024,2024.0
30,Jacksonville (ASUN),13,9-4,136,125,261,0.521,04/16/2024,2024.0
31,Lafayette (Patriot),11,5-6,156,145,301,0.518,04/16/2024,2024.0
32,Dartmouth (Ivy League),11,3-8,155,145,300,0.517,04/16/2024,2024.0
33,Vermont (America East),12,5-7,176,166,342,0.515,04/16/2024,2024.0
34,Drexel (CAA),12,5-7,157,154,311,0.505,04/16/2024,2024.0
35,Mercer (ASUN),11,2-9,141,139,280,0.504,04/16/2024,2024.0
36,Bellarmine (ASUN),14,9-5,177,177,354,0.500,04/16/2024,2024.0
36,Canisius (MAAC),14,5-9,176,176,352,0.500,04/16/2024,2024.0
36,UMass Lowell (America East),10,0-10,126,126,252,0.500,04/16/2024,2024.0
39,Delaware (CAA),10,7-3,126,129,255,0.494,04/16/2024,2024.0
40,LIU (MAAC),12,9-3,155,159,314,0.494,04/16/2024,2024.0
41,Monmouth (CAA),11,5-6,134,139,273,0.491,04/16/2024,2024.0
42,Marist (MAAC),13,7-6,168,175,343,0.490,04/16/2024,2024.0
43,Saint Joseph's (Atlantic 10),11,8-3,136,143,279,0.487,04/16/2024,2024.0
44,Richmond (Atlantic 10),12,8-4,153,163,316,0.484,04/16/2024,2024.0
45,Massachusetts (Atlantic 10),11,6-5,136,146,282,0.482,04/16/2024,2024.0
46,Princeton (Ivy League),11,7-4,140,152,292,0.479,04/16/2024,2024.0
47,Johns Hopkins (Big Ten),12,9-3,146,159,305,0.479,04/16/2024,2024.0
48,Siena (MAAC),13,6-7,166,182,348,0.477,04/16/2024,2024.0
49,Cornell (Ivy League),11,7-4,171,189,360,0.475,04/16/2024,2024.0
50,Cleveland St. (ASUN),13,7-6,154,171,325,0.474,04/16/2024,2024.0
51,Bucknell (Patriot),12,4-8,147,165,312,0.471,04/16/2024,2024.0
52,Air Force (ASUN),11,7-4,122,137,259,0.471,04/16/2024,2024.0
53,Stony Brook (CAA),12,4-8,154,174,328,0.470,04/16/2024,2024.0
54,St. John's (NY) (Big East),13,4-9,159,181,340,0.468,04/16/2024,2024.0
55,Utah (ASUN),12,8-4,143,164,307,0.466,04/16/2024,2024.0
56,Brown (Ivy League),11,2-9,128,148,276,0.464,04/16/2024,2024.0
57,Boston U. (Patriot),12,7-5,153,179,332,0.461,04/16/2024,2024.0
58,Penn (Ivy League),12,8-4,135,161,296,0.456,04/16/2024,2024.0
59,Fairfield (CAA),12,6-6,144,173,317,0.454,04/16/2024,2024.0
60,Penn St. (Big Ten),11,8-3,133,165,298,0.446,04/16/2024,2024.0
61,Providence (Big East),12,6-6,154,192,346,0.445,04/16/2024,2024.0
62,Quinnipiac (MAAC),12,9-3,146,185,331,0.441,04/16/2024,2024.0
63,Harvard (Ivy League),11,7-4,135,183,318,0.425,04/16/2024,2024.0
64,Wagner (MAAC),14,1-13,143,198,341,0.419,04/16/2024,2024.0
65,Mount St. Mary's (MAAC),14,1-13,145,201,346,0.419,04/16/2024,2024.0
66,St. Bonaventure (Atlantic 10),10,1-9,103,150,253,0.407,04/16/2024,2024.0
67,Loyola Maryland (Patriot),12,6-6,127,187,314,0.404,04/16/2024,2024.0
68,Holy Cross (Patriot),11,2-9,112,171,283,0.396,04/16/2024,2024.0
69,Colgate (Patriot),12,7-5,126,202,328,0.384,04/16/2024,2024.0
70,Manhattan (MAAC),13,5-8,123,198,321,0.383,04/16/2024,2024.0
71,Merrimack (America East),12,5-7,127,209,336,0.378,04/16/2024,2024.0
72,Hampton (CAA),11,0-11,102,211,313,0.326,04/16/2024,2024.0
73,Detroit Mercy (ASUN),11,2-9,98,211,309,0.317,04/16/2024,2024.0
-,Le Moyne (NEC),9,2-7,104,114,218,0.477,04/16/2024,2024.0
-,Queens (NC) (ASUN),11,2-9,123,140,263,0.468,04/16/2024,2024.0
-,Lindenwood (ASUN),10,0-10,85,123,208,0.409,04/16/2024,2024.0
1,Yale (Ivy League),11,9-2,227,135,362,0.627,04/14/2024,2024.0
2,North Carolina (ACC),12,6-6,197,120,317,0.621,04/14/2024,2024.0
3,Army West Point (Patriot),11,9-2,192,122,314,0.611,04/14/2024,2024.0
4,Bryant (America East),11,7-4,177,113,290,0.610,04/14/2024,2024.0
5,Michigan (Big Ten),12,6-6,200,134,334,0.599,04/14/2024,2024.0
6,Marquette (Big East),12,4-8,178,121,299,0.595,04/14/2024,2024.0
7,Denver (Big East),11,9-2,167,114,281,0.594,04/14/2024,2024.0
8,Syracuse (ACC),14,10-4,232,161,393,0.590,04/14/2024,2024.0
9,NJIT (America East),12,7-5,186,133,319,0.583,04/14/2024,2024.0
10,Maryland (Big Ten),11,8-3,161,117,278,0.579,04/14/2024,2024.0
11,High Point (Atlantic 10),13,7-6,210,154,364,0.577,04/14/2024,2024.0
12,Towson (CAA),12,9-3,180,134,314,0.573,04/14/2024,2024.0
13,Hobart (Atlantic 10),11,3-8,177,134,311,0.569,04/14/2024,2024.0
14,Villanova (Big East),12,7-5,176,134,310,0.568,04/14/2024,2024.0
15,Ohio St. (Big Ten),13,6-7,172,135,307,0.560,04/14/2024,2024.0
16,Navy (Patriot),12,7-5,167,132,299,0.559,04/14/2024,2024.0
17,UAlbany (America East),11,5-6,167,134,301,0.555,04/14/2024,2024.0
18,Sacred Heart (MAAC),14,10-4,204,164,368,0.554,04/14/2024,2024.0
19,Notre Dame (ACC),9,8-1,148,119,267,0.554,04/14/2024,2024.0
20,Duke (ACC),14,11-3,219,178,397,0.552,04/14/2024,2024.0
21,Binghamton (America East),11,6-5,164,139,303,0.541,04/14/2024,2024.0
22,Rutgers (Big Ten),12,7-5,160,139,299,0.535,04/14/2024,2024.0
23,Virginia (ACC),12,10-2,183,160,343,0.534,04/14/2024,2024.0
24,Robert Morris (ASUN),12,4-8,157,138,295,0.532,04/14/2024,2024.0
25,Hofstra (CAA),12,4-8,176,155,331,0.532,04/14/2024,2024.0
26,VMI (MAAC),14,7-7,204,182,386,0.528,04/14/2024,2024.0
27,UMBC (America East),9,4-5,132,118,250,0.528,04/14/2024,2024.0
28,Georgetown (Big East),11,8-3,147,132,279,0.527,04/14/2024,2024.0
29,Lehigh (Patriot),12,6-6,154,140,294,0.524,04/14/2024,2024.0
30,Jacksonville (ASUN),13,9-4,136,125,261,0.521,04/14/2024,2024.0
31,Lafayette (Patriot),11,5-6,156,145,301,0.518,04/14/2024,2024.0
32,Dartmouth (Ivy League),11,3-8,155,145,300,0.517,04/14/2024,2024.0
33,Vermont (America East),12,5-7,176,166,342,0.515,04/14/2024,2024.0
34,Drexel (CAA),12,5-7,157,154,311,0.505,04/14/2024,2024.0
35,Mercer (ASUN),11,2-9,141,139,280,0.504,04/14/2024,2024.0
36,Bellarmine (ASUN),14,9-5,177,177,354,0.500,04/14/2024,2024.0
36,Canisius (MAAC),14,5-9,176,176,352,0.500,04/14/2024,2024.0
36,UMass Lowell (America East),10,0-10,126,126,252,0.500,04/14/2024,2024.0
39,Delaware (CAA),10,7-3,126,129,255,0.494,04/14/2024,2024.0
40,LIU (MAAC),12,9-3,155,159,314,0.494,04/14/2024,2024.0
41,Monmouth (CAA),11,5-6,134,139,273,0.491,04/14/2024,2024.0
42,Marist (MAAC),13,7-6,168,175,343,0.490,04/14/2024,2024.0
43,Saint Joseph's (Atlantic 10),11,8-3,136,143,279,0.487,04/14/2024,2024.0
44,Richmond (Atlantic 10),12,8-4,153,163,316,0.484,04/14/2024,2024.0
45,Massachusetts (Atlantic 10),11,6-5,136,146,282,0.482,04/14/2024,2024.0
46,Princeton (Ivy League),11,7-4,140,152,292,0.479,04/14/2024,2024.0
47,Johns Hopkins (Big Ten),12,9-3,146,159,305,0.479,04/14/2024,2024.0
48,Cornell (Ivy League),11,7-4,172,188,360,0.478,04/14/2024,2024.0
49,Siena (MAAC),13,6-7,166,182,348,0.477,04/14/2024,2024.0
50,Cleveland St. (ASUN),13,7-6,154,171,325,0.474,04/14/2024,2024.0
51,Bucknell (Patriot),12,4-8,147,165,312,0.471,04/14/2024,2024.0
52,Air Force (ASUN),11,7-4,122,137,259,0.471,04/14/2024,2024.0
53,Stony Brook (CAA),12,4-8,154,174,328,0.470,04/14/2024,2024.0
54,St. John's (NY) (Big East),13,4-9,159,181,340,0.468,04/14/2024,2024.0
55,Utah (ASUN),12,8-4,143,164,307,0.466,04/14/2024,2024.0
56,Brown (Ivy League),11,2-9,128,148,276,0.464,04/14/2024,2024.0
57,Boston U. (Patriot),12,7-5,153,179,332,0.461,04/14/2024,2024.0
58,Penn (Ivy League),12,8-4,135,161,296,0.456,04/14/2024,2024.0
59,Fairfield (CAA),12,6-6,144,173,317,0.454,04/14/2024,2024.0
60,Penn St. (Big Ten),11,8-3,133,165,298,0.446,04/14/2024,2024.0
61,Providence (Big East),12,6-6,154,192,346,0.445,04/14/2024,2024.0
62,Quinnipiac (MAAC),12,9-3,146,185,331,0.441,04/14/2024,2024.0
63,Harvard (Ivy League),11,7-4,135,183,318,0.425,04/14/2024,2024.0
64,Wagner (MAAC),14,1-13,143,198,341,0.419,04/14/2024,2024.0
65,Mount St. Mary's (MAAC),14,1-13,145,201,346,0.419,04/14/2024,2024.0
66,St. Bonaventure (Atlantic 10),10,1-9,103,150,253,0.407,04/14/2024,2024.0
67,Loyola Maryland (Patriot),12,6-6,127,187,314,0.404,04/14/2024,2024.0
68,Holy Cross (Patriot),11,2-9,112,171,283,0.396,04/14/2024,2024.0
69,Colgate (Patriot),12,7-5,126,202,328,0.384,04/14/2024,2024.0
70,Manhattan (MAAC),13,5-8,123,198,321,0.383,04/14/2024,2024.0
71,Merrimack (America East),12,5-7,127,209,336,0.378,04/14/2024,2024.0
72,Hampton (CAA),11,0-11,102,211,313,0.326,04/14/2024,2024.0
73,Detroit Mercy (ASUN),11,2-9,98,211,309,0.317,04/14/2024,2024.0
-,Le Moyne (NEC),9,2-7,104,114,218,0.477,04/14/2024,2024.0
-,Queens (NC) (ASUN),11,2-9,123,140,263,0.468,04/14/2024,2024.0
-,Lindenwood (ASUN),10,0-10,85,123,208,0.409,04/14/2024,2024.0
1,Yale (Ivy League),10,8-2,208,118,326,0.638,04/10/2024,2024.0
2,North Carolina (ACC),11,6-5,186,108,294,0.633,04/10/2024,2024.0
3,Bryant (America East),10,7-3,163,96,259,0.629,04/10/2024,2024.0
4,Army West Point (Patriot),10,8-2,179,110,289,0.619,04/10/2024,2024.0
5,NJIT (America East),11,7-4,175,117,292,0.599,04/10/2024,2024.0
6,Denver (Big East),10,8-2,155,104,259,0.598,04/10/2024,2024.0
7,Syracuse (ACC),13,9-4,220,150,370,0.595,04/10/2024,2024.0
8,Michigan (Big Ten),11,6-5,183,126,309,0.592,04/10/2024,2024.0
9,Marquette (Big East),11,4-7,160,112,272,0.588,04/10/2024,2024.0
10,Maryland (Big Ten),10,7-3,150,107,257,0.584,04/10/2024,2024.0
11,Hobart (Atlantic 10),10,3-7,168,120,288,0.583,04/10/2024,2024.0
12,Villanova (Big East),11,6-5,161,122,283,0.569,04/10/2024,2024.0
13,Navy (Patriot),11,7-4,155,119,274,0.566,04/10/2024,2024.0
14,Duke (ACC),13,10-3,205,158,363,0.565,04/10/2024,2024.0
15,Notre Dame (ACC),8,7-1,129,100,229,0.563,04/10/2024,2024.0
16,High Point (Atlantic 10),12,7-5,195,152,347,0.562,04/10/2024,2024.0
17,Towson (CAA),11,8-3,159,124,283,0.562,04/10/2024,2024.0
18,Ohio St. (Big Ten),12,6-6,158,125,283,0.558,04/10/2024,2024.0
19,Sacred Heart (MAAC),13,9-4,192,152,344,0.558,04/10/2024,2024.0
20,UAlbany (America East),10,4-6,151,123,274,0.551,04/10/2024,2024.0
21,UMBC (America East),8,4-4,117,98,215,0.544,04/10/2024,2024.0
22,Rutgers (Big Ten),11,7-4,150,128,278,0.540,04/10/2024,2024.0
23,Binghamton (America East),10,5-5,144,124,268,0.537,04/10/2024,2024.0
24,Robert Morris (ASUN),11,3-8,143,124,267,0.536,04/10/2024,2024.0
25,Georgetown (Big East),10,8-2,137,120,257,0.533,04/10/2024,2024.0
26,Hofstra (CAA),11,4-7,160,142,302,0.530,04/10/2024,2024.0
27,Virginia (ACC),11,10-1,163,146,309,0.528,04/10/2024,2024.0
28,VMI (MAAC),13,7-6,188,170,358,0.525,04/10/2024,2024.0
29,Dartmouth (Ivy League),10,3-7,138,126,264,0.523,04/10/2024,2024.0
30,Jacksonville (ASUN),12,8-4,136,125,261,0.521,04/10/2024,2024.0
31,Lafayette (Patriot),10,4-6,144,133,277,0.520,04/10/2024,2024.0
32,Vermont (America East),11,4-7,159,152,311,0.511,04/10/2024,2024.0
33,Drexel (CAA),11,4-7,144,138,282,0.511,04/10/2024,2024.0
34,Delaware (CAA),9,6-3,114,110,224,0.509,04/10/2024,2024.0
35,Lehigh (Patriot),11,5-6,140,136,276,0.507,04/10/2024,2024.0
36,Mercer (ASUN),10,2-8,125,122,247,0.506,04/10/2024,2024.0
37,Richmond (Atlantic 10),11,7-4,151,148,299,0.505,04/10/2024,2024.0
38,Bellarmine (ASUN),13,8-5,164,163,327,0.502,04/10/2024,2024.0
39,Marist (MAAC),12,6-6,158,159,317,0.498,04/10/2024,2024.0
40,UMass Lowell (America East),9,0-9,111,114,225,0.493,04/10/2024,2024.0
41,Canisius (MAAC),13,4-9,163,169,332,0.491,04/10/2024,2024.0
42,Johns Hopkins (Big Ten),11,8-3,136,145,281,0.484,04/10/2024,2024.0
43,LIU (MAAC),11,9-2,139,149,288,0.483,04/10/2024,2024.0
44,Monmouth (CAA),10,5-5,119,129,248,0.480,04/10/2024,2024.0
45,Bucknell (Patriot),11,3-8,142,155,297,0.478,04/10/2024,2024.0
46,Princeton (Ivy League),10,7-3,126,138,264,0.477,04/10/2024,2024.0
47,Saint Joseph's (Atlantic 10),10,7-3,122,134,256,0.477,04/10/2024,2024.0
48,Cornell (Ivy League),10,7-3,153,169,322,0.475,04/10/2024,2024.0
49,Cleveland St. (ASUN),12,7-5,140,158,298,0.470,04/10/2024,2024.0
50,St. John's (NY) (Big East),12,4-8,147,166,313,0.470,04/10/2024,2024.0
51,Siena (MAAC),12,5-7,151,173,324,0.466,04/10/2024,2024.0
52,Massachusetts (Atlantic 10),10,5-5,121,139,260,0.465,04/10/2024,2024.0
53,Utah (ASUN),11,7-4,126,148,274,0.460,04/10/2024,2024.0
54,Brown (Ivy League),10,1-9,114,134,248,0.460,04/10/2024,2024.0
55,Fairfield (CAA),11,5-6,134,158,292,0.459,04/10/2024,2024.0
56,Penn St. (Big Ten),10,7-3,125,148,273,0.458,04/10/2024,2024.0
57,Boston U. (Patriot),11,7-4,141,167,308,0.458,04/10/2024,2024.0
58,Providence (Big East),11,5-6,145,174,319,0.455,04/10/2024,2024.0
58,Stony Brook (CAA),11,4-7,135,162,297,0.455,04/10/2024,2024.0
60,Air Force (ASUN),10,6-4,108,131,239,0.452,04/10/2024,2024.0
61,Quinnipiac (MAAC),11,8-3,134,169,303,0.442,04/10/2024,2024.0
62,Harvard (Ivy League),10,7-3,125,163,288,0.434,04/10/2024,2024.0
63,Penn (Ivy League),11,7-4,115,151,266,0.432,04/10/2024,2024.0
64,Wagner (MAAC),13,1-12,136,185,321,0.424,04/10/2024,2024.0
65,St. Bonaventure (Atlantic 10),9,1-8,96,135,231,0.416,04/10/2024,2024.0
66,Mount St. Mary's (MAAC),13,1-12,133,189,322,0.413,04/10/2024,2024.0
67,Loyola Maryland (Patriot),11,5-6,116,173,289,0.401,04/10/2024,2024.0
68,Colgate (Patriot),11,7-4,122,188,310,0.394,04/10/2024,2024.0
69,Manhattan (MAAC),12,5-7,114,183,297,0.384,04/10/2024,2024.0
70,Holy Cross (Patriot),10,2-8,98,160,258,0.380,04/10/2024,2024.0
71,Merrimack (America East),11,4-7,115,194,309,0.372,04/10/2024,2024.0
72,Hampton (CAA),10,0-10,92,190,282,0.326,04/10/2024,2024.0
73,Detroit Mercy (ASUN),10,2-8,92,197,289,0.318,04/10/2024,2024.0
-,Queens (NC) (ASUN),10,2-8,109,126,235,0.464,04/10/2024,2024.0
-,Le Moyne (NEC),8,2-6,94,109,203,0.463,04/10/2024,2024.0
-,Lindenwood (ASUN),9,0-9,85,123,208,0.409,04/10/2024,2024.0
1,Yale (Ivy League),10,8-2,208,118,326,0.638,04/09/2024,2024.0
2,North Carolina (ACC),11,6-5,186,108,294,0.633,04/09/2024,2024.0
3,Bryant (America East),10,7-3,163,96,259,0.629,04/09/2024,2024.0
4,Army West Point (Patriot),10,8-2,179,110,289,0.619,04/09/2024,2024.0
5,NJIT (America East),11,7-4,175,117,292,0.599,04/09/2024,2024.0
6,Denver (Big East),10,8-2,155,104,259,0.598,04/09/2024,2024.0
7,Syracuse (ACC),13,9-4,220,150,370,0.595,04/09/2024,2024.0
8,Michigan (Big Ten),11,6-5,183,126,309,0.592,04/09/2024,2024.0
9,Marquette (Big East),11,4-7,160,112,272,0.588,04/09/2024,2024.0
10,Maryland (Big Ten),10,7-3,150,107,257,0.584,04/09/2024,2024.0
11,Hobart (Atlantic 10),10,3-7,168,120,288,0.583,04/09/2024,2024.0
12,Villanova (Big East),11,6-5,161,122,283,0.569,04/09/2024,2024.0
13,Navy (Patriot),11,7-4,155,119,274,0.566,04/09/2024,2024.0
14,Duke (ACC),13,10-3,205,158,363,0.565,04/09/2024,2024.0
15,Notre Dame (ACC),8,7-1,129,100,229,0.563,04/09/2024,2024.0
16,High Point (Atlantic 10),12,7-5,195,152,347,0.562,04/09/2024,2024.0
17,Towson (CAA),11,8-3,159,124,283,0.562,04/09/2024,2024.0
18,Ohio St. (Big Ten),12,6-6,158,125,283,0.558,04/09/2024,2024.0
19,UAlbany (America East),10,4-6,151,123,274,0.551,04/09/2024,2024.0
20,Sacred Heart (MAAC),12,8-4,174,143,317,0.549,04/09/2024,2024.0
21,UMBC (America East),8,4-4,117,98,215,0.544,04/09/2024,2024.0
22,Robert Morris (ASUN),10,3-7,128,109,237,0.540,04/09/2024,2024.0
23,Rutgers (Big Ten),11,7-4,150,128,278,0.540,04/09/2024,2024.0
24,Binghamton (America East),10,5-5,144,124,268,0.537,04/09/2024,2024.0
25,Georgetown (Big East),10,8-2,137,120,257,0.533,04/09/2024,2024.0
26,Hofstra (CAA),11,4-7,160,142,302,0.530,04/09/2024,2024.0
27,Virginia (ACC),11,10-1,163,146,309,0.528,04/09/2024,2024.0
28,VMI (MAAC),12,6-6,162,147,309,0.524,04/09/2024,2024.0
29,Dartmouth (Ivy League),10,3-7,138,126,264,0.523,04/09/2024,2024.0
30,Lafayette (Patriot),10,4-6,144,133,277,0.520,04/09/2024,2024.0
31,Vermont (America East),11,4-7,159,152,311,0.511,04/09/2024,2024.0
32,Drexel (CAA),11,4-7,144,138,282,0.511,04/09/2024,2024.0
33,Delaware (CAA),9,6-3,114,110,224,0.509,04/09/2024,2024.0
34,Lehigh (Patriot),11,5-6,140,136,276,0.507,04/09/2024,2024.0
35,Jacksonville (ASUN),11,7-4,116,113,229,0.507,04/09/2024,2024.0
36,Mercer (ASUN),10,2-8,125,122,247,0.506,04/09/2024,2024.0
37,Richmond (Atlantic 10),11,7-4,151,148,299,0.505,04/09/2024,2024.0
38,Marist (MAAC),11,5-6,144,142,286,0.503,04/09/2024,2024.0
39,Bellarmine (ASUN),12,7-5,149,148,297,0.502,04/09/2024,2024.0
40,UMass Lowell (America East),9,0-9,111,114,225,0.493,04/09/2024,2024.0
41,Canisius (MAAC),12,3-9,151,157,308,0.490,04/09/2024,2024.0
42,LIU (MAAC),10,8-2,126,133,259,0.486,04/09/2024,2024.0
43,Johns Hopkins (Big Ten),11,8-3,136,145,281,0.484,04/09/2024,2024.0
44,Monmouth (CAA),10,5-5,119,129,248,0.480,04/09/2024,2024.0
45,Bucknell (Patriot),11,3-8,142,155,297,0.478,04/09/2024,2024.0
46,Princeton (Ivy League),10,7-3,126,138,264,0.477,04/09/2024,2024.0
47,Saint Joseph's (Atlantic 10),10,7-3,122,134,256,0.477,04/09/2024,2024.0
48,Cornell (Ivy League),10,7-3,153,169,322,0.475,04/09/2024,2024.0
49,St. John's (NY) (Big East),12,4-8,147,166,313,0.470,04/09/2024,2024.0
50,Massachusetts (Atlantic 10),10,5-5,121,139,260,0.465,04/09/2024,2024.0
51,Cleveland St. (ASUN),11,6-5,128,149,277,0.462,04/09/2024,2024.0
52,Brown (Ivy League),10,1-9,114,134,248,0.460,04/09/2024,2024.0
53,Fairfield (CAA),11,5-6,134,158,292,0.459,04/09/2024,2024.0
54,Penn St. (Big Ten),10,7-3,125,148,273,0.458,04/09/2024,2024.0
55,Boston U. (Patriot),11,7-4,141,167,308,0.458,04/09/2024,2024.0
56,Siena (MAAC),11,5-6,134,159,293,0.457,04/09/2024,2024.0
57,Providence (Big East),11,5-6,145,174,319,0.455,04/09/2024,2024.0
57,Stony Brook (CAA),11,4-7,135,162,297,0.455,04/09/2024,2024.0
59,Quinnipiac (MAAC),10,8-2,125,151,276,0.453,04/09/2024,2024.0
60,Air Force (ASUN),10,6-4,108,131,239,0.452,04/09/2024,2024.0
61,Utah (ASUN),10,6-4,110,138,248,0.444,04/09/2024,2024.0
62,Harvard (Ivy League),10,7-3,125,163,288,0.434,04/09/2024,2024.0
63,Penn (Ivy League),11,7-4,115,151,266,0.432,04/09/2024,2024.0
64,Wagner (MAAC),12,1-11,122,171,293,0.416,04/09/2024,2024.0
65,St. Bonaventure (Atlantic 10),9,1-8,96,135,231,0.416,04/09/2024,2024.0
66,Mount St. Mary's (MAAC),12,1-11,121,177,298,0.406,04/09/2024,2024.0
67,Loyola Maryland (Patriot),11,5-6,116,173,289,0.401,04/09/2024,2024.0
68,Colgate (Patriot),11,7-4,122,188,310,0.394,04/09/2024,2024.0
69,Holy Cross (Patriot),10,2-8,98,160,258,0.380,04/09/2024,2024.0
70,Merrimack (America East),11,4-7,115,194,309,0.372,04/09/2024,2024.0
71,Manhattan (MAAC),11,5-6,89,158,247,0.360,04/09/2024,2024.0
72,Hampton (CAA),10,0-10,92,190,282,0.326,04/09/2024,2024.0
73,Detroit Mercy (ASUN),9,2-7,80,177,257,0.311,04/09/2024,2024.0
-,Queens (NC) (ASUN),9,2-7,100,114,214,0.467,04/09/2024,2024.0
-,Le Moyne (NEC),8,2-6,94,109,203,0.463,04/09/2024,2024.0
-,Lindenwood (ASUN),8,0-8,75,107,182,0.412,04/09/2024,2024.0
1,Yale (Ivy League),9,7-2,187,101,288,0.649,04/07/2024,2024.0
2,North Carolina (ACC),11,6-5,186,108,294,0.633,04/07/2024,2024.0
3,Bryant (America East),10,7-3,163,96,259,0.629,04/07/2024,2024.0
4,Army West Point (Patriot),10,8-2,179,110,289,0.619,04/07/2024,2024.0
5,NJIT (America East),11,7-4,175,117,292,0.599,04/07/2024,2024.0
6,Denver (Big East),10,8-2,155,104,259,0.598,04/07/2024,2024.0
7,Syracuse (ACC),13,9-4,220,150,370,0.595,04/07/2024,2024.0
8,Michigan (Big Ten),11,6-5,183,126,309,0.592,04/07/2024,2024.0
9,Marquette (Big East),11,4-7,160,112,272,0.588,04/07/2024,2024.0
10,Maryland (Big Ten),10,7-3,150,107,257,0.584,04/07/2024,2024.0
11,Hobart (Atlantic 10),10,3-7,168,120,288,0.583,04/07/2024,2024.0
12,Villanova (Big East),11,6-5,161,122,283,0.569,04/07/2024,2024.0
13,Navy (Patriot),11,7-4,155,119,274,0.566,04/07/2024,2024.0
14,Duke (ACC),13,10-3,205,158,363,0.565,04/07/2024,2024.0
15,Notre Dame (ACC),8,7-1,129,100,229,0.563,04/07/2024,2024.0
16,High Point (Atlantic 10),12,7-5,195,152,347,0.562,04/07/2024,2024.0
17,Towson (CAA),11,8-3,159,124,283,0.562,04/07/2024,2024.0
18,Ohio St. (Big Ten),12,6-6,158,125,283,0.558,04/07/2024,2024.0
19,UAlbany (America East),10,4-6,151,123,274,0.551,04/07/2024,2024.0
20,Sacred Heart (MAAC),12,8-4,174,143,317,0.549,04/07/2024,2024.0
21,UMBC (America East),8,4-4,117,98,215,0.544,04/07/2024,2024.0
22,Robert Morris (ASUN),10,3-7,128,109,237,0.540,04/07/2024,2024.0
23,Rutgers (Big Ten),11,7-4,150,128,278,0.540,04/07/2024,2024.0
24,Binghamton (America East),10,5-5,144,124,268,0.537,04/07/2024,2024.0
25,Georgetown (Big East),10,8-2,137,120,257,0.533,04/07/2024,2024.0
26,Hofstra (CAA),11,4-7,160,142,302,0.530,04/07/2024,2024.0
27,Virginia (ACC),11,10-1,163,146,309,0.528,04/07/2024,2024.0
28,VMI (MAAC),12,6-6,162,147,309,0.524,04/07/2024,2024.0
29,Dartmouth (Ivy League),10,3-7,138,126,264,0.523,04/07/2024,2024.0
30,Lafayette (Patriot),10,4-6,143,134,277,0.516,04/07/2024,2024.0
31,Vermont (America East),11,4-7,159,152,311,0.511,04/07/2024,2024.0
32,Drexel (CAA),11,4-7,144,138,282,0.511,04/07/2024,2024.0
33,Delaware (CAA),9,6-3,114,110,224,0.509,04/07/2024,2024.0
34,Lehigh (Patriot),11,5-6,140,136,276,0.507,04/07/2024,2024.0
35,Jacksonville (ASUN),11,7-4,116,113,229,0.507,04/07/2024,2024.0
36,Mercer (ASUN),10,2-8,125,122,247,0.506,04/07/2024,2024.0
37,Richmond (Atlantic 10),11,7-4,151,148,299,0.505,04/07/2024,2024.0
38,Marist (MAAC),11,5-6,144,142,286,0.503,04/07/2024,2024.0
39,Bellarmine (ASUN),12,7-5,149,148,297,0.502,04/07/2024,2024.0
40,UMass Lowell (America East),9,0-9,111,114,225,0.493,04/07/2024,2024.0
41,Canisius (MAAC),12,3-9,151,157,308,0.490,04/07/2024,2024.0
42,LIU (MAAC),10,8-2,126,133,259,0.486,04/07/2024,2024.0
43,Johns Hopkins (Big Ten),11,8-3,136,145,281,0.484,04/07/2024,2024.0
44,Monmouth (CAA),10,5-5,119,129,248,0.480,04/07/2024,2024.0
45,Bucknell (Patriot),11,3-8,142,155,297,0.478,04/07/2024,2024.0
46,Princeton (Ivy League),10,7-3,126,138,264,0.477,04/07/2024,2024.0
47,Saint Joseph's (Atlantic 10),10,7-3,122,134,256,0.477,04/07/2024,2024.0
48,Cornell (Ivy League),10,7-3,153,169,322,0.475,04/07/2024,2024.0
49,St. John's (NY) (Big East),12,4-8,147,166,313,0.470,04/07/2024,2024.0
50,Massachusetts (Atlantic 10),10,5-5,121,139,260,0.465,04/07/2024,2024.0
51,Cleveland St. (ASUN),11,6-5,128,149,277,0.462,04/07/2024,2024.0
52,Brown (Ivy League),10,1-9,114,134,248,0.460,04/07/2024,2024.0
53,Boston U. (Patriot),10,7-3,124,146,270,0.459,04/07/2024,2024.0
54,Fairfield (CAA),11,5-6,134,158,292,0.459,04/07/2024,2024.0
55,Penn St. (Big Ten),10,7-3,125,148,273,0.458,04/07/2024,2024.0
56,Siena (MAAC),11,5-6,134,159,293,0.457,04/07/2024,2024.0
57,Providence (Big East),11,5-6,145,174,319,0.455,04/07/2024,2024.0
57,Stony Brook (CAA),11,4-7,135,162,297,0.455,04/07/2024,2024.0
59,Quinnipiac (MAAC),10,8-2,125,151,276,0.453,04/07/2024,2024.0
60,Air Force (ASUN),10,6-4,108,131,239,0.452,04/07/2024,2024.0
61,Utah (ASUN),10,6-4,110,138,248,0.444,04/07/2024,2024.0
62,Harvard (Ivy League),10,7-3,125,163,288,0.434,04/07/2024,2024.0
63,Penn (Ivy League),11,7-4,115,151,266,0.432,04/07/2024,2024.0
64,Wagner (MAAC),12,1-11,122,171,293,0.416,04/07/2024,2024.0
65,St. Bonaventure (Atlantic 10),9,1-8,96,135,231,0.416,04/07/2024,2024.0
66,Mount St. Mary's (MAAC),12,1-11,121,177,298,0.406,04/07/2024,2024.0
67,Loyola Maryland (Patriot),11,5-6,117,172,289,0.405,04/07/2024,2024.0
68,Colgate (Patriot),11,7-4,122,188,310,0.394,04/07/2024,2024.0
69,Holy Cross (Patriot),10,2-8,98,160,258,0.380,04/07/2024,2024.0
70,Merrimack (America East),11,4-7,115,194,309,0.372,04/07/2024,2024.0
71,Manhattan (MAAC),11,5-6,89,158,247,0.360,04/07/2024,2024.0
72,Hampton (CAA),10,0-10,92,190,282,0.326,04/07/2024,2024.0
73,Detroit Mercy (ASUN),9,2-7,80,177,257,0.311,04/07/2024,2024.0
-,Queens (NC) (ASUN),9,2-7,100,114,214,0.467,04/07/2024,2024.0
-,Le Moyne (NEC),8,2-6,94,109,203,0.463,04/07/2024,2024.0
-,Lindenwood (ASUN),8,0-8,75,107,182,0.412,04/07/2024,2024.0
1,Yale (Ivy League),8,6-2,173,90,263,0.658,04/02/2024,2024.0
2,Bryant (America East),9,6-3,150,82,232,0.647,04/02/2024,2024.0
3,North Carolina (ACC),10,6-4,173,97,270,0.641,04/02/2024,2024.0
4,Army West Point (Patriot),9,8-1,157,104,261,0.602,04/02/2024,2024.0
5,Denver (Big East),9,7-2,137,92,229,0.598,04/02/2024,2024.0
6,Michigan (Big Ten),10,6-4,172,117,289,0.595,04/02/2024,2024.0
7,Syracuse (ACC),13,9-4,220,150,370,0.595,04/02/2024,2024.0
8,NJIT (America East),10,7-3,154,106,260,0.592,04/02/2024,2024.0
9,Hobart (Atlantic 10),9,3-6,152,105,257,0.591,04/02/2024,2024.0
10,Villanova (Big East),10,6-4,149,103,252,0.591,04/02/2024,2024.0
11,Ohio St. (Big Ten),11,6-5,153,112,265,0.577,04/02/2024,2024.0
12,Navy (Patriot),10,6-4,144,107,251,0.574,04/02/2024,2024.0
13,Maryland (Big Ten),9,6-3,137,102,239,0.573,04/02/2024,2024.0
14,Towson (CAA),10,7-3,146,109,255,0.573,04/02/2024,2024.0
15,Duke (ACC),12,10-2,190,142,332,0.572,04/02/2024,2024.0
16,Notre Dame (ACC),7,6-1,113,85,198,0.571,04/02/2024,2024.0
17,Georgetown (Big East),9,7-2,134,101,235,0.570,04/02/2024,2024.0
18,Marquette (Big East),10,4-6,141,109,250,0.564,04/02/2024,2024.0
19,UAlbany (America East),9,4-5,137,110,247,0.555,04/02/2024,2024.0
20,High Point (Atlantic 10),11,6-5,176,143,319,0.552,04/02/2024,2024.0
21,Robert Morris (ASUN),9,3-6,117,97,214,0.547,04/02/2024,2024.0
22,Rutgers (Big Ten),10,6-4,141,117,258,0.547,04/02/2024,2024.0
23,Sacred Heart (MAAC),11,7-4,155,133,288,0.538,04/02/2024,2024.0
24,Virginia (ACC),10,9-1,152,133,285,0.533,04/02/2024,2024.0
25,Vermont (America East),10,4-6,152,134,286,0.531,04/02/2024,2024.0
26,Hofstra (CAA),10,4-6,145,129,274,0.529,04/02/2024,2024.0
27,UMBC (America East),7,3-4,97,88,185,0.524,04/02/2024,2024.0
28,VMI (MAAC),11,6-5,162,147,309,0.524,04/02/2024,2024.0
29,Binghamton (America East),9,4-5,126,117,243,0.519,04/02/2024,2024.0
30,UMass Lowell (America East),8,0-8,101,94,195,0.518,04/02/2024,2024.0
31,Delaware (CAA),8,5-3,104,97,201,0.517,04/02/2024,2024.0
32,Lafayette (Patriot),9,4-5,131,123,254,0.516,04/02/2024,2024.0
33,Drexel (CAA),10,4-6,133,125,258,0.516,04/02/2024,2024.0
34,Mercer (ASUN),9,2-7,113,107,220,0.514,04/02/2024,2024.0
35,Dartmouth (Ivy League),9,3-6,123,117,240,0.513,04/02/2024,2024.0
36,Bellarmine (ASUN),11,7-4,141,135,276,0.511,04/02/2024,2024.0
37,Richmond (Atlantic 10),10,6-4,136,132,268,0.507,04/02/2024,2024.0
38,LIU (MAAC),9,7-2,113,110,223,0.507,04/02/2024,2024.0
39,Marist (MAAC),10,4-6,132,129,261,0.506,04/02/2024,2024.0
40,Lehigh (Patriot),10,4-6,129,129,258,0.500,04/02/2024,2024.0
41,Jacksonville (ASUN),10,6-4,97,104,201,0.483,04/02/2024,2024.0
42,Johns Hopkins (Big Ten),10,7-3,125,135,260,0.481,04/02/2024,2024.0
43,Princeton (Ivy League),10,7-3,126,138,264,0.477,04/02/2024,2024.0
44,St. John's (NY) (Big East),11,4-7,135,148,283,0.477,04/02/2024,2024.0
45,Massachusetts (Atlantic 10),9,5-4,113,126,239,0.473,04/02/2024,2024.0
46,Canisius (MAAC),11,3-8,128,144,272,0.471,04/02/2024,2024.0
47,Quinnipiac (MAAC),9,8-1,117,132,249,0.470,04/02/2024,2024.0
48,Cornell (Ivy League),9,6-3,139,157,296,0.470,04/02/2024,2024.0
49,Monmouth (CAA),9,4-5,105,120,225,0.467,04/02/2024,2024.0
50,Saint Joseph's (Atlantic 10),9,6-3,109,126,235,0.464,04/02/2024,2024.0
51,Bucknell (Patriot),10,3-7,123,143,266,0.462,04/02/2024,2024.0
52,Brown (Ivy League),9,1-8,102,120,222,0.459,04/02/2024,2024.0
53,Boston U. (Patriot),10,7-3,124,146,270,0.459,04/02/2024,2024.0
54,Penn St. (Big Ten),9,7-2,115,137,252,0.456,04/02/2024,2024.0
55,Cleveland St. (ASUN),10,5-5,113,137,250,0.452,04/02/2024,2024.0
56,Fairfield (CAA),10,5-5,121,148,269,0.450,04/02/2024,2024.0
57,Stony Brook (CAA),10,3-7,122,151,273,0.447,04/02/2024,2024.0
58,Harvard (Ivy League),9,6-3,116,148,264,0.439,04/02/2024,2024.0
59,Providence (Big East),10,4-6,126,162,288,0.438,04/02/2024,2024.0
60,Air Force (ASUN),9,5-4,95,123,218,0.436,04/02/2024,2024.0
61,Utah (ASUN),9,5-4,98,127,225,0.436,04/02/2024,2024.0
62,Siena (MAAC),10,4-6,115,151,266,0.432,04/02/2024,2024.0
63,Penn (Ivy League),10,7-3,104,137,241,0.432,04/02/2024,2024.0
64,St. Bonaventure (Atlantic 10),8,1-7,87,116,203,0.429,04/02/2024,2024.0
65,Wagner (MAAC),11,1-10,112,152,264,0.424,04/02/2024,2024.0
66,Colgate (Patriot),10,6-4,116,166,282,0.411,04/02/2024,2024.0
67,Loyola Maryland (Patriot),10,4-6,105,153,258,0.407,04/02/2024,2024.0
68,Mount St. Mary's (MAAC),11,1-10,108,165,273,0.396,04/02/2024,2024.0
69,Holy Cross (Patriot),9,2-7,91,149,240,0.379,04/02/2024,2024.0
70,Merrimack (America East),10,3-7,104,173,277,0.375,04/02/2024,2024.0
71,Manhattan (MAAC),10,4-6,89,158,247,0.360,04/02/2024,2024.0
72,Hampton (CAA),9,0-9,83,176,259,0.320,04/02/2024,2024.0
73,Detroit Mercy (ASUN),8,1-7,65,168,233,0.279,04/02/2024,2024.0
-,Queens (NC) (ASUN),8,2-6,91,95,186,0.489,04/02/2024,2024.0
-,Le Moyne (NEC),8,2-6,94,109,203,0.463,04/02/2024,2024.0
-,Lindenwood (ASUN),7,0-7,66,92,158,0.418,04/02/2024,2024.0
1,Yale (Ivy League),8,6-2,173,90,263,0.658,03/31/2024,2024.0
2,Bryant (America East),9,6-3,149,83,232,0.642,03/31/2024,2024.0
3,North Carolina (ACC),10,6-4,173,97,270,0.641,03/31/2024,2024.0
4,Army West Point (Patriot),9,8-1,157,104,261,0.602,03/31/2024,2024.0
5,Denver (Big East),9,7-2,137,92,229,0.598,03/31/2024,2024.0
6,NJIT (America East),10,7-3,155,105,260,0.596,03/31/2024,2024.0
7,Michigan (Big Ten),10,6-4,172,117,289,0.595,03/31/2024,2024.0
8,Hobart (Atlantic 10),9,3-6,152,105,257,0.591,03/31/2024,2024.0
9,Villanova (Big East),10,6-4,149,103,252,0.591,03/31/2024,2024.0
10,Syracuse (ACC),12,9-3,197,137,334,0.590,03/31/2024,2024.0
11,Ohio St. (Big Ten),11,6-5,153,112,265,0.577,03/31/2024,2024.0
12,Navy (Patriot),10,6-4,144,107,251,0.574,03/31/2024,2024.0
13,Maryland (Big Ten),9,6-3,137,102,239,0.573,03/31/2024,2024.0
14,Towson (CAA),10,7-3,146,109,255,0.573,03/31/2024,2024.0
15,Duke (ACC),12,10-2,190,142,332,0.572,03/31/2024,2024.0
16,Notre Dame (ACC),7,6-1,113,85,198,0.571,03/31/2024,2024.0
17,Georgetown (Big East),9,7-2,134,101,235,0.570,03/31/2024,2024.0
18,Marquette (Big East),10,4-6,141,109,250,0.564,03/31/2024,2024.0
19,UAlbany (America East),9,4-5,137,110,247,0.555,03/31/2024,2024.0
20,High Point (Atlantic 10),11,6-5,176,143,319,0.552,03/31/2024,2024.0
21,Robert Morris (ASUN),9,3-6,117,97,214,0.547,03/31/2024,2024.0
22,Rutgers (Big Ten),10,6-4,141,117,258,0.547,03/31/2024,2024.0
23,Sacred Heart (MAAC),11,7-4,153,132,285,0.537,03/31/2024,2024.0
24,Virginia (ACC),10,9-1,152,133,285,0.533,03/31/2024,2024.0
25,Vermont (America East),10,4-6,152,134,286,0.531,03/31/2024,2024.0
26,Hofstra (CAA),10,4-6,145,129,274,0.529,03/31/2024,2024.0
27,UMBC (America East),7,3-4,97,88,185,0.524,03/31/2024,2024.0
28,VMI (MAAC),11,6-5,162,147,309,0.524,03/31/2024,2024.0
29,Jacksonville (ASUN),10,6-4,107,98,205,0.522,03/31/2024,2024.0
30,Binghamton (America East),9,4-5,126,117,243,0.519,03/31/2024,2024.0
31,UMass Lowell (America East),8,0-8,101,94,195,0.518,03/31/2024,2024.0
32,Delaware (CAA),8,5-3,104,97,201,0.517,03/31/2024,2024.0
33,Lafayette (Patriot),9,4-5,131,123,254,0.516,03/31/2024,2024.0
34,Drexel (CAA),10,4-6,133,125,258,0.516,03/31/2024,2024.0
35,Mercer (ASUN),9,2-7,113,107,220,0.514,03/31/2024,2024.0
36,Dartmouth (Ivy League),9,3-6,123,117,240,0.513,03/31/2024,2024.0
37,Bellarmine (ASUN),11,7-4,141,135,276,0.511,03/31/2024,2024.0
38,LIU (MAAC),9,7-2,112,108,220,0.509,03/31/2024,2024.0
39,Richmond (Atlantic 10),10,6-4,136,132,268,0.507,03/31/2024,2024.0
40,Marist (MAAC),10,4-6,132,129,261,0.506,03/31/2024,2024.0
41,Princeton (Ivy League),9,6-3,118,122,240,0.492,03/31/2024,2024.0
42,Cornell (Ivy League),8,5-3,126,134,260,0.485,03/31/2024,2024.0
43,Lehigh (Patriot),9,4-5,113,121,234,0.483,03/31/2024,2024.0
44,Johns Hopkins (Big Ten),10,7-3,125,135,260,0.481,03/31/2024,2024.0
45,St. John's (NY) (Big East),11,4-7,135,148,283,0.477,03/31/2024,2024.0
46,Massachusetts (Atlantic 10),9,5-4,113,126,239,0.473,03/31/2024,2024.0
47,Canisius (MAAC),11,3-8,128,144,272,0.471,03/31/2024,2024.0
48,Quinnipiac (MAAC),9,8-1,117,132,249,0.470,03/31/2024,2024.0
49,Monmouth (CAA),9,4-5,105,120,225,0.467,03/31/2024,2024.0
50,Saint Joseph's (Atlantic 10),9,6-3,109,126,235,0.464,03/31/2024,2024.0
51,Bucknell (Patriot),10,3-7,123,143,266,0.462,03/31/2024,2024.0
52,Brown (Ivy League),9,1-8,102,120,222,0.459,03/31/2024,2024.0
53,Boston U. (Patriot),10,7-3,124,146,270,0.459,03/31/2024,2024.0
54,Penn St. (Big Ten),9,7-2,115,137,252,0.456,03/31/2024,2024.0
55,Cleveland St. (ASUN),10,5-5,100,122,222,0.450,03/31/2024,2024.0
56,Fairfield (CAA),10,5-5,121,148,269,0.450,03/31/2024,2024.0
57,Stony Brook (CAA),10,3-7,122,151,273,0.447,03/31/2024,2024.0
58,Harvard (Ivy League),9,6-3,116,148,264,0.439,03/31/2024,2024.0
59,Providence (Big East),10,4-6,126,162,288,0.438,03/31/2024,2024.0
60,Air Force (ASUN),9,5-4,95,123,218,0.436,03/31/2024,2024.0
61,Siena (MAAC),10,4-6,115,151,266,0.432,03/31/2024,2024.0
62,Penn (Ivy League),10,7-3,104,137,241,0.432,03/31/2024,2024.0
63,St. Bonaventure (Atlantic 10),8,1-7,87,116,203,0.429,03/31/2024,2024.0
64,Wagner (MAAC),11,1-10,112,152,264,0.424,03/31/2024,2024.0
65,Colgate (Patriot),10,6-4,116,166,282,0.411,03/31/2024,2024.0
66,Utah (ASUN),9,5-4,105,152,257,0.409,03/31/2024,2024.0
67,Loyola Maryland (Patriot),10,4-6,105,153,258,0.407,03/31/2024,2024.0
68,Mount St. Mary's (MAAC),11,1-10,108,165,273,0.396,03/31/2024,2024.0
69,Holy Cross (Patriot),9,2-7,91,149,240,0.379,03/31/2024,2024.0
70,Merrimack (America East),10,3-7,104,173,277,0.375,03/31/2024,2024.0
71,Manhattan (MAAC),10,4-6,89,158,247,0.360,03/31/2024,2024.0
72,Hampton (CAA),9,0-9,83,176,259,0.320,03/31/2024,2024.0
73,Detroit Mercy (ASUN),8,1-7,65,168,233,0.279,03/31/2024,2024.0
-,Queens (NC) (ASUN),8,2-6,91,95,186,0.489,03/31/2024,2024.0
-,Le Moyne (NEC),8,2-6,94,109,203,0.463,03/31/2024,2024.0
-,Lindenwood (ASUN),7,0-7,66,92,158,0.418,03/31/2024,2024.0
1,North Carolina (ACC),9,6-3,157,84,241,0.651,03/27/2024,2024.0
2,Bryant (America East),8,5-3,136,74,210,0.648,03/27/2024,2024.0
3,Yale (Ivy League),7,5-2,148,86,234,0.632,03/27/2024,2024.0
4,Army West Point (Patriot),8,7-1,144,88,232,0.621,03/27/2024,2024.0
5,Syracuse (ACC),11,9-2,188,117,305,0.616,03/27/2024,2024.0
6,Villanova (Big East),9,6-3,143,90,233,0.614,03/27/2024,2024.0
7,NJIT (America East),9,7-2,146,92,238,0.613,03/27/2024,2024.0
8,Hobart (Atlantic 10),8,3-5,136,91,227,0.599,03/27/2024,2024.0
9,Michigan (Big Ten),9,6-3,154,106,260,0.592,03/27/2024,2024.0
10,Denver (Big East),8,6-2,124,86,210,0.590,03/27/2024,2024.0
11,Ohio St. (Big Ten),10,5-5,139,100,239,0.582,03/27/2024,2024.0
12,Duke (ACC),12,10-2,190,142,332,0.572,03/27/2024,2024.0
13,Navy (Patriot),9,5-4,131,98,229,0.572,03/27/2024,2024.0
14,UAlbany (America East),8,3-5,124,93,217,0.571,03/27/2024,2024.0
15,Maryland (Big Ten),8,5-3,120,91,211,0.569,03/27/2024,2024.0
16,Marquette (Big East),9,4-5,127,98,225,0.564,03/27/2024,2024.0
17,Georgetown (Big East),8,6-2,116,90,206,0.563,03/27/2024,2024.0
18,Rutgers (Big Ten),9,6-3,129,103,232,0.556,03/27/2024,2024.0
19,Towson (CAA),9,6-3,130,105,235,0.553,03/27/2024,2024.0
20,High Point (Atlantic 10),10,6-4,164,133,297,0.552,03/27/2024,2024.0
21,Notre Dame (ACC),6,5-1,93,76,169,0.550,03/27/2024,2024.0
22,Hofstra (CAA),9,3-6,139,116,255,0.545,03/27/2024,2024.0
23,Mercer (ASUN),8,2-6,106,89,195,0.544,03/27/2024,2024.0
24,VMI (MAAC),10,5-5,153,132,285,0.537,03/27/2024,2024.0
25,Virginia (ACC),9,8-1,138,121,259,0.533,03/27/2024,2024.0
26,UMass Lowell (America East),7,0-7,91,80,171,0.532,03/27/2024,2024.0
27,Sacred Heart (MAAC),10,6-4,139,123,262,0.531,03/27/2024,2024.0
28,LIU (MAAC),8,7-1,90,81,171,0.526,03/27/2024,2024.0
29,Robert Morris (ASUN),8,2-6,99,90,189,0.524,03/27/2024,2024.0
30,Dartmouth (Ivy League),8,3-5,112,104,216,0.519,03/27/2024,2024.0
31,Delaware (CAA),7,4-3,90,84,174,0.517,03/27/2024,2024.0
32,UMBC (America East),6,3-3,80,75,155,0.516,03/27/2024,2024.0
33,Drexel (CAA),9,4-5,115,108,223,0.516,03/27/2024,2024.0
34,Richmond (Atlantic 10),9,5-4,122,115,237,0.515,03/27/2024,2024.0
35,Binghamton (America East),8,3-5,112,107,219,0.511,03/27/2024,2024.0
36,Lafayette (Patriot),8,4-4,115,110,225,0.511,03/27/2024,2024.0
37,Brown (Ivy League),8,1-7,98,95,193,0.508,03/27/2024,2024.0
38,Vermont (America East),9,3-6,128,125,253,0.506,03/27/2024,2024.0
39,Bellarmine (ASUN),10,6-4,122,124,246,0.496,03/27/2024,2024.0
40,Johns Hopkins (Big Ten),9,6-3,114,117,231,0.494,03/27/2024,2024.0
41,Jacksonville (ASUN),9,6-3,98,103,201,0.488,03/27/2024,2024.0
42,Princeton (Ivy League),8,5-3,105,111,216,0.486,03/27/2024,2024.0
43,Marist (MAAC),9,4-5,114,122,236,0.483,03/27/2024,2024.0
44,St. John's (NY) (Big East),10,3-7,124,134,258,0.481,03/27/2024,2024.0
45,Cornell (Ivy League),7,5-2,112,122,234,0.479,03/27/2024,2024.0
46,Massachusetts (Atlantic 10),8,4-4,99,110,209,0.474,03/27/2024,2024.0
47,Stony Brook (CAA),9,3-6,118,135,253,0.466,03/27/2024,2024.0
48,Saint Joseph's (Atlantic 10),8,5-3,99,114,213,0.465,03/27/2024,2024.0
49,Penn St. (Big Ten),8,7-1,104,120,224,0.464,03/27/2024,2024.0
50,Bucknell (Patriot),9,2-7,110,127,237,0.464,03/27/2024,2024.0
51,Quinnipiac (MAAC),8,7-1,101,119,220,0.459,03/27/2024,2024.0
52,Canisius (MAAC),10,3-7,113,135,248,0.456,03/27/2024,2024.0
53,Lehigh (Patriot),8,4-4,94,114,208,0.452,03/27/2024,2024.0
54,Monmouth (CAA),8,4-4,92,114,206,0.447,03/27/2024,2024.0
55,Fairfield (CAA),9,4-5,104,130,234,0.444,03/27/2024,2024.0
56,Providence (Big East),9,4-5,115,144,259,0.444,03/27/2024,2024.0
57,Air Force (ASUN),8,4-4,87,109,196,0.444,03/27/2024,2024.0
58,Boston U. (Patriot),9,6-3,104,134,238,0.437,03/27/2024,2024.0
58,Harvard (Ivy League),8,6-2,104,134,238,0.437,03/27/2024,2024.0
60,Utah (ASUN),8,4-4,98,127,225,0.436,03/27/2024,2024.0
61,Cleveland St. (ASUN),9,5-4,98,130,228,0.430,03/27/2024,2024.0
62,Penn (Ivy League),9,6-3,92,123,215,0.428,03/27/2024,2024.0
63,Siena (MAAC),9,3-6,104,142,246,0.423,03/27/2024,2024.0
64,Loyola Maryland (Patriot),9,3-6,98,134,232,0.422,03/27/2024,2024.0
65,Wagner (MAAC),10,1-9,90,128,218,0.413,03/27/2024,2024.0
66,Colgate (Patriot),9,6-3,107,153,260,0.412,03/27/2024,2024.0
67,St. Bonaventure (Atlantic 10),7,1-6,70,102,172,0.407,03/27/2024,2024.0
68,Merrimack (America East),9,3-6,95,149,244,0.389,03/27/2024,2024.0
68,Mount St. Mary's (MAAC),10,1-9,95,149,244,0.389,03/27/2024,2024.0
70,Holy Cross (Patriot),8,2-6,79,129,208,0.380,03/27/2024,2024.0
71,Manhattan (MAAC),9,3-6,82,140,222,0.369,03/27/2024,2024.0
72,Hampton (CAA),8,0-8,70,162,232,0.302,03/27/2024,2024.0
73,Detroit Mercy (ASUN),7,0-7,58,152,210,0.276,03/27/2024,2024.0
-,Le Moyne (NEC),8,2-6,94,109,203,0.463,03/27/2024,2024.0
-,Queens (NC) (ASUN),7,2-5,75,88,163,0.460,03/27/2024,2024.0
-,Lindenwood (ASUN),6,0-6,55,73,128,0.430,03/27/2024,2024.0
1,North Carolina (ACC),9,6-3,157,84,241,0.651,03/26/2024,2024.0
2,Bryant (America East),8,5-3,136,74,210,0.648,03/26/2024,2024.0
3,Yale (Ivy League),7,5-2,148,86,234,0.632,03/26/2024,2024.0
4,Army West Point (Patriot),8,7-1,144,88,232,0.621,03/26/2024,2024.0
5,Syracuse (ACC),11,9-2,188,117,305,0.616,03/26/2024,2024.0
6,Villanova (Big East),9,6-3,143,90,233,0.614,03/26/2024,2024.0
7,NJIT (America East),9,7-2,146,92,238,0.613,03/26/2024,2024.0
8,Hobart (Atlantic 10),8,3-5,136,91,227,0.599,03/26/2024,2024.0
9,Denver (Big East),8,6-2,124,86,210,0.590,03/26/2024,2024.0
10,Michigan (Big Ten),9,6-3,153,107,260,0.588,03/26/2024,2024.0
11,Ohio St. (Big Ten),10,5-5,139,100,239,0.582,03/26/2024,2024.0
12,Maryland (Big Ten),8,5-3,121,90,211,0.573,03/26/2024,2024.0
13,Navy (Patriot),9,5-4,131,98,229,0.572,03/26/2024,2024.0
14,UAlbany (America East),8,3-5,124,93,217,0.571,03/26/2024,2024.0
15,Duke (ACC),11,9-2,175,132,307,0.570,03/26/2024,2024.0
16,Marquette (Big East),9,4-5,127,98,225,0.564,03/26/2024,2024.0
17,Georgetown (Big East),8,6-2,116,90,206,0.563,03/26/2024,2024.0
18,Rutgers (Big Ten),9,6-3,129,103,232,0.556,03/26/2024,2024.0
19,Towson (CAA),9,6-3,130,105,235,0.553,03/26/2024,2024.0
20,High Point (Atlantic 10),10,6-4,164,133,297,0.552,03/26/2024,2024.0
21,Notre Dame (ACC),6,5-1,93,76,169,0.550,03/26/2024,2024.0
22,Hofstra (CAA),9,3-6,139,116,255,0.545,03/26/2024,2024.0
23,Mercer (ASUN),8,2-6,106,89,195,0.544,03/26/2024,2024.0
24,Sacred Heart (MAAC),9,5-4,131,110,241,0.544,03/26/2024,2024.0
25,VMI (MAAC),9,4-5,141,121,262,0.538,03/26/2024,2024.0
26,Virginia (ACC),9,8-1,138,121,259,0.533,03/26/2024,2024.0
27,UMass Lowell (America East),7,0-7,91,80,171,0.532,03/26/2024,2024.0
28,LIU (MAAC),7,6-1,90,81,171,0.526,03/26/2024,2024.0
29,Robert Morris (ASUN),8,2-6,99,90,189,0.524,03/26/2024,2024.0
30,Dartmouth (Ivy League),8,3-5,112,104,216,0.519,03/26/2024,2024.0
31,Delaware (CAA),7,4-3,90,84,174,0.517,03/26/2024,2024.0
32,UMBC (America East),6,3-3,80,75,155,0.516,03/26/2024,2024.0
33,Drexel (CAA),9,4-5,115,108,223,0.516,03/26/2024,2024.0
34,Richmond (Atlantic 10),9,5-4,122,115,237,0.515,03/26/2024,2024.0
35,Binghamton (America East),8,3-5,112,107,219,0.511,03/26/2024,2024.0
36,Lafayette (Patriot),8,4-4,115,110,225,0.511,03/26/2024,2024.0
37,Brown (Ivy League),8,1-7,98,95,193,0.508,03/26/2024,2024.0
38,Vermont (America East),9,3-6,128,125,253,0.506,03/26/2024,2024.0
39,Bellarmine (ASUN),10,6-4,122,124,246,0.496,03/26/2024,2024.0
40,Johns Hopkins (Big Ten),9,6-3,114,117,231,0.494,03/26/2024,2024.0
41,Princeton (Ivy League),8,5-3,105,111,216,0.486,03/26/2024,2024.0
42,St. John's (NY) (Big East),10,3-7,124,134,258,0.481,03/26/2024,2024.0
43,Cornell (Ivy League),7,5-2,112,122,234,0.479,03/26/2024,2024.0
44,Jacksonville (ASUN),8,5-3,82,91,173,0.474,03/26/2024,2024.0
45,Massachusetts (Atlantic 10),8,4-4,99,110,209,0.474,03/26/2024,2024.0
46,Marist (MAAC),8,4-4,101,114,215,0.470,03/26/2024,2024.0
47,Stony Brook (CAA),9,3-6,118,135,253,0.466,03/26/2024,2024.0
48,Saint Joseph's (Atlantic 10),8,5-3,99,114,213,0.465,03/26/2024,2024.0
49,Penn St. (Big Ten),8,7-1,104,120,224,0.464,03/26/2024,2024.0
50,Bucknell (Patriot),9,2-7,110,127,237,0.464,03/26/2024,2024.0
51,Quinnipiac (MAAC),7,7-0,86,104,190,0.453,03/26/2024,2024.0
52,Canisius (MAAC),9,2-7,99,120,219,0.452,03/26/2024,2024.0
53,Lehigh (Patriot),8,4-4,94,114,208,0.452,03/26/2024,2024.0
54,Monmouth (CAA),8,4-4,92,114,206,0.447,03/26/2024,2024.0
55,Fairfield (CAA),9,4-5,104,130,234,0.444,03/26/2024,2024.0
56,Providence (Big East),9,4-5,115,144,259,0.444,03/26/2024,2024.0
57,Air Force (ASUN),8,4-4,87,109,196,0.444,03/26/2024,2024.0
58,Boston U. (Patriot),8,6-2,94,119,213,0.441,03/26/2024,2024.0
59,Harvard (Ivy League),8,6-2,104,134,238,0.437,03/26/2024,2024.0
60,Utah (ASUN),8,4-4,98,127,225,0.436,03/26/2024,2024.0
61,Cleveland St. (ASUN),8,5-3,86,114,200,0.430,03/26/2024,2024.0
62,Penn (Ivy League),9,6-3,92,123,215,0.428,03/26/2024,2024.0
63,Loyola Maryland (Patriot),9,3-6,98,134,232,0.422,03/26/2024,2024.0
64,Wagner (MAAC),9,1-8,90,128,218,0.413,03/26/2024,2024.0
65,Colgate (Patriot),9,6-3,107,153,260,0.412,03/26/2024,2024.0
66,Siena (MAAC),8,3-5,89,128,217,0.410,03/26/2024,2024.0
67,St. Bonaventure (Atlantic 10),7,1-6,70,102,172,0.407,03/26/2024,2024.0
68,Merrimack (America East),9,3-6,95,149,244,0.389,03/26/2024,2024.0
69,Mount St. Mary's (MAAC),9,1-8,84,137,221,0.380,03/26/2024,2024.0
70,Holy Cross (Patriot),8,2-6,79,129,208,0.380,03/26/2024,2024.0
71,Manhattan (MAAC),8,2-6,67,125,192,0.349,03/26/2024,2024.0
72,Hampton (CAA),8,0-8,70,162,232,0.302,03/26/2024,2024.0
73,Detroit Mercy (ASUN),7,0-7,58,152,210,0.276,03/26/2024,2024.0
-,Le Moyne (NEC),8,2-6,94,109,203,0.463,03/26/2024,2024.0
-,Queens (NC) (ASUN),7,2-5,75,88,163,0.460,03/26/2024,2024.0
-,Lindenwood (ASUN),6,0-6,55,73,128,0.430,03/26/2024,2024.0
1,North Carolina (ACC),9,6-3,157,84,241,0.651,03/25/2024,2024.0
2,Bryant (America East),8,5-3,136,74,210,0.648,03/25/2024,2024.0
3,Army West Point (Patriot),8,7-1,144,88,232,0.621,03/25/2024,2024.0
4,Yale (Ivy League),6,4-2,123,76,199,0.618,03/25/2024,2024.0
5,Syracuse (ACC),11,9-2,188,117,305,0.616,03/25/2024,2024.0
6,Villanova (Big East),9,6-3,143,90,233,0.614,03/25/2024,2024.0
7,NJIT (America East),9,7-2,146,92,238,0.613,03/25/2024,2024.0
8,Hobart (Atlantic 10),8,3-5,136,91,227,0.599,03/25/2024,2024.0
9,Denver (Big East),8,6-2,124,86,210,0.590,03/25/2024,2024.0
10,Michigan (Big Ten),9,6-3,153,107,260,0.588,03/25/2024,2024.0
11,Ohio St. (Big Ten),10,5-5,139,100,239,0.582,03/25/2024,2024.0
12,Maryland (Big Ten),8,5-3,121,90,211,0.573,03/25/2024,2024.0
13,Navy (Patriot),9,5-4,131,98,229,0.572,03/25/2024,2024.0
14,UAlbany (America East),8,3-5,124,93,217,0.571,03/25/2024,2024.0
15,Duke (ACC),11,9-2,175,132,307,0.570,03/25/2024,2024.0
16,Marquette (Big East),9,4-5,127,98,225,0.564,03/25/2024,2024.0
17,Georgetown (Big East),8,6-2,116,90,206,0.563,03/25/2024,2024.0
18,Rutgers (Big Ten),9,6-3,129,103,232,0.556,03/25/2024,2024.0
19,Towson (CAA),9,6-3,130,105,235,0.553,03/25/2024,2024.0
20,High Point (Atlantic 10),10,6-4,164,133,297,0.552,03/25/2024,2024.0
21,Notre Dame (ACC),6,5-1,93,76,169,0.550,03/25/2024,2024.0
22,Hofstra (CAA),9,3-6,139,116,255,0.545,03/25/2024,2024.0
23,Mercer (ASUN),8,2-6,106,89,195,0.544,03/25/2024,2024.0
24,Sacred Heart (MAAC),9,5-4,131,110,241,0.544,03/25/2024,2024.0
25,VMI (MAAC),9,4-5,141,121,262,0.538,03/25/2024,2024.0
26,Virginia (ACC),9,8-1,138,121,259,0.533,03/25/2024,2024.0
27,UMass Lowell (America East),7,0-7,91,80,171,0.532,03/25/2024,2024.0
28,LIU (MAAC),7,6-1,90,81,171,0.526,03/25/2024,2024.0
29,Robert Morris (ASUN),8,2-6,99,90,189,0.524,03/25/2024,2024.0
30,Dartmouth (Ivy League),8,3-5,112,104,216,0.519,03/25/2024,2024.0
31,Delaware (CAA),7,4-3,90,84,174,0.517,03/25/2024,2024.0
32,UMBC (America East),6,3-3,80,75,155,0.516,03/25/2024,2024.0
33,Drexel (CAA),9,4-5,115,108,223,0.516,03/25/2024,2024.0
34,Richmond (Atlantic 10),9,5-4,122,115,237,0.515,03/25/2024,2024.0
35,Binghamton (America East),8,3-5,112,107,219,0.511,03/25/2024,2024.0
36,Lafayette (Patriot),8,4-4,115,110,225,0.511,03/25/2024,2024.0
37,Brown (Ivy League),8,1-7,98,95,193,0.508,03/25/2024,2024.0
38,Vermont (America East),9,3-6,128,125,253,0.506,03/25/2024,2024.0
39,Bellarmine (ASUN),10,6-4,122,124,246,0.496,03/25/2024,2024.0
40,Johns Hopkins (Big Ten),9,6-3,114,117,231,0.494,03/25/2024,2024.0
41,Princeton (Ivy League),8,5-3,105,111,216,0.486,03/25/2024,2024.0
42,St. John's (NY) (Big East),10,3-7,124,134,258,0.481,03/25/2024,2024.0
43,Cornell (Ivy League),7,5-2,112,122,234,0.479,03/25/2024,2024.0
44,Jacksonville (ASUN),8,5-3,82,91,173,0.474,03/25/2024,2024.0
45,Massachusetts (Atlantic 10),8,4-4,99,110,209,0.474,03/25/2024,2024.0
46,Marist (MAAC),8,4-4,101,114,215,0.470,03/25/2024,2024.0
47,Stony Brook (CAA),9,3-6,118,135,253,0.466,03/25/2024,2024.0
48,Saint Joseph's (Atlantic 10),8,5-3,99,114,213,0.465,03/25/2024,2024.0
49,Penn St. (Big Ten),8,7-1,104,120,224,0.464,03/25/2024,2024.0
50,Bucknell (Patriot),9,2-7,110,127,237,0.464,03/25/2024,2024.0
51,Quinnipiac (MAAC),7,7-0,86,104,190,0.453,03/25/2024,2024.0
52,Canisius (MAAC),9,2-7,99,120,219,0.452,03/25/2024,2024.0
53,Lehigh (Patriot),8,4-4,94,114,208,0.452,03/25/2024,2024.0
54,Monmouth (CAA),8,4-4,92,114,206,0.447,03/25/2024,2024.0
55,Fairfield (CAA),9,4-5,104,130,234,0.444,03/25/2024,2024.0
56,Providence (Big East),9,4-5,115,144,259,0.444,03/25/2024,2024.0
57,Air Force (ASUN),8,4-4,87,109,196,0.444,03/25/2024,2024.0
58,Boston U. (Patriot),8,6-2,94,119,213,0.441,03/25/2024,2024.0
59,Harvard (Ivy League),8,6-2,104,134,238,0.437,03/25/2024,2024.0
60,Utah (ASUN),8,4-4,98,127,225,0.436,03/25/2024,2024.0
61,Cleveland St. (ASUN),8,5-3,86,114,200,0.430,03/25/2024,2024.0
62,Penn (Ivy League),9,6-3,92,123,215,0.428,03/25/2024,2024.0
63,Loyola Maryland (Patriot),9,3-6,98,134,232,0.422,03/25/2024,2024.0
64,Wagner (MAAC),9,1-8,90,128,218,0.413,03/25/2024,2024.0
65,Colgate (Patriot),9,6-3,107,153,260,0.412,03/25/2024,2024.0
66,Siena (MAAC),8,3-5,89,128,217,0.410,03/25/2024,2024.0
67,St. Bonaventure (Atlantic 10),7,1-6,70,102,172,0.407,03/25/2024,2024.0
68,Merrimack (America East),9,3-6,95,149,244,0.389,03/25/2024,2024.0
69,Mount St. Mary's (MAAC),9,1-8,84,137,221,0.380,03/25/2024,2024.0
70,Holy Cross (Patriot),8,2-6,79,129,208,0.380,03/25/2024,2024.0
71,Manhattan (MAAC),8,2-6,67,125,192,0.349,03/25/2024,2024.0
72,Hampton (CAA),8,0-8,70,162,232,0.302,03/25/2024,2024.0
73,Detroit Mercy (ASUN),7,0-7,58,152,210,0.276,03/25/2024,2024.0
-,Le Moyne (NEC),7,2-5,84,84,168,0.500,03/25/2024,2024.0
-,Queens (NC) (ASUN),7,2-5,75,88,163,0.460,03/25/2024,2024.0
-,Lindenwood (ASUN),6,0-6,55,73,128,0.430,03/25/2024,2024.0
1,North Carolina (ACC),9,6-3,157,84,241,0.651,03/24/2024,2024.0
2,Bryant (America East),8,5-3,136,74,210,0.648,03/24/2024,2024.0
3,Army West Point (Patriot),8,7-1,144,88,232,0.621,03/24/2024,2024.0
4,Villanova (Big East),8,5-3,133,82,215,0.619,03/24/2024,2024.0
5,Yale (Ivy League),6,4-2,123,76,199,0.618,03/24/2024,2024.0
6,Syracuse (ACC),11,9-2,188,117,305,0.616,03/24/2024,2024.0
7,NJIT (America East),9,7-2,146,92,238,0.613,03/24/2024,2024.0
8,Hobart (Atlantic 10),8,3-5,136,91,227,0.599,03/24/2024,2024.0
9,Denver (Big East),8,6-2,124,86,210,0.590,03/24/2024,2024.0
10,Michigan (Big Ten),9,6-3,153,107,260,0.588,03/24/2024,2024.0
11,Ohio St. (Big Ten),10,5-5,139,100,239,0.582,03/24/2024,2024.0
12,Maryland (Big Ten),8,5-3,121,90,211,0.573,03/24/2024,2024.0
13,Navy (Patriot),9,5-4,131,98,229,0.572,03/24/2024,2024.0
14,UAlbany (America East),8,3-5,124,93,217,0.571,03/24/2024,2024.0
15,Duke (ACC),11,9-2,175,132,307,0.570,03/24/2024,2024.0
16,Marquette (Big East),9,4-5,127,98,225,0.564,03/24/2024,2024.0
17,Georgetown (Big East),8,6-2,116,90,206,0.563,03/24/2024,2024.0
18,Rutgers (Big Ten),9,6-3,129,103,232,0.556,03/24/2024,2024.0
19,Towson (CAA),9,6-3,130,105,235,0.553,03/24/2024,2024.0
20,High Point (Atlantic 10),10,6-4,164,133,297,0.552,03/24/2024,2024.0
21,Notre Dame (ACC),6,5-1,93,76,169,0.550,03/24/2024,2024.0
22,Hofstra (CAA),9,3-6,139,116,255,0.545,03/24/2024,2024.0
23,Mercer (ASUN),8,2-6,106,89,195,0.544,03/24/2024,2024.0
24,Sacred Heart (MAAC),9,5-4,131,110,241,0.544,03/24/2024,2024.0
25,VMI (MAAC),9,4-5,141,121,262,0.538,03/24/2024,2024.0
26,Virginia (ACC),9,8-1,138,121,259,0.533,03/24/2024,2024.0
27,UMass Lowell (America East),7,0-7,91,80,171,0.532,03/24/2024,2024.0
28,LIU (MAAC),7,6-1,90,81,171,0.526,03/24/2024,2024.0
29,Robert Morris (ASUN),8,2-6,99,90,189,0.524,03/24/2024,2024.0
30,Dartmouth (Ivy League),8,3-5,112,104,216,0.519,03/24/2024,2024.0
31,Delaware (CAA),7,4-3,90,84,174,0.517,03/24/2024,2024.0
32,UMBC (America East),6,3-3,80,75,155,0.516,03/24/2024,2024.0
33,Richmond (Atlantic 10),9,5-4,122,115,237,0.515,03/24/2024,2024.0
34,Brown (Ivy League),7,1-6,90,85,175,0.514,03/24/2024,2024.0
35,Binghamton (America East),8,3-5,112,107,219,0.511,03/24/2024,2024.0
36,Lafayette (Patriot),8,4-4,115,110,225,0.511,03/24/2024,2024.0
37,Drexel (CAA),8,3-5,101,98,199,0.508,03/24/2024,2024.0
38,Vermont (America East),9,3-6,128,125,253,0.506,03/24/2024,2024.0
39,Bellarmine (ASUN),10,6-4,122,124,246,0.496,03/24/2024,2024.0
40,Johns Hopkins (Big Ten),9,6-3,114,117,231,0.494,03/24/2024,2024.0
41,Princeton (Ivy League),8,5-3,105,111,216,0.486,03/24/2024,2024.0
42,St. John's (NY) (Big East),10,3-7,124,134,258,0.481,03/24/2024,2024.0
43,Cornell (Ivy League),7,5-2,112,122,234,0.479,03/24/2024,2024.0
44,Jacksonville (ASUN),8,5-3,82,91,173,0.474,03/24/2024,2024.0
45,Massachusetts (Atlantic 10),8,4-4,99,110,209,0.474,03/24/2024,2024.0
46,Marist (MAAC),8,4-4,101,114,215,0.470,03/24/2024,2024.0
47,Stony Brook (CAA),9,3-6,118,135,253,0.466,03/24/2024,2024.0
48,Saint Joseph's (Atlantic 10),8,5-3,99,114,213,0.465,03/24/2024,2024.0
49,Penn St. (Big Ten),8,7-1,104,120,224,0.464,03/24/2024,2024.0
50,Bucknell (Patriot),9,2-7,110,127,237,0.464,03/24/2024,2024.0
51,Quinnipiac (MAAC),7,7-0,86,104,190,0.453,03/24/2024,2024.0
52,Canisius (MAAC),9,2-7,99,120,219,0.452,03/24/2024,2024.0
53,Lehigh (Patriot),8,4-4,94,114,208,0.452,03/24/2024,2024.0
54,Monmouth (CAA),8,4-4,92,114,206,0.447,03/24/2024,2024.0
55,Fairfield (CAA),9,4-5,104,130,234,0.444,03/24/2024,2024.0
56,Providence (Big East),9,4-5,115,144,259,0.444,03/24/2024,2024.0
57,Air Force (ASUN),8,4-4,87,109,196,0.444,03/24/2024,2024.0
58,Boston U. (Patriot),8,6-2,94,119,213,0.441,03/24/2024,2024.0
59,Harvard (Ivy League),8,6-2,104,134,238,0.437,03/24/2024,2024.0
60,Utah (ASUN),8,4-4,98,127,225,0.436,03/24/2024,2024.0
61,Cleveland St. (ASUN),8,5-3,86,114,200,0.430,03/24/2024,2024.0
62,Penn (Ivy League),9,6-3,92,123,215,0.428,03/24/2024,2024.0
63,Loyola Maryland (Patriot),9,3-6,98,134,232,0.422,03/24/2024,2024.0
64,Wagner (MAAC),9,1-8,90,128,218,0.413,03/24/2024,2024.0
65,Colgate (Patriot),9,6-3,107,153,260,0.412,03/24/2024,2024.0
66,Siena (MAAC),8,3-5,89,128,217,0.410,03/24/2024,2024.0
67,St. Bonaventure (Atlantic 10),7,1-6,70,102,172,0.407,03/24/2024,2024.0
68,Merrimack (America East),9,3-6,95,149,244,0.389,03/24/2024,2024.0
69,Mount St. Mary's (MAAC),9,1-8,84,137,221,0.380,03/24/2024,2024.0
70,Holy Cross (Patriot),8,2-6,79,129,208,0.380,03/24/2024,2024.0
71,Manhattan (MAAC),8,2-6,67,125,192,0.349,03/24/2024,2024.0
72,Hampton (CAA),7,0-7,60,148,208,0.288,03/24/2024,2024.0
73,Detroit Mercy (ASUN),7,0-7,58,152,210,0.276,03/24/2024,2024.0
-,Le Moyne (NEC),7,2-5,84,84,168,0.500,03/24/2024,2024.0
-,Queens (NC) (ASUN),7,2-5,75,88,163,0.460,03/24/2024,2024.0
-,Lindenwood (ASUN),6,0-6,55,73,128,0.430,03/24/2024,2024.0
1,North Carolina (ACC),9,6-3,157,84,241,0.651,03/23/2024,2024.0
2,Bryant (America East),8,5-3,136,74,210,0.648,03/23/2024,2024.0
3,Army West Point (Patriot),8,7-1,144,88,232,0.621,03/23/2024,2024.0
4,Villanova (Big East),8,5-3,133,82,215,0.619,03/23/2024,2024.0
5,Yale (Ivy League),6,4-2,123,76,199,0.618,03/23/2024,2024.0
6,Syracuse (ACC),11,9-2,188,117,305,0.616,03/23/2024,2024.0
7,NJIT (America East),9,7-2,146,92,238,0.613,03/23/2024,2024.0
8,Hobart (Atlantic 10),8,3-5,136,91,227,0.599,03/23/2024,2024.0
9,Denver (Big East),7,6-1,112,76,188,0.596,03/23/2024,2024.0
10,Michigan (Big Ten),9,6-3,153,107,260,0.588,03/23/2024,2024.0
11,Ohio St. (Big Ten),9,5-4,124,90,214,0.579,03/23/2024,2024.0
12,Duke (ACC),10,8-2,165,120,285,0.579,03/23/2024,2024.0
13,Maryland (Big Ten),8,5-3,121,90,211,0.573,03/23/2024,2024.0
14,Navy (Patriot),9,5-4,131,98,229,0.572,03/23/2024,2024.0
15,UAlbany (America East),8,3-5,124,93,217,0.571,03/23/2024,2024.0
16,Marquette (Big East),9,4-5,127,98,225,0.564,03/23/2024,2024.0
17,Georgetown (Big East),8,6-2,116,90,206,0.563,03/23/2024,2024.0
18,Rutgers (Big Ten),8,6-2,117,92,209,0.560,03/23/2024,2024.0
19,Hofstra (CAA),8,3-5,128,101,229,0.559,03/23/2024,2024.0
20,Towson (CAA),9,6-3,130,105,235,0.553,03/23/2024,2024.0
21,High Point (Atlantic 10),10,6-4,164,133,297,0.552,03/23/2024,2024.0
22,Notre Dame (ACC),6,5-1,93,76,169,0.550,03/23/2024,2024.0
23,Mercer (ASUN),8,2-6,106,89,195,0.544,03/23/2024,2024.0
24,Sacred Heart (MAAC),9,5-4,131,110,241,0.544,03/23/2024,2024.0
25,VMI (MAAC),9,4-5,141,121,262,0.538,03/23/2024,2024.0
26,Virginia (ACC),9,8-1,138,121,259,0.533,03/23/2024,2024.0
27,UMass Lowell (America East),7,0-7,91,80,171,0.532,03/23/2024,2024.0
28,LIU (MAAC),7,6-1,90,81,171,0.526,03/23/2024,2024.0
29,Dartmouth (Ivy League),8,3-5,112,104,216,0.519,03/23/2024,2024.0
30,UMBC (America East),6,3-3,80,75,155,0.516,03/23/2024,2024.0
31,Richmond (Atlantic 10),9,5-4,122,115,237,0.515,03/23/2024,2024.0
32,Brown (Ivy League),7,1-6,90,85,175,0.514,03/23/2024,2024.0
33,Robert Morris (ASUN),7,2-5,85,81,166,0.512,03/23/2024,2024.0
34,Binghamton (America East),8,3-5,112,107,219,0.511,03/23/2024,2024.0
35,Lafayette (Patriot),8,4-4,115,110,225,0.511,03/23/2024,2024.0
36,Drexel (CAA),8,3-5,101,98,199,0.508,03/23/2024,2024.0
37,Delaware (CAA),6,3-3,75,73,148,0.507,03/23/2024,2024.0
38,Vermont (America East),9,3-6,128,125,253,0.506,03/23/2024,2024.0
39,Bellarmine (ASUN),10,6-4,122,124,246,0.496,03/23/2024,2024.0
40,Johns Hopkins (Big Ten),8,5-3,103,105,208,0.495,03/23/2024,2024.0
41,Princeton (Ivy League),8,5-3,105,111,216,0.486,03/23/2024,2024.0
42,St. John's (NY) (Big East),10,3-7,124,134,258,0.481,03/23/2024,2024.0
43,Cornell (Ivy League),7,5-2,112,122,234,0.479,03/23/2024,2024.0
44,Jacksonville (ASUN),8,5-3,82,91,173,0.474,03/23/2024,2024.0
45,Massachusetts (Atlantic 10),8,4-4,99,110,209,0.474,03/23/2024,2024.0
46,Penn St. (Big Ten),7,6-1,94,105,199,0.472,03/23/2024,2024.0
47,Marist (MAAC),8,4-4,101,114,215,0.470,03/23/2024,2024.0
48,Stony Brook (CAA),9,3-6,118,135,253,0.466,03/23/2024,2024.0
49,Saint Joseph's (Atlantic 10),8,5-3,99,114,213,0.465,03/23/2024,2024.0
50,Bucknell (Patriot),9,2-7,110,127,237,0.464,03/23/2024,2024.0
51,Quinnipiac (MAAC),7,7-0,86,104,190,0.453,03/23/2024,2024.0
52,Canisius (MAAC),9,2-7,99,120,219,0.452,03/23/2024,2024.0
53,Lehigh (Patriot),8,4-4,94,114,208,0.452,03/23/2024,2024.0
54,Monmouth (CAA),8,4-4,92,114,206,0.447,03/23/2024,2024.0
55,Fairfield (CAA),9,4-5,104,130,234,0.444,03/23/2024,2024.0
56,Providence (Big East),9,4-5,115,144,259,0.444,03/23/2024,2024.0
57,Air Force (ASUN),8,4-4,87,109,196,0.444,03/23/2024,2024.0
58,Boston U. (Patriot),8,6-2,94,119,213,0.441,03/23/2024,2024.0
59,Harvard (Ivy League),8,6-2,104,134,238,0.437,03/23/2024,2024.0
60,Utah (ASUN),8,4-4,98,127,225,0.436,03/23/2024,2024.0
61,Cleveland St. (ASUN),7,4-3,77,100,177,0.435,03/23/2024,2024.0
62,Penn (Ivy League),9,6-3,92,123,215,0.428,03/23/2024,2024.0
63,Loyola Maryland (Patriot),9,3-6,98,134,232,0.422,03/23/2024,2024.0
64,Wagner (MAAC),9,1-8,90,128,218,0.413,03/23/2024,2024.0
65,Colgate (Patriot),9,6-3,107,153,260,0.412,03/23/2024,2024.0
66,Siena (MAAC),8,3-5,89,128,217,0.410,03/23/2024,2024.0
67,St. Bonaventure (Atlantic 10),7,1-6,70,102,172,0.407,03/23/2024,2024.0
68,Merrimack (America East),9,3-6,95,149,244,0.389,03/23/2024,2024.0
69,Mount St. Mary's (MAAC),9,1-8,84,137,221,0.380,03/23/2024,2024.0
70,Holy Cross (Patriot),8,2-6,79,129,208,0.380,03/23/2024,2024.0
71,Manhattan (MAAC),8,2-6,67,125,192,0.349,03/23/2024,2024.0
72,Hampton (CAA),7,0-7,60,148,208,0.288,03/23/2024,2024.0
73,Detroit Mercy (ASUN),7,0-7,58,152,210,0.276,03/23/2024,2024.0
-,Le Moyne (NEC),7,2-5,84,84,168,0.500,03/23/2024,2024.0
-,Queens (NC) (ASUN),7,2-5,75,88,163,0.460,03/23/2024,2024.0
-,Lindenwood (ASUN),6,0-6,55,73,128,0.430,03/23/2024,2024.0
1,North Carolina (ACC),8,6-2,146,68,214,0.682,03/22/2024,2024.0
2,Bryant (America East),7,4-3,126,61,187,0.674,03/22/2024,2024.0
3,Syracuse (ACC),10,8-2,175,106,281,0.623,03/22/2024,2024.0
4,Yale (Ivy League),5,4-1,102,62,164,0.622,03/22/2024,2024.0
5,Army West Point (Patriot),8,7-1,144,88,232,0.621,03/22/2024,2024.0
6,Villanova (Big East),8,5-3,133,82,215,0.619,03/22/2024,2024.0
7,Hobart (Atlantic 10),7,3-4,125,78,203,0.616,03/22/2024,2024.0
8,NJIT (America East),8,7-1,123,82,205,0.600,03/22/2024,2024.0
9,Maryland (Big Ten),7,5-2,110,74,184,0.598,03/22/2024,2024.0
10,Denver (Big East),7,6-1,112,76,188,0.596,03/22/2024,2024.0
11,Michigan (Big Ten),8,5-3,137,96,233,0.588,03/22/2024,2024.0
12,Ohio St. (Big Ten),9,5-4,124,90,214,0.579,03/22/2024,2024.0
13,Duke (ACC),10,8-2,165,120,285,0.579,03/22/2024,2024.0
14,Georgetown (Big East),7,5-2,102,78,180,0.567,03/22/2024,2024.0
15,VMI (MAAC),8,4-4,132,101,233,0.567,03/22/2024,2024.0
16,Navy (Patriot),8,4-4,113,88,201,0.562,03/22/2024,2024.0
17,Rutgers (Big Ten),8,6-2,117,92,209,0.560,03/22/2024,2024.0
17,Towson (CAA),8,5-3,117,92,209,0.560,03/22/2024,2024.0
19,Hofstra (CAA),8,3-5,128,101,229,0.559,03/22/2024,2024.0
20,UAlbany (America East),7,2-5,105,85,190,0.553,03/22/2024,2024.0
21,Mercer (ASUN),7,2-5,97,79,176,0.551,03/22/2024,2024.0
22,Notre Dame (ACC),6,5-1,93,76,169,0.550,03/22/2024,2024.0
23,Marquette (Big East),8,3-5,116,95,211,0.550,03/22/2024,2024.0
24,Binghamton (America East),7,2-5,102,84,186,0.548,03/22/2024,2024.0
25,High Point (Atlantic 10),9,5-4,148,122,270,0.548,03/22/2024,2024.0
26,LIU (MAAC),6,5-1,78,66,144,0.542,03/22/2024,2024.0
27,Virginia (ACC),8,7-1,127,111,238,0.534,03/22/2024,2024.0
28,Vermont (America East),8,3-5,120,106,226,0.531,03/22/2024,2024.0
29,UMass Lowell (America East),6,0-6,78,70,148,0.527,03/22/2024,2024.0
30,Sacred Heart (MAAC),8,4-4,111,101,212,0.524,03/22/2024,2024.0
31,Richmond (Atlantic 10),8,5-3,110,101,211,0.521,03/22/2024,2024.0
32,Dartmouth (Ivy League),7,3-4,101,93,194,0.521,03/22/2024,2024.0
32,Lafayette (Patriot),7,4-3,101,93,194,0.521,03/22/2024,2024.0
34,Brown (Ivy League),7,1-6,90,85,175,0.514,03/22/2024,2024.0
35,Robert Morris (ASUN),7,2-5,85,81,166,0.512,03/22/2024,2024.0
36,Drexel (CAA),7,3-4,91,87,178,0.511,03/22/2024,2024.0
37,Delaware (CAA),6,3-3,75,73,148,0.507,03/22/2024,2024.0
38,Johns Hopkins (Big Ten),8,5-3,103,105,208,0.495,03/22/2024,2024.0
39,Cornell (Ivy League),6,4-2,98,101,199,0.492,03/22/2024,2024.0
40,Bucknell (Patriot),8,2-6,104,112,216,0.481,03/22/2024,2024.0
41,Bellarmine (ASUN),9,5-4,108,117,225,0.480,03/22/2024,2024.0
42,St. John's (NY) (Big East),9,2-7,114,124,238,0.479,03/22/2024,2024.0
43,Massachusetts (Atlantic 10),8,4-4,99,110,209,0.474,03/22/2024,2024.0
44,Penn St. (Big Ten),7,6-1,94,105,199,0.472,03/22/2024,2024.0
45,Providence (Big East),8,4-4,108,122,230,0.470,03/22/2024,2024.0
46,Jacksonville (ASUN),7,4-3,72,82,154,0.468,03/22/2024,2024.0
47,Stony Brook (CAA),8,3-5,108,125,233,0.464,03/22/2024,2024.0
48,UMBC (America East),5,2-3,59,69,128,0.461,03/22/2024,2024.0
49,Marist (MAAC),7,4-3,86,102,188,0.457,03/22/2024,2024.0
50,Harvard (Ivy League),7,6-1,95,114,209,0.455,03/22/2024,2024.0
50,Princeton (Ivy League),7,4-3,85,102,187,0.455,03/22/2024,2024.0
52,Quinnipiac (MAAC),6,6-0,74,89,163,0.454,03/22/2024,2024.0
53,Air Force (ASUN),7,3-4,77,97,174,0.443,03/22/2024,2024.0
54,Boston U. (Patriot),8,6-2,94,119,213,0.441,03/22/2024,2024.0
55,Monmouth (CAA),7,3-4,82,104,186,0.441,03/22/2024,2024.0
56,Fairfield (CAA),8,4-4,91,117,208,0.438,03/22/2024,2024.0
57,Cleveland St. (ASUN),7,4-3,77,100,177,0.435,03/22/2024,2024.0
58,St. Bonaventure (Atlantic 10),6,1-5,67,91,158,0.424,03/22/2024,2024.0
59,Lehigh (Patriot),7,3-4,79,108,187,0.422,03/22/2024,2024.0
60,Penn (Ivy League),8,5-3,81,112,193,0.420,03/22/2024,2024.0
61,Saint Joseph's (Atlantic 10),7,4-3,77,107,184,0.418,03/22/2024,2024.0
62,Canisius (MAAC),8,2-6,83,116,199,0.417,03/22/2024,2024.0
63,Colgate (Patriot),9,6-3,107,153,260,0.412,03/22/2024,2024.0
64,Merrimack (America East),8,3-5,89,128,217,0.410,03/22/2024,2024.0
65,Wagner (MAAC),8,1-7,81,118,199,0.407,03/22/2024,2024.0
66,Loyola Maryland (Patriot),8,2-6,81,120,201,0.403,03/22/2024,2024.0
67,Utah (ASUN),7,3-4,75,116,191,0.393,03/22/2024,2024.0
68,Siena (MAAC),7,3-4,74,116,190,0.389,03/22/2024,2024.0
69,Holy Cross (Patriot),7,2-5,69,111,180,0.383,03/22/2024,2024.0
70,Mount St. Mary's (MAAC),8,0-8,74,128,202,0.366,03/22/2024,2024.0
71,Manhattan (MAAC),7,1-6,63,109,172,0.366,03/22/2024,2024.0
72,Hampton (CAA),7,0-7,60,148,208,0.288,03/22/2024,2024.0
73,Detroit Mercy (ASUN),6,0-6,47,129,176,0.267,03/22/2024,2024.0
-,Le Moyne (NEC),6,2-4,74,74,148,0.500,03/22/2024,2024.0
-,Queens (NC) (ASUN),6,2-4,68,74,142,0.479,03/22/2024,2024.0
-,Lindenwood (ASUN),5,0-5,43,63,106,0.406,03/22/2024,2024.0
1,North Carolina (ACC),8,6-2,146,68,214,0.682,03/20/2024,2024.0
2,Bryant (America East),7,4-3,126,61,187,0.674,03/20/2024,2024.0
3,Syracuse (ACC),10,8-2,175,106,281,0.623,03/20/2024,2024.0
4,Yale (Ivy League),5,4-1,102,62,164,0.622,03/20/2024,2024.0
5,Villanova (Big East),8,5-3,133,82,215,0.619,03/20/2024,2024.0
6,Army West Point (Patriot),7,7-0,127,79,206,0.617,03/20/2024,2024.0
7,Hobart (Atlantic 10),7,3-4,125,78,203,0.616,03/20/2024,2024.0
8,NJIT (America East),8,7-1,123,82,205,0.600,03/20/2024,2024.0
9,Maryland (Big Ten),7,5-2,110,74,184,0.598,03/20/2024,2024.0
10,Denver (Big East),7,6-1,112,76,188,0.596,03/20/2024,2024.0
11,Michigan (Big Ten),8,5-3,137,96,233,0.588,03/20/2024,2024.0
12,Ohio St. (Big Ten),9,5-4,124,90,214,0.579,03/20/2024,2024.0
13,Duke (ACC),10,8-2,165,120,285,0.579,03/20/2024,2024.0
14,Georgetown (Big East),7,5-2,102,78,180,0.567,03/20/2024,2024.0
15,VMI (MAAC),8,4-4,132,101,233,0.567,03/20/2024,2024.0
16,Navy (Patriot),8,4-4,113,88,201,0.562,03/20/2024,2024.0
17,Rutgers (Big Ten),8,6-2,117,92,209,0.560,03/20/2024,2024.0
17,Towson (CAA),8,5-3,117,92,209,0.560,03/20/2024,2024.0
19,Hofstra (CAA),8,3-5,128,101,229,0.559,03/20/2024,2024.0
20,UAlbany (America East),7,2-5,105,85,190,0.553,03/20/2024,2024.0
21,Mercer (ASUN),7,2-5,97,79,176,0.551,03/20/2024,2024.0
22,Notre Dame (ACC),6,5-1,93,76,169,0.550,03/20/2024,2024.0
23,Marquette (Big East),8,3-5,116,95,211,0.550,03/20/2024,2024.0
24,Binghamton (America East),7,2-5,102,84,186,0.548,03/20/2024,2024.0
25,High Point (Atlantic 10),9,5-4,148,122,270,0.548,03/20/2024,2024.0
26,LIU (MAAC),6,5-1,78,66,144,0.542,03/20/2024,2024.0
27,Virginia (ACC),8,7-1,127,111,238,0.534,03/20/2024,2024.0
28,Vermont (America East),8,3-5,120,106,226,0.531,03/20/2024,2024.0
29,UMass Lowell (America East),6,0-6,78,70,148,0.527,03/20/2024,2024.0
30,Sacred Heart (MAAC),8,4-4,111,101,212,0.524,03/20/2024,2024.0
31,Richmond (Atlantic 10),8,5-3,110,101,211,0.521,03/20/2024,2024.0
32,Dartmouth (Ivy League),7,3-4,101,93,194,0.521,03/20/2024,2024.0
32,Lafayette (Patriot),7,4-3,101,93,194,0.521,03/20/2024,2024.0
34,Brown (Ivy League),6,0-6,78,74,152,0.513,03/20/2024,2024.0
35,Robert Morris (ASUN),7,2-5,85,81,166,0.512,03/20/2024,2024.0
36,Drexel (CAA),7,3-4,91,87,178,0.511,03/20/2024,2024.0
37,Delaware (CAA),6,3-3,75,73,148,0.507,03/20/2024,2024.0
38,Johns Hopkins (Big Ten),8,5-3,103,105,208,0.495,03/20/2024,2024.0
39,Cornell (Ivy League),6,4-2,98,101,199,0.492,03/20/2024,2024.0
40,Bucknell (Patriot),8,2-6,104,112,216,0.481,03/20/2024,2024.0
41,Bellarmine (ASUN),9,5-4,108,117,225,0.480,03/20/2024,2024.0
42,St. John's (NY) (Big East),9,2-7,114,124,238,0.479,03/20/2024,2024.0
43,Massachusetts (Atlantic 10),7,4-3,88,98,186,0.473,03/20/2024,2024.0
44,Penn St. (Big Ten),7,6-1,94,105,199,0.472,03/20/2024,2024.0
45,Providence (Big East),8,4-4,108,122,230,0.470,03/20/2024,2024.0
46,Jacksonville (ASUN),7,4-3,72,82,154,0.468,03/20/2024,2024.0
47,Stony Brook (CAA),8,3-5,108,125,233,0.464,03/20/2024,2024.0
48,UMBC (America East),5,2-3,59,69,128,0.461,03/20/2024,2024.0
49,Marist (MAAC),7,4-3,86,102,188,0.457,03/20/2024,2024.0
50,Harvard (Ivy League),7,6-1,95,114,209,0.455,03/20/2024,2024.0
50,Boston U. (Patriot),7,5-2,85,102,187,0.455,03/20/2024,2024.0
50,Princeton (Ivy League),7,4-3,85,102,187,0.455,03/20/2024,2024.0
53,Quinnipiac (MAAC),6,6-0,74,89,163,0.454,03/20/2024,2024.0
54,Air Force (ASUN),7,3-4,77,97,174,0.443,03/20/2024,2024.0
55,Monmouth (CAA),7,3-4,82,104,186,0.441,03/20/2024,2024.0
56,Fairfield (CAA),8,4-4,91,117,208,0.438,03/20/2024,2024.0
57,Cleveland St. (ASUN),7,4-3,77,100,177,0.435,03/20/2024,2024.0
58,St. Bonaventure (Atlantic 10),6,1-5,67,91,158,0.424,03/20/2024,2024.0
59,Lehigh (Patriot),7,3-4,79,108,187,0.422,03/20/2024,2024.0
60,Penn (Ivy League),8,5-3,81,112,193,0.420,03/20/2024,2024.0
61,Saint Joseph's (Atlantic 10),7,4-3,77,107,184,0.418,03/20/2024,2024.0
62,Canisius (MAAC),8,2-6,83,116,199,0.417,03/20/2024,2024.0
63,Colgate (Patriot),9,6-3,107,153,260,0.412,03/20/2024,2024.0
64,Merrimack (America East),8,3-5,89,128,217,0.410,03/20/2024,2024.0
65,Wagner (MAAC),8,1-7,81,118,199,0.407,03/20/2024,2024.0
66,Loyola Maryland (Patriot),8,2-6,81,120,201,0.403,03/20/2024,2024.0
67,Utah (ASUN),7,3-4,75,116,191,0.393,03/20/2024,2024.0
68,Siena (MAAC),7,3-4,74,116,190,0.389,03/20/2024,2024.0
69,Holy Cross (Patriot),7,2-5,69,111,180,0.383,03/20/2024,2024.0
70,Mount St. Mary's (MAAC),8,0-8,74,128,202,0.366,03/20/2024,2024.0
71,Manhattan (MAAC),7,1-6,63,109,172,0.366,03/20/2024,2024.0
72,Hampton (CAA),7,0-7,60,148,208,0.288,03/20/2024,2024.0
73,Detroit Mercy (ASUN),6,0-6,47,129,176,0.267,03/20/2024,2024.0
-,Le Moyne (NEC),6,2-4,74,74,148,0.500,03/20/2024,2024.0
-,Queens (NC) (ASUN),6,2-4,68,74,142,0.479,03/20/2024,2024.0
-,Lindenwood (ASUN),5,0-5,43,63,106,0.406,03/20/2024,2024.0
1,North Carolina (ACC),8,6-2,146,68,214,0.682,03/19/2024,2024.0
2,Bryant (America East),7,4-3,126,61,187,0.674,03/19/2024,2024.0
3,Syracuse (ACC),9,7-2,169,95,264,0.640,03/19/2024,2024.0
4,Yale (Ivy League),5,4-1,102,62,164,0.622,03/19/2024,2024.0
5,Villanova (Big East),8,5-3,133,82,215,0.619,03/19/2024,2024.0
6,Hobart (Atlantic 10),7,3-4,125,78,203,0.616,03/19/2024,2024.0
7,Army West Point (Patriot),7,7-0,126,80,206,0.612,03/19/2024,2024.0
8,NJIT (America East),8,7-1,123,82,205,0.600,03/19/2024,2024.0
9,Maryland (Big Ten),7,5-2,110,74,184,0.598,03/19/2024,2024.0
10,Denver (Big East),7,6-1,112,76,188,0.596,03/19/2024,2024.0
11,Michigan (Big Ten),8,5-3,137,96,233,0.588,03/19/2024,2024.0
12,Ohio St. (Big Ten),9,5-4,124,90,214,0.579,03/19/2024,2024.0
13,Duke (ACC),9,8-1,154,114,268,0.575,03/19/2024,2024.0
14,Georgetown (Big East),7,5-2,102,78,180,0.567,03/19/2024,2024.0
15,VMI (MAAC),8,4-4,132,101,233,0.567,03/19/2024,2024.0
16,Navy (Patriot),8,4-4,113,88,201,0.562,03/19/2024,2024.0
17,Rutgers (Big Ten),8,6-2,117,92,209,0.560,03/19/2024,2024.0
17,Towson (CAA),8,5-3,117,92,209,0.560,03/19/2024,2024.0
19,Hofstra (CAA),8,3-5,128,101,229,0.559,03/19/2024,2024.0
20,Mercer (ASUN),6,2-4,82,65,147,0.558,03/19/2024,2024.0
21,UAlbany (America East),7,2-5,105,85,190,0.553,03/19/2024,2024.0
22,Notre Dame (ACC),6,5-1,93,76,169,0.550,03/19/2024,2024.0
23,Marquette (Big East),8,3-5,116,95,211,0.550,03/19/2024,2024.0
24,Binghamton (America East),7,2-5,102,84,186,0.548,03/19/2024,2024.0
25,High Point (Atlantic 10),9,5-4,148,122,270,0.548,03/19/2024,2024.0
26,LIU (MAAC),6,5-1,78,66,144,0.542,03/19/2024,2024.0
27,Virginia (ACC),8,7-1,127,111,238,0.534,03/19/2024,2024.0
28,Vermont (America East),8,3-5,120,106,226,0.531,03/19/2024,2024.0
29,UMass Lowell (America East),6,0-6,78,70,148,0.527,03/19/2024,2024.0
30,Sacred Heart (MAAC),8,4-4,111,101,212,0.524,03/19/2024,2024.0
31,Richmond (Atlantic 10),8,5-3,110,101,211,0.521,03/19/2024,2024.0
32,Dartmouth (Ivy League),7,3-4,101,93,194,0.521,03/19/2024,2024.0
32,Lafayette (Patriot),7,4-3,101,93,194,0.521,03/19/2024,2024.0
34,Brown (Ivy League),6,0-6,78,74,152,0.513,03/19/2024,2024.0
35,Drexel (CAA),7,3-4,91,87,178,0.511,03/19/2024,2024.0
36,Delaware (CAA),6,3-3,75,73,148,0.507,03/19/2024,2024.0
37,Johns Hopkins (Big Ten),8,5-3,103,105,208,0.495,03/19/2024,2024.0
38,Cornell (Ivy League),6,4-2,98,101,199,0.492,03/19/2024,2024.0
39,Bucknell (Patriot),8,2-6,104,112,216,0.481,03/19/2024,2024.0
40,Bellarmine (ASUN),8,4-4,94,102,196,0.480,03/19/2024,2024.0
41,St. John's (NY) (Big East),9,2-7,114,124,238,0.479,03/19/2024,2024.0
42,Massachusetts (Atlantic 10),7,4-3,88,98,186,0.473,03/19/2024,2024.0
43,Penn St. (Big Ten),7,6-1,94,105,199,0.472,03/19/2024,2024.0
44,Providence (Big East),8,4-4,108,122,230,0.470,03/19/2024,2024.0
45,Jacksonville (ASUN),7,4-3,72,82,154,0.468,03/19/2024,2024.0
46,Stony Brook (CAA),8,3-5,108,125,233,0.464,03/19/2024,2024.0
47,UMBC (America East),5,2-3,59,69,128,0.461,03/19/2024,2024.0
48,Marist (MAAC),7,4-3,86,102,188,0.457,03/19/2024,2024.0
49,Harvard (Ivy League),7,6-1,95,114,209,0.455,03/19/2024,2024.0
49,Boston U. (Patriot),7,5-2,85,102,187,0.455,03/19/2024,2024.0
49,Princeton (Ivy League),7,4-3,85,102,187,0.455,03/19/2024,2024.0
52,Quinnipiac (MAAC),6,6-0,74,89,163,0.454,03/19/2024,2024.0
53,Robert Morris (ASUN),6,1-5,62,77,139,0.446,03/19/2024,2024.0
54,Air Force (ASUN),6,2-4,66,82,148,0.446,03/19/2024,2024.0
55,Monmouth (CAA),7,3-4,82,104,186,0.441,03/19/2024,2024.0
56,Fairfield (CAA),8,4-4,91,117,208,0.438,03/19/2024,2024.0
57,Cleveland St. (ASUN),7,4-3,77,100,177,0.435,03/19/2024,2024.0
58,Lehigh (Patriot),7,3-4,80,107,187,0.428,03/19/2024,2024.0
59,St. Bonaventure (Atlantic 10),6,1-5,67,91,158,0.424,03/19/2024,2024.0
60,Penn (Ivy League),8,5-3,81,112,193,0.420,03/19/2024,2024.0
61,Saint Joseph's (Atlantic 10),7,4-3,77,107,184,0.418,03/19/2024,2024.0
62,Canisius (MAAC),8,2-6,83,116,199,0.417,03/19/2024,2024.0
63,Colgate (Patriot),9,6-3,107,153,260,0.412,03/19/2024,2024.0
64,Merrimack (America East),8,3-5,89,128,217,0.410,03/19/2024,2024.0
65,Wagner (MAAC),8,1-7,81,118,199,0.407,03/19/2024,2024.0
66,Loyola Maryland (Patriot),8,2-6,81,120,201,0.403,03/19/2024,2024.0
67,Siena (MAAC),7,3-4,74,116,190,0.389,03/19/2024,2024.0
68,Holy Cross (Patriot),7,2-5,69,111,180,0.383,03/19/2024,2024.0
69,Mount St. Mary's (MAAC),8,0-8,74,128,202,0.366,03/19/2024,2024.0
70,Manhattan (MAAC),7,1-6,63,109,172,0.366,03/19/2024,2024.0
71,Utah (ASUN),6,3-3,60,105,165,0.364,03/19/2024,2024.0
72,Detroit Mercy (ASUN),5,0-5,43,106,149,0.289,03/19/2024,2024.0
73,Hampton (CAA),7,0-7,60,148,208,0.288,03/19/2024,2024.0
-,Le Moyne (NEC),6,2-4,74,74,148,0.500,03/19/2024,2024.0
-,Queens (NC) (ASUN),5,1-4,61,68,129,0.473,03/19/2024,2024.0
-,Lindenwood (ASUN),4,0-4,37,56,93,0.398,03/19/2024,2024.0
1,North Carolina (ACC),8,6-2,146,68,214,0.682,03/17/2024,2024.0
2,Bryant (America East),7,4-3,126,61,187,0.674,03/17/2024,2024.0
3,Syracuse (ACC),9,7-2,169,95,264,0.640,03/17/2024,2024.0
4,Yale (Ivy League),5,4-1,102,62,164,0.622,03/17/2024,2024.0
5,Villanova (Big East),7,4-3,118,73,191,0.618,03/17/2024,2024.0
6,Hobart (Atlantic 10),7,3-4,125,78,203,0.616,03/17/2024,2024.0
7,Army West Point (Patriot),7,7-0,126,80,206,0.612,03/17/2024,2024.0
8,NJIT (America East),8,7-1,123,82,205,0.600,03/17/2024,2024.0
9,Maryland (Big Ten),7,5-2,110,74,184,0.598,03/17/2024,2024.0
10,Denver (Big East),7,6-1,112,76,188,0.596,03/17/2024,2024.0
11,Michigan (Big Ten),8,5-3,137,96,233,0.588,03/17/2024,2024.0
12,Navy (Patriot),7,4-3,104,73,177,0.588,03/17/2024,2024.0
13,UAlbany (America East),6,2-4,93,67,160,0.581,03/17/2024,2024.0
14,Ohio St. (Big Ten),9,5-4,124,90,214,0.579,03/17/2024,2024.0
15,Duke (ACC),9,8-1,154,114,268,0.575,03/17/2024,2024.0
16,VMI (MAAC),8,4-4,132,101,233,0.567,03/17/2024,2024.0
17,Towson (CAA),8,5-3,117,92,209,0.560,03/17/2024,2024.0
18,Hofstra (CAA),8,3-5,128,101,229,0.559,03/17/2024,2024.0
19,Mercer (ASUN),6,2-4,82,65,147,0.558,03/17/2024,2024.0
20,Rutgers (Big Ten),8,6-2,116,92,208,0.558,03/17/2024,2024.0
21,Georgetown (Big East),6,4-2,81,65,146,0.555,03/17/2024,2024.0
22,Notre Dame (ACC),6,5-1,93,76,169,0.550,03/17/2024,2024.0
23,Dartmouth (Ivy League),6,3-3,88,72,160,0.550,03/17/2024,2024.0
24,Marquette (Big East),8,3-5,116,95,211,0.550,03/17/2024,2024.0
25,Binghamton (America East),7,2-5,101,85,186,0.543,03/17/2024,2024.0
26,High Point (Atlantic 10),9,5-4,134,113,247,0.543,03/17/2024,2024.0
27,LIU (MAAC),6,5-1,78,66,144,0.542,03/17/2024,2024.0
28,Vermont (America East),8,3-5,120,106,226,0.531,03/17/2024,2024.0
29,UMass Lowell (America East),6,0-6,78,70,148,0.527,03/17/2024,2024.0
30,Virginia (ACC),7,6-1,109,99,208,0.524,03/17/2024,2024.0
31,Sacred Heart (MAAC),8,4-4,111,101,212,0.524,03/17/2024,2024.0
32,Richmond (Atlantic 10),8,5-3,110,101,211,0.521,03/17/2024,2024.0
33,Lafayette (Patriot),7,4-3,101,93,194,0.521,03/17/2024,2024.0
34,Brown (Ivy League),6,0-6,78,74,152,0.513,03/17/2024,2024.0
35,Drexel (CAA),7,3-4,91,87,178,0.511,03/17/2024,2024.0
36,Delaware (CAA),6,3-3,75,73,148,0.507,03/17/2024,2024.0
37,Johns Hopkins (Big Ten),8,5-3,103,105,208,0.495,03/17/2024,2024.0
38,Cornell (Ivy League),6,4-2,98,101,199,0.492,03/17/2024,2024.0
39,Jacksonville (ASUN),7,4-3,77,80,157,0.490,03/17/2024,2024.0
40,Bucknell (Patriot),8,2-6,104,112,216,0.481,03/17/2024,2024.0
41,Bellarmine (ASUN),8,4-4,94,102,196,0.480,03/17/2024,2024.0
42,St. John's (NY) (Big East),9,2-7,114,124,238,0.479,03/17/2024,2024.0
43,Massachusetts (Atlantic 10),7,4-3,88,97,185,0.476,03/17/2024,2024.0
44,Penn St. (Big Ten),7,6-1,94,105,199,0.472,03/17/2024,2024.0
45,Providence (Big East),8,4-4,108,122,230,0.470,03/17/2024,2024.0
46,Stony Brook (CAA),8,3-5,108,125,233,0.464,03/17/2024,2024.0
47,UMBC (America East),5,2-3,59,69,128,0.461,03/17/2024,2024.0
48,Marist (MAAC),7,4-3,86,102,188,0.457,03/17/2024,2024.0
49,Harvard (Ivy League),7,6-1,95,114,209,0.455,03/17/2024,2024.0
49,Boston U. (Patriot),7,5-2,85,102,187,0.455,03/17/2024,2024.0
49,Princeton (Ivy League),7,4-3,85,102,187,0.455,03/17/2024,2024.0
52,Quinnipiac (MAAC),6,6-0,74,89,163,0.454,03/17/2024,2024.0
53,Robert Morris (ASUN),6,1-5,74,91,165,0.448,03/17/2024,2024.0
54,Air Force (ASUN),6,2-4,66,82,148,0.446,03/17/2024,2024.0
55,Monmouth (CAA),7,3-4,82,104,186,0.441,03/17/2024,2024.0
56,Fairfield (CAA),8,4-4,91,117,208,0.438,03/17/2024,2024.0
57,Cleveland St. (ASUN),7,4-3,77,100,177,0.435,03/17/2024,2024.0
58,Lehigh (Patriot),7,3-4,80,107,187,0.428,03/17/2024,2024.0
59,St. Bonaventure (Atlantic 10),6,1-5,67,91,158,0.424,03/17/2024,2024.0
60,Penn (Ivy League),7,5-2,71,99,170,0.418,03/17/2024,2024.0
61,Canisius (MAAC),8,2-6,83,116,199,0.417,03/17/2024,2024.0
62,Merrimack (America East),8,3-5,90,127,217,0.415,03/17/2024,2024.0
63,Colgate (Patriot),9,6-3,107,153,260,0.412,03/17/2024,2024.0
64,Wagner (MAAC),8,1-7,81,118,199,0.407,03/17/2024,2024.0
65,Loyola Maryland (Patriot),8,2-6,81,120,201,0.403,03/17/2024,2024.0
66,Saint Joseph's (Atlantic 10),6,3-3,64,97,161,0.398,03/17/2024,2024.0
67,Siena (MAAC),7,3-4,74,116,190,0.389,03/17/2024,2024.0
68,Holy Cross (Patriot),7,2-5,69,111,180,0.383,03/17/2024,2024.0
69,Mount St. Mary's (MAAC),8,0-8,74,128,202,0.366,03/17/2024,2024.0
70,Manhattan (MAAC),7,1-6,63,109,172,0.366,03/17/2024,2024.0
71,Utah (ASUN),6,3-3,60,105,165,0.364,03/17/2024,2024.0
72,Detroit Mercy (ASUN),5,0-5,43,106,149,0.289,03/17/2024,2024.0
73,Hampton (CAA),7,0-7,60,148,208,0.288,03/17/2024,2024.0
-,Le Moyne (NEC),6,2-4,74,74,148,0.500,03/17/2024,2024.0
-,Queens (NC) (ASUN),5,1-4,61,68,129,0.473,03/17/2024,2024.0
-,Lindenwood (ASUN),4,0-4,37,56,93,0.398,03/17/2024,2024.0
1,Bryant (America East),6,4-2,109,50,159,0.686,03/14/2024,2024.0
2,North Carolina (ACC),7,5-2,128,62,190,0.674,03/14/2024,2024.0
3,Syracuse (ACC),8,6-2,155,86,241,0.643,03/14/2024,2024.0
4,Hobart (Atlantic 10),6,2-4,105,66,171,0.614,03/14/2024,2024.0
5,NJIT (America East),7,7-0,111,71,182,0.610,03/14/2024,2024.0
6,Michigan (Big Ten),7,5-2,122,79,201,0.607,03/14/2024,2024.0
7,Ohio St. (Big Ten),8,5-3,118,77,195,0.605,03/14/2024,2024.0
8,Yale (Ivy League),4,3-1,78,51,129,0.605,03/14/2024,2024.0
9,Maryland (Big Ten),6,5-1,94,62,156,0.603,03/14/2024,2024.0
10,Army West Point (Patriot),6,6-0,104,69,173,0.601,03/14/2024,2024.0
11,Villanova (Big East),6,3-3,99,66,165,0.600,03/14/2024,2024.0
12,Navy (Patriot),6,3-3,91,63,154,0.591,03/14/2024,2024.0
13,Duke (ACC),8,7-1,146,103,249,0.586,03/14/2024,2024.0
14,Denver (Big East),6,5-1,99,70,169,0.586,03/14/2024,2024.0
15,UMass Lowell (America East),5,0-5,68,50,118,0.576,03/14/2024,2024.0
16,VMI (MAAC),7,4-3,121,89,210,0.576,03/14/2024,2024.0
17,Hofstra (CAA),7,3-4,114,88,202,0.564,03/14/2024,2024.0
18,UAlbany (America East),5,1-4,73,57,130,0.562,03/14/2024,2024.0
19,Marquette (Big East),7,3-4,105,82,187,0.561,03/14/2024,2024.0
20,Towson (CAA),7,4-3,100,79,179,0.559,03/14/2024,2024.0
21,Binghamton (America East),6,2-4,91,73,164,0.555,03/14/2024,2024.0
22,Georgetown (Big East),6,4-2,81,65,146,0.555,03/14/2024,2024.0
23,Notre Dame (ACC),5,4-1,76,61,137,0.555,03/14/2024,2024.0
24,Rutgers (Big Ten),7,5-2,103,83,186,0.554,03/14/2024,2024.0
25,Dartmouth (Ivy League),6,3-3,88,72,160,0.550,03/14/2024,2024.0
26,High Point (Atlantic 10),9,5-4,134,113,247,0.543,03/14/2024,2024.0
27,Virginia (ACC),6,5-1,97,83,180,0.539,03/14/2024,2024.0
28,Vermont (America East),7,2-5,109,94,203,0.537,03/14/2024,2024.0
29,Delaware (CAA),5,3-2,66,59,125,0.528,03/14/2024,2024.0
30,Drexel (CAA),6,3-3,78,70,148,0.527,03/14/2024,2024.0
31,LIU (MAAC),5,4-1,64,58,122,0.525,03/14/2024,2024.0
32,Sacred Heart (MAAC),7,3-4,95,87,182,0.522,03/14/2024,2024.0
33,Richmond (Atlantic 10),7,5-2,99,93,192,0.516,03/14/2024,2024.0
34,Brown (Ivy League),5,0-5,66,64,130,0.508,03/14/2024,2024.0
35,Mercer (ASUN),5,1-4,58,57,115,0.504,03/14/2024,2024.0
36,Lafayette (Patriot),6,3-3,83,82,165,0.503,03/14/2024,2024.0
37,Cornell (Ivy League),5,3-2,84,83,167,0.503,03/14/2024,2024.0
38,Johns Hopkins (Big Ten),7,5-2,93,92,185,0.503,03/14/2024,2024.0
39,Massachusetts (Atlantic 10),6,4-2,79,84,163,0.485,03/14/2024,2024.0
40,Stony Brook (CAA),7,3-4,101,108,209,0.483,03/14/2024,2024.0
41,Harvard (Ivy League),6,6-0,84,90,174,0.483,03/14/2024,2024.0
42,Jacksonville (ASUN),6,3-3,63,68,131,0.481,03/14/2024,2024.0
43,UMBC (America East),4,1-3,48,52,100,0.480,03/14/2024,2024.0
44,Bucknell (Patriot),7,2-5,91,100,191,0.476,03/14/2024,2024.0
45,Bellarmine (ASUN),7,4-3,80,89,169,0.473,03/14/2024,2024.0
46,Providence (Big East),8,4-4,108,122,230,0.470,03/14/2024,2024.0
47,Monmouth (CAA),6,3-3,75,85,160,0.469,03/14/2024,2024.0
48,Boston U. (Patriot),6,4-2,75,87,162,0.463,03/14/2024,2024.0
49,Penn St. (Big Ten),6,5-1,81,94,175,0.463,03/14/2024,2024.0
50,St. John's (NY) (Big East),8,2-6,97,115,212,0.458,03/14/2024,2024.0
51,Lehigh (Patriot),6,3-3,69,85,154,0.448,03/14/2024,2024.0
52,Robert Morris (ASUN),5,1-4,62,77,139,0.446,03/14/2024,2024.0
53,Quinnipiac (MAAC),5,5-0,60,77,137,0.438,03/14/2024,2024.0
54,Marist (MAAC),6,3-3,66,85,151,0.437,03/14/2024,2024.0
55,Princeton (Ivy League),6,4-2,67,88,155,0.432,03/14/2024,2024.0
56,Fairfield (CAA),7,3-4,78,103,181,0.431,03/14/2024,2024.0
57,St. Bonaventure (Atlantic 10),6,1-5,67,91,158,0.424,03/14/2024,2024.0
58,Penn (Ivy League),6,4-2,61,87,148,0.412,03/14/2024,2024.0
59,Canisius (MAAC),7,2-5,66,96,162,0.407,03/14/2024,2024.0
59,Saint Joseph's (Atlantic 10),5,2-3,55,80,135,0.407,03/14/2024,2024.0
61,Air Force (ASUN),5,1-4,49,72,121,0.405,03/14/2024,2024.0
62,Wagner (MAAC),7,1-6,70,103,173,0.405,03/14/2024,2024.0
63,Colgate (Patriot),8,5-3,95,140,235,0.404,03/14/2024,2024.0
64,Merrimack (America East),7,2-5,78,117,195,0.400,03/14/2024,2024.0
65,Cleveland St. (ASUN),6,3-3,62,94,156,0.397,03/14/2024,2024.0
66,Holy Cross (Patriot),6,2-4,58,93,151,0.384,03/14/2024,2024.0
67,Loyola Maryland (Patriot),7,2-5,66,110,176,0.375,03/14/2024,2024.0
68,Siena (MAAC),6,2-4,62,105,167,0.371,03/14/2024,2024.0
69,Mount St. Mary's (MAAC),7,0-7,66,114,180,0.367,03/14/2024,2024.0
70,Manhattan (MAAC),6,1-5,49,93,142,0.345,03/14/2024,2024.0
71,Utah (ASUN),5,2-3,47,91,138,0.341,03/14/2024,2024.0
72,Detroit Mercy (ASUN),4,0-4,35,82,117,0.299,03/14/2024,2024.0
73,Hampton (CAA),7,0-7,60,148,208,0.288,03/14/2024,2024.0
-,Le Moyne (NEC),5,2-3,62,54,116,0.534,03/14/2024,2024.0
-,Queens (NC) (ASUN),4,1-3,51,51,102,0.500,03/14/2024,2024.0
-,Lindenwood (ASUN),3,0-3,31,41,72,0.431,03/14/2024,2024.0
1,Bryant (America East),6,4-2,109,50,159,0.686,03/13/2024,2024.0
2,North Carolina (ACC),7,5-2,128,62,190,0.674,03/13/2024,2024.0
3,Syracuse (ACC),8,6-2,155,86,241,0.643,03/13/2024,2024.0
4,Hobart (Atlantic 10),6,2-4,105,66,171,0.614,03/13/2024,2024.0
5,NJIT (America East),7,7-0,111,71,182,0.610,03/13/2024,2024.0
6,Michigan (Big Ten),7,5-2,122,79,201,0.607,03/13/2024,2024.0
7,Ohio St. (Big Ten),8,5-3,118,77,195,0.605,03/13/2024,2024.0
8,Yale (Ivy League),4,3-1,78,51,129,0.605,03/13/2024,2024.0
9,Maryland (Big Ten),6,5-1,94,62,156,0.603,03/13/2024,2024.0
10,Army West Point (Patriot),6,6-0,104,69,173,0.601,03/13/2024,2024.0
11,Villanova (Big East),6,3-3,99,66,165,0.600,03/13/2024,2024.0
12,Navy (Patriot),6,3-3,91,63,154,0.591,03/13/2024,2024.0
13,Duke (ACC),8,7-1,146,103,249,0.586,03/13/2024,2024.0
14,Denver (Big East),6,5-1,99,70,169,0.586,03/13/2024,2024.0
15,UMass Lowell (America East),5,0-5,68,50,118,0.576,03/13/2024,2024.0
16,VMI (MAAC),7,4-3,121,89,210,0.576,03/13/2024,2024.0
17,Hofstra (CAA),7,3-4,114,88,202,0.564,03/13/2024,2024.0
18,UAlbany (America East),5,1-4,73,57,130,0.562,03/13/2024,2024.0
19,Marquette (Big East),7,3-4,105,82,187,0.561,03/13/2024,2024.0
20,Towson (CAA),7,4-3,100,79,179,0.559,03/13/2024,2024.0
21,Binghamton (America East),6,2-4,91,73,164,0.555,03/13/2024,2024.0
22,Georgetown (Big East),6,4-2,81,65,146,0.555,03/13/2024,2024.0
23,Notre Dame (ACC),5,4-1,76,61,137,0.555,03/13/2024,2024.0
24,Rutgers (Big Ten),7,5-2,103,83,186,0.554,03/13/2024,2024.0
25,Vermont (America East),6,2-4,98,80,178,0.551,03/13/2024,2024.0
26,Dartmouth (Ivy League),5,2-3,74,61,135,0.548,03/13/2024,2024.0
27,High Point (Atlantic 10),9,5-4,134,113,247,0.543,03/13/2024,2024.0
28,Virginia (ACC),6,5-1,97,83,180,0.539,03/13/2024,2024.0
29,Delaware (CAA),5,3-2,66,59,125,0.528,03/13/2024,2024.0
30,Drexel (CAA),6,3-3,78,70,148,0.527,03/13/2024,2024.0
31,LIU (MAAC),5,4-1,64,58,122,0.525,03/13/2024,2024.0
32,Sacred Heart (MAAC),7,3-4,95,87,182,0.522,03/13/2024,2024.0
33,Richmond (Atlantic 10),7,5-2,99,93,192,0.516,03/13/2024,2024.0
34,Brown (Ivy League),5,0-5,66,64,130,0.508,03/13/2024,2024.0
35,Mercer (ASUN),5,1-4,58,57,115,0.504,03/13/2024,2024.0
36,Lafayette (Patriot),6,3-3,83,82,165,0.503,03/13/2024,2024.0
37,Cornell (Ivy League),5,3-2,84,83,167,0.503,03/13/2024,2024.0
38,Johns Hopkins (Big Ten),7,5-2,93,92,185,0.503,03/13/2024,2024.0
39,Massachusetts (Atlantic 10),6,4-2,79,84,163,0.485,03/13/2024,2024.0
40,Stony Brook (CAA),7,3-4,101,108,209,0.483,03/13/2024,2024.0
41,Harvard (Ivy League),6,6-0,84,90,174,0.483,03/13/2024,2024.0
42,Jacksonville (ASUN),6,3-3,63,68,131,0.481,03/13/2024,2024.0
43,UMBC (America East),4,1-3,48,52,100,0.480,03/13/2024,2024.0
44,Bucknell (Patriot),7,2-5,91,100,191,0.476,03/13/2024,2024.0
45,Bellarmine (ASUN),7,4-3,80,89,169,0.473,03/13/2024,2024.0
46,Providence (Big East),8,4-4,108,122,230,0.470,03/13/2024,2024.0
47,Monmouth (CAA),6,3-3,75,85,160,0.469,03/13/2024,2024.0
48,Boston U. (Patriot),6,4-2,75,87,162,0.463,03/13/2024,2024.0
49,Penn St. (Big Ten),6,5-1,81,94,175,0.463,03/13/2024,2024.0
50,St. John's (NY) (Big East),8,2-6,97,115,212,0.458,03/13/2024,2024.0
51,Lehigh (Patriot),6,3-3,69,85,154,0.448,03/13/2024,2024.0
52,Robert Morris (ASUN),5,1-4,62,77,139,0.446,03/13/2024,2024.0
53,Quinnipiac (MAAC),5,5-0,60,77,137,0.438,03/13/2024,2024.0
54,Marist (MAAC),6,3-3,66,85,151,0.437,03/13/2024,2024.0
55,Princeton (Ivy League),6,4-2,67,88,155,0.432,03/13/2024,2024.0
56,Fairfield (CAA),7,3-4,78,103,181,0.431,03/13/2024,2024.0
57,St. Bonaventure (Atlantic 10),6,1-5,67,91,158,0.424,03/13/2024,2024.0
58,Penn (Ivy League),6,4-2,61,87,148,0.412,03/13/2024,2024.0
59,Canisius (MAAC),7,2-5,66,96,162,0.407,03/13/2024,2024.0
59,Saint Joseph's (Atlantic 10),5,2-3,55,80,135,0.407,03/13/2024,2024.0
61,Air Force (ASUN),5,1-4,49,72,121,0.405,03/13/2024,2024.0
62,Wagner (MAAC),7,1-6,70,103,173,0.405,03/13/2024,2024.0
63,Colgate (Patriot),8,5-3,95,140,235,0.404,03/13/2024,2024.0
64,Merrimack (America East),7,2-5,78,117,195,0.400,03/13/2024,2024.0
65,Cleveland St. (ASUN),6,3-3,62,94,156,0.397,03/13/2024,2024.0
66,Holy Cross (Patriot),6,2-4,58,93,151,0.384,03/13/2024,2024.0
67,Loyola Maryland (Patriot),7,2-5,66,110,176,0.375,03/13/2024,2024.0
68,Siena (MAAC),6,2-4,62,105,167,0.371,03/13/2024,2024.0
69,Mount St. Mary's (MAAC),7,0-7,66,114,180,0.367,03/13/2024,2024.0
70,Manhattan (MAAC),6,1-5,49,93,142,0.345,03/13/2024,2024.0
71,Utah (ASUN),5,2-3,47,91,138,0.341,03/13/2024,2024.0
72,Detroit Mercy (ASUN),4,0-4,35,82,117,0.299,03/13/2024,2024.0
73,Hampton (CAA),7,0-7,60,148,208,0.288,03/13/2024,2024.0
-,Le Moyne (NEC),5,2-3,62,54,116,0.534,03/13/2024,2024.0
-,Queens (NC) (ASUN),4,1-3,51,51,102,0.500,03/13/2024,2024.0
-,Lindenwood (ASUN),3,0-3,31,41,72,0.431,03/13/2024,2024.0
1,Bryant (America East),6,4-2,109,50,159,0.686,03/12/2024,2024.0
2,North Carolina (ACC),7,5-2,128,62,190,0.674,03/12/2024,2024.0
3,Syracuse (ACC),8,6-2,155,86,241,0.643,03/12/2024,2024.0
4,Hobart (Atlantic 10),6,2-4,105,66,171,0.614,03/12/2024,2024.0
5,NJIT (America East),7,7-0,111,71,182,0.610,03/12/2024,2024.0
6,Michigan (Big Ten),7,5-2,122,79,201,0.607,03/12/2024,2024.0
7,Ohio St. (Big Ten),8,5-3,118,77,195,0.605,03/12/2024,2024.0
8,Yale (Ivy League),4,3-1,78,51,129,0.605,03/12/2024,2024.0
9,Maryland (Big Ten),6,5-1,94,62,156,0.603,03/12/2024,2024.0
10,Army West Point (Patriot),6,6-0,104,69,173,0.601,03/12/2024,2024.0
11,Villanova (Big East),6,3-3,99,66,165,0.600,03/12/2024,2024.0
12,Navy (Patriot),6,3-3,91,63,154,0.591,03/12/2024,2024.0
13,Duke (ACC),7,6-1,128,90,218,0.587,03/12/2024,2024.0
14,Denver (Big East),6,5-1,99,70,169,0.586,03/12/2024,2024.0
15,UMass Lowell (America East),5,0-5,68,50,118,0.576,03/12/2024,2024.0
16,VMI (MAAC),7,4-3,121,89,210,0.576,03/12/2024,2024.0
17,Hofstra (CAA),7,3-4,114,88,202,0.564,03/12/2024,2024.0
18,UAlbany (America East),5,1-4,73,57,130,0.562,03/12/2024,2024.0
19,Marquette (Big East),7,3-4,105,82,187,0.561,03/12/2024,2024.0
20,Towson (CAA),7,4-3,100,79,179,0.559,03/12/2024,2024.0
21,Binghamton (America East),6,2-4,91,73,164,0.555,03/12/2024,2024.0
22,Georgetown (Big East),6,4-2,81,65,146,0.555,03/12/2024,2024.0
23,Notre Dame (ACC),5,4-1,76,61,137,0.555,03/12/2024,2024.0
24,Rutgers (Big Ten),7,5-2,103,83,186,0.554,03/12/2024,2024.0
25,Vermont (America East),6,2-4,98,80,178,0.551,03/12/2024,2024.0
26,Dartmouth (Ivy League),5,2-3,74,61,135,0.548,03/12/2024,2024.0
27,High Point (Atlantic 10),10,6-4,134,113,247,0.543,03/12/2024,2024.0
28,Virginia (ACC),6,5-1,97,83,180,0.539,03/12/2024,2024.0
29,Delaware (CAA),5,3-2,66,59,125,0.528,03/12/2024,2024.0
30,Drexel (CAA),6,3-3,78,70,148,0.527,03/12/2024,2024.0
31,LIU (MAAC),5,4-1,64,58,122,0.525,03/12/2024,2024.0
32,Sacred Heart (MAAC),7,3-4,95,87,182,0.522,03/12/2024,2024.0
33,Richmond (Atlantic 10),7,5-2,99,93,192,0.516,03/12/2024,2024.0
34,Brown (Ivy League),5,0-5,66,64,130,0.508,03/12/2024,2024.0
35,Mercer (ASUN),5,1-4,58,57,115,0.504,03/12/2024,2024.0
36,Lafayette (Patriot),6,3-3,83,82,165,0.503,03/12/2024,2024.0
37,Cornell (Ivy League),5,3-2,84,83,167,0.503,03/12/2024,2024.0
38,Johns Hopkins (Big Ten),7,5-2,93,92,185,0.503,03/12/2024,2024.0
39,Massachusetts (Atlantic 10),6,4-2,79,84,163,0.485,03/12/2024,2024.0
40,Stony Brook (CAA),7,3-4,101,108,209,0.483,03/12/2024,2024.0
41,Harvard (Ivy League),6,6-0,84,90,174,0.483,03/12/2024,2024.0
42,Jacksonville (ASUN),6,3-3,63,68,131,0.481,03/12/2024,2024.0
43,UMBC (America East),4,1-3,48,52,100,0.480,03/12/2024,2024.0
44,Providence (Big East),7,4-3,95,104,199,0.477,03/12/2024,2024.0
45,Bucknell (Patriot),7,2-5,91,100,191,0.476,03/12/2024,2024.0
46,Bellarmine (ASUN),7,4-3,80,89,169,0.473,03/12/2024,2024.0
47,Monmouth (CAA),6,3-3,75,85,160,0.469,03/12/2024,2024.0
48,Boston U. (Patriot),6,4-2,75,87,162,0.463,03/12/2024,2024.0
49,Penn St. (Big Ten),6,5-1,81,94,175,0.463,03/12/2024,2024.0
50,St. John's (NY) (Big East),8,2-6,97,115,212,0.458,03/12/2024,2024.0
51,Lehigh (Patriot),6,3-3,69,85,154,0.448,03/12/2024,2024.0
52,Robert Morris (ASUN),5,1-4,62,77,139,0.446,03/12/2024,2024.0
53,Quinnipiac (MAAC),5,5-0,60,77,137,0.438,03/12/2024,2024.0
54,Marist (MAAC),6,3-3,66,85,151,0.437,03/12/2024,2024.0
55,Princeton (Ivy League),6,4-2,67,88,155,0.432,03/12/2024,2024.0
56,Fairfield (CAA),7,3-4,78,103,181,0.431,03/12/2024,2024.0
57,Canisius (MAAC),7,2-5,58,80,138,0.420,03/12/2024,2024.0
58,Penn (Ivy League),6,4-2,61,87,148,0.412,03/12/2024,2024.0
59,Saint Joseph's (Atlantic 10),5,2-3,55,80,135,0.407,03/12/2024,2024.0
60,Air Force (ASUN),5,1-4,49,72,121,0.405,03/12/2024,2024.0
61,Wagner (MAAC),7,1-6,70,103,173,0.405,03/12/2024,2024.0
62,Colgate (Patriot),8,5-3,95,140,235,0.404,03/12/2024,2024.0
63,Merrimack (America East),7,2-5,78,117,195,0.400,03/12/2024,2024.0
64,Cleveland St. (ASUN),6,3-3,62,94,156,0.397,03/12/2024,2024.0
65,Holy Cross (Patriot),6,2-4,58,93,151,0.384,03/12/2024,2024.0
66,St. Bonaventure (Atlantic 10),6,1-5,51,83,134,0.381,03/12/2024,2024.0
67,Loyola Maryland (Patriot),7,2-5,66,110,176,0.375,03/12/2024,2024.0
68,Siena (MAAC),6,2-4,62,105,167,0.371,03/12/2024,2024.0
69,Mount St. Mary's (MAAC),7,0-7,66,114,180,0.367,03/12/2024,2024.0
70,Manhattan (MAAC),6,1-5,49,93,142,0.345,03/12/2024,2024.0
71,Utah (ASUN),5,2-3,47,91,138,0.341,03/12/2024,2024.0
72,Detroit Mercy (ASUN),4,0-4,35,82,117,0.299,03/12/2024,2024.0
73,Hampton (CAA),8,0-8,60,148,208,0.288,03/12/2024,2024.0
-,Le Moyne (NEC),5,2-3,62,54,116,0.534,03/12/2024,2024.0
-,Queens (NC) (ASUN),4,1-3,51,51,102,0.500,03/12/2024,2024.0
-,Lindenwood (ASUN),3,0-3,31,41,72,0.431,03/12/2024,2024.0
1,Bryant (America East),6,4-2,109,50,159,0.686,03/10/2024,2024.0
2,North Carolina (ACC),6,4-2,108,57,165,0.655,03/10/2024,2024.0
3,Syracuse (ACC),8,6-2,155,86,241,0.643,03/10/2024,2024.0
4,Hobart (Atlantic 10),6,2-4,105,66,171,0.614,03/10/2024,2024.0
5,NJIT (America East),7,7-0,111,71,182,0.610,03/10/2024,2024.0
6,Yale (Ivy League),4,3-1,78,51,129,0.605,03/10/2024,2024.0
7,Maryland (Big Ten),6,5-1,94,62,156,0.603,03/10/2024,2024.0
8,Michigan (Big Ten),7,5-2,121,80,201,0.602,03/10/2024,2024.0
9,Army West Point (Patriot),6,6-0,104,69,173,0.601,03/10/2024,2024.0
10,Villanova (Big East),6,3-3,99,66,165,0.600,03/10/2024,2024.0
11,Navy (Patriot),6,3-3,91,63,154,0.591,03/10/2024,2024.0
12,Duke (ACC),7,6-1,128,90,218,0.587,03/10/2024,2024.0
13,Denver (Big East),6,5-1,99,70,169,0.586,03/10/2024,2024.0
14,UMass Lowell (America East),5,0-5,68,50,118,0.576,03/10/2024,2024.0
15,VMI (MAAC),7,4-3,121,89,210,0.576,03/10/2024,2024.0
16,Ohio St. (Big Ten),7,4-3,96,71,167,0.575,03/10/2024,2024.0
17,Hofstra (CAA),7,3-4,114,88,202,0.564,03/10/2024,2024.0
18,UAlbany (America East),5,1-4,73,57,130,0.562,03/10/2024,2024.0
19,Marquette (Big East),7,3-4,105,82,187,0.561,03/10/2024,2024.0
20,Towson (CAA),7,4-3,100,79,179,0.559,03/10/2024,2024.0
21,Binghamton (America East),6,2-4,91,73,164,0.555,03/10/2024,2024.0
22,Georgetown (Big East),6,4-2,81,65,146,0.555,03/10/2024,2024.0
23,Notre Dame (ACC),5,4-1,76,61,137,0.555,03/10/2024,2024.0
24,Rutgers (Big Ten),7,5-2,103,83,186,0.554,03/10/2024,2024.0
25,Vermont (America East),6,2-4,98,80,178,0.551,03/10/2024,2024.0
26,Dartmouth (Ivy League),5,2-3,74,61,135,0.548,03/10/2024,2024.0
27,High Point (Atlantic 10),8,4-4,116,96,212,0.547,03/10/2024,2024.0
28,Virginia (ACC),6,5-1,97,83,180,0.539,03/10/2024,2024.0
29,Delaware (CAA),5,3-2,66,59,125,0.528,03/10/2024,2024.0
30,Drexel (CAA),6,3-3,78,70,148,0.527,03/10/2024,2024.0
31,LIU (MAAC),5,4-1,64,58,122,0.525,03/10/2024,2024.0
32,Sacred Heart (MAAC),7,3-4,95,87,182,0.522,03/10/2024,2024.0
33,Richmond (Atlantic 10),6,4-2,86,80,166,0.518,03/10/2024,2024.0
34,Brown (Ivy League),5,0-5,66,64,130,0.508,03/10/2024,2024.0
35,Mercer (ASUN),5,1-4,58,57,115,0.504,03/10/2024,2024.0
36,Lafayette (Patriot),6,3-3,83,82,165,0.503,03/10/2024,2024.0
37,Cornell (Ivy League),5,3-2,84,83,167,0.503,03/10/2024,2024.0
38,Johns Hopkins (Big Ten),7,5-2,93,92,185,0.503,03/10/2024,2024.0
39,Harvard (Ivy League),6,6-0,85,89,174,0.489,03/10/2024,2024.0
40,Massachusetts (Atlantic 10),6,4-2,79,84,163,0.485,03/10/2024,2024.0
41,Stony Brook (CAA),7,3-4,101,108,209,0.483,03/10/2024,2024.0
42,Jacksonville (ASUN),6,3-3,63,68,131,0.481,03/10/2024,2024.0
43,UMBC (America East),4,1-3,48,52,100,0.480,03/10/2024,2024.0
44,Providence (Big East),7,4-3,95,104,199,0.477,03/10/2024,2024.0
45,Bellarmine (ASUN),7,4-3,80,89,169,0.473,03/10/2024,2024.0
46,Bucknell (Patriot),6,2-4,78,87,165,0.473,03/10/2024,2024.0
47,Monmouth (CAA),6,3-3,75,85,160,0.469,03/10/2024,2024.0
48,Boston U. (Patriot),6,4-2,75,87,162,0.463,03/10/2024,2024.0
49,Penn St. (Big Ten),6,5-1,81,94,175,0.463,03/10/2024,2024.0
50,St. John's (NY) (Big East),8,2-6,97,115,212,0.458,03/10/2024,2024.0
51,Marist (MAAC),6,3-3,59,72,131,0.450,03/10/2024,2024.0
52,Lehigh (Patriot),6,3-3,69,85,154,0.448,03/10/2024,2024.0
53,Robert Morris (ASUN),5,1-4,62,77,139,0.446,03/10/2024,2024.0
54,Quinnipiac (MAAC),5,5-0,60,77,137,0.438,03/10/2024,2024.0
55,Princeton (Ivy League),6,4-2,67,88,155,0.432,03/10/2024,2024.0
56,Fairfield (CAA),7,3-4,78,103,181,0.431,03/10/2024,2024.0
57,Canisius (MAAC),6,2-4,58,80,138,0.420,03/10/2024,2024.0
58,Penn (Ivy League),6,4-2,61,87,148,0.412,03/10/2024,2024.0
59,Saint Joseph's (Atlantic 10),5,2-3,55,80,135,0.407,03/10/2024,2024.0
60,Wagner (MAAC),6,1-5,52,76,128,0.406,03/10/2024,2024.0
61,Air Force (ASUN),5,1-4,49,72,121,0.405,03/10/2024,2024.0
62,Colgate (Patriot),8,5-3,95,140,235,0.404,03/10/2024,2024.0
63,Merrimack (America East),7,2-5,78,117,195,0.400,03/10/2024,2024.0
64,Cleveland St. (ASUN),6,3-3,62,94,156,0.397,03/10/2024,2024.0
65,Holy Cross (Patriot),6,2-4,58,93,151,0.384,03/10/2024,2024.0
66,St. Bonaventure (Atlantic 10),5,0-5,51,83,134,0.381,03/10/2024,2024.0
67,Loyola Maryland (Patriot),7,2-5,66,110,176,0.375,03/10/2024,2024.0
68,Siena (MAAC),6,2-4,62,105,167,0.371,03/10/2024,2024.0
69,Mount St. Mary's (MAAC),7,0-7,66,114,180,0.367,03/10/2024,2024.0
70,Manhattan (MAAC),6,1-5,49,93,142,0.345,03/10/2024,2024.0
71,Utah (ASUN),5,2-3,47,91,138,0.341,03/10/2024,2024.0
72,Detroit Mercy (ASUN),3,0-3,29,60,89,0.326,03/10/2024,2024.0
73,Hampton (CAA),6,0-6,43,130,173,0.249,03/10/2024,2024.0
-,Le Moyne (NEC),5,2-3,62,54,116,0.534,03/10/2024,2024.0
-,Queens (NC) (ASUN),4,1-3,51,51,102,0.500,03/10/2024,2024.0
-,Lindenwood (ASUN),3,0-3,31,41,72,0.431,03/10/2024,2024.0
1,Bryant (America East),6,4-2,109,50,159,0.686,03/06/2024,2024.0
2,North Carolina (ACC),5,3-2,86,46,132,0.652,03/06/2024,2024.0
3,Hobart (Atlantic 10),5,2-3,93,50,143,0.650,03/06/2024,2024.0
4,Maryland (Big Ten),5,4-1,81,45,126,0.643,03/06/2024,2024.0
5,Syracuse (ACC),7,5-2,133,77,210,0.633,03/06/2024,2024.0
6,Denver (Big East),5,5-0,86,51,137,0.628,03/06/2024,2024.0
7,NJIT (America East),6,6-0,96,59,155,0.619,03/06/2024,2024.0
8,Hofstra (CAA),6,3-3,103,66,169,0.609,03/06/2024,2024.0
9,Yale (Ivy League),3,2-1,59,38,97,0.608,03/06/2024,2024.0
10,Navy (Patriot),5,3-2,78,51,129,0.605,03/06/2024,2024.0
11,Michigan (Big Ten),6,5-1,105,71,176,0.597,03/06/2024,2024.0
12,Ohio St. (Big Ten),6,4-2,83,57,140,0.593,03/06/2024,2024.0
13,Army West Point (Patriot),5,5-0,84,59,143,0.587,03/06/2024,2024.0
14,VMI (MAAC),6,4-2,106,75,181,0.586,03/06/2024,2024.0
15,Duke (ACC),6,5-1,108,80,188,0.574,03/06/2024,2024.0
15,Binghamton (America East),5,2-3,81,60,141,0.574,03/06/2024,2024.0
15,UMass Lowell (America East),4,0-4,54,40,94,0.574,03/06/2024,2024.0
18,Villanova (Big East),5,3-2,81,61,142,0.570,03/06/2024,2024.0
19,Towson (CAA),6,4-2,81,62,143,0.566,03/06/2024,2024.0
20,Marquette (Big East),6,3-3,95,73,168,0.565,03/06/2024,2024.0
21,Notre Dame (ACC),4,3-1,62,48,110,0.564,03/06/2024,2024.0
22,UAlbany (America East),4,0-4,57,45,102,0.559,03/06/2024,2024.0
23,Virginia (ACC),5,4-1,80,64,144,0.556,03/06/2024,2024.0
24,Georgetown (Big East),6,4-2,81,65,146,0.555,03/06/2024,2024.0
25,Dartmouth (Ivy League),5,2-3,74,61,135,0.548,03/06/2024,2024.0
26,High Point (Atlantic 10),7,4-3,116,96,212,0.547,03/06/2024,2024.0
27,Johns Hopkins (Big Ten),6,5-1,84,70,154,0.545,03/06/2024,2024.0
27,Vermont (America East),5,1-4,66,55,121,0.545,03/06/2024,2024.0
29,Rutgers (Big Ten),6,5-1,87,73,160,0.544,03/06/2024,2024.0
30,LIU (MAAC),4,3-1,50,43,93,0.538,03/06/2024,2024.0
31,Sacred Heart (MAAC),6,2-4,80,72,152,0.526,03/06/2024,2024.0
32,Monmouth (CAA),5,3-2,69,64,133,0.519,03/06/2024,2024.0
33,Lafayette (Patriot),5,3-2,70,65,135,0.519,03/06/2024,2024.0
34,Massachusetts (Atlantic 10),5,4-1,69,66,135,0.511,03/06/2024,2024.0
35,Harvard (Ivy League),5,5-0,61,59,120,0.508,03/06/2024,2024.0
36,UMBC (America East),3,1-2,40,39,79,0.506,03/06/2024,2024.0
37,Mercer (ASUN),4,1-3,49,48,97,0.505,03/06/2024,2024.0
38,Richmond (Atlantic 10),5,3-2,73,72,145,0.503,03/06/2024,2024.0
39,Drexel (CAA),5,3-2,62,63,125,0.496,03/06/2024,2024.0
40,Bucknell (Patriot),5,2-3,69,71,140,0.493,03/06/2024,2024.0
41,Brown (Ivy League),4,0-4,49,51,100,0.490,03/06/2024,2024.0
42,Providence (Big East),6,3-3,83,88,171,0.485,03/06/2024,2024.0
43,Cornell (Ivy League),4,3-1,65,69,134,0.485,03/06/2024,2024.0
44,Jacksonville (ASUN),5,2-3,63,68,131,0.481,03/06/2024,2024.0
45,Bellarmine (ASUN),6,3-3,71,79,150,0.473,03/06/2024,2024.0
46,Penn St. (Big Ten),5,4-1,67,75,142,0.472,03/06/2024,2024.0
47,Stony Brook (CAA),6,3-3,85,96,181,0.470,03/06/2024,2024.0
48,Delaware (CAA),4,2-2,45,53,98,0.459,03/06/2024,2024.0
49,Marist (MAAC),5,3-2,59,72,131,0.450,03/06/2024,2024.0
50,Penn (Ivy League),5,3-2,56,69,125,0.448,03/06/2024,2024.0
51,Robert Morris (ASUN),5,1-4,62,77,139,0.446,03/06/2024,2024.0
52,St. John's (NY) (Big East),7,1-6,84,105,189,0.444,03/06/2024,2024.0
53,Lehigh (Patriot),5,2-3,57,72,129,0.442,03/06/2024,2024.0
53,Princeton (Ivy League),5,3-2,57,72,129,0.442,03/06/2024,2024.0
55,Fairfield (CAA),6,2-4,68,89,157,0.433,03/06/2024,2024.0
56,Boston U. (Patriot),5,3-2,59,78,137,0.431,03/06/2024,2024.0
57,Quinnipiac (MAAC),4,4-0,48,64,112,0.429,03/06/2024,2024.0
57,Saint Joseph's (Atlantic 10),4,1-3,48,64,112,0.429,03/06/2024,2024.0
59,Wagner (MAAC),5,0-5,52,76,128,0.406,03/06/2024,2024.0
60,Air Force (ASUN),5,1-4,49,72,121,0.405,03/06/2024,2024.0
61,Merrimack (America East),7,2-5,78,117,195,0.400,03/06/2024,2024.0
62,Canisius (MAAC),5,2-3,45,68,113,0.398,03/06/2024,2024.0
63,Holy Cross (Patriot),5,2-3,48,73,121,0.397,03/06/2024,2024.0
64,Loyola Maryland (Patriot),6,2-4,56,90,146,0.384,03/06/2024,2024.0
65,Colgate (Patriot),7,4-3,78,127,205,0.380,03/06/2024,2024.0
66,St. Bonaventure (Atlantic 10),4,0-4,42,71,113,0.372,03/06/2024,2024.0
67,Cleveland St. (ASUN),5,2-3,50,85,135,0.370,03/06/2024,2024.0
68,Mount St. Mary's (MAAC),6,0-6,57,101,158,0.361,03/06/2024,2024.0
69,Siena (MAAC),5,2-3,47,90,137,0.343,03/06/2024,2024.0
70,Utah (ASUN),5,2-3,47,91,138,0.341,03/06/2024,2024.0
71,Detroit Mercy (ASUN),3,0-3,29,60,89,0.326,03/06/2024,2024.0
72,Manhattan (MAAC),5,0-5,36,84,120,0.300,03/06/2024,2024.0
73,Hampton (CAA),6,0-6,43,130,173,0.249,03/06/2024,2024.0
-,Le Moyne (NEC),4,1-3,53,45,98,0.541,03/06/2024,2024.0
-,Queens (NC) (ASUN),4,1-3,51,51,102,0.500,03/06/2024,2024.0
-,Lindenwood (ASUN),2,0-2,19,26,45,0.422,03/06/2024,2024.0
1,Bryant (America East),5,3-2,96,38,134,0.716,03/05/2024,2024.0
2,North Carolina (ACC),5,3-2,86,46,132,0.652,03/05/2024,2024.0
3,Hobart (Atlantic 10),5,2-3,93,50,143,0.650,03/05/2024,2024.0
4,Maryland (Big Ten),5,4-1,81,45,126,0.643,03/05/2024,2024.0
5,Syracuse (ACC),7,5-2,133,77,210,0.633,03/05/2024,2024.0
6,Denver (Big East),5,5-0,86,51,137,0.628,03/05/2024,2024.0
7,NJIT (America East),6,6-0,96,59,155,0.619,03/05/2024,2024.0
8,Hofstra (CAA),6,3-3,103,66,169,0.609,03/05/2024,2024.0
9,Yale (Ivy League),3,2-1,59,38,97,0.608,03/05/2024,2024.0
10,Navy (Patriot),5,3-2,78,51,129,0.605,03/05/2024,2024.0
11,Michigan (Big Ten),6,5-1,105,71,176,0.597,03/05/2024,2024.0
12,Ohio St. (Big Ten),6,4-2,83,57,140,0.593,03/05/2024,2024.0
13,Army West Point (Patriot),5,5-0,84,59,143,0.587,03/05/2024,2024.0
14,VMI (MAAC),6,4-2,106,75,181,0.586,03/05/2024,2024.0
15,Duke (ACC),6,5-1,108,80,188,0.574,03/05/2024,2024.0
15,Binghamton (America East),5,2-3,81,60,141,0.574,03/05/2024,2024.0
15,UMass Lowell (America East),4,0-4,54,40,94,0.574,03/05/2024,2024.0
18,Villanova (Big East),5,3-2,81,61,142,0.570,03/05/2024,2024.0
19,Towson (CAA),6,4-2,81,62,143,0.566,03/05/2024,2024.0
20,Marquette (Big East),6,3-3,95,73,168,0.565,03/05/2024,2024.0
21,Notre Dame (ACC),4,3-1,62,48,110,0.564,03/05/2024,2024.0
22,UAlbany (America East),4,0-4,57,45,102,0.559,03/05/2024,2024.0
23,Virginia (ACC),5,4-1,80,64,144,0.556,03/05/2024,2024.0
24,Georgetown (Big East),6,4-2,81,65,146,0.555,03/05/2024,2024.0
25,Dartmouth (Ivy League),5,2-3,74,61,135,0.548,03/05/2024,2024.0
26,High Point (Atlantic 10),7,4-3,116,96,212,0.547,03/05/2024,2024.0
27,Johns Hopkins (Big Ten),6,5-1,84,70,154,0.545,03/05/2024,2024.0
28,Rutgers (Big Ten),6,5-1,87,73,160,0.544,03/05/2024,2024.0
29,LIU (MAAC),4,3-1,50,43,93,0.538,03/05/2024,2024.0
30,Vermont (America East),5,1-4,80,70,150,0.533,03/05/2024,2024.0
31,Sacred Heart (MAAC),6,2-4,80,72,152,0.526,03/05/2024,2024.0
32,Monmouth (CAA),5,3-2,69,64,133,0.519,03/05/2024,2024.0
33,Lafayette (Patriot),5,3-2,70,65,135,0.519,03/05/2024,2024.0
34,Massachusetts (Atlantic 10),5,4-1,69,66,135,0.511,03/05/2024,2024.0
35,Harvard (Ivy League),5,5-0,76,73,149,0.510,03/05/2024,2024.0
36,UMBC (America East),3,1-2,40,39,79,0.506,03/05/2024,2024.0
37,Mercer (ASUN),4,1-3,49,48,97,0.505,03/05/2024,2024.0
38,Richmond (Atlantic 10),5,3-2,73,72,145,0.503,03/05/2024,2024.0
39,Drexel (CAA),5,3-2,62,63,125,0.496,03/05/2024,2024.0
40,Bucknell (Patriot),5,2-3,69,71,140,0.493,03/05/2024,2024.0
41,Brown (Ivy League),4,0-4,49,51,100,0.490,03/05/2024,2024.0
42,Providence (Big East),6,3-3,83,88,171,0.485,03/05/2024,2024.0
43,Cornell (Ivy League),4,3-1,65,69,134,0.485,03/05/2024,2024.0
44,Jacksonville (ASUN),5,2-3,63,68,131,0.481,03/05/2024,2024.0
45,Bellarmine (ASUN),6,3-3,71,79,150,0.473,03/05/2024,2024.0
46,Penn St. (Big Ten),5,4-1,67,75,142,0.472,03/05/2024,2024.0
47,Stony Brook (CAA),6,3-3,85,96,181,0.470,03/05/2024,2024.0
48,Delaware (CAA),4,2-2,45,53,98,0.459,03/05/2024,2024.0
49,Marist (MAAC),5,3-2,59,72,131,0.450,03/05/2024,2024.0
50,Penn (Ivy League),5,3-2,56,69,125,0.448,03/05/2024,2024.0
51,Robert Morris (ASUN),5,1-4,62,77,139,0.446,03/05/2024,2024.0
52,St. John's (NY) (Big East),7,1-6,84,105,189,0.444,03/05/2024,2024.0
53,Lehigh (Patriot),5,2-3,57,72,129,0.442,03/05/2024,2024.0
53,Princeton (Ivy League),5,3-2,57,72,129,0.442,03/05/2024,2024.0
55,Boston U. (Patriot),5,3-2,59,78,137,0.431,03/05/2024,2024.0
56,Quinnipiac (MAAC),4,4-0,48,64,112,0.429,03/05/2024,2024.0
56,Saint Joseph's (Atlantic 10),4,1-3,48,64,112,0.429,03/05/2024,2024.0
58,Fairfield (CAA),5,2-3,56,76,132,0.424,03/05/2024,2024.0
59,Wagner (MAAC),5,0-5,52,76,128,0.406,03/05/2024,2024.0
60,Air Force (ASUN),5,1-4,49,72,121,0.405,03/05/2024,2024.0
61,Merrimack (America East),7,2-5,78,117,195,0.400,03/05/2024,2024.0
62,Canisius (MAAC),5,2-3,45,68,113,0.398,03/05/2024,2024.0
63,Holy Cross (Patriot),5,2-3,48,73,121,0.397,03/05/2024,2024.0
64,Colgate (Patriot),7,4-3,79,126,205,0.385,03/05/2024,2024.0
65,Loyola Maryland (Patriot),6,2-4,55,91,146,0.377,03/05/2024,2024.0
66,St. Bonaventure (Atlantic 10),4,0-4,42,71,113,0.372,03/05/2024,2024.0
67,Cleveland St. (ASUN),5,2-3,50,85,135,0.370,03/05/2024,2024.0
68,Mount St. Mary's (MAAC),6,0-6,57,101,158,0.361,03/05/2024,2024.0
69,Siena (MAAC),5,2-3,47,90,137,0.343,03/05/2024,2024.0
70,Utah (ASUN),5,2-3,47,91,138,0.341,03/05/2024,2024.0
71,Detroit Mercy (ASUN),3,0-3,29,60,89,0.326,03/05/2024,2024.0
72,Manhattan (MAAC),5,0-5,36,84,120,0.300,03/05/2024,2024.0
73,Hampton (CAA),6,0-6,43,130,173,0.249,03/05/2024,2024.0
-,Le Moyne (NEC),4,1-3,53,45,98,0.541,03/05/2024,2024.0
-,Queens (NC) (ASUN),4,1-3,51,51,102,0.500,03/05/2024,2024.0
-,Lindenwood (ASUN),2,0-2,19,26,45,0.422,03/05/2024,2024.0
1,Bryant (America East),5,3-2,96,38,134,0.716,03/03/2024,2024.0
2,North Carolina (ACC),5,3-2,86,46,132,0.652,03/03/2024,2024.0
3,Hobart (Atlantic 10),5,2-3,93,50,143,0.650,03/03/2024,2024.0
4,Maryland (Big Ten),5,4-1,81,45,126,0.643,03/03/2024,2024.0
5,Syracuse (ACC),7,5-2,133,77,210,0.633,03/03/2024,2024.0
6,Denver (Big East),5,5-0,86,51,137,0.628,03/03/2024,2024.0
7,NJIT (America East),6,6-0,96,59,155,0.619,03/03/2024,2024.0
8,Hofstra (CAA),6,3-3,103,66,169,0.609,03/03/2024,2024.0
9,Yale (Ivy League),3,2-1,59,38,97,0.608,03/03/2024,2024.0
10,Navy (Patriot),5,3-2,78,51,129,0.605,03/03/2024,2024.0
11,Michigan (Big Ten),6,5-1,105,71,176,0.597,03/03/2024,2024.0
12,Ohio St. (Big Ten),6,4-2,83,57,140,0.593,03/03/2024,2024.0
13,High Point (Atlantic 10),6,4-2,110,76,186,0.591,03/03/2024,2024.0
14,Army West Point (Patriot),5,5-0,84,59,143,0.587,03/03/2024,2024.0
15,VMI (MAAC),6,4-2,106,75,181,0.586,03/03/2024,2024.0
16,Duke (ACC),6,5-1,108,80,188,0.574,03/03/2024,2024.0
16,UMass Lowell (America East),4,0-4,54,40,94,0.574,03/03/2024,2024.0
18,Towson (CAA),6,4-2,81,62,143,0.566,03/03/2024,2024.0
19,Marquette (Big East),6,3-3,95,73,168,0.565,03/03/2024,2024.0
20,Notre Dame (ACC),4,3-1,62,48,110,0.564,03/03/2024,2024.0
21,UAlbany (America East),4,0-4,57,45,102,0.559,03/03/2024,2024.0
22,Drexel (CAA),4,3-1,53,42,95,0.558,03/03/2024,2024.0
23,Dartmouth (Ivy League),4,2-2,58,46,104,0.558,03/03/2024,2024.0
24,Johns Hopkins (Big Ten),6,5-1,84,70,154,0.545,03/03/2024,2024.0
25,Virginia (ACC),4,3-1,64,54,118,0.542,03/03/2024,2024.0
26,LIU (MAAC),4,3-1,50,43,93,0.538,03/03/2024,2024.0
27,Rutgers (Big Ten),5,4-1,72,62,134,0.537,03/03/2024,2024.0
28,Villanova (Big East),4,2-2,60,52,112,0.536,03/03/2024,2024.0
29,Vermont (America East),5,1-4,80,70,150,0.533,03/03/2024,2024.0
30,Binghamton (America East),4,1-3,60,53,113,0.531,03/03/2024,2024.0
31,Sacred Heart (MAAC),6,2-4,80,72,152,0.526,03/03/2024,2024.0
32,Monmouth (CAA),5,3-2,69,64,133,0.519,03/03/2024,2024.0
33,Lafayette (Patriot),5,3-2,70,65,135,0.519,03/03/2024,2024.0
34,Massachusetts (Atlantic 10),5,4-1,69,66,135,0.511,03/03/2024,2024.0
35,Harvard (Ivy League),5,5-0,76,73,149,0.510,03/03/2024,2024.0
36,Georgetown (Big East),5,3-2,61,59,120,0.508,03/03/2024,2024.0
37,UMBC (America East),3,1-2,40,39,79,0.506,03/03/2024,2024.0
38,Mercer (ASUN),4,1-3,49,48,97,0.505,03/03/2024,2024.0
39,Richmond (Atlantic 10),5,3-2,73,72,145,0.503,03/03/2024,2024.0
40,Bucknell (Patriot),5,2-3,69,71,140,0.493,03/03/2024,2024.0
41,Brown (Ivy League),4,0-4,49,51,100,0.490,03/03/2024,2024.0
42,Cornell (Ivy League),4,3-1,65,69,134,0.485,03/03/2024,2024.0
43,Jacksonville (ASUN),5,2-3,63,68,131,0.481,03/03/2024,2024.0
44,Bellarmine (ASUN),6,3-3,71,79,150,0.473,03/03/2024,2024.0
45,Penn St. (Big Ten),5,4-1,67,75,142,0.472,03/03/2024,2024.0
46,Stony Brook (CAA),5,2-3,70,80,150,0.467,03/03/2024,2024.0
47,Robert Morris (ASUN),4,1-3,52,61,113,0.460,03/03/2024,2024.0
48,Delaware (CAA),4,2-2,45,53,98,0.459,03/03/2024,2024.0
49,Marist (MAAC),5,3-2,59,72,131,0.450,03/03/2024,2024.0
50,Penn (Ivy League),5,3-2,56,69,125,0.448,03/03/2024,2024.0
51,St. John's (NY) (Big East),7,1-6,84,105,189,0.444,03/03/2024,2024.0
52,Lehigh (Patriot),5,2-3,57,72,129,0.442,03/03/2024,2024.0
52,Princeton (Ivy League),5,3-2,57,72,129,0.442,03/03/2024,2024.0
54,Providence (Big East),5,2-3,61,79,140,0.436,03/03/2024,2024.0
55,Boston U. (Patriot),5,3-2,59,78,137,0.431,03/03/2024,2024.0
56,Quinnipiac (MAAC),4,4-0,48,64,112,0.429,03/03/2024,2024.0
56,Saint Joseph's (Atlantic 10),4,1-3,48,64,112,0.429,03/03/2024,2024.0
58,Fairfield (CAA),5,2-3,56,76,132,0.424,03/03/2024,2024.0
59,Merrimack (America East),6,2-4,69,95,164,0.421,03/03/2024,2024.0
60,Wagner (MAAC),5,0-5,52,76,128,0.406,03/03/2024,2024.0
61,Air Force (ASUN),5,1-4,49,72,121,0.405,03/03/2024,2024.0
62,Canisius (MAAC),5,2-3,45,68,113,0.398,03/03/2024,2024.0
63,Holy Cross (Patriot),5,2-3,48,73,121,0.397,03/03/2024,2024.0
64,Colgate (Patriot),7,4-3,79,126,205,0.385,03/03/2024,2024.0
65,Mount St. Mary's (MAAC),5,0-5,50,80,130,0.385,03/03/2024,2024.0
66,Loyola Maryland (Patriot),6,2-4,55,91,146,0.377,03/03/2024,2024.0
67,St. Bonaventure (Atlantic 10),4,0-4,42,71,113,0.372,03/03/2024,2024.0
68,Cleveland St. (ASUN),5,2-3,50,85,135,0.370,03/03/2024,2024.0
69,Siena (MAAC),5,2-3,47,90,137,0.343,03/03/2024,2024.0
70,Utah (ASUN),5,2-3,47,91,138,0.341,03/03/2024,2024.0
71,Manhattan (MAAC),5,0-5,36,84,120,0.300,03/03/2024,2024.0
72,Detroit Mercy (ASUN),2,0-2,18,45,63,0.286,03/03/2024,2024.0
73,Hampton (CAA),6,0-6,43,130,173,0.249,03/03/2024,2024.0
-,Le Moyne (NEC),4,1-3,53,45,98,0.541,03/03/2024,2024.0
-,Queens (NC) (ASUN),4,1-3,51,51,102,0.500,03/03/2024,2024.0
-,Lindenwood (ASUN),2,0-2,19,26,45,0.422,03/03/2024,2024.0
1,Bryant (America East),4,2-2,79,32,111,0.712,02/28/2024,2024.0
2,Maryland (Big Ten),4,4-0,68,32,100,0.680,02/28/2024,2024.0
3,North Carolina (ACC),3,2-1,51,27,78,0.654,02/28/2024,2024.0
4,Syracuse (ACC),6,4-2,113,61,174,0.649,02/28/2024,2024.0
5,NJIT (America East),5,5-0,84,49,133,0.632,02/28/2024,2024.0
6,High Point (Atlantic 10),5,4-1,94,56,150,0.627,02/28/2024,2024.0
7,Hobart (Atlantic 10),4,1-3,72,43,115,0.626,02/28/2024,2024.0
8,Denver (Big East),4,4-0,71,43,114,0.623,02/28/2024,2024.0
9,UMass Lowell (America East),3,0-3,44,27,71,0.620,02/28/2024,2024.0
10,Duke (ACC),4,4-0,80,51,131,0.611,02/28/2024,2024.0
11,Yale (Ivy League),2,2-0,39,25,64,0.609,02/28/2024,2024.0
12,Hofstra (CAA),5,3-2,88,58,146,0.603,02/28/2024,2024.0
13,Michigan (Big Ten),5,4-1,91,61,152,0.599,02/28/2024,2024.0
14,Virginia (ACC),3,3-0,50,34,84,0.595,02/28/2024,2024.0
15,Ohio St. (Big Ten),5,4-1,65,45,110,0.591,02/28/2024,2024.0
16,Army West Point (Patriot),4,4-0,66,46,112,0.589,02/28/2024,2024.0
17,Notre Dame (ACC),3,2-1,49,35,84,0.583,02/28/2024,2024.0
18,Navy (Patriot),4,2-2,58,42,100,0.580,02/28/2024,2024.0
19,Rutgers (Big Ten),4,3-1,64,47,111,0.577,02/28/2024,2024.0
20,UAlbany (America East),3,0-3,43,32,75,0.573,02/28/2024,2024.0
21,Sacred Heart (MAAC),5,2-3,75,56,131,0.573,02/28/2024,2024.0
22,UMBC (America East),2,1-1,30,23,53,0.566,02/28/2024,2024.0
23,Towson (CAA),5,3-2,65,52,117,0.556,02/28/2024,2024.0
23,Binghamton (America East),3,1-2,45,36,81,0.556,02/28/2024,2024.0
25,VMI (MAAC),5,3-2,84,68,152,0.553,02/28/2024,2024.0
26,Marquette (Big East),5,3-2,81,66,147,0.551,02/28/2024,2024.0
27,Lafayette (Patriot),4,3-1,57,47,104,0.548,02/28/2024,2024.0
28,Villanova (Big East),3,1-2,47,39,86,0.547,02/28/2024,2024.0
29,Vermont (America East),4,1-3,66,55,121,0.545,02/28/2024,2024.0
30,Monmouth (CAA),4,2-2,56,48,104,0.538,02/28/2024,2024.0
31,Johns Hopkins (Big Ten),5,4-1,64,56,120,0.533,02/28/2024,2024.0
32,Robert Morris (ASUN),3,1-2,45,40,85,0.529,02/28/2024,2024.0
33,LIU (MAAC),3,2-1,37,33,70,0.529,02/28/2024,2024.0
34,Dartmouth (Ivy League),3,1-2,40,37,77,0.519,02/28/2024,2024.0
35,Massachusetts (Atlantic 10),4,3-1,56,52,108,0.519,02/28/2024,2024.0
36,Georgetown (Big East),4,2-2,51,49,100,0.510,02/28/2024,2024.0
37,Cornell (Ivy League),3,2-1,53,51,104,0.510,02/28/2024,2024.0
38,Harvard (Ivy League),4,4-0,61,59,120,0.508,02/28/2024,2024.0
39,Mercer (ASUN),4,1-3,49,48,97,0.505,02/28/2024,2024.0
40,Drexel (CAA),3,2-1,37,37,74,0.500,02/28/2024,2024.0
41,Bucknell (Patriot),4,1-3,57,58,115,0.496,02/28/2024,2024.0
42,Richmond (Atlantic 10),4,2-2,56,57,113,0.496,02/28/2024,2024.0
43,Penn St. (Big Ten),4,3-1,54,55,109,0.495,02/28/2024,2024.0
44,Delaware (CAA),3,2-1,36,37,73,0.493,02/28/2024,2024.0
45,Brown (Ivy League),3,0-3,39,41,80,0.488,02/28/2024,2024.0
46,Penn (Ivy League),3,2-1,34,36,70,0.486,02/28/2024,2024.0
47,Bellarmine (ASUN),5,2-3,60,66,126,0.476,02/28/2024,2024.0
48,Boston U. (Patriot),4,3-1,50,58,108,0.463,02/28/2024,2024.0
49,Jacksonville (ASUN),4,1-3,44,54,98,0.449,02/28/2024,2024.0
50,St. John's (NY) (Big East),6,1-5,68,87,155,0.439,02/28/2024,2024.0
51,Marist (MAAC),4,3-1,46,61,107,0.430,02/28/2024,2024.0
52,Providence (Big East),4,2-2,47,63,110,0.427,02/28/2024,2024.0
53,Lehigh (Patriot),4,2-2,44,59,103,0.427,02/28/2024,2024.0
54,Princeton (Ivy League),3,2-1,31,42,73,0.425,02/28/2024,2024.0
55,Merrimack (America East),5,2-3,54,79,133,0.406,02/28/2024,2024.0
56,Air Force (ASUN),4,1-3,37,55,92,0.402,02/28/2024,2024.0
57,Stony Brook (CAA),4,1-3,48,73,121,0.397,02/28/2024,2024.0
58,Wagner (MAAC),4,0-4,42,64,106,0.396,02/28/2024,2024.0
59,Quinnipiac (MAAC),3,3-0,32,49,81,0.395,02/28/2024,2024.0
60,Fairfield (CAA),4,1-3,40,62,102,0.392,02/28/2024,2024.0
61,Loyola Maryland (Patriot),5,2-3,44,73,117,0.376,02/28/2024,2024.0
62,Saint Joseph's (Atlantic 10),3,0-3,31,52,83,0.373,02/28/2024,2024.0
63,St. Bonaventure (Atlantic 10),4,0-4,42,71,113,0.372,02/28/2024,2024.0
64,Holy Cross (Patriot),4,2-2,35,61,96,0.365,02/28/2024,2024.0
65,Canisius (MAAC),4,2-2,33,58,91,0.363,02/28/2024,2024.0
66,Cleveland St. (ASUN),4,1-3,40,73,113,0.354,02/28/2024,2024.0
67,Colgate (Patriot),6,3-3,61,115,176,0.347,02/28/2024,2024.0
68,Siena (MAAC),4,2-2,38,72,110,0.345,02/28/2024,2024.0
69,Utah (ASUN),4,1-3,40,77,117,0.342,02/28/2024,2024.0
70,Mount St. Mary's (MAAC),4,0-4,34,67,101,0.337,02/28/2024,2024.0
71,Detroit Mercy (ASUN),1,0-1,11,23,34,0.324,02/28/2024,2024.0
72,Manhattan (MAAC),4,0-4,30,67,97,0.309,02/28/2024,2024.0
73,Hampton (CAA),5,0-5,36,108,144,0.250,02/28/2024,2024.0
-,Le Moyne (NEC),3,1-2,45,30,75,0.600,02/28/2024,2024.0
-,Queens (NC) (ASUN),4,1-3,51,51,102,0.500,02/28/2024,2024.0
-,Lindenwood (ASUN),2,0-2,19,26,45,0.422,02/28/2024,2024.0
1,Bryant (America East),4,2-2,79,32,111,0.712,02/27/2024,2024.0
2,Syracuse (ACC),5,4-1,98,45,143,0.685,02/27/2024,2024.0
3,Maryland (Big Ten),4,4-0,68,32,100,0.680,02/27/2024,2024.0
4,North Carolina (ACC),3,2-1,51,27,78,0.654,02/27/2024,2024.0
5,NJIT (America East),5,5-0,84,49,133,0.632,02/27/2024,2024.0
6,High Point (Atlantic 10),5,4-1,94,56,150,0.627,02/27/2024,2024.0
7,Hobart (Atlantic 10),4,1-3,72,43,115,0.626,02/27/2024,2024.0
8,Denver (Big East),4,4-0,71,43,114,0.623,02/27/2024,2024.0
9,UMass Lowell (America East),3,0-3,44,27,71,0.620,02/27/2024,2024.0
10,Army West Point (Patriot),3,3-0,50,31,81,0.617,02/27/2024,2024.0
11,Duke (ACC),4,4-0,80,51,131,0.611,02/27/2024,2024.0
12,Yale (Ivy League),2,2-0,39,25,64,0.609,02/27/2024,2024.0
13,Hofstra (CAA),5,3-2,88,58,146,0.603,02/27/2024,2024.0
14,Michigan (Big Ten),5,4-1,91,61,152,0.599,02/27/2024,2024.0
15,Virginia (ACC),3,3-0,50,34,84,0.595,02/27/2024,2024.0
16,Ohio St. (Big Ten),5,4-1,65,45,110,0.591,02/27/2024,2024.0
17,Notre Dame (ACC),3,2-1,49,35,84,0.583,02/27/2024,2024.0
18,Navy (Patriot),4,2-2,58,42,100,0.580,02/27/2024,2024.0
19,Rutgers (Big Ten),4,3-1,64,47,111,0.577,02/27/2024,2024.0
20,UAlbany (America East),3,0-3,43,32,75,0.573,02/27/2024,2024.0
21,Sacred Heart (MAAC),5,2-3,75,56,131,0.573,02/27/2024,2024.0
22,UMBC (America East),2,1-1,30,23,53,0.566,02/27/2024,2024.0
23,Towson (CAA),5,3-2,65,52,117,0.556,02/27/2024,2024.0
23,Binghamton (America East),3,1-2,45,36,81,0.556,02/27/2024,2024.0
25,VMI (MAAC),5,3-2,84,68,152,0.553,02/27/2024,2024.0
26,Marquette (Big East),5,3-2,81,66,147,0.551,02/27/2024,2024.0
27,Lafayette (Patriot),4,3-1,57,47,104,0.548,02/27/2024,2024.0
28,Villanova (Big East),3,1-2,47,39,86,0.547,02/27/2024,2024.0
29,Monmouth (CAA),4,2-2,56,48,104,0.538,02/27/2024,2024.0
30,Johns Hopkins (Big Ten),5,4-1,64,56,120,0.533,02/27/2024,2024.0
31,Robert Morris (ASUN),3,1-2,45,40,85,0.529,02/27/2024,2024.0
32,LIU (MAAC),3,2-1,37,33,70,0.529,02/27/2024,2024.0
33,Dartmouth (Ivy League),3,1-2,40,37,77,0.519,02/27/2024,2024.0
34,Massachusetts (Atlantic 10),4,3-1,56,52,108,0.519,02/27/2024,2024.0
35,Georgetown (Big East),4,2-2,51,49,100,0.510,02/27/2024,2024.0
36,Cornell (Ivy League),3,2-1,53,51,104,0.510,02/27/2024,2024.0
37,Harvard (Ivy League),4,4-0,61,59,120,0.508,02/27/2024,2024.0
38,Mercer (ASUN),4,1-3,49,48,97,0.505,02/27/2024,2024.0
38,Vermont (America East),4,1-3,49,48,97,0.505,02/27/2024,2024.0
40,Drexel (CAA),3,2-1,37,37,74,0.500,02/27/2024,2024.0
41,Bucknell (Patriot),4,1-3,57,58,115,0.496,02/27/2024,2024.0
42,Richmond (Atlantic 10),4,2-2,56,57,113,0.496,02/27/2024,2024.0
43,Penn St. (Big Ten),4,3-1,54,55,109,0.495,02/27/2024,2024.0
44,Delaware (CAA),3,2-1,36,37,73,0.493,02/27/2024,2024.0
45,Brown (Ivy League),3,0-3,39,41,80,0.488,02/27/2024,2024.0
46,Penn (Ivy League),3,2-1,34,36,70,0.486,02/27/2024,2024.0
47,Bellarmine (ASUN),5,2-3,60,66,126,0.476,02/27/2024,2024.0
48,Boston U. (Patriot),4,3-1,50,58,108,0.463,02/27/2024,2024.0
49,Jacksonville (ASUN),4,1-3,44,54,98,0.449,02/27/2024,2024.0
50,Marist (MAAC),4,3-1,46,61,107,0.430,02/27/2024,2024.0
51,Providence (Big East),4,2-2,47,63,110,0.427,02/27/2024,2024.0
52,Lehigh (Patriot),4,2-2,44,59,103,0.427,02/27/2024,2024.0
53,Princeton (Ivy League),3,2-1,31,42,73,0.425,02/27/2024,2024.0
54,St. John's (NY) (Big East),5,0-5,56,77,133,0.421,02/27/2024,2024.0
55,Merrimack (America East),5,2-3,54,79,133,0.406,02/27/2024,2024.0
56,Air Force (ASUN),4,1-3,37,55,92,0.402,02/27/2024,2024.0
57,Stony Brook (CAA),4,1-3,48,73,121,0.397,02/27/2024,2024.0
58,Wagner (MAAC),4,0-4,42,64,106,0.396,02/27/2024,2024.0
59,Quinnipiac (MAAC),3,3-0,32,49,81,0.395,02/27/2024,2024.0
60,Fairfield (CAA),4,1-3,40,62,102,0.392,02/27/2024,2024.0
61,Loyola Maryland (Patriot),5,2-3,44,73,117,0.376,02/27/2024,2024.0
62,Saint Joseph's (Atlantic 10),3,0-3,31,52,83,0.373,02/27/2024,2024.0
63,St. Bonaventure (Atlantic 10),4,0-4,42,71,113,0.372,02/27/2024,2024.0
64,Holy Cross (Patriot),4,2-2,35,61,96,0.365,02/27/2024,2024.0
65,Canisius (MAAC),4,2-2,33,58,91,0.363,02/27/2024,2024.0
66,Cleveland St. (ASUN),4,1-3,40,73,113,0.354,02/27/2024,2024.0
67,Siena (MAAC),3,1-2,30,56,86,0.349,02/27/2024,2024.0
68,Colgate (Patriot),6,3-3,61,115,176,0.347,02/27/2024,2024.0
69,Utah (ASUN),4,1-3,40,77,117,0.342,02/27/2024,2024.0
70,Mount St. Mary's (MAAC),4,0-4,34,67,101,0.337,02/27/2024,2024.0
71,Detroit Mercy (ASUN),1,0-1,11,23,34,0.324,02/27/2024,2024.0
72,Manhattan (MAAC),4,0-4,23,50,73,0.315,02/27/2024,2024.0
73,Hampton (CAA),5,0-5,36,108,144,0.250,02/27/2024,2024.0
-,Le Moyne (NEC),2,1-1,29,22,51,0.569,02/27/2024,2024.0
-,Queens (NC) (ASUN),3,1-2,41,39,80,0.513,02/27/2024,2024.0
-,Lindenwood (ASUN),2,0-2,19,26,45,0.422,02/27/2024,2024.0
1,Bryant (America East),4,2-2,79,32,111,0.712,02/26/2024,2024.0
2,Syracuse (ACC),5,4-1,98,45,143,0.685,02/26/2024,2024.0
3,Maryland (Big Ten),4,4-0,68,32,100,0.680,02/26/2024,2024.0
4,Hobart (Atlantic 10),3,1-2,54,28,82,0.659,02/26/2024,2024.0
5,North Carolina (ACC),3,2-1,51,27,78,0.654,02/26/2024,2024.0
6,NJIT (America East),5,5-0,84,49,133,0.632,02/26/2024,2024.0
7,High Point (Atlantic 10),5,4-1,94,56,150,0.627,02/26/2024,2024.0
8,Denver (Big East),4,4-0,71,43,114,0.623,02/26/2024,2024.0
9,UMass Lowell (America East),3,0-3,44,27,71,0.620,02/26/2024,2024.0
10,Army West Point (Patriot),3,3-0,50,31,81,0.617,02/26/2024,2024.0
11,Duke (ACC),4,4-0,80,51,131,0.611,02/26/2024,2024.0
12,Yale (Ivy League),2,2-0,39,25,64,0.609,02/26/2024,2024.0
13,Hofstra (CAA),5,3-2,88,58,146,0.603,02/26/2024,2024.0
14,Virginia (ACC),3,3-0,50,34,84,0.595,02/26/2024,2024.0
15,Ohio St. (Big Ten),5,4-1,65,45,110,0.591,02/26/2024,2024.0
16,Notre Dame (ACC),3,2-1,49,35,84,0.583,02/26/2024,2024.0
17,Navy (Patriot),4,2-2,58,42,100,0.580,02/26/2024,2024.0
18,Rutgers (Big Ten),4,3-1,64,47,111,0.577,02/26/2024,2024.0
19,UAlbany (America East),3,0-3,43,32,75,0.573,02/26/2024,2024.0
20,Sacred Heart (MAAC),5,2-3,75,56,131,0.573,02/26/2024,2024.0
21,UMBC (America East),2,1-1,30,23,53,0.566,02/26/2024,2024.0
22,Binghamton (America East),3,1-2,45,36,81,0.556,02/26/2024,2024.0
23,Towson (CAA),4,3-1,52,42,94,0.553,02/26/2024,2024.0
24,VMI (MAAC),5,3-2,84,68,152,0.553,02/26/2024,2024.0
25,Michigan (Big Ten),4,3-1,69,56,125,0.552,02/26/2024,2024.0
26,Marquette (Big East),5,3-2,81,66,147,0.551,02/26/2024,2024.0
27,Villanova (Big East),3,1-2,33,27,60,0.550,02/26/2024,2024.0
28,Jacksonville (ASUN),3,1-2,39,32,71,0.549,02/26/2024,2024.0
29,Lafayette (Patriot),4,3-1,57,47,104,0.548,02/26/2024,2024.0
30,Cornell (Ivy League),2,1-1,38,33,71,0.535,02/26/2024,2024.0
31,Johns Hopkins (Big Ten),5,4-1,64,56,120,0.533,02/26/2024,2024.0
32,Robert Morris (ASUN),3,1-2,45,40,85,0.529,02/26/2024,2024.0
33,LIU (MAAC),3,2-1,37,33,70,0.529,02/26/2024,2024.0
34,Dartmouth (Ivy League),3,1-2,40,37,77,0.519,02/26/2024,2024.0
35,Massachusetts (Atlantic 10),4,3-1,56,52,108,0.519,02/26/2024,2024.0
36,Monmouth (CAA),3,1-2,43,40,83,0.518,02/26/2024,2024.0
37,Georgetown (Big East),4,2-2,51,49,100,0.510,02/26/2024,2024.0
38,Harvard (Ivy League),3,3-0,44,43,87,0.506,02/26/2024,2024.0
39,Mercer (ASUN),4,1-3,49,48,97,0.505,02/26/2024,2024.0
39,Vermont (America East),4,1-3,49,48,97,0.505,02/26/2024,2024.0
41,Drexel (CAA),3,2-1,37,37,74,0.500,02/26/2024,2024.0
42,Bucknell (Patriot),4,1-3,57,58,115,0.496,02/26/2024,2024.0
43,Richmond (Atlantic 10),4,2-2,56,57,113,0.496,02/26/2024,2024.0
44,Penn St. (Big Ten),4,3-1,54,55,109,0.495,02/26/2024,2024.0
45,Delaware (CAA),3,2-1,36,37,73,0.493,02/26/2024,2024.0
46,Brown (Ivy League),3,0-3,39,41,80,0.488,02/26/2024,2024.0
47,Penn (Ivy League),3,2-1,34,36,70,0.486,02/26/2024,2024.0
48,Boston U. (Patriot),4,3-1,50,58,108,0.463,02/26/2024,2024.0
49,Bellarmine (ASUN),4,1-3,41,54,95,0.432,02/26/2024,2024.0
50,Marist (MAAC),4,3-1,46,61,107,0.430,02/26/2024,2024.0
51,Providence (Big East),4,2-2,47,63,110,0.427,02/26/2024,2024.0
52,Lehigh (Patriot),4,2-2,44,59,103,0.427,02/26/2024,2024.0
53,Princeton (Ivy League),3,2-1,31,42,73,0.425,02/26/2024,2024.0
54,St. John's (NY) (Big East),5,0-5,56,77,133,0.421,02/26/2024,2024.0
55,Air Force (ASUN),4,1-3,37,55,92,0.402,02/26/2024,2024.0
56,Wagner (MAAC),3,0-3,34,51,85,0.400,02/26/2024,2024.0
57,Stony Brook (CAA),4,1-3,48,73,121,0.397,02/26/2024,2024.0
58,Quinnipiac (MAAC),3,3-0,32,49,81,0.395,02/26/2024,2024.0
59,Fairfield (CAA),4,1-3,40,62,102,0.392,02/26/2024,2024.0
60,Merrimack (America East),4,2-2,38,62,100,0.380,02/26/2024,2024.0
61,Saint Joseph's (Atlantic 10),3,0-3,31,52,83,0.373,02/26/2024,2024.0
62,St. Bonaventure (Atlantic 10),4,0-4,42,71,113,0.372,02/26/2024,2024.0
63,Holy Cross (Patriot),4,2-2,35,61,96,0.365,02/26/2024,2024.0
64,Canisius (MAAC),4,2-2,33,58,91,0.363,02/26/2024,2024.0
65,Loyola Maryland (Patriot),4,1-3,34,60,94,0.362,02/26/2024,2024.0
66,Cleveland St. (ASUN),4,1-3,40,73,113,0.354,02/26/2024,2024.0
67,Siena (MAAC),3,1-2,30,56,86,0.349,02/26/2024,2024.0
68,Utah (ASUN),4,1-3,40,77,117,0.342,02/26/2024,2024.0
69,Mount St. Mary's (MAAC),4,0-4,34,67,101,0.337,02/26/2024,2024.0
70,Colgate (Patriot),6,3-3,49,101,150,0.327,02/26/2024,2024.0
71,Detroit Mercy (ASUN),1,0-1,11,23,34,0.324,02/26/2024,2024.0
72,Manhattan (MAAC),4,0-4,23,50,73,0.315,02/26/2024,2024.0
73,Hampton (CAA),4,0-4,24,89,113,0.212,02/26/2024,2024.0
-,Le Moyne (NEC),2,1-1,29,22,51,0.569,02/26/2024,2024.0
-,Queens (NC) (ASUN),3,1-2,41,39,80,0.513,02/26/2024,2024.0
-,Lindenwood (ASUN),2,0-2,19,26,45,0.422,02/26/2024,2024.0
1,Bryant (America East),4,2-2,79,32,111,0.712,02/25/2024,2024.0
2,Syracuse (ACC),5,4-1,98,45,143,0.685,02/25/2024,2024.0
3,Maryland (Big Ten),4,4-0,68,32,100,0.680,02/25/2024,2024.0
4,Hobart (Atlantic 10),3,1-2,54,28,82,0.659,02/25/2024,2024.0
5,North Carolina (ACC),3,2-1,51,27,78,0.654,02/25/2024,2024.0
6,NJIT (America East),5,5-0,84,49,133,0.632,02/25/2024,2024.0
7,High Point (Atlantic 10),5,4-1,94,56,150,0.627,02/25/2024,2024.0
8,Denver (Big East),4,4-0,71,43,114,0.623,02/25/2024,2024.0
9,UMass Lowell (America East),3,0-3,44,27,71,0.620,02/25/2024,2024.0
10,Army West Point (Patriot),3,3-0,50,31,81,0.617,02/25/2024,2024.0
11,Duke (ACC),4,4-0,80,51,131,0.611,02/25/2024,2024.0
12,Yale (Ivy League),2,2-0,39,25,64,0.609,02/25/2024,2024.0
13,Hofstra (CAA),5,3-2,88,58,146,0.603,02/25/2024,2024.0
14,Virginia (ACC),3,3-0,50,34,84,0.595,02/25/2024,2024.0
15,Ohio St. (Big Ten),5,4-1,65,45,110,0.591,02/25/2024,2024.0
16,Notre Dame (ACC),3,2-1,49,35,84,0.583,02/25/2024,2024.0
17,Navy (Patriot),4,2-2,58,42,100,0.580,02/25/2024,2024.0
18,Rutgers (Big Ten),4,3-1,64,47,111,0.577,02/25/2024,2024.0
19,UAlbany (America East),3,0-3,43,32,75,0.573,02/25/2024,2024.0
20,Sacred Heart (MAAC),5,2-3,75,56,131,0.573,02/25/2024,2024.0
21,UMBC (America East),2,1-1,30,23,53,0.566,02/25/2024,2024.0
22,Binghamton (America East),3,1-2,45,36,81,0.556,02/25/2024,2024.0
23,Towson (CAA),4,3-1,52,42,94,0.553,02/25/2024,2024.0
24,VMI (MAAC),5,3-2,84,68,152,0.553,02/25/2024,2024.0
25,Michigan (Big Ten),4,3-1,69,56,125,0.552,02/25/2024,2024.0
26,Marquette (Big East),5,3-2,81,66,147,0.551,02/25/2024,2024.0
27,Jacksonville (ASUN),3,1-2,39,32,71,0.549,02/25/2024,2024.0
28,Lafayette (Patriot),4,3-1,57,47,104,0.548,02/25/2024,2024.0
29,Villanova (Big East),3,1-2,47,39,86,0.547,02/25/2024,2024.0
30,Cornell (Ivy League),2,1-1,38,33,71,0.535,02/25/2024,2024.0
31,Johns Hopkins (Big Ten),5,4-1,64,56,120,0.533,02/25/2024,2024.0
32,Robert Morris (ASUN),3,1-2,45,40,85,0.529,02/25/2024,2024.0
33,LIU (MAAC),3,2-1,37,33,70,0.529,02/25/2024,2024.0
34,Massachusetts (Atlantic 10),4,3-1,56,52,108,0.519,02/25/2024,2024.0
35,Monmouth (CAA),3,1-2,43,40,83,0.518,02/25/2024,2024.0
36,Georgetown (Big East),4,2-2,51,49,100,0.510,02/25/2024,2024.0
37,Dartmouth (Ivy League),2,1-1,29,28,57,0.509,02/25/2024,2024.0
38,Harvard (Ivy League),3,3-0,44,43,87,0.506,02/25/2024,2024.0
39,Mercer (ASUN),4,1-3,49,48,97,0.505,02/25/2024,2024.0
39,Vermont (America East),4,1-3,49,48,97,0.505,02/25/2024,2024.0
41,Drexel (CAA),3,2-1,37,37,74,0.500,02/25/2024,2024.0
42,Bucknell (Patriot),4,1-3,57,58,115,0.496,02/25/2024,2024.0
43,Penn St. (Big Ten),4,3-1,54,55,109,0.495,02/25/2024,2024.0
44,Delaware (CAA),3,2-1,36,37,73,0.493,02/25/2024,2024.0
45,Brown (Ivy League),3,0-3,39,41,80,0.488,02/25/2024,2024.0
46,Penn (Ivy League),3,2-1,34,36,70,0.486,02/25/2024,2024.0
47,Boston U. (Patriot),4,3-1,50,58,108,0.463,02/25/2024,2024.0
48,St. John's (NY) (Big East),5,0-5,49,60,109,0.450,02/25/2024,2024.0
49,Richmond (Atlantic 10),4,2-2,39,50,89,0.438,02/25/2024,2024.0
50,Bellarmine (ASUN),4,1-3,41,54,95,0.432,02/25/2024,2024.0
51,Marist (MAAC),4,3-1,46,61,107,0.430,02/25/2024,2024.0
52,Providence (Big East),4,2-2,47,63,110,0.427,02/25/2024,2024.0
53,Princeton (Ivy League),3,2-1,31,42,73,0.425,02/25/2024,2024.0
54,Lehigh (Patriot),3,1-2,35,48,83,0.422,02/25/2024,2024.0
55,Air Force (ASUN),4,1-3,37,55,92,0.402,02/25/2024,2024.0
56,Wagner (MAAC),3,0-3,34,51,85,0.400,02/25/2024,2024.0
57,Stony Brook (CAA),4,1-3,48,73,121,0.397,02/25/2024,2024.0
58,Quinnipiac (MAAC),3,3-0,32,49,81,0.395,02/25/2024,2024.0
59,Fairfield (CAA),4,1-3,40,62,102,0.392,02/25/2024,2024.0
60,Merrimack (America East),4,2-2,38,62,100,0.380,02/25/2024,2024.0
61,Saint Joseph's (Atlantic 10),3,0-3,31,52,83,0.373,02/25/2024,2024.0
62,St. Bonaventure (Atlantic 10),4,0-4,42,71,113,0.372,02/25/2024,2024.0
63,Holy Cross (Patriot),4,2-2,35,61,96,0.365,02/25/2024,2024.0
64,Canisius (MAAC),4,2-2,33,58,91,0.363,02/25/2024,2024.0
65,Loyola Maryland (Patriot),4,1-3,34,60,94,0.362,02/25/2024,2024.0
66,Cleveland St. (ASUN),4,1-3,40,73,113,0.354,02/25/2024,2024.0
67,Siena (MAAC),3,1-2,30,56,86,0.349,02/25/2024,2024.0
68,Colgate (Patriot),6,3-3,61,115,176,0.347,02/25/2024,2024.0
69,Utah (ASUN),4,1-3,40,77,117,0.342,02/25/2024,2024.0
70,Mount St. Mary's (MAAC),4,0-4,34,67,101,0.337,02/25/2024,2024.0
71,Detroit Mercy (ASUN),1,0-1,11,23,34,0.324,02/25/2024,2024.0
72,Manhattan (MAAC),4,0-4,23,50,73,0.315,02/25/2024,2024.0
73,Hampton (CAA),4,0-4,24,89,113,0.212,02/25/2024,2024.0
-,Le Moyne (NEC),2,1-1,29,22,51,0.569,02/25/2024,2024.0
-,Queens (NC) (ASUN),3,1-2,41,39,80,0.513,02/25/2024,2024.0
-,Lindenwood (ASUN),2,0-2,19,26,45,0.422,02/25/2024,2024.0
1,Bryant (America East),3,2-1,60,24,84,0.714,02/21/2024,2024.0
2,North Carolina (ACC),2,2-0,36,16,52,0.692,02/21/2024,2024.0
3,Syracuse (ACC),5,4-1,98,45,143,0.685,02/21/2024,2024.0
4,Army West Point (Patriot),2,2-0,38,18,56,0.679,02/21/2024,2024.0
5,Cornell (Ivy League),1,1-0,23,11,34,0.676,02/21/2024,2024.0
6,Duke (ACC),3,3-0,66,34,100,0.660,02/21/2024,2024.0
7,Hobart (Atlantic 10),3,1-2,54,28,82,0.659,02/21/2024,2024.0
8,Denver (Big East),3,3-0,49,28,77,0.636,02/21/2024,2024.0
9,Ohio St. (Big Ten),4,4-0,53,31,84,0.631,02/21/2024,2024.0
10,Binghamton (America East),2,1-1,29,17,46,0.630,02/21/2024,2024.0
11,NJIT (America East),4,4-0,68,40,108,0.630,02/21/2024,2024.0
12,UMass Lowell (America East),2,0-2,30,18,48,0.625,02/21/2024,2024.0
13,Virginia (ACC),2,2-0,36,22,58,0.621,02/21/2024,2024.0
14,Maryland (Big Ten),3,3-0,47,29,76,0.618,02/21/2024,2024.0
15,Marquette (Big East),4,3-1,69,43,112,0.616,02/21/2024,2024.0
16,Delaware (CAA),2,2-0,30,19,49,0.612,02/21/2024,2024.0
17,Yale (Ivy League),2,2-0,39,25,64,0.609,02/21/2024,2024.0
18,UAlbany (America East),2,0-2,28,18,46,0.609,02/21/2024,2024.0
19,High Point (Atlantic 10),4,3-1,71,46,117,0.607,02/21/2024,2024.0
20,Sacred Heart (MAAC),4,1-3,64,43,107,0.598,02/21/2024,2024.0
21,Navy (Patriot),3,2-1,47,33,80,0.588,02/21/2024,2024.0
22,Hofstra (CAA),4,3-1,70,51,121,0.579,02/21/2024,2024.0
23,Princeton (Ivy League),2,2-0,28,21,49,0.571,02/21/2024,2024.0
24,Johns Hopkins (Big Ten),4,3-1,53,41,94,0.564,02/21/2024,2024.0
25,Georgetown (Big East),3,1-2,43,34,77,0.558,02/21/2024,2024.0
26,Notre Dame (ACC),2,2-0,34,27,61,0.557,02/21/2024,2024.0
27,Towson (CAA),3,2-1,39,31,70,0.557,02/21/2024,2024.0
28,Robert Morris (ASUN),2,1-1,36,29,65,0.554,02/21/2024,2024.0
29,Lafayette (Patriot),3,2-1,38,31,69,0.551,02/21/2024,2024.0
30,Rutgers (Big Ten),3,2-1,49,40,89,0.551,02/21/2024,2024.0
31,Villanova (Big East),2,0-2,33,27,60,0.550,02/21/2024,2024.0
31,Jacksonville (ASUN),2,1-1,22,18,40,0.550,02/21/2024,2024.0
33,Monmouth (CAA),3,1-2,43,40,83,0.518,02/21/2024,2024.0
34,VMI (MAAC),4,2-2,63,59,122,0.516,02/21/2024,2024.0
35,Michigan (Big Ten),3,2-1,46,44,90,0.511,02/21/2024,2024.0
35,Drexel (CAA),2,1-1,23,22,45,0.511,02/21/2024,2024.0
37,Bucknell (Patriot),3,1-2,45,44,89,0.506,02/21/2024,2024.0
37,Penn St. (Big Ten),3,2-1,45,44,89,0.506,02/21/2024,2024.0
39,Mercer (ASUN),3,1-2,36,36,72,0.500,02/21/2024,2024.0
39,LIU (MAAC),2,1-1,25,25,50,0.500,02/21/2024,2024.0
39,Dartmouth (Ivy League),1,0-1,16,16,32,0.500,02/21/2024,2024.0
39,UMBC (America East),1,0-1,13,13,26,0.500,02/21/2024,2024.0
43,Harvard (Ivy League),2,2-0,30,31,61,0.492,02/21/2024,2024.0
44,Marist (MAAC),3,2-1,39,43,82,0.476,02/21/2024,2024.0
45,Massachusetts (Atlantic 10),3,2-1,38,43,81,0.469,02/21/2024,2024.0
46,Boston U. (Patriot),4,3-1,50,58,108,0.463,02/21/2024,2024.0
47,St. John's (NY) (Big East),4,0-4,49,60,109,0.450,02/21/2024,2024.0
48,Brown (Ivy League),2,0-2,24,30,54,0.444,02/21/2024,2024.0
48,Quinnipiac (MAAC),2,2-0,24,30,54,0.444,02/21/2024,2024.0
50,Richmond (Atlantic 10),3,1-2,39,50,89,0.438,02/21/2024,2024.0
51,Bellarmine (ASUN),4,1-3,41,54,95,0.432,02/21/2024,2024.0
52,Providence (Big East),3,1-2,36,48,84,0.429,02/21/2024,2024.0
53,Vermont (America East),3,1-2,25,34,59,0.424,02/21/2024,2024.0
54,Lehigh (Patriot),3,1-2,35,48,83,0.422,02/21/2024,2024.0
55,Wagner (MAAC),2,0-2,24,35,59,0.407,02/21/2024,2024.0
56,Stony Brook (CAA),3,1-2,38,57,95,0.400,02/21/2024,2024.0
57,St. Bonaventure (Atlantic 10),3,0-3,33,50,83,0.398,02/21/2024,2024.0
58,Merrimack (America East),3,2-1,29,44,73,0.397,02/21/2024,2024.0
59,Cleveland St. (ASUN),3,1-2,30,50,80,0.375,02/21/2024,2024.0
59,Loyola Maryland (Patriot),3,1-2,27,45,72,0.375,02/21/2024,2024.0
61,Penn (Ivy League),2,1-1,16,30,46,0.348,02/21/2024,2024.0
62,Saint Joseph's (Atlantic 10),2,0-2,20,39,59,0.339,02/21/2024,2024.0
63,Siena (MAAC),2,0-2,21,42,63,0.333,02/21/2024,2024.0
64,Utah (ASUN),3,0-3,26,53,79,0.329,02/21/2024,2024.0
65,Colgate (Patriot),5,3-2,49,101,150,0.327,02/21/2024,2024.0
66,Mount St. Mary's (MAAC),3,0-3,24,50,74,0.324,02/21/2024,2024.0
67,Holy Cross (Patriot),3,2-1,23,48,71,0.324,02/21/2024,2024.0
68,Detroit Mercy (ASUN),1,0-1,11,23,34,0.324,02/21/2024,2024.0
69,Air Force (ASUN),3,0-3,21,45,66,0.318,02/21/2024,2024.0
70,Fairfield (CAA),3,0-3,24,52,76,0.316,02/21/2024,2024.0
71,Canisius (MAAC),3,1-2,22,49,71,0.310,02/21/2024,2024.0
72,Manhattan (MAAC),3,0-3,14,34,48,0.292,02/21/2024,2024.0
73,Hampton (CAA),3,0-3,20,68,88,0.227,02/21/2024,2024.0
-,Le Moyne (NEC),1,1-0,16,11,27,0.593,02/21/2024,2024.0
-,Lindenwood (ASUN),1,0-1,11,14,25,0.440,02/21/2024,2024.0
-,Queens (NC) (ASUN),2,0-2,20,35,55,0.364,02/21/2024,2024.0
1,Bryant (America East),3,2-1,60,24,84,0.714,02/20/2024,2024.0
2,North Carolina (ACC),2,2-0,36,16,52,0.692,02/20/2024,2024.0
3,Army West Point (Patriot),2,2-0,38,18,56,0.679,02/20/2024,2024.0
4,Cornell (Ivy League),1,1-0,23,11,34,0.676,02/20/2024,2024.0
5,Syracuse (ACC),4,3-1,77,37,114,0.675,02/20/2024,2024.0
6,NJIT (America East),3,3-0,51,26,77,0.662,02/20/2024,2024.0
7,Duke (ACC),3,3-0,66,34,100,0.660,02/20/2024,2024.0
8,Hobart (Atlantic 10),3,1-2,54,28,82,0.659,02/20/2024,2024.0
9,Denver (Big East),3,3-0,49,28,77,0.636,02/20/2024,2024.0
10,Ohio St. (Big Ten),4,4-0,53,31,84,0.631,02/20/2024,2024.0
11,Binghamton (America East),2,1-1,29,17,46,0.630,02/20/2024,2024.0
12,UMass Lowell (America East),2,0-2,30,18,48,0.625,02/20/2024,2024.0
13,Virginia (ACC),2,2-0,36,22,58,0.621,02/20/2024,2024.0
14,Maryland (Big Ten),3,3-0,47,29,76,0.618,02/20/2024,2024.0
15,Marquette (Big East),4,3-1,69,43,112,0.616,02/20/2024,2024.0
16,Delaware (CAA),2,2-0,30,19,49,0.612,02/20/2024,2024.0
17,UAlbany (America East),2,0-2,28,18,46,0.609,02/20/2024,2024.0
18,High Point (Atlantic 10),4,3-1,71,46,117,0.607,02/20/2024,2024.0
19,Navy (Patriot),3,2-1,47,33,80,0.588,02/20/2024,2024.0
20,Hofstra (CAA),4,3-1,70,51,121,0.579,02/20/2024,2024.0
21,Princeton (Ivy League),2,2-0,28,21,49,0.571,02/20/2024,2024.0
21,Yale (Ivy League),1,1-0,16,12,28,0.571,02/20/2024,2024.0
23,Johns Hopkins (Big Ten),4,3-1,53,41,94,0.564,02/20/2024,2024.0
24,Georgetown (Big East),3,1-2,43,34,77,0.558,02/20/2024,2024.0
25,Monmouth (CAA),2,1-1,29,23,52,0.558,02/20/2024,2024.0
26,Notre Dame (ACC),2,2-0,34,27,61,0.557,02/20/2024,2024.0
27,Towson (CAA),3,2-1,39,31,70,0.557,02/20/2024,2024.0
28,Robert Morris (ASUN),2,1-1,36,29,65,0.554,02/20/2024,2024.0
29,Lafayette (Patriot),3,2-1,38,31,69,0.551,02/20/2024,2024.0
30,Rutgers (Big Ten),3,2-1,49,40,89,0.551,02/20/2024,2024.0
31,Villanova (Big East),2,0-2,33,27,60,0.550,02/20/2024,2024.0
31,Jacksonville (ASUN),2,1-1,22,18,40,0.550,02/20/2024,2024.0
33,Sacred Heart (MAAC),3,0-3,44,38,82,0.537,02/20/2024,2024.0
34,VMI (MAAC),4,2-2,63,59,122,0.516,02/20/2024,2024.0
35,Michigan (Big Ten),3,2-1,46,44,90,0.511,02/20/2024,2024.0
35,Drexel (CAA),2,1-1,23,22,45,0.511,02/20/2024,2024.0
37,Bucknell (Patriot),3,1-2,45,44,89,0.506,02/20/2024,2024.0
37,Penn St. (Big Ten),3,2-1,45,44,89,0.506,02/20/2024,2024.0
39,Mercer (ASUN),3,1-2,36,36,72,0.500,02/20/2024,2024.0
39,LIU (MAAC),2,1-1,25,25,50,0.500,02/20/2024,2024.0
39,Dartmouth (Ivy League),1,0-1,16,16,32,0.500,02/20/2024,2024.0
39,UMBC (America East),1,0-1,13,13,26,0.500,02/20/2024,2024.0
43,Harvard (Ivy League),2,2-0,30,31,61,0.492,02/20/2024,2024.0
44,Brown (Ivy League),2,0-2,26,28,54,0.481,02/20/2024,2024.0
45,Marist (MAAC),3,2-1,39,43,82,0.476,02/20/2024,2024.0
46,Massachusetts (Atlantic 10),3,2-1,38,43,81,0.469,02/20/2024,2024.0
47,St. John's (NY) (Big East),4,0-4,49,60,109,0.450,02/20/2024,2024.0
48,Boston U. (Patriot),4,3-1,48,60,108,0.444,02/20/2024,2024.0
48,Quinnipiac (MAAC),2,2-0,24,30,54,0.444,02/20/2024,2024.0
50,Richmond (Atlantic 10),3,1-2,39,50,89,0.438,02/20/2024,2024.0
51,Bellarmine (ASUN),4,1-3,41,54,95,0.432,02/20/2024,2024.0
52,Providence (Big East),3,1-2,36,48,84,0.429,02/20/2024,2024.0
53,Vermont (America East),3,1-2,25,34,59,0.424,02/20/2024,2024.0
54,Lehigh (Patriot),3,1-2,35,48,83,0.422,02/20/2024,2024.0
55,Wagner (MAAC),2,0-2,24,35,59,0.407,02/20/2024,2024.0
56,Stony Brook (CAA),3,1-2,38,57,95,0.400,02/20/2024,2024.0
57,St. Bonaventure (Atlantic 10),3,0-3,33,50,83,0.398,02/20/2024,2024.0
58,Merrimack (America East),3,2-1,29,44,73,0.397,02/20/2024,2024.0
59,Fairfield (CAA),2,0-2,19,31,50,0.380,02/20/2024,2024.0
60,Cleveland St. (ASUN),3,1-2,30,50,80,0.375,02/20/2024,2024.0
60,Loyola Maryland (Patriot),3,1-2,27,45,72,0.375,02/20/2024,2024.0
62,Utah (ASUN),2,0-2,18,32,50,0.360,02/20/2024,2024.0
63,Penn (Ivy League),2,1-1,16,30,46,0.348,02/20/2024,2024.0
64,Saint Joseph's (Atlantic 10),2,0-2,20,39,59,0.339,02/20/2024,2024.0
65,Siena (MAAC),2,0-2,21,42,63,0.333,02/20/2024,2024.0
66,Mount St. Mary's (MAAC),3,0-3,24,50,74,0.324,02/20/2024,2024.0
67,Holy Cross (Patriot),3,2-1,23,48,71,0.324,02/20/2024,2024.0
68,Detroit Mercy (ASUN),1,0-1,11,23,34,0.324,02/20/2024,2024.0
69,Air Force (ASUN),3,0-3,21,45,66,0.318,02/20/2024,2024.0
70,Colgate (Patriot),4,3-1,36,78,114,0.316,02/20/2024,2024.0
71,Canisius (MAAC),3,1-2,22,49,71,0.310,02/20/2024,2024.0
72,Manhattan (MAAC),3,0-3,14,34,48,0.292,02/20/2024,2024.0
73,Hampton (CAA),3,0-3,20,68,88,0.227,02/20/2024,2024.0
-,Le Moyne (NEC),1,1-0,16,11,27,0.593,02/20/2024,2024.0
-,Lindenwood (ASUN),1,0-1,11,14,25,0.440,02/20/2024,2024.0
-,Queens (NC) (ASUN),2,0-2,20,35,55,0.364,02/20/2024,2024.0
1,Bryant (America East),2,2-0,39,15,54,0.722,02/18/2024,2024.0
2,North Carolina (ACC),2,2-0,36,16,52,0.692,02/18/2024,2024.0
3,Army West Point (Patriot),2,2-0,38,18,56,0.679,02/18/2024,2024.0
4,Harvard (Ivy League),1,1-0,21,10,31,0.677,02/18/2024,2024.0
5,Cornell (Ivy League),1,1-0,23,11,34,0.676,02/18/2024,2024.0
6,Syracuse (ACC),4,3-1,77,37,114,0.675,02/18/2024,2024.0
7,NJIT (America East),3,3-0,51,26,77,0.662,02/18/2024,2024.0
8,Duke (ACC),3,3-0,66,34,100,0.660,02/18/2024,2024.0
9,Denver (Big East),3,3-0,50,28,78,0.641,02/18/2024,2024.0
10,Ohio St. (Big Ten),4,4-0,53,31,84,0.631,02/18/2024,2024.0
11,Binghamton (America East),2,1-1,29,17,46,0.630,02/18/2024,2024.0
12,UMass Lowell (America East),2,0-2,30,18,48,0.625,02/18/2024,2024.0
12,UAlbany (America East),1,0-1,15,9,24,0.625,02/18/2024,2024.0
14,Virginia (ACC),2,2-0,36,22,58,0.621,02/18/2024,2024.0
15,Maryland (Big Ten),3,3-0,47,29,76,0.618,02/18/2024,2024.0
16,Marquette (Big East),4,3-1,69,43,112,0.616,02/18/2024,2024.0
17,Delaware (CAA),2,2-0,30,19,49,0.612,02/18/2024,2024.0
18,High Point (Atlantic 10),4,3-1,71,46,117,0.607,02/18/2024,2024.0
19,Navy (Patriot),3,2-1,47,33,80,0.588,02/18/2024,2024.0
20,Hobart (Atlantic 10),2,0-2,34,24,58,0.586,02/18/2024,2024.0
21,Lafayette (Patriot),2,1-1,29,21,50,0.580,02/18/2024,2024.0
22,Hofstra (CAA),4,3-1,70,51,121,0.579,02/18/2024,2024.0
23,Yale (Ivy League),1,1-0,16,12,28,0.571,02/18/2024,2024.0
24,Johns Hopkins (Big Ten),4,3-1,53,41,94,0.564,02/18/2024,2024.0
25,Georgetown (Big East),3,1-2,43,34,77,0.558,02/18/2024,2024.0
26,Monmouth (CAA),2,1-1,29,23,52,0.558,02/18/2024,2024.0
27,Notre Dame (ACC),2,2-0,34,27,61,0.557,02/18/2024,2024.0
28,Towson (CAA),3,2-1,39,31,70,0.557,02/18/2024,2024.0
29,Rutgers (Big Ten),3,2-1,49,40,89,0.551,02/18/2024,2024.0
30,Villanova (Big East),2,0-2,33,27,60,0.550,02/18/2024,2024.0
30,Jacksonville (ASUN),2,1-1,22,18,40,0.550,02/18/2024,2024.0
32,Princeton (Ivy League),1,1-0,13,11,24,0.542,02/18/2024,2024.0
33,Sacred Heart (MAAC),3,0-3,44,38,82,0.537,02/18/2024,2024.0
34,Michigan (Big Ten),3,2-1,46,44,90,0.511,02/18/2024,2024.0
35,Bucknell (Patriot),3,1-2,45,44,89,0.506,02/18/2024,2024.0
35,Penn St. (Big Ten),3,2-1,45,44,89,0.506,02/18/2024,2024.0
37,Mercer (ASUN),3,1-2,36,36,72,0.500,02/18/2024,2024.0
37,LIU (MAAC),2,1-1,25,25,50,0.500,02/18/2024,2024.0
37,Dartmouth (Ivy League),1,0-1,16,16,32,0.500,02/18/2024,2024.0
37,Drexel (CAA),1,1-0,13,13,26,0.500,02/18/2024,2024.0
37,UMBC (America East),1,0-1,13,13,26,0.500,02/18/2024,2024.0
37,Brown (Ivy League),1,0-1,12,12,24,0.500,02/18/2024,2024.0
43,Massachusetts (Atlantic 10),2,1-1,23,27,50,0.460,02/18/2024,2024.0
44,Marist (MAAC),2,2-0,23,28,51,0.451,02/18/2024,2024.0
45,St. John's (NY) (Big East),4,0-4,49,60,109,0.450,02/18/2024,2024.0
46,Quinnipiac (MAAC),2,2-0,24,30,54,0.444,02/18/2024,2024.0
47,VMI (MAAC),3,1-2,38,49,87,0.437,02/18/2024,2024.0
48,Providence (Big East),3,1-2,36,48,84,0.429,02/18/2024,2024.0
49,Vermont (America East),2,0-2,25,34,59,0.424,02/18/2024,2024.0
50,Bellarmine (ASUN),3,1-2,33,45,78,0.423,02/18/2024,2024.0
51,Lehigh (Patriot),3,1-2,35,48,83,0.422,02/18/2024,2024.0
52,Richmond (Atlantic 10),3,1-2,23,32,55,0.418,02/18/2024,2024.0
53,Boston U. (Patriot),3,2-1,32,46,78,0.410,02/18/2024,2024.0
54,Wagner (MAAC),2,0-2,24,35,59,0.407,02/18/2024,2024.0
55,Stony Brook (CAA),3,1-2,38,57,95,0.400,02/18/2024,2024.0
56,Merrimack (America East),3,2-1,29,44,73,0.397,02/18/2024,2024.0
57,St. Bonaventure (Atlantic 10),2,0-2,20,32,52,0.385,02/18/2024,2024.0
58,Fairfield (CAA),2,0-2,19,31,50,0.380,02/18/2024,2024.0
59,Cleveland St. (ASUN),3,1-2,30,50,80,0.375,02/18/2024,2024.0
59,Loyola Maryland (Patriot),3,1-2,27,45,72,0.375,02/18/2024,2024.0
61,Utah (ASUN),2,0-2,18,33,51,0.353,02/18/2024,2024.0
62,Saint Joseph's (Atlantic 10),2,0-2,20,39,59,0.339,02/18/2024,2024.0
63,Siena (MAAC),2,0-2,21,42,63,0.333,02/18/2024,2024.0
64,Mount St. Mary's (MAAC),3,0-3,24,50,74,0.324,02/18/2024,2024.0
65,Holy Cross (Patriot),3,2-1,23,48,71,0.324,02/18/2024,2024.0
66,Detroit Mercy (ASUN),1,0-1,11,23,34,0.324,02/18/2024,2024.0
67,Air Force (ASUN),3,0-3,21,45,66,0.318,02/18/2024,2024.0
68,Colgate (Patriot),4,3-1,36,78,114,0.316,02/18/2024,2024.0
69,Canisius (MAAC),1,0-1,9,21,30,0.300,02/18/2024,2024.0
70,Penn (Ivy League),1,0-1,7,17,24,0.292,02/18/2024,2024.0
71,Hampton (CAA),2,0-2,10,43,53,0.189,02/18/2024,2024.0
72,Manhattan (MAAC),1,0-1,4,19,23,0.174,02/18/2024,2024.0
-,Le Moyne (NEC),1,1-0,16,11,27,0.593,02/18/2024,2024.0
-,Lindenwood (ASUN),1,0-1,11,14,25,0.440,02/18/2024,2024.0
-,Queens (NC) (ASUN),2,0-2,20,35,55,0.364,02/18/2024,2024.0
1,UMass Lowell (America East),1,0-1,24,3,27,0.889,02/14/2024,2024.0
2,North Carolina (ACC),1,1-0,17,4,21,0.810,02/14/2024,2024.0
3,Syracuse (ACC),3,3-0,64,21,85,0.753,02/14/2024,2024.0
4,Delaware (CAA),1,1-0,18,6,24,0.750,02/14/2024,2024.0
5,Army West Point (Patriot),1,1-0,21,8,29,0.724,02/14/2024,2024.0
6,NJIT (America East),2,2-0,36,18,54,0.667,02/14/2024,2024.0
6,Hobart (Atlantic 10),1,0-1,20,10,30,0.667,02/14/2024,2024.0
8,Maryland (Big Ten),2,2-0,31,16,47,0.660,02/14/2024,2024.0
9,Bryant (America East),1,1-0,21,11,32,0.656,02/14/2024,2024.0
9,Villanova (Big East),1,0-1,21,11,32,0.656,02/14/2024,2024.0
9,Virginia (ACC),1,1-0,21,11,32,0.656,02/14/2024,2024.0
12,Marquette (Big East),3,3-0,53,28,81,0.654,02/14/2024,2024.0
13,Navy (Patriot),2,2-0,35,19,54,0.648,02/14/2024,2024.0
14,Monmouth (CAA),1,1-0,18,10,28,0.643,02/14/2024,2024.0
15,Ohio St. (Big Ten),3,3-0,41,23,64,0.641,02/14/2024,2024.0
16,Notre Dame (ACC),1,1-0,19,11,30,0.633,02/14/2024,2024.0
17,Rutgers (Big Ten),2,2-0,39,23,62,0.629,02/14/2024,2024.0
18,Denver (Big East),2,2-0,31,19,50,0.620,02/14/2024,2024.0
19,Duke (ACC),2,2-0,42,27,69,0.609,02/14/2024,2024.0
20,Sacred Heart (MAAC),2,0-2,35,24,59,0.593,02/14/2024,2024.0
21,Binghamton (America East),1,0-1,11,8,19,0.579,02/14/2024,2024.0
22,Johns Hopkins (Big Ten),3,2-1,40,30,70,0.571,02/14/2024,2024.0
23,Towson (CAA),2,1-1,25,19,44,0.568,02/14/2024,2024.0
24,Hofstra (CAA),3,2-1,51,40,91,0.560,02/14/2024,2024.0
25,Marist (MAAC),1,1-0,16,14,30,0.533,02/14/2024,2024.0
26,Robert Morris (ASUN),1,0-1,18,16,34,0.529,02/14/2024,2024.0
27,VMI (MAAC),2,1-1,29,26,55,0.527,02/14/2024,2024.0
28,Michigan (Big Ten),2,1-1,32,30,62,0.516,02/14/2024,2024.0
29,Bucknell (Patriot),2,0-2,29,28,57,0.509,02/14/2024,2024.0
30,Mercer (ASUN),3,1-2,36,36,72,0.500,02/14/2024,2024.0
30,Boston U. (Patriot),2,2-0,28,28,56,0.500,02/14/2024,2024.0
32,Penn St. (Big Ten),2,1-1,30,31,61,0.492,02/14/2024,2024.0
33,Georgetown (Big East),2,0-2,26,27,53,0.491,02/14/2024,2024.0
33,Providence (Big East),2,1-1,26,27,53,0.491,02/14/2024,2024.0
35,High Point (Atlantic 10),2,1-1,28,30,58,0.483,02/14/2024,2024.0
36,Saint Joseph's (Atlantic 10),1,0-1,13,15,28,0.464,02/14/2024,2024.0
37,Richmond (Atlantic 10),2,1-1,28,35,63,0.444,02/14/2024,2024.0
38,St. Bonaventure (Atlantic 10),1,0-1,11,14,25,0.440,02/14/2024,2024.0
39,Merrimack (America East),2,2-0,22,29,51,0.431,02/14/2024,2024.0
40,St. John's (NY) (Big East),3,0-3,36,48,84,0.429,02/14/2024,2024.0
41,Vermont (America East),2,0-2,25,34,59,0.424,02/14/2024,2024.0
42,Bellarmine (ASUN),3,1-2,33,45,78,0.423,02/14/2024,2024.0
43,Jacksonville (ASUN),1,1-0,8,11,19,0.421,02/14/2024,2024.0
44,Wagner (MAAC),1,0-1,13,19,32,0.406,02/14/2024,2024.0
45,Lehigh (Patriot),2,1-1,12,18,30,0.400,02/14/2024,2024.0
45,Quinnipiac (MAAC),1,1-0,12,18,30,0.400,02/14/2024,2024.0
47,Utah (ASUN),1,0-1,9,14,23,0.391,02/14/2024,2024.0
48,Cleveland St. (ASUN),3,1-2,30,50,80,0.375,02/14/2024,2024.0
49,Stony Brook (CAA),2,1-1,25,42,67,0.373,02/14/2024,2024.0
50,LIU (MAAC),1,0-1,10,18,28,0.357,02/14/2024,2024.0
51,Loyola Maryland (Patriot),2,1-1,16,32,48,0.333,02/14/2024,2024.0
52,Detroit Mercy (ASUN),1,0-1,11,23,34,0.324,02/14/2024,2024.0
53,Mount St. Mary's (MAAC),2,0-2,16,35,51,0.314,02/14/2024,2024.0
54,Siena (MAAC),1,0-1,10,23,33,0.303,02/14/2024,2024.0
55,Colgate (Patriot),3,2-1,27,63,90,0.300,02/14/2024,2024.0
55,Canisius (MAAC),1,0-1,9,21,30,0.300,02/14/2024,2024.0
57,Air Force (ASUN),2,0-2,13,33,46,0.283,02/14/2024,2024.0
58,Massachusetts (Atlantic 10),1,0-1,8,21,29,0.276,02/14/2024,2024.0
59,Hampton (CAA),1,0-1,7,20,27,0.259,02/14/2024,2024.0
60,Lafayette (Patriot),1,0-1,6,18,24,0.250,02/14/2024,2024.0
61,Holy Cross (Patriot),2,1-1,9,39,48,0.188,02/14/2024,2024.0
62,Manhattan (MAAC),1,0-1,4,19,23,0.174,02/14/2024,2024.0
-,Queens (NC) (ASUN),1,0-1,13,15,28,0.464,02/14/2024,2024.0
-,Lindenwood (ASUN),1,0-1,11,14,25,0.440,02/14/2024,2024.0
1,UMass Lowell (America East),1,0-1,24,3,27,0.889,02/13/2024,2024.0
2,North Carolina (ACC),1,1-0,17,4,21,0.810,02/13/2024,2024.0
3,Syracuse (ACC),3,3-0,64,21,85,0.753,02/13/2024,2024.0
4,Delaware (CAA),1,1-0,18,6,24,0.750,02/13/2024,2024.0
5,Army West Point (Patriot),1,1-0,21,8,29,0.724,02/13/2024,2024.0
6,NJIT (America East),2,2-0,36,18,54,0.667,02/13/2024,2024.0
6,Hobart (Atlantic 10),1,0-1,20,10,30,0.667,02/13/2024,2024.0
8,Maryland (Big Ten),2,2-0,31,16,47,0.660,02/13/2024,2024.0
9,Bryant (America East),1,1-0,21,11,32,0.656,02/13/2024,2024.0
9,Villanova (Big East),1,0-1,21,11,32,0.656,02/13/2024,2024.0
9,Virginia (ACC),1,1-0,21,11,32,0.656,02/13/2024,2024.0
12,Marquette (Big East),3,3-0,53,28,81,0.654,02/13/2024,2024.0
13,Navy (Patriot),2,2-0,35,19,54,0.648,02/13/2024,2024.0
14,Ohio St. (Big Ten),3,3-0,41,23,64,0.641,02/13/2024,2024.0
15,Rutgers (Big Ten),2,2-0,39,23,62,0.629,02/13/2024,2024.0
16,Denver (Big East),2,2-0,31,19,50,0.620,02/13/2024,2024.0
17,Duke (ACC),2,2-0,42,27,69,0.609,02/13/2024,2024.0
18,Sacred Heart (MAAC),2,0-2,35,24,59,0.593,02/13/2024,2024.0
19,Binghamton (America East),1,0-1,11,8,19,0.579,02/13/2024,2024.0
20,Johns Hopkins (Big Ten),3,2-1,40,30,70,0.571,02/13/2024,2024.0
21,Towson (CAA),2,1-1,25,19,44,0.568,02/13/2024,2024.0
22,Hofstra (CAA),3,2-1,51,40,91,0.560,02/13/2024,2024.0
23,Marist (MAAC),1,1-0,16,14,30,0.533,02/13/2024,2024.0
24,Robert Morris (ASUN),1,0-1,18,16,34,0.529,02/13/2024,2024.0
25,VMI (MAAC),2,1-1,29,26,55,0.527,02/13/2024,2024.0
26,Michigan (Big Ten),2,1-1,32,30,62,0.516,02/13/2024,2024.0
27,Bucknell (Patriot),2,0-2,29,28,57,0.509,02/13/2024,2024.0
28,Mercer (ASUN),3,1-2,36,36,72,0.500,02/13/2024,2024.0
28,Boston U. (Patriot),2,2-0,28,28,56,0.500,02/13/2024,2024.0
30,Penn St. (Big Ten),2,1-1,30,31,61,0.492,02/13/2024,2024.0
31,Georgetown (Big East),2,0-2,26,27,53,0.491,02/13/2024,2024.0
31,Providence (Big East),2,1-1,26,27,53,0.491,02/13/2024,2024.0
33,Lehigh (Patriot),2,1-1,24,25,49,0.490,02/13/2024,2024.0
34,High Point (Atlantic 10),2,1-1,28,30,58,0.483,02/13/2024,2024.0
35,Saint Joseph's (Atlantic 10),1,0-1,13,15,28,0.464,02/13/2024,2024.0
36,Richmond (Atlantic 10),2,1-1,28,35,63,0.444,02/13/2024,2024.0
37,St. Bonaventure (Atlantic 10),1,0-1,11,14,25,0.440,02/13/2024,2024.0
38,Merrimack (America East),2,2-0,22,29,51,0.431,02/13/2024,2024.0
39,St. John's (NY) (Big East),3,0-3,36,48,84,0.429,02/13/2024,2024.0
40,Vermont (America East),2,0-2,25,34,59,0.424,02/13/2024,2024.0
41,Bellarmine (ASUN),3,1-2,33,45,78,0.423,02/13/2024,2024.0
42,Jacksonville (ASUN),1,1-0,8,11,19,0.421,02/13/2024,2024.0
43,Wagner (MAAC),1,0-1,13,19,32,0.406,02/13/2024,2024.0
44,Quinnipiac (MAAC),1,1-0,12,18,30,0.400,02/13/2024,2024.0
45,Utah (ASUN),1,0-1,9,14,23,0.391,02/13/2024,2024.0
46,Cleveland St. (ASUN),2,1-1,19,31,50,0.380,02/13/2024,2024.0
47,Stony Brook (CAA),2,1-1,25,42,67,0.373,02/13/2024,2024.0
48,Fairfield (CAA),1,0-1,7,12,19,0.368,02/13/2024,2024.0
49,Loyola Maryland (Patriot),2,1-1,16,32,48,0.333,02/13/2024,2024.0
50,Detroit Mercy (ASUN),1,0-1,11,23,34,0.324,02/13/2024,2024.0
51,Mount St. Mary's (MAAC),2,0-2,16,35,51,0.314,02/13/2024,2024.0
52,Siena (MAAC),1,0-1,10,23,33,0.303,02/13/2024,2024.0
53,Colgate (Patriot),3,2-1,27,63,90,0.300,02/13/2024,2024.0
53,Canisius (MAAC),1,0-1,9,21,30,0.300,02/13/2024,2024.0
55,Air Force (ASUN),2,0-2,13,33,46,0.283,02/13/2024,2024.0
56,Massachusetts (Atlantic 10),1,0-1,8,21,29,0.276,02/13/2024,2024.0
57,Hampton (CAA),1,0-1,7,20,27,0.259,02/13/2024,2024.0
58,Lafayette (Patriot),1,0-1,6,18,24,0.250,02/13/2024,2024.0
59,Holy Cross (Patriot),2,1-1,9,39,48,0.188,02/13/2024,2024.0
60,Manhattan (MAAC),1,0-1,4,19,23,0.174,02/13/2024,2024.0
-,Queens (NC) (ASUN),1,0-1,13,15,28,0.464,02/13/2024,2024.0
-,Lindenwood (ASUN),1,0-1,11,14,25,0.440,02/13/2024,2024.0
1,UMass Lowell (America East),1,0-1,24,3,27,0.889,02/11/2024,2024.0
2,North Carolina (ACC),1,1-0,17,4,21,0.810,02/11/2024,2024.0
3,Syracuse (ACC),3,3-0,64,21,85,0.753,02/11/2024,2024.0
4,Army West Point (Patriot),1,1-0,21,8,29,0.724,02/11/2024,2024.0
5,Ohio St. (Big Ten),2,2-0,31,15,46,0.674,02/11/2024,2024.0
6,NJIT (America East),2,2-0,36,18,54,0.667,02/11/2024,2024.0
6,Hobart (Atlantic 10),1,0-1,20,10,30,0.667,02/11/2024,2024.0
8,Maryland (Big Ten),2,2-0,31,16,47,0.660,02/11/2024,2024.0
9,Bryant (America East),1,1-0,21,11,32,0.656,02/11/2024,2024.0
9,Villanova (Big East),1,0-1,21,11,32,0.656,02/11/2024,2024.0
9,Virginia (ACC),1,1-0,21,11,32,0.656,02/11/2024,2024.0
12,Navy (Patriot),2,2-0,35,19,54,0.648,02/11/2024,2024.0
13,Marquette (Big East),2,2-0,30,17,47,0.638,02/11/2024,2024.0
14,Rutgers (Big Ten),2,2-0,39,23,62,0.629,02/11/2024,2024.0
15,Denver (Big East),2,2-0,31,19,50,0.620,02/11/2024,2024.0
16,Duke (ACC),2,2-0,42,27,69,0.609,02/11/2024,2024.0
17,Sacred Heart (MAAC),2,0-2,35,24,59,0.593,02/11/2024,2024.0
18,Binghamton (America East),1,0-1,11,8,19,0.579,02/11/2024,2024.0
19,Towson (CAA),2,1-1,26,19,45,0.578,02/11/2024,2024.0
20,Johns Hopkins (Big Ten),3,2-1,40,31,71,0.563,02/11/2024,2024.0
21,Marist (MAAC),1,1-0,16,14,30,0.533,02/11/2024,2024.0
22,VMI (MAAC),2,1-1,29,26,55,0.527,02/11/2024,2024.0
23,St. John's (NY) (Big East),2,0-2,26,25,51,0.510,02/11/2024,2024.0
24,Bucknell (Patriot),2,0-2,29,28,57,0.509,02/11/2024,2024.0
25,Mercer (ASUN),3,1-2,36,36,72,0.500,02/11/2024,2024.0
25,Boston U. (Patriot),2,2-0,28,28,56,0.500,02/11/2024,2024.0
27,Penn St. (Big Ten),2,1-1,30,31,61,0.492,02/11/2024,2024.0
28,Georgetown (Big East),2,0-2,26,27,53,0.491,02/11/2024,2024.0
28,Providence (Big East),2,1-1,26,27,53,0.491,02/11/2024,2024.0
30,Lehigh (Patriot),2,1-1,24,25,49,0.490,02/11/2024,2024.0
31,High Point (Atlantic 10),2,1-1,28,30,58,0.483,02/11/2024,2024.0
31,Hofstra (CAA),2,1-1,28,30,58,0.483,02/11/2024,2024.0
33,Saint Joseph's (Atlantic 10),1,0-1,13,15,28,0.464,02/11/2024,2024.0
34,St. Bonaventure (Atlantic 10),1,0-1,11,14,25,0.440,02/11/2024,2024.0
35,Merrimack (America East),2,2-0,22,29,51,0.431,02/11/2024,2024.0
36,Vermont (America East),2,0-2,25,34,59,0.424,02/11/2024,2024.0
37,Jacksonville (ASUN),1,1-0,8,11,19,0.421,02/11/2024,2024.0
38,Bellarmine (ASUN),2,1-1,25,35,60,0.417,02/11/2024,2024.0
39,Richmond (Atlantic 10),1,0-1,12,17,29,0.414,02/11/2024,2024.0
40,Wagner (MAAC),1,0-1,13,19,32,0.406,02/11/2024,2024.0
41,Quinnipiac (MAAC),1,1-0,12,18,30,0.400,02/11/2024,2024.0
42,Utah (ASUN),1,0-1,9,14,23,0.391,02/11/2024,2024.0
43,Stony Brook (CAA),2,1-1,25,42,67,0.373,02/11/2024,2024.0
44,Fairfield (CAA),1,0-1,7,12,19,0.368,02/11/2024,2024.0
45,Cleveland St. (ASUN),2,1-1,18,32,50,0.360,02/11/2024,2024.0
46,Michigan (Big Ten),1,0-1,11,21,32,0.344,02/11/2024,2024.0
47,Loyola Maryland (Patriot),2,1-1,16,32,48,0.333,02/11/2024,2024.0
48,Mount St. Mary's (MAAC),2,0-2,16,35,51,0.314,02/11/2024,2024.0
49,Siena (MAAC),1,0-1,10,23,33,0.303,02/11/2024,2024.0
50,Colgate (Patriot),3,2-1,27,63,90,0.300,02/11/2024,2024.0
51,Air Force (ASUN),2,0-2,13,33,46,0.283,02/11/2024,2024.0
52,Massachusetts (Atlantic 10),1,0-1,8,21,29,0.276,02/11/2024,2024.0
53,Hampton (CAA),1,0-1,7,20,27,0.259,02/11/2024,2024.0
54,Holy Cross (Patriot),2,1-1,9,39,48,0.188,02/11/2024,2024.0
55,Manhattan (MAAC),1,0-1,4,19,23,0.174,02/11/2024,2024.0
-,Queens (NC) (ASUN),1,0-1,14,14,28,0.500,02/11/2024,2024.0
-,Lindenwood (ASUN),1,0-1,11,14,25,0.440,02/11/2024,2024.0
1,Marquette (Big East),1,1-0,16,6,22,0.727,02/06/2024,2024.0
2,Syracuse (ACC),2,2-0,45,17,62,0.726,02/06/2024,2024.0
3,Providence (Big East),1,1-0,15,6,21,0.714,02/06/2024,2024.0
4,Duke (ACC),1,1-0,24,11,35,0.686,02/06/2024,2024.0
5,NJIT (America East),1,1-0,14,7,21,0.667,02/06/2024,2024.0
6,Navy (Patriot),1,1-0,18,10,28,0.643,02/06/2024,2024.0
7,Mercer (ASUN),2,1-1,32,19,51,0.627,02/06/2024,2024.0
8,Ohio St. (Big Ten),1,1-0,14,9,23,0.609,02/06/2024,2024.0
9,Sacred Heart (MAAC),1,0-1,21,14,35,0.600,02/06/2024,2024.0
9,Georgetown (Big East),1,0-1,18,12,30,0.600,02/06/2024,2024.0
9,Rutgers (Big Ten),1,1-0,18,12,30,0.600,02/06/2024,2024.0
12,Hofstra (CAA),1,1-0,19,13,32,0.594,02/06/2024,2024.0
13,Maryland (Big Ten),1,1-0,17,12,29,0.586,02/06/2024,2024.0
13,Penn St. (Big Ten),1,0-1,17,12,29,0.586,02/06/2024,2024.0
15,Bucknell (Patriot),1,0-1,15,12,27,0.556,02/06/2024,2024.0
15,VMI (MAAC),1,0-1,15,12,27,0.556,02/06/2024,2024.0
17,Denver (Big East),1,1-0,14,12,26,0.538,02/06/2024,2024.0
18,Johns Hopkins (Big Ten),2,1-1,25,23,48,0.521,02/06/2024,2024.0
19,Boston U. (Patriot),1,1-0,14,14,28,0.500,02/06/2024,2024.0
19,Saint Joseph's (Atlantic 10),1,0-1,14,14,28,0.500,02/06/2024,2024.0
19,High Point (Atlantic 10),1,1-0,12,12,24,0.500,02/06/2024,2024.0
22,Cleveland St. (ASUN),1,1-0,12,15,27,0.444,02/06/2024,2024.0
22,Merrimack (America East),1,1-0,12,15,27,0.444,02/06/2024,2024.0
24,Richmond (Atlantic 10),1,0-1,12,17,29,0.414,02/06/2024,2024.0
25,Towson (CAA),1,0-1,9,13,22,0.409,02/06/2024,2024.0
26,Wagner (MAAC),1,0-1,13,19,32,0.406,02/06/2024,2024.0
27,Stony Brook (CAA),1,1-0,14,21,35,0.400,02/06/2024,2024.0
27,Lehigh (Patriot),1,0-1,12,18,30,0.400,02/06/2024,2024.0
27,Loyola Maryland (Patriot),1,1-0,12,18,30,0.400,02/06/2024,2024.0
30,Utah (ASUN),1,0-1,9,14,23,0.391,02/06/2024,2024.0
31,Mount St. Mary's (MAAC),1,0-1,10,18,28,0.357,02/06/2024,2024.0
32,St. John's (NY) (Big East),1,0-1,7,14,21,0.333,02/06/2024,2024.0
33,Vermont (America East),1,0-1,10,21,31,0.323,02/06/2024,2024.0
34,Colgate (Patriot),2,1-1,19,41,60,0.317,02/06/2024,2024.0
35,Bellarmine (ASUN),1,0-1,11,24,35,0.314,02/06/2024,2024.0
36,Holy Cross (Patriot),1,0-1,6,15,21,0.286,02/06/2024,2024.0
37,Air Force (ASUN),1,0-1,6,16,22,0.273,02/06/2024,2024.0
38,Hampton (CAA),1,0-1,7,20,27,0.259,02/06/2024,2024.0
1,Marquette (Big East),1,1-0,16,6,22,0.727,02/05/2024,2024.0
2,Syracuse (ACC),2,2-0,45,17,62,0.726,02/05/2024,2024.0
3,Providence (Big East),1,1-0,15,6,21,0.714,02/05/2024,2024.0
4,Duke (ACC),1,1-0,24,11,35,0.686,02/05/2024,2024.0
5,NJIT (America East),1,1-0,14,7,21,0.667,02/05/2024,2024.0
6,Navy (Patriot),1,1-0,18,10,28,0.643,02/05/2024,2024.0
7,Mercer (ASUN),2,1-1,32,19,51,0.627,02/05/2024,2024.0
8,Ohio St. (Big Ten),1,1-0,14,9,23,0.609,02/05/2024,2024.0
9,Sacred Heart (MAAC),1,0-1,21,14,35,0.600,02/05/2024,2024.0
9,Georgetown (Big East),1,0-1,18,12,30,0.600,02/05/2024,2024.0
9,Rutgers (Big Ten),1,1-0,18,12,30,0.600,02/05/2024,2024.0
12,Hofstra (CAA),1,1-0,19,13,32,0.594,02/05/2024,2024.0
13,Maryland (Big Ten),1,1-0,17,12,29,0.586,02/05/2024,2024.0
13,Penn St. (Big Ten),1,0-1,17,12,29,0.586,02/05/2024,2024.0
15,Bucknell (Patriot),1,0-1,15,12,27,0.556,02/05/2024,2024.0
15,VMI (MAAC),1,0-1,15,12,27,0.556,02/05/2024,2024.0
17,Denver (Big East),1,1-0,14,12,26,0.538,02/05/2024,2024.0
18,High Point (Atlantic 10),1,1-0,12,12,24,0.500,02/05/2024,2024.0
19,Johns Hopkins (Big Ten),1,0-1,12,14,26,0.462,02/05/2024,2024.0
20,Cleveland St. (ASUN),1,1-0,12,15,27,0.444,02/05/2024,2024.0
20,Merrimack (America East),1,1-0,12,15,27,0.444,02/05/2024,2024.0
22,Richmond (Atlantic 10),1,0-1,12,17,29,0.414,02/05/2024,2024.0
23,Wagner (MAAC),1,0-1,13,19,32,0.406,02/05/2024,2024.0
24,Stony Brook (CAA),1,1-0,14,21,35,0.400,02/05/2024,2024.0
24,Lehigh (Patriot),1,0-1,12,18,30,0.400,02/05/2024,2024.0
24,Loyola Maryland (Patriot),1,1-0,12,18,30,0.400,02/05/2024,2024.0
27,Utah (ASUN),1,0-1,9,14,23,0.391,02/05/2024,2024.0
28,Mount St. Mary's (MAAC),1,0-1,10,18,28,0.357,02/05/2024,2024.0
29,St. John's (NY) (Big East),1,0-1,7,14,21,0.333,02/05/2024,2024.0
30,Vermont (America East),1,0-1,10,21,31,0.323,02/05/2024,2024.0
31,Colgate (Patriot),2,1-1,19,41,60,0.317,02/05/2024,2024.0
32,Bellarmine (ASUN),1,0-1,11,24,35,0.314,02/05/2024,2024.0
33,Holy Cross (Patriot),1,0-1,6,15,21,0.286,02/05/2024,2024.0
34,Air Force (ASUN),1,0-1,6,16,22,0.273,02/05/2024,2024.0
35,Hampton (CAA),1,0-1,7,20,27,0.259,02/05/2024,2024.0
1,Marquette (Big East),1,1-0,16,6,22,0.727,02/04/2024,2024.0
2,Providence (Big East),1,1-0,15,6,21,0.714,02/04/2024,2024.0
3,Duke (ACC),1,1-0,24,11,35,0.686,02/04/2024,2024.0
4,Syracuse (ACC),1,1-0,21,10,31,0.677,02/04/2024,2024.0
5,NJIT (America East),1,1-0,14,7,21,0.667,02/04/2024,2024.0
6,Navy (Patriot),1,1-0,18,10,28,0.643,02/04/2024,2024.0
7,Mercer (ASUN),2,1-1,32,19,51,0.627,02/04/2024,2024.0
8,Ohio St. (Big Ten),1,1-0,14,9,23,0.609,02/04/2024,2024.0
9,Sacred Heart (MAAC),1,0-1,21,14,35,0.600,02/04/2024,2024.0
9,Georgetown (Big East),1,0-1,18,12,30,0.600,02/04/2024,2024.0
9,Rutgers (Big Ten),1,1-0,18,12,30,0.600,02/04/2024,2024.0
12,Hofstra (CAA),1,1-0,19,13,32,0.594,02/04/2024,2024.0
13,Maryland (Big Ten),1,1-0,17,12,29,0.586,02/04/2024,2024.0
13,Penn St. (Big Ten),1,0-1,17,12,29,0.586,02/04/2024,2024.0
15,Bucknell (Patriot),1,0-1,15,12,27,0.556,02/04/2024,2024.0
15,VMI (MAAC),1,0-1,15,12,27,0.556,02/04/2024,2024.0
17,Denver (Big East),1,1-0,14,12,26,0.538,02/04/2024,2024.0
18,High Point (Atlantic 10),1,1-0,12,12,24,0.500,02/04/2024,2024.0
19,Johns Hopkins (Big Ten),1,0-1,12,14,26,0.462,02/04/2024,2024.0
20,Cleveland St. (ASUN),1,1-0,12,15,27,0.444,02/04/2024,2024.0
20,Merrimack (America East),1,1-0,12,15,27,0.444,02/04/2024,2024.0
22,Colgate (Patriot),1,1-0,12,17,29,0.414,02/04/2024,2024.0
22,Richmond (Atlantic 10),1,0-1,12,17,29,0.414,02/04/2024,2024.0
24,Wagner (MAAC),1,0-1,13,19,32,0.406,02/04/2024,2024.0
25,Stony Brook (CAA),1,1-0,14,21,35,0.400,02/04/2024,2024.0
25,Lehigh (Patriot),1,0-1,12,18,30,0.400,02/04/2024,2024.0
25,Loyola Maryland (Patriot),1,1-0,12,18,30,0.400,02/04/2024,2024.0
28,Utah (ASUN),1,0-1,9,14,23,0.391,02/04/2024,2024.0
29,Mount St. Mary's (MAAC),1,0-1,10,18,28,0.357,02/04/2024,2024.0
30,St. John's (NY) (Big East),1,0-1,7,14,21,0.333,02/04/2024,2024.0
31,Vermont (America East),1,0-1,10,21,31,0.323,02/04/2024,2024.0
32,Bellarmine (ASUN),1,0-1,11,24,35,0.314,02/04/2024,2024.0
33,Holy Cross (Patriot),1,0-1,6,15,21,0.286,02/04/2024,2024.0
34,Air Force (ASUN),1,0-1,6,16,22,0.273,02/04/2024,2024.0
35,Hampton (CAA),1,0-1,7,20,27,0.259,02/04/2024,2024.0
